time,race1,race2,supplyUsed1,supplyUsed2,supplyMade1,supplyMade2,totalIncome1,totalIncome2,mineralsIncome1,mineralsIncome2,vespeneIncome1,vespeneIncome2,totalResources1,totalResources2,minerals1,minerals2,vespene1,vespene2,activeWorkers1,activeWorkers2,army1,army2,technology1,technology2,lostResources1,lostResources2,winner
7,2,0,13.0,13.0,15.0,15.0,335,293,335,293,0,0,40,35,40,35,0,0,12,12,0,0,0,0,0,0,0
14,2,0,14.0,14.0,15.0,15.0,671,615,671,615,0,0,70,60,70,60,0,0,13,13,0,0,0,0,0,0,0
21,2,0,14.0,14.0,15.0,15.0,727,699,727,699,0,0,5,45,5,45,0,0,13,13,0,0,0,0,0,0,0
29,2,0,15.0,15.0,15.0,15.0,727,671,727,671,0,0,45,75,45,75,0,0,14,14,0,0,0,0,0,0,0
36,2,0,16.0,15.0,23.0,15.0,839,783,839,783,0,0,150,130,150,130,0,0,15,14,0,0,0,0,0,0,0
43,2,0,16.0,16.0,23.0,23.0,867,727,867,727,0,0,50,60,50,60,0,0,15,15,0,0,0,0,0,0,0
50,2,0,17.0,16.0,23.0,23.0,839,783,839,783,0,0,15,30,15,30,0,0,16,15,0,0,0,0,0,0,0
57,2,0,18.0,17.0,23.0,23.0,895,699,895,699,0,0,30,120,30,120,0,0,17,16,0,0,0,0,0,0,0
64,2,0,19.0,18.0,23.0,23.0,895,839,895,839,0,0,135,170,135,170,0,0,18,17,0,0,0,0,0,0,0
71,2,0,19.0,18.0,23.0,23.0,973,855,951,811,22,44,249,268,245,260,4,8,18,17,0,0,0,0,0,0,0
79,2,0,20.0,19.0,23.0,23.0,939,939,895,783,44,156,363,333,355,305,8,28,19,18,0,0,0,0,0,0,0
86,2,0,20.0,19.0,23.0,23.0,967,911,923,755,44,156,86,443,70,395,16,48,19,18,0,0,150,0,0,0,0
93,2,0,20.0,20.0,23.0,23.0,1012,883,923,727,89,156,53,293,25,275,28,18,20,19,0,0,150,150,0,0,0
100,2,0,21.0,20.0,23.0,23.0,1001,911,867,755,134,156,119,403,75,365,44,38,20,19,0,0,150,150,0,0,0
107,2,0,22.0,20.0,23.0,23.0,995,934,839,755,156,179,124,108,60,50,64,58,21,19,0,0,150,150,0,0,0
114,2,0,22.0,20.0,23.0,23.0,1079,967,923,811,156,156,104,224,20,150,84,74,21,19,0,0,150,150,0,0,0
121,2,0,23.0,22.0,23.0,23.0,1079,967,923,811,156,156,229,89,125,45,104,44,22,19,0,100,150,150,0,0,0
129,2,0,25.0,22.0,31.0,23.0,1102,1107,923,951,179,156,193,134,90,70,103,64,22,19,0,100,300,150,0,0,0
136,2,0,26.0,23.0,31.0,23.0,1107,1219,839,1063,268,156,219,249,80,165,139,84,23,20,0,100,300,150,0,0,0
143,2,0,26.0,22.0,31.0,23.0,1174,1247,839,1091,335,156,60,339,35,235,25,104,23,19,0,100,300,150,0,50,0
150,2,0,29.0,23.0,31.0,31.0,1152,1270,839,1091,313,179,61,554,25,430,36,124,24,20,125,100,300,150,0,50,0
157,2,0,31.0,23.0,46.0,31.0,1180,1298,867,1119,313,179,61,204,35,110,26,94,25,21,125,200,300,150,0,50,0
164,2,0,32.0,24.0,46.0,31.0,1264,1303,951,1147,313,156,111,305,45,195,66,110,26,21,125,200,300,150,0,50,0
171,2,0,35.0,25.0,46.0,31.0,1404,1415,1091,1259,313,156,106,260,25,130,81,130,27,22,250,200,300,150,0,50,0
179,2,0,36.0,25.0,46.0,46.0,1594,1387,1259,1231,335,156,196,215,75,65,121,150,28,22,250,200,300,150,0,50,0
186,2,0,41.0,26.0,46.0,46.0,1622,1247,1287,1091,335,156,82,225,75,55,7,170,30,23,250,200,600,150,0,50,0
193,2,0,42.0,28.0,46.0,46.0,1706,1331,1371,1175,335,156,82,300,35,110,47,190,31,23,250,200,600,250,0,50,0
200,2,0,43.0,29.0,46.0,46.0,1656,1298,1343,1119,313,179,188,255,105,45,83,210,32,24,250,200,600,250,0,50,0
207,2,0,46.0,30.0,46.0,46.0,1712,1354,1399,1175,313,179,223,375,125,145,98,230,34,25,375,200,600,250,0,50,0
214,2,0,47.0,33.0,54.0,46.0,1796,1387,1483,1231,313,156,243,401,105,155,138,246,34,25,675,300,600,375,0,50,0
221,2,0,51.0,34.0,54.0,46.0,1874,1583,1539,1427,335,156,73,166,45,25,28,141,35,27,675,300,600,525,0,50,0
229,2,0,53.0,37.0,54.0,61.0,1874,1723,1539,1567,335,156,253,236,185,75,68,161,37,27,675,400,600,525,0,50,0
236,2,0,54.0,38.0,54.0,61.0,2042,1863,1707,1707,335,156,444,251,340,70,104,181,38,29,800,400,600,625,0,50,0
243,2,0,55.0,40.0,62.0,61.0,2042,1886,1707,1707,335,179,244,176,100,75,144,101,39,29,800,400,600,700,0,50,0
250,2,0,56.0,44.0,62.0,61.0,2160,1774,1847,1595,313,179,395,191,215,70,180,121,40,31,1100,500,600,850,0,50,0
257,2,0,57.0,44.0,62.0,61.0,2188,1919,1875,1763,313,156,380,187,160,75,220,112,41,31,1100,500,600,850,0,50,0
264,2,0,58.0,50.0,62.0,61.0,2244,2031,1931,1875,313,156,360,237,100,105,260,132,42,33,1100,650,750,850,0,50,0
271,2,0,60.0,52.0,70.0,61.0,2322,2311,1987,2155,335,156,335,127,135,75,200,52,44,35,1100,650,750,925,0,50,0
279,2,0,61.0,56.0,78.0,61.0,2317,2395,1959,2239,358,156,290,192,50,145,240,47,45,36,1100,700,750,925,0,50,0
286,2,0,57.0,50.0,78.0,61.0,2278,2574,1875,2351,403,223,398,504,110,425,288,79,46,38,675,450,750,925,425,400,0
293,2,0,54.0,47.0,78.0,69.0,2535,2798,1931,2463,604,335,609,669,245,550,364,119,47,39,425,200,750,925,675,700,0
300,2,0,55.0,47.0,78.0,69.0,2530,2518,1903,2183,627,335,544,644,200,485,344,159,48,38,425,125,750,925,675,950,0
307,2,0,56.0,46.0,78.0,69.0,2658,1370,1987,1035,671,335,874,535,450,340,424,195,49,36,425,175,750,925,675,1050,0
314,2,0,61.0,51.0,78.0,69.0,2541,1208,1847,895,694,313,609,311,305,180,304,131,50,39,425,275,900,925,675,1050,0
321,2,0,65.0,55.0,93.0,69.0,2546,2132,1875,1819,671,313,275,371,220,200,55,171,52,42,725,325,1150,925,675,1050,0
329,2,0,67.0,57.0,93.0,69.0,2524,2608,1875,2295,649,313,367,316,240,105,127,211,54,42,725,475,1150,925,675,1050,0
336,2,0,69.0,61.0,93.0,69.0,2748,2412,2099,2099,649,313,357,316,225,90,132,226,56,45,725,525,1400,925,675,1050,0
343,2,0,72.0,63.0,93.0,69.0,2838,2614,2211,2211,627,403,103,188,45,35,58,153,58,45,825,575,1400,925,675,1050,0
350,2,0,74.0,66.0,93.0,77.0,2978,2927,2351,2435,627,492,183,429,45,220,138,209,60,47,825,625,1400,925,675,1050,0
357,2,0,76.0,68.0,93.0,77.0,3162,3123,2491,2631,671,492,468,359,250,190,218,169,62,49,825,750,1650,1275,675,1050,0
364,2,0,83.0,72.0,93.0,77.0,3302,3045,2631,2575,671,470,374,535,180,285,194,250,65,47,925,925,1800,1275,675,1150,0
371,2,0,90.0,73.0,93.0,77.0,3224,3006,2575,2491,649,515,100,379,30,165,70,214,66,48,1275,975,2100,1275,675,1150,0
379,2,0,90.0,75.0,93.0,85.0,3454,2933,2715,2351,739,582,427,406,265,170,162,236,68,50,1275,975,2100,1425,675,1150,0
386,2,0,92.0,80.0,101.0,85.0,3571,2910,2631,2239,940,671,563,451,335,160,228,291,69,53,1450,1200,2250,1575,675,1150,0
393,2,0,98.0,84.0,109.0,85.0,3717,3050,2799,2379,918,671,390,362,200,70,190,292,69,54,1975,1200,2550,1575,675,1150,0
400,2,0,104.0,86.0,117.0,101.0,3874,3224,2911,2575,963,649,170,473,10,155,160,318,69,56,1975,1300,2550,1675,675,1150,0
407,2,0,104.0,91.0,125.0,101.0,3890,3252,2883,2603,1007,649,620,649,340,280,280,369,69,57,2500,1350,2550,2100,675,1150,0
414,2,0,104.0,99.0,125.0,101.0,3896,3510,2911,2883,985,627,471,480,75,235,396,245,69,59,3000,1475,2550,2200,675,1150,0
421,2,0,110.0,99.0,133.0,109.0,3896,3566,2911,2939,985,627,413,665,105,340,308,325,69,61,3000,1425,2550,2400,675,1200,0
429,2,0,110.0,107.0,133.0,109.0,3924,3728,2939,3079,985,649,884,205,460,175,424,30,69,63,3000,1650,2700,2400,675,1200,0
436,2,0,113.0,109.0,141.0,109.0,3795,3918,2855,3247,940,671,771,220,435,110,336,110,69,63,3000,1750,2700,2400,675,1200,0
443,2,0,123.0,110.0,141.0,125.0,3795,3913,2855,3219,940,694,576,591,120,405,456,186,69,65,3000,1775,2700,2400,675,1375,0
450,2,0,126.0,114.0,149.0,125.0,3728,3868,2743,3219,985,649,531,458,105,350,426,108,72,65,3500,2025,2700,2500,675,1425,0
457,2,0,125.0,118.0,149.0,125.0,3840,3778,2855,3107,985,671,997,597,455,455,542,142,75,67,3400,2850,2700,2500,775,1525,0
464,2,0,137.0,122.0,157.0,125.0,3806,3588,2799,2715,1007,873,852,383,190,150,662,233,75,68,3400,2850,2700,2500,775,1525,0
471,2,0,140.0,125.0,157.0,133.0,3672,3767,2687,2827,985,940,975,598,205,245,770,353,75,70,4500,2850,2700,2500,775,1525,0
479,2,0,147.0,129.0,157.0,133.0,3364,3941,2379,2911,985,1030,890,468,200,145,690,323,78,71,4500,3650,2800,2500,775,1525,0
486,2,0,147.0,133.0,180.0,133.0,3375,3896,2435,2911,940,985,1152,336,350,55,802,281,78,71,4500,3825,2800,2500,775,1525,0
493,2,0,147.0,133.0,180.0,141.0,3706,3980,2743,2995,963,985,1617,697,695,300,922,397,79,71,4500,3875,2800,2500,775,1525,0
500,2,0,157.0,140.0,180.0,141.0,3930,3851,2967,2911,963,940,823,519,135,135,688,384,79,71,4500,3875,2800,2500,775,1525,0
507,2,0,161.0,141.0,180.0,141.0,4092,3851,3107,2911,985,940,813,839,105,335,708,504,79,71,5725,4125,2800,2625,775,1525,0
514,2,0,161.0,149.0,180.0,157.0,4198,3868,3191,2883,1007,985,1205,504,385,80,820,424,79,73,5725,4575,2950,2625,775,1525,0
521,2,0,158.0,153.0,180.0,157.0,4142,3874,3135,2911,1007,963,1426,666,490,180,936,486,79,74,5425,4850,2950,2875,1075,1525,0
529,2,0,161.0,153.0,180.0,157.0,4299,4176,3135,3191,1164,985,1554,491,620,235,934,256,79,74,5925,4850,2950,2875,1075,1525,0
536,2,0,161.0,156.0,180.0,157.0,4305,4226,3051,3219,1254,1007,1645,352,705,155,940,197,79,77,5925,5150,2950,2875,1075,1525,0
543,2,0,164.0,163.0,180.0,172.0,4299,4148,3023,3163,1276,985,1865,578,915,265,950,313,79,77,5925,5150,3200,3225,1075,1525,0
550,2,0,167.0,167.0,188.0,172.0,4394,4344,3051,3359,1343,985,1995,220,1035,120,960,100,79,78,6225,5600,3450,3325,1075,1525,0
557,2,0,167.0,170.0,196.0,172.0,4299,4215,3023,3275,1276,940,2234,182,1130,120,1104,62,79,78,6225,5775,3600,3425,1075,1525,0
564,2,0,167.0,172.0,196.0,172.0,4282,4355,2939,3415,1343,940,1995,282,1035,200,960,82,79,78,6225,6125,3600,3425,1075,1525,0
571,2,0,167.0,180.0,220.0,180.0,4299,4462,3023,3499,1276,963,1308,182,200,130,1108,52,79,79,6225,6125,3600,3425,1075,1525,0
579,2,0,173.0,183.0,220.0,196.0,4148,4540,2939,3555,1209,985,1517,467,415,295,1102,172,79,80,6825,6700,3600,3425,1075,1525,0
586,2,0,173.0,185.0,220.0,196.0,4226,4081,2995,3051,1231,1030,1873,829,615,570,1258,259,79,81,6825,6700,3600,3425,1075,1525,0
593,2,0,173.0,185.0,220.0,204.0,4299,4417,3023,3275,1276,1142,2400,729,990,330,1410,399,79,81,6825,7150,3750,3425,1075,1525,0
600,2,0,177.0,189.0,236.0,220.0,4462,4333,3163,3079,1299,1254,2182,840,970,435,1212,405,79,81,7125,7500,3900,3425,1075,1525,0
607,2,0,180.0,194.0,236.0,220.0,4389,4529,3135,3275,1254,1254,2182,1125,1080,585,1102,540,79,81,7425,7625,4200,3425,1075,1525,0
614,2,0,180.0,198.0,236.0,220.0,4389,4523,3135,3247,1254,1276,2705,965,1455,615,1250,350,80,81,7425,7525,4200,3625,1075,1625,0
621,2,0,194.0,198.0,236.0,220.0,4254,4607,3023,3219,1231,1388,968,1495,695,985,273,510,80,81,7200,7750,4950,3625,1300,1625,0
629,2,0,198.0,199.0,236.0,220.0,4254,4618,3023,3275,1231,1343,976,714,805,260,171,454,80,81,9950,8200,4950,3625,1300,1625,0
636,2,0,196.0,199.0,236.0,220.0,4310,4322,3079,3023,1231,1299,1503,906,1180,450,323,456,80,81,10150,8200,4950,3775,1400,1625,0
643,2,0,196.0,194.0,236.0,205.0,4042,4036,2743,2827,1299,1209,1955,1385,1480,785,475,600,80,76,10450,8250,4950,4075,1400,2575,0
650,2,0,194.0,187.0,236.0,205.0,3834,3386,2603,2379,1231,1007,2414,1629,1795,905,619,724,80,66,10200,8250,4950,4300,1650,3075,0
657,2,0,184.0,187.0,251.0,205.0,4114,3190,2883,2183,1231,1007,2922,2014,2155,1170,767,844,80,68,8950,8850,4950,4300,2900,3075,0
664,2,0,184.0,190.0,251.0,197.0,4383,3252,3107,2267,1276,985,3139,2005,2220,1145,919,860,80,69,8950,8850,4950,4300,2900,3175,0
671,2,0,198.0,190.0,251.0,197.0,4372,3218,3163,2211,1209,1007,2578,1285,1515,805,1063,480,80,69,9500,8850,4950,4300,3150,3175,0
679,2,0,198.0,190.0,251.0,197.0,4534,3185,3303,2155,1231,1030,3114,1325,1895,900,1219,425,80,71,9500,8900,4950,4525,3150,3325,0
686,2,0,196.0,187.0,251.0,197.0,4518,3302,3219,2295,1299,1007,3649,1676,2270,1135,1379,541,80,69,9325,8800,4950,4525,3325,3625,0
693,2,0,196.0,181.0,251.0,197.0,4674,3358,3331,2351,1343,1007,4119,2317,2580,1810,1539,507,80,62,9325,8800,4950,4525,3325,3600,0
700,2,0,196.0,189.0,251.0,197.0,4434,3286,3135,2323,1299,963,4632,1014,2945,845,1687,169,80,63,9325,8800,4950,4525,3325,3750,0
707,2,0,196.0,192.0,251.0,197.0,4624,3151,3303,2211,1321,940,4679,889,2840,750,1839,139,80,63,9325,8800,5100,4525,3325,3750,0
714,2,0,197.0,190.0,259.0,197.0,4462,2916,3163,1931,1299,985,4710,1139,2965,880,1745,259,80,61,9075,8800,5250,4525,3575,3850,0
721,2,0,197.0,194.0,259.0,197.0,4501,2888,3247,1903,1254,985,4862,1285,2965,960,1897,325,80,61,9075,8800,5550,4525,3575,3850,0
729,2,0,197.0,190.0,259.0,189.0,4333,2961,3079,1931,1254,1030,5232,1411,3175,1070,2057,341,80,60,9075,8500,5550,4725,3575,4300,0
736,2,0,193.0,183.0,267.0,189.0,4456,2843,3135,1903,1321,940,5768,1604,3555,1234,2213,370,80,59,9025,8050,5550,4625,3925,4831,0
743,2,0,191.0,177.0,275.0,181.0,4590,2530,3247,1679,1343,851,6323,1893,3950,1419,2373,474,80,57,8925,8775,5550,4625,4025,5406,0
750,2,0,172.0,148.0,275.0,173.0,4568,2468,3247,1707,1321,761,5956,2209,3885,1639,2071,570,80,57,7250,7425,5550,4625,5700,7156,0
757,2,0,186.0,146.0,275.0,173.0,4518,2664,3219,1903,1299,761,4448,1646,2675,1309,1773,337,80,57,6050,6475,5550,4625,6900,8106,0
764,2,0,174.0,151.0,275.0,173.0,4389,2574,3135,1791,1254,783,4446,1143,2725,1064,1721,79,80,57,6700,6475,5550,4625,8000,8106,0
771,2,0,182.0,155.0,275.0,203.0,4081,2457,2827,1651,1254,806,4262,1121,2585,1004,1677,117,80,56,7400,6525,5700,4625,8000,8156,0
779,2,0,182.0,156.0,275.0,203.0,4294,2378,2995,1595,1299,783,4372,1288,2535,1079,1837,209,80,58,7700,6700,6000,4625,8300,8206,0
786,2,0,200.0,161.0,275.0,203.0,4310,2546,2967,1651,1343,895,2987,1350,1440,1075,1547,275,80,58,7600,6950,6000,4625,8400,8256,0
793,2,0,200.0,152.0,290.0,195.0,4344,2154,3023,1259,1321,895,3495,1563,1800,1180,1695,383,80,52,8600,7200,6000,4625,8400,8831,0
800,2,0,196.0,153.0,290.0,195.0,4316,1774,2995,1035,1321,739,4012,1312,2165,995,1847,317,80,49,8850,7800,6000,4625,8750,8981,0
807,2,0,199.0,153.0,290.0,195.0,4495,1863,3219,1035,1276,828,3214,1470,1740,1045,1474,425,80,49,8850,8350,6400,4625,8750,8981,0
814,2,0,195.0,147.0,290.0,195.0,4501,2485,3247,1455,1254,1030,3445,1163,1965,860,1480,303,80,51,8650,7625,6900,4625,8950,9906,0
821,2,0,167.0,111.0,290.0,195.0,4579,2451,3303,1399,1276,1052,4010,1447,2370,1020,1640,427,80,53,6875,4750,6900,4625,10825,12781,0
7,2,0,13.0,13.0,15.0,15.0,251,293,251,293,0,0,30,35,30,35,0,0,12,12,0,0,0,0,0,0,0
14,2,0,14.0,14.0,15.0,15.0,671,671,671,671,0,0,70,70,70,70,0,0,13,13,0,0,0,0,0,0,0
21,2,0,14.0,14.0,15.0,15.0,755,699,755,699,0,0,50,50,50,50,0,0,13,13,0,0,0,0,0,0,0
29,2,0,15.0,15.0,15.0,15.0,783,699,783,699,0,0,90,40,90,40,0,0,14,14,0,0,0,0,0,0,0
36,2,0,15.0,15.0,23.0,15.0,839,755,839,755,0,0,150,135,150,135,0,0,14,14,0,0,0,0,0,0,0
43,2,0,16.0,16.0,23.0,23.0,867,783,867,783,0,0,40,75,40,75,0,0,15,15,0,0,0,0,0,0,0
50,2,0,17.0,16.0,23.0,23.0,867,839,867,839,0,0,65,45,65,45,0,0,16,15,0,0,0,0,0,0,0
57,2,0,18.0,17.0,23.0,23.0,867,783,867,783,0,0,130,40,130,40,0,0,17,16,0,0,0,0,0,0,0
64,2,0,19.0,18.0,23.0,23.0,951,867,951,867,0,0,190,140,190,140,0,0,18,17,0,0,0,0,0,0,0
71,2,0,19.0,18.0,23.0,23.0,973,883,951,839,22,44,304,238,300,230,4,8,18,17,0,0,0,0,0,0,0
79,2,0,20.0,19.0,23.0,23.0,1090,883,979,727,111,156,390,338,370,310,20,28,19,18,0,0,0,0,0,0,0
86,2,0,20.0,19.0,23.0,23.0,1057,967,923,811,134,156,361,463,325,415,36,48,19,18,0,0,150,0,0,0,0
93,2,0,21.0,20.0,23.0,23.0,1085,962,951,783,134,179,442,363,390,295,52,68,20,19,0,0,150,150,0,0,0
100,2,0,21.0,20.0,23.0,23.0,1107,990,951,811,156,179,177,478,105,390,72,88,21,19,0,0,150,150,0,0,0
107,2,0,22.0,20.0,23.0,23.0,1079,995,923,839,156,156,148,199,60,95,88,104,21,19,0,50,150,150,0,0,0
114,2,0,22.0,20.0,23.0,23.0,1135,967,979,811,156,156,208,314,100,190,108,124,21,19,0,50,150,150,0,0,0
121,2,0,25.0,21.0,31.0,23.0,1107,939,951,783,156,156,163,124,60,80,103,44,22,19,0,50,300,150,0,0,0
129,2,0,25.0,21.0,31.0,23.0,1135,995,979,839,156,156,143,154,70,140,73,14,22,20,0,50,300,150,0,0,0
136,2,0,26.0,22.0,31.0,23.0,1130,990,951,811,179,179,282,139,185,105,97,34,23,20,0,50,300,150,0,0,0
143,2,0,29.0,22.0,31.0,23.0,1298,1046,1007,867,291,179,238,119,205,65,33,54,24,20,125,50,300,150,0,0,0
150,2,0,30.0,23.0,31.0,23.0,1286,1107,951,951,335,156,188,270,115,200,73,70,25,21,125,50,300,150,0,0,0
157,2,0,30.0,24.0,31.0,31.0,1292,1191,979,1035,313,156,284,360,175,270,109,90,25,22,125,50,300,150,0,0,0
164,2,0,31.0,24.0,31.0,31.0,1292,1163,979,1007,313,156,279,495,180,385,99,110,26,22,125,50,300,500,0,0,0
171,2,0,34.0,29.0,46.0,31.0,1348,1303,1035,1147,313,156,79,70,40,40,39,30,26,23,275,50,300,600,0,0,0
179,2,0,36.0,29.0,46.0,46.0,1370,1331,1035,1175,335,156,204,80,125,30,79,50,28,23,275,50,300,600,0,0,0
186,2,0,37.0,30.0,46.0,46.0,1566,1270,1231,1091,335,179,340,165,225,95,115,70,30,24,275,50,300,600,0,0,0
193,2,0,38.0,30.0,46.0,46.0,1650,1326,1315,1147,335,179,440,335,285,245,155,90,30,24,275,250,300,600,0,0,0
200,2,0,41.0,35.0,46.0,46.0,1656,1326,1343,1147,313,179,216,250,75,140,141,110,31,25,450,250,450,600,0,0,0
207,2,0,42.0,38.0,46.0,46.0,1712,1449,1399,1203,313,246,366,112,185,95,181,17,32,25,450,250,700,850,0,0,0
214,2,0,43.0,38.0,46.0,46.0,1740,1712,1427,1399,313,313,136,342,15,285,121,57,33,26,450,250,700,850,0,0,0
221,2,0,44.0,40.0,46.0,46.0,1852,1790,1539,1455,313,335,252,342,95,245,157,97,34,27,450,450,700,925,0,0,0
229,2,0,45.0,45.0,46.0,46.0,1936,1964,1623,1651,313,313,437,213,240,205,197,8,36,28,625,450,800,925,0,0,0
236,2,0,46.0,45.0,46.0,46.0,2009,1930,1651,1595,358,335,617,123,380,75,237,48,37,29,625,650,800,925,0,0,0
243,2,0,51.0,47.0,54.0,54.0,2070,1964,1735,1651,335,313,363,144,190,60,173,84,37,29,975,650,900,925,0,0,0
250,2,0,52.0,49.0,54.0,54.0,2048,1852,1735,1539,313,313,544,244,335,120,209,124,38,29,975,750,1050,925,0,0,0
257,2,0,52.0,51.0,54.0,54.0,2048,1880,1735,1567,313,313,264,274,165,110,99,164,39,31,975,750,1300,925,50,0,0
264,2,0,51.0,51.0,62.0,54.0,1919,1986,1651,1651,268,335,391,519,335,315,56,204,40,31,825,1025,1300,925,200,100,0
271,2,0,53.0,54.0,62.0,62.0,1914,2014,1623,1679,291,335,502,254,410,135,92,119,40,33,825,1025,1300,925,200,100,0
279,2,0,53.0,56.0,70.0,62.0,1774,1958,1483,1623,291,335,269,380,145,225,124,155,40,33,825,1025,1300,925,200,100,0
286,2,0,57.0,60.0,70.0,62.0,2020,2098,1707,1763,313,335,294,310,180,165,114,145,42,35,1100,1125,1300,1225,200,100,0
293,2,0,58.0,58.0,70.0,62.0,2182,2160,1735,1847,447,313,510,466,340,285,170,181,43,35,1100,1025,1300,1225,200,200,0
300,2,0,59.0,62.0,70.0,62.0,2322,2188,1875,1875,447,313,221,561,145,340,76,221,44,37,1100,1400,1300,1350,200,200,0
307,2,0,63.0,62.0,70.0,62.0,2266,2266,1819,1931,447,335,123,586,95,375,28,211,45,37,1100,1300,1300,1500,200,300,0
314,2,0,65.0,66.0,70.0,70.0,2322,2322,1875,1987,447,335,150,351,70,300,80,51,46,39,1450,1300,1300,1500,200,300,0
321,2,0,67.0,68.0,70.0,70.0,2154,2143,1707,1763,447,380,357,314,225,265,132,49,48,39,1450,1400,1300,1500,200,300,0
329,2,0,67.0,70.0,70.0,70.0,2334,2334,1819,1819,515,515,651,416,455,311,196,105,48,41,1450,1525,1300,1500,200,300,0
336,2,0,68.0,70.0,70.0,70.0,2451,2250,1847,1735,604,515,758,227,540,174,218,53,50,41,1525,1750,1450,1500,300,300,0
343,2,0,70.0,78.0,78.0,78.0,2395,2429,1791,1959,604,470,656,306,470,210,186,96,50,43,1525,1750,1450,1500,300,300,0
350,2,0,77.0,78.0,93.0,78.0,2485,2317,1903,1847,582,470,98,171,40,115,58,56,52,43,1525,1750,1750,1500,300,300,0
357,2,0,79.0,78.0,93.0,78.0,2625,2406,2043,1847,582,559,80,153,50,75,30,78,52,45,1525,1850,1750,1600,300,300,0
364,2,0,82.0,78.0,101.0,78.0,2658,2608,2099,1959,559,649,304,248,210,115,94,133,55,45,1525,2100,1750,1600,300,300,0
371,2,0,83.0,90.0,101.0,94.0,2821,2714,2239,2043,582,671,300,329,130,145,170,184,56,45,1525,2100,1750,1600,300,300,0
379,2,0,86.0,94.0,101.0,94.0,2978,2686,2351,2015,627,671,141,239,95,175,46,64,58,47,1525,2100,1750,1600,300,300,0
386,2,0,87.0,94.0,101.0,94.0,3084,2748,2435,2099,649,649,362,366,240,230,122,136,58,47,2200,2200,1750,1600,300,300,0
393,2,0,89.0,98.0,101.0,110.0,3028,2496,2379,1847,649,649,457,466,305,300,152,166,60,47,2375,2550,1900,1600,300,400,0
400,2,0,96.0,102.0,101.0,110.0,3269,2586,2575,1959,694,627,287,507,255,365,32,142,61,47,2375,2550,2050,1500,300,425,0
407,2,0,96.0,100.0,101.0,118.0,3218,2608,2547,1959,671,649,683,837,575,615,108,222,62,47,2375,2950,2050,1500,300,525,0
414,2,0,96.0,99.0,109.0,118.0,3336,2698,2687,2071,649,627,1070,763,890,465,180,298,62,47,2375,3100,2150,1500,300,575,0
421,2,0,104.0,110.0,109.0,118.0,3286,2770,2659,2099,627,671,1061,303,805,175,256,128,62,46,2375,3350,2450,1500,300,625,0
429,2,0,102.0,110.0,109.0,118.0,3286,2877,2659,2183,627,694,1461,368,1125,210,336,158,62,46,2650,3150,2450,1500,425,825,0
436,2,0,102.0,110.0,109.0,118.0,3314,2888,2687,2239,627,649,856,405,640,175,216,230,62,48,2300,3250,2450,1500,775,825,0
443,2,0,108.0,112.0,109.0,118.0,3291,2698,2687,2071,604,627,648,401,360,195,288,206,62,48,3000,3450,2450,1500,775,825,0
450,2,0,108.0,116.0,109.0,118.0,3336,2692,2687,2043,649,649,544,521,180,285,364,236,62,48,3000,4100,2450,1500,775,825,0
457,2,0,108.0,118.0,109.0,118.0,3330,2664,2659,2015,671,649,940,286,500,20,440,266,62,50,3000,4100,2450,1500,775,825,0
464,2,0,108.0,118.0,117.0,118.0,3252,2586,2603,1959,649,627,1327,217,815,75,512,142,62,50,3000,4100,2450,1500,775,825,0
471,2,0,120.0,118.0,141.0,118.0,3286,2602,2659,1931,627,671,929,227,445,55,484,172,62,50,3600,4250,2450,1500,775,875,0
479,2,0,120.0,118.0,141.0,118.0,3202,2748,2575,2099,627,649,474,449,60,230,414,219,62,50,4100,4375,2450,1500,775,875,0
486,2,0,120.0,133.0,141.0,134.0,3297,2636,2715,1987,582,649,771,389,285,140,486,249,62,51,4100,4375,2750,1800,775,875,0
493,2,0,120.0,134.0,149.0,149.0,3207,2642,2603,2015,604,627,1157,620,595,295,562,325,62,51,4100,4375,3050,1800,775,875,0
500,2,0,136.0,135.0,165.0,149.0,3274,2496,2603,1847,671,649,747,640,105,310,642,330,62,52,4500,4475,3050,2000,775,875,0
507,2,0,139.0,141.0,165.0,165.0,3112,2692,2463,2043,649,649,954,295,240,135,714,160,62,54,4900,4925,3200,2000,775,875,0
514,2,0,137.0,145.0,165.0,165.0,2804,3078,2155,2407,649,671,955,281,165,170,790,111,63,55,4900,5325,3400,2075,875,875,0
521,2,0,138.0,143.0,180.0,165.0,2412,3162,1763,2491,649,671,1096,256,230,215,866,41,61,56,4900,5125,3400,2075,975,1075,0
529,2,0,143.0,143.0,180.0,165.0,2558,3336,1931,2687,627,649,1097,668,155,555,942,113,60,56,4900,5225,3400,2075,1025,1075,0
536,2,0,143.0,147.0,180.0,165.0,2972,3370,2323,2743,649,627,1327,484,305,295,1022,189,63,58,5200,5775,3400,2175,1025,1075,0
543,2,0,149.0,145.0,180.0,165.0,3190,3140,2519,2491,671,649,1222,864,320,595,902,269,63,58,5200,5950,3700,2175,1025,1175,0
550,2,0,148.0,145.0,180.0,165.0,3280,3196,2631,2547,649,649,1298,1249,320,900,978,349,63,58,5000,6150,4000,2175,1225,1175,0
557,2,0,146.0,150.0,180.0,173.0,3168,3118,2519,2491,649,627,1684,530,630,355,1054,175,63,58,4900,6050,4000,2175,1325,1275,0
564,2,0,158.0,151.0,180.0,181.0,3386,3241,2715,2435,671,806,389,834,105,555,284,279,66,58,4900,6000,4150,2175,1325,1325,0
571,2,0,150.0,146.0,180.0,181.0,3286,3230,2659,2267,627,963,771,1226,415,835,356,391,66,61,5250,5725,4150,2175,1725,1425,0
579,2,0,151.0,150.0,172.0,181.0,3202,3314,2575,2351,627,963,956,1287,520,830,436,457,63,61,6000,5725,4300,2175,1975,1425,0
586,2,0,150.0,150.0,172.0,181.0,2776,3291,2127,2351,649,940,976,1163,460,665,516,498,62,61,6000,5950,4300,2175,2025,1750,0
593,2,0,144.0,148.0,172.0,181.0,2686,3258,2015,2295,671,963,1296,1563,700,945,596,618,66,61,6000,5875,4050,2175,2275,1925,0
600,2,0,158.0,153.0,180.0,181.0,2983,3224,2379,2239,604,985,449,1038,135,475,314,563,66,61,6000,6100,4050,2175,2275,1925,0
607,2,0,157.0,151.0,196.0,181.0,3515,3241,2911,2211,604,1030,717,1419,335,740,382,679,66,61,6950,6000,4050,2175,2550,2275,0
614,2,0,161.0,153.0,196.0,181.0,3510,3078,2883,2071,627,1007,633,1475,425,680,208,795,66,61,6950,5900,4050,2175,2550,2475,0
621,2,0,163.0,159.0,196.0,181.0,3566,3090,2939,2127,627,963,415,993,260,290,155,703,69,61,7700,6125,4050,2175,2550,2475,0
629,2,0,166.0,163.0,196.0,181.0,3622,3650,2995,2687,627,963,170,1468,85,645,85,823,69,64,7700,6425,4050,2300,2550,2475,0
636,2,0,166.0,167.0,196.0,196.0,3666,3627,2995,2687,671,940,590,1249,425,410,165,839,69,64,7700,6425,4050,2300,2550,2475,0
643,2,0,160.0,161.0,204.0,196.0,3728,3678,3079,2715,649,963,1046,1709,805,750,241,959,72,67,7400,5950,4550,2300,2850,3075,0
650,2,0,174.0,161.0,204.0,196.0,3728,3812,3079,2827,649,985,187,2165,170,1090,17,1075,72,69,7800,6475,4550,2550,3150,3075,0
657,2,0,178.0,170.0,204.0,196.0,3750,3941,3079,2911,671,1030,352,2110,305,990,47,1120,72,69,7800,6625,4550,2875,3150,3075,0
664,2,0,180.0,161.0,204.0,196.0,3728,3778,3079,2771,649,1007,578,2187,455,1005,123,1182,72,59,8075,6625,4550,2875,3250,3575,0
671,2,0,178.0,162.0,204.0,196.0,3812,2490,2939,1707,873,783,1053,2457,810,1195,243,1262,74,59,7825,6775,4550,3025,3500,3575,0
679,2,0,188.0,168.0,204.0,196.0,4019,2877,3079,2183,940,694,664,1331,555,685,109,646,74,59,9300,7150,4550,3325,3500,3575,0
686,2,0,182.0,165.0,204.0,196.0,3907,3437,2967,2743,940,694,826,1175,755,695,71,480,74,59,8550,7025,4550,3325,4250,3750,0
693,2,0,174.0,165.0,204.0,196.0,4075,3011,3135,2295,940,716,1313,888,1130,570,183,318,74,59,7850,6950,4550,3325,4950,3875,0
700,2,0,150.0,147.0,219.0,196.0,3913,2927,2995,2211,918,716,1762,1232,1475,830,287,402,74,59,6200,5900,4550,3250,6600,5400,0
707,2,0,163.0,155.0,219.0,196.0,4019,2978,3079,2239,940,739,553,980,450,715,103,265,74,59,7050,6050,4550,3250,7200,5525,0
714,2,0,168.0,158.0,219.0,196.0,3913,2810,2995,2071,918,739,466,1149,405,800,61,349,74,59,7050,6150,4550,3350,7200,5525,0
721,2,0,169.0,161.0,219.0,196.0,3801,2737,2883,1819,918,918,872,849,695,480,177,369,79,62,7050,6250,4550,3350,7200,5525,0
729,2,0,173.0,167.0,219.0,196.0,3851,2670,2911,1707,940,963,838,1160,795,675,43,485,79,62,7050,6925,4550,3350,7200,5525,0
736,2,0,173.0,169.0,211.0,196.0,3913,2776,2883,1791,1030,985,1283,1505,1120,900,163,605,80,62,7550,7600,4550,3350,7300,5525,0
743,2,0,189.0,173.0,211.0,196.0,3952,2922,2967,1959,985,963,555,1331,280,685,275,646,80,62,8900,7725,4550,3350,7300,5575,0
750,2,0,189.0,171.0,211.0,196.0,4092,3106,3107,2099,985,1007,1032,1407,645,795,387,612,80,62,8900,7625,4550,3450,7300,5800,0
757,2,0,181.0,166.0,211.0,196.0,4019,2994,3079,1987,940,1007,1524,1382,1025,700,499,682,80,61,8200,7275,4550,3450,8000,7025,0
764,2,0,159.0,143.0,211.0,196.0,4243,1942,3303,1091,940,851,2029,1050,1410,355,619,695,80,58,6725,5600,4550,3450,9475,8975,0
771,2,0,119.0,117.0,211.0,196.0,4350,1785,3387,1091,963,694,2563,740,1820,40,743,700,80,56,3300,3875,4800,3450,12900,10975,0
779,2,0,130.0,120.0,211.0,196.0,4467,1796,3415,1147,1052,649,1561,865,840,85,721,780,80,56,3150,3850,4800,3450,14050,11425,0
786,2,0,128.0,123.0,211.0,196.0,4490,1796,3415,1147,1075,649,2101,983,1260,123,841,860,80,56,3050,4175,4800,3450,14150,11425,0
793,2,0,129.0,123.0,211.0,196.0,4562,1998,3443,1371,1119,627,2493,962,1520,58,973,904,80,53,2950,4400,4800,3450,14250,11625,0
800,2,0,135.0,121.0,211.0,181.0,4518,2126,3331,1455,1187,671,1284,1200,675,220,609,980,83,52,2050,4500,4800,3450,15150,12737,0
807,2,0,119.0,124.0,211.0,181.0,4523,2345,3359,1651,1164,694,1219,918,770,108,449,810,83,52,2600,4575,4800,3450,16350,12787,0
814,2,0,124.0,124.0,203.0,181.0,4473,2210,3331,1651,1142,559,1308,1169,915,303,393,866,83,52,3050,4800,4800,3450,16550,12787,0
821,2,0,121.0,132.0,203.0,181.0,4462,1874,3275,1539,1187,335,1441,934,900,78,541,856,83,52,2750,4925,4800,3550,16850,12787,0
829,2,0,135.0,127.0,203.0,181.0,4557,1852,3303,1427,1254,425,994,1150,305,238,689,912,84,52,3450,4650,4800,3550,17150,13062,0
836,2,0,125.0,125.0,203.0,181.0,4618,1930,3387,1483,1231,447,1024,850,395,128,629,722,84,53,2875,5025,4800,3550,17725,13237,0
843,2,0,121.0,124.0,203.0,181.0,4630,2188,3443,1651,1187,537,1561,953,800,188,761,765,84,53,2975,5175,4800,3550,18225,13487,0
850,2,0,138.0,126.0,203.0,181.0,4680,2160,3471,1623,1209,537,1139,848,230,73,909,775,83,53,2800,4900,4650,3550,18600,13812,0
857,2,0,136.0,120.0,203.0,181.0,4613,2132,3471,1595,1142,537,1675,1123,630,288,1045,835,83,53,3625,4600,4650,3550,19175,14162,0
864,2,0,137.0,126.0,195.0,181.0,4635,2384,3471,1847,1164,537,2193,1068,1000,223,1193,845,83,53,3625,4825,4650,3550,19275,14162,0
871,2,0,137.0,130.0,195.0,181.0,4708,2507,3499,2015,1209,492,2516,914,1300,163,1216,751,83,53,3375,5075,4650,3550,19525,14162,0
879,2,0,137.0,128.0,195.0,181.0,4674,3011,3443,2519,1231,492,2066,1323,1110,508,956,815,84,53,3325,4875,4650,3550,19825,14362,0
886,2,0,155.0,137.0,195.0,181.0,4568,3151,3359,2659,1209,492,1041,927,395,298,646,629,84,53,4900,5225,4650,3550,19825,14362,0
893,2,0,161.0,145.0,195.0,181.0,4484,3532,3275,2883,1209,649,1566,861,780,223,786,638,84,53,5400,5225,4650,3550,19825,14362,0
900,2,0,161.0,139.0,195.0,181.0,4378,3907,3191,3191,1187,716,2095,1167,1165,478,930,689,84,53,5400,5450,4650,3550,19825,14837,0
907,2,0,161.0,140.0,195.0,181.0,4025,4002,2883,3331,1142,671,2570,1098,1500,408,1070,690,84,51,5400,5450,4650,3550,19825,14937,0
914,2,0,179.0,145.0,195.0,181.0,3958,3672,2771,3023,1187,649,2053,1084,835,443,1218,641,84,47,6150,6425,4650,3650,20075,15137,0
921,2,0,177.0,149.0,195.0,181.0,4053,2849,2799,2267,1254,582,2131,1031,765,368,1366,663,84,47,6050,6700,4650,3650,20175,15137,0
929,2,0,157.0,137.0,195.0,181.0,4092,1718,2883,1091,1209,627,2622,1177,1120,434,1502,743,84,47,4775,6025,4650,3650,21150,16037,0
936,2,0,158.0,145.0,195.0,181.0,3991,1718,2883,1091,1108,627,1479,774,155,34,1324,740,84,47,5100,6350,4650,3650,22325,16362,0
943,2,0,153.0,141.0,195.0,181.0,3991,1690,2939,1063,1052,627,1852,960,450,144,1402,816,84,47,5125,6250,4650,3650,22800,16587,0
950,2,0,139.0,127.0,195.0,181.0,4058,2070,3051,1399,1007,671,2337,1221,815,329,1522,892,84,47,4350,5350,4650,3650,23575,17637,0
957,2,0,155.0,135.0,195.0,181.0,4036,1830,3051,1203,985,627,1896,978,250,64,1646,914,84,47,5150,5850,4650,3650,23675,17637,0
964,2,0,140.0,126.0,195.0,181.0,3851,1802,2799,1175,1052,627,2109,1149,460,159,1649,990,84,47,4425,5100,4650,3650,24950,18387,0
971,2,0,130.0,107.0,195.0,181.0,4070,1947,2995,1343,1075,604,2583,1381,810,319,1773,1062,84,47,3850,3750,4650,3650,25325,19837,0
979,2,0,125.0,102.0,195.0,181.0,3907,2031,2911,1427,996,604,1642,1067,155,154,1487,913,84,47,2375,3300,4650,3650,26800,20687,0
986,2,0,129.0,106.0,195.0,181.0,3790,1858,2883,1231,907,627,1487,1048,200,84,1287,964,84,47,3600,3300,4650,3650,26975,20687,0
993,2,0,131.0,102.0,210.0,181.0,3896,2222,3023,1595,873,627,1705,1349,435,309,1270,1040,84,47,3850,3125,4650,3650,26975,20912,0
1000,2,0,139.0,97.0,210.0,181.0,3846,2350,2995,1679,851,671,650,1300,30,234,620,1066,84,47,3425,2650,4650,3650,27400,21562,0
1007,2,0,139.0,97.0,210.0,181.0,3930,2927,3079,2323,851,604,1144,1634,420,504,724,1130,84,47,4925,3225,4650,3650,27400,21562,0
1014,2,0,139.0,110.0,210.0,181.0,4036,2910,3163,2463,873,447,1522,1091,690,184,832,907,84,47,4925,3225,4650,3650,27400,21562,0
1021,2,0,137.0,114.0,210.0,181.0,4014,2216,3051,1791,963,425,1988,1063,1040,129,948,934,84,47,5275,3575,4650,3650,27650,21562,0
1029,2,0,148.0,114.0,210.0,181.0,3924,2524,2939,2099,985,425,1483,1410,815,424,668,986,83,47,5275,3725,4650,3650,27700,21562,0
1036,2,0,144.0,120.0,218.0,181.0,4092,2910,3107,2463,985,447,1370,1252,890,289,480,963,83,47,4775,3900,4650,3650,28200,21712,0
1043,2,0,154.0,126.0,218.0,181.0,4232,2922,3247,2519,985,403,1076,1231,480,274,596,957,83,47,4025,4075,4650,3550,28950,21862,0
1050,2,0,158.0,126.0,218.0,181.0,4187,2950,3247,2547,940,403,1388,1234,680,279,708,955,83,47,5025,4475,4650,3550,28950,21862,0
1057,2,0,158.0,139.0,218.0,181.0,4154,2502,3191,2099,963,403,1493,1112,665,184,828,928,83,47,5025,5100,4650,3550,28950,21912,0
1064,2,0,158.0,145.0,218.0,181.0,4058,2446,3051,2043,1007,403,1628,1009,880,79,748,930,83,47,5025,5350,4650,3550,28950,21912,0
1071,2,0,184.0,150.0,218.0,181.0,4114,2698,3107,2295,1007,403,1124,857,260,104,864,753,83,47,7025,5500,4650,3550,28950,21912,0
1079,2,0,184.0,156.0,218.0,181.0,4070,2642,3107,2239,963,403,1611,614,635,59,976,555,83,47,7025,6125,4650,3550,28950,21912,0
1086,2,0,172.0,154.0,218.0,181.0,4120,2754,3135,2351,985,403,2107,938,1015,339,1092,599,83,47,6275,6375,4650,3550,29700,22012,0
1093,2,0,186.0,147.0,195.0,181.0,3756,2020,2883,1595,873,425,1037,1121,145,474,892,647,81,40,6025,6425,4650,3550,30550,22362,0
1100,2,0,194.0,146.0,195.0,166.0,3118,1348,2491,923,627,425,1303,1284,335,589,968,695,81,39,7625,6525,4650,3350,30550,23322,0
1107,2,0,182.0,143.0,195.0,166.0,3056,1270,2407,867,649,403,1383,732,485,239,898,493,79,37,7125,6975,5000,3350,31150,23922,0
1114,2,0,182.0,139.0,195.0,166.0,3151,1214,2491,811,660,403,1737,870,765,329,972,541,79,37,7125,6575,5000,3350,31150,24322,0
1121,2,0,194.0,143.0,195.0,166.0,3011,990,2463,699,548,291,1057,582,325,209,732,373,79,37,7125,6575,5000,3350,31150,24322,0
1129,2,0,187.0,136.0,187.0,166.0,2658,962,2211,671,447,291,1356,707,580,294,776,413,79,37,7525,6300,4850,3350,32050,24622,0
1136,2,0,183.0,135.0,179.0,166.0,2272,1096,1959,783,313,313,1627,843,815,394,812,449,79,37,7775,6800,4850,3350,32000,24672,0
1143,2,0,183.0,138.0,179.0,166.0,2037,1326,1791,1035,246,291,1871,685,1035,329,836,356,79,37,7775,6800,4850,3350,32000,24672,0
1150,2,0,192.0,140.0,194.0,166.0,2177,1152,1931,839,246,313,887,266,640,124,247,142,78,37,7775,7075,4850,3350,32050,24797,0
1157,2,0,194.0,140.0,179.0,166.0,2278,1466,1987,1175,291,291,378,462,295,284,83,178,76,37,8925,7075,4850,3350,32650,24797,0
1164,2,0,186.0,130.0,179.0,166.0,2334,1645,2043,1399,291,246,664,660,545,454,119,206,76,31,8525,6925,4850,3250,33050,25417,0
1171,2,0,174.0,121.0,179.0,166.0,2423,1023,2211,979,212,44,761,485,620,404,141,81,76,21,7925,7150,4850,3250,33650,25967,0
1179,2,0,166.0,112.0,179.0,166.0,2317,727,2183,727,134,0,1027,565,870,484,157,81,76,12,7525,7700,4850,3250,34050,26492,0
1186,2,0,164.0,108.0,179.0,166.0,2384,167,2295,167,89,0,200,570,185,489,15,81,76,9,6775,7650,4850,3250,34800,26692,0
1193,2,0,162.0,108.0,195.0,166.0,2373,111,2239,111,134,0,456,585,425,504,31,81,76,9,7250,7650,4850,3250,35050,26692,0
1200,2,0,156.0,108.0,195.0,166.0,2485,27,2351,27,134,0,757,585,710,504,47,81,76,9,6500,7925,4850,3250,35800,26692,0
1207,2,0,156.0,108.0,195.0,166.0,2289,0,2155,0,134,0,868,585,805,504,63,81,76,9,6500,7925,5000,3250,35800,26692,0
1214,2,0,158.0,114.0,195.0,166.0,2345,0,2211,0,134,0,559,235,530,204,29,31,68,9,7000,7925,5150,3250,36200,26692,0
1221,2,0,158.0,114.0,195.0,166.0,1964,0,1875,0,89,0,772,235,735,204,37,31,68,9,7575,7925,5150,3250,36200,26692,0
1229,2,0,157.0,114.0,172.0,151.0,1684,0,1595,0,89,0,963,235,910,204,53,31,67,9,7575,8025,5150,3250,36750,27317,0
1236,2,0,157.0,114.0,172.0,151.0,1561,0,1427,0,134,0,1159,235,1090,204,69,31,67,9,7575,8275,5150,3250,36750,27317,0
1243,2,0,151.0,114.0,149.0,151.0,1247,0,1203,0,44,0,979,235,910,204,69,31,61,9,7575,8275,5150,3250,37550,27317,0
1250,2,0,148.0,98.0,149.0,151.0,951,0,951,0,0,0,1094,235,1025,204,69,31,58,9,7575,6575,5150,3250,37700,29017,0
1257,2,0,128.0,88.0,173.0,151.0,1147,0,1147,0,0,0,1254,235,1185,204,69,31,58,9,6125,5875,5000,3250,39300,29717,0
7,1,2,13.0,13.0,14.0,15.0,293,293,293,293,0,0,35,35,35,35,0,0,12,12,0,0,0,0,0,0,0
14,1,2,13.0,14.0,14.0,15.0,671,671,671,671,0,0,20,70,20,70,0,0,13,13,0,0,0,0,0,0,0
21,1,2,14.0,14.0,14.0,15.0,699,727,699,727,0,0,55,5,55,5,0,0,13,13,0,0,0,0,0,0,0
29,1,2,14.0,15.0,14.0,15.0,755,727,755,727,0,0,145,40,145,40,0,0,13,14,0,0,0,0,0,0,0
36,1,2,16.0,15.0,22.0,15.0,783,839,783,839,0,0,150,150,150,150,0,0,14,14,0,0,0,0,0,0,0
43,1,2,16.0,16.0,22.0,23.0,811,839,811,839,0,0,240,40,240,40,0,0,16,15,0,0,0,0,0,0,0
50,1,2,15.0,17.0,22.0,23.0,783,867,783,867,0,0,30,60,30,60,0,0,15,16,0,0,0,0,0,0,0
57,1,2,17.0,18.0,22.0,23.0,839,867,839,867,0,0,35,65,35,65,0,0,15,17,0,0,0,0,0,0,0
64,1,2,18.0,19.0,22.0,23.0,923,1007,923,1007,0,0,95,130,95,130,0,0,16,18,0,0,0,0,0,0,0
71,1,2,17.0,19.0,22.0,23.0,979,1001,979,979,0,22,175,249,175,245,0,4,17,18,0,0,0,0,0,0,0
79,1,2,17.0,20.0,22.0,23.0,979,1018,979,951,0,67,35,362,35,350,0,12,16,19,0,0,0,0,0,0,0
86,1,2,18.0,20.0,22.0,23.0,923,1006,923,895,0,111,95,33,95,5,0,28,16,19,0,0,0,150,0,0,0
93,1,2,19.0,21.0,22.0,23.0,895,1057,895,923,0,134,145,159,145,115,0,44,18,20,0,0,0,150,0,0,0
100,1,2,20.0,22.0,22.0,23.0,906,1107,839,951,67,156,207,84,195,20,12,64,18,21,0,0,0,150,0,0,0
107,1,2,20.0,22.0,22.0,23.0,1029,1051,895,895,134,156,333,134,305,50,28,84,19,21,0,0,0,150,0,0,0
114,1,2,21.0,22.0,22.0,23.0,1051,1079,895,923,156,156,408,164,360,60,48,104,20,22,0,0,0,150,0,0,0
121,1,2,26.0,23.0,28.0,23.0,1135,1074,979,895,156,179,89,189,25,65,64,124,20,22,0,0,250,150,0,0,0
129,1,2,26.0,23.0,28.0,23.0,1107,1102,951,923,156,179,224,319,140,175,84,144,21,23,0,0,250,150,0,0,0
136,1,2,28.0,26.0,28.0,31.0,1141,1191,1007,923,134,268,65,135,65,30,0,105,21,23,0,0,250,300,0,0,0
143,1,2,30.0,27.0,36.0,31.0,1085,1208,1063,895,22,313,90,285,90,140,0,145,22,24,50,0,250,300,0,0,0
150,1,2,30.0,27.0,36.0,31.0,1175,1180,1175,867,0,313,245,130,245,95,0,35,23,24,50,0,250,300,0,0,0
157,1,2,30.0,31.0,36.0,46.0,1315,1236,1315,923,0,313,45,105,45,55,0,50,24,25,350,125,250,300,0,0,0
164,1,2,32.0,32.0,36.0,46.0,1371,1314,1371,979,0,335,115,170,115,80,0,90,24,26,350,125,250,300,0,0,0
171,1,2,34.0,34.0,36.0,46.0,1399,1477,1399,1119,0,358,20,295,20,165,0,130,24,28,350,125,250,300,0,0,0
179,1,2,36.0,35.0,36.0,46.0,1455,1516,1455,1203,0,313,105,422,105,260,0,162,26,29,400,125,250,300,0,0,0
186,1,2,36.0,36.0,36.0,46.0,1455,1628,1455,1315,0,313,270,562,270,360,0,202,26,30,400,250,250,300,0,0,0
193,1,2,43.0,41.0,44.0,46.0,1595,1656,1595,1343,0,313,115,272,115,180,0,92,28,31,400,250,250,600,0,0,0
200,1,2,44.0,42.0,44.0,46.0,1539,1740,1539,1427,0,313,140,282,140,150,0,132,28,32,400,250,250,600,0,0,0
207,1,2,44.0,44.0,44.0,46.0,1651,1824,1651,1511,0,313,240,388,240,220,0,168,33,34,650,250,250,600,0,0,0
214,1,2,47.0,44.0,52.0,54.0,1695,1818,1651,1483,44,335,243,553,235,345,8,208,33,34,650,250,250,600,0,0,0
221,1,2,47.0,50.0,52.0,54.0,1925,1936,1791,1623,134,313,384,399,360,305,24,94,33,36,700,600,250,600,100,0,0
229,1,2,51.0,51.0,58.0,54.0,1953,1830,1819,1539,134,291,415,150,375,20,40,130,34,37,700,600,250,600,100,0,0
236,1,2,51.5,52.0,66.0,54.0,1981,1942,1847,1651,134,291,551,352,495,190,56,162,38,38,625,600,250,600,175,0,0
243,1,2,59.0,52.0,66.0,54.0,2003,1942,1847,1651,156,291,241,263,165,115,76,148,38,38,550,650,250,600,250,175,0
250,1,2,59.0,51.0,66.0,54.0,2082,2031,1903,1763,179,268,431,171,335,95,96,76,38,39,750,525,250,750,300,300,0
257,1,2,65.0,52.0,66.0,54.0,2222,1925,2043,1679,179,246,226,244,110,140,116,104,38,40,750,875,250,750,300,300,0
264,1,2,66.0,53.0,66.0,62.0,2199,2031,2043,1875,156,156,322,210,190,190,132,20,40,41,1000,875,250,750,300,300,0
271,1,2,65.5,52.0,66.0,62.0,2171,1947,2015,1791,156,156,487,345,335,305,152,40,43,40,975,875,250,750,325,400,0
279,1,2,64.5,54.0,66.0,70.0,2395,2076,2239,1875,156,201,337,303,265,235,72,68,43,42,1125,875,375,750,325,400,0
286,1,2,70.5,55.0,82.0,70.0,2283,1998,2127,1819,156,179,202,198,110,110,92,88,42,43,1125,875,375,750,325,400,0
293,1,2,70.5,56.0,90.0,70.0,2395,1975,2239,1819,156,156,327,159,215,105,112,54,47,43,1275,875,375,1000,325,450,0
300,1,2,72.5,53.0,90.0,85.0,2530,1550,2351,1483,179,67,442,223,310,165,132,58,50,41,1225,875,375,1000,375,775,0
307,1,2,78.5,50.0,90.0,85.0,2530,1007,2351,1007,179,0,382,238,230,180,152,58,50,39,1175,700,500,1000,425,1100,0
314,1,2,77.0,48.0,90.0,93.0,2630,755,2295,755,335,0,330,273,230,215,100,58,55,38,1000,700,500,1250,600,1250,0
321,1,2,73.0,51.0,90.0,93.0,2709,1063,2239,1063,470,0,591,489,435,431,156,58,58,40,900,700,500,1400,700,1250,0
329,1,2,80.0,54.0,90.0,93.0,2955,1931,2463,1931,492,0,506,364,290,356,216,8,61,41,900,875,500,1550,700,1250,0
336,1,2,86.0,57.0,90.0,93.0,3129,2043,2659,2043,470,0,342,449,170,441,172,8,60,44,900,875,950,1550,700,1250,0
343,1,2,88.0,60.0,90.0,93.0,3073,2188,2491,2099,582,89,367,620,115,596,252,24,65,47,900,875,950,1550,700,1250,0
350,1,2,90.0,61.0,90.0,93.0,3448,2227,2575,1959,873,268,284,482,95,426,189,56,70,48,900,875,950,1550,700,1250,0
357,1,2,98.0,63.0,106.0,93.0,3588,2412,2603,2099,985,313,295,627,65,531,230,96,70,50,900,875,950,1650,700,1250,0
364,1,2,106.0,67.0,106.0,93.0,3706,2496,2743,2183,963,313,346,578,100,521,246,57,70,53,1300,875,950,1650,700,1250,0
371,1,2,114.0,69.0,114.0,93.0,3840,2664,2855,2351,985,313,402,698,140,601,262,97,70,55,1400,875,1200,1650,700,1250,0
379,1,2,114.0,75.0,114.0,93.0,3896,2843,2911,2463,985,380,663,535,285,486,378,49,70,57,1950,975,1200,1650,700,1250,0
386,1,2,114.0,78.0,114.0,93.0,3851,3011,2911,2407,940,604,1120,586,630,461,490,125,70,60,2350,975,1200,1800,700,1250,0
393,1,2,113.5,79.0,130.0,93.0,3868,3090,2883,2463,985,627,1380,452,770,351,610,101,70,61,2725,975,1200,1800,725,1250,0
400,1,2,128.5,81.0,130.0,93.0,3924,3017,2939,2323,985,694,580,722,225,541,355,181,70,63,2725,975,1200,1800,725,1250,0
407,1,2,128.0,82.0,130.0,93.0,3874,3258,2911,2407,963,851,1037,246,570,161,467,85,70,65,2700,975,1200,1800,750,1250,0
414,1,2,149.0,81.0,162.0,93.0,3868,3459,2883,2519,985,940,267,653,205,456,62,197,70,67,2700,875,1200,1800,750,1350,0
421,1,2,152.0,89.0,178.0,93.0,3890,3487,2883,2547,1007,940,273,429,170,316,103,113,70,67,2700,1250,1200,2050,750,1350,0
429,1,2,162.5,89.0,178.0,93.0,3784,3566,2799,2603,985,963,109,624,90,391,19,233,70,67,3550,1550,1200,2050,775,1350,0
436,1,2,166.5,89.0,178.0,93.0,3795,3672,2855,2687,940,985,391,754,260,401,131,353,70,67,3650,1550,1200,2350,775,1350,0
443,1,2,165.5,89.0,202.0,93.0,3784,3470,2799,2463,985,1007,236,420,135,251,101,169,69,67,5075,1550,1200,2350,775,1350,0
450,1,2,175.5,93.0,202.0,93.0,3868,3633,2883,2603,985,1030,206,936,110,651,96,285,69,67,5550,1925,1200,2700,775,1350,0
457,1,2,184.5,93.0,202.0,109.0,3784,3476,2799,2491,985,985,148,1248,115,851,33,397,69,67,5750,1925,1200,3100,775,1350,0
464,1,2,184.5,103.0,202.0,109.0,3672,3515,2687,2575,985,940,579,860,430,501,149,359,69,67,5950,2425,1200,3100,775,1350,0
471,1,2,196.5,93.0,202.0,117.0,3672,3487,2687,2547,985,940,425,1285,310,806,115,479,69,67,6350,1650,1200,3100,775,2125,0
479,1,2,198.5,91.0,202.0,117.0,3627,3672,2687,2687,940,985,552,1535,400,936,152,599,69,67,6550,1275,1200,3600,975,2500,0
486,1,2,196.5,101.0,202.0,117.0,3538,3638,2575,2631,963,1007,637,1085,515,466,122,619,69,67,7050,2150,1200,3600,1075,2700,0
493,1,2,195.5,97.0,202.0,117.0,3616,3588,2631,2603,985,985,972,698,805,171,167,527,69,67,6950,1950,1200,3450,1175,2900,0
500,1,2,197.5,95.0,202.0,117.0,3566,3398,2603,2435,963,963,989,610,810,121,179,489,69,67,7050,1750,1200,3300,1475,3300,0
507,1,2,197.5,85.0,202.0,117.0,3566,3358,2603,2463,963,895,989,819,810,226,179,593,69,65,7050,1100,1200,3300,1475,4250,0
7,,,13.0,13.0,15.0,15.0,293,293,293,293,0,0,35,35,35,35,0,0,12,12,0,0,0,0,0,0,1
14,,,14.0,13.0,15.0,15.0,615,643,615,643,0,0,60,65,60,65,0,0,13,12,0,0,0,0,0,0,1
21,,,14.0,14.0,15.0,15.0,671,643,671,643,0,0,30,35,30,35,0,0,13,13,0,0,0,0,0,0,1
29,,,14.0,15.0,15.0,15.0,587,671,587,671,0,0,95,65,95,65,0,0,14,14,0,0,0,0,0,0,1
36,,,14.0,15.0,15.0,15.0,671,699,671,699,0,0,180,160,180,160,0,0,14,14,0,0,0,0,0,0,1
43,,,14.0,16.0,23.0,23.0,643,727,643,727,0,0,100,35,100,35,0,0,14,15,0,0,0,0,0,0,1
50,,,14.0,16.0,23.0,23.0,643,811,643,811,0,0,25,40,25,40,0,0,14,15,0,0,0,0,0,0,1
57,,,15.0,17.0,23.0,23.0,643,839,643,839,0,0,60,15,60,15,0,0,14,16,0,0,0,0,0,0,1
64,,,16.0,18.0,23.0,23.0,699,895,699,895,0,0,95,75,95,75,0,0,15,17,0,0,0,0,0,0,1
71,,,16.0,18.0,23.0,31.0,699,895,699,895,0,0,105,20,105,20,0,0,15,17,0,0,0,0,0,0,1
79,,,17.0,19.0,23.0,31.0,699,951,699,951,0,0,140,90,140,90,0,0,16,18,0,0,0,0,0,0,1
86,,,17.0,19.0,23.0,31.0,727,878,727,811,0,67,230,47,230,35,0,12,16,18,0,0,0,150,0,0,1
93,,,18.0,21.0,23.0,31.0,794,967,727,811,67,156,127,72,115,40,12,32,17,19,0,0,150,150,0,0,1
100,,,19.0,22.0,23.0,31.0,906,995,727,839,179,156,132,67,100,15,32,52,17,19,0,0,300,150,0,0,1
107,,,20.0,23.0,23.0,31.0,855,995,699,839,156,156,123,137,75,65,48,72,17,20,50,0,300,150,0,0,1
114,,,21.0,23.0,23.0,31.0,855,1051,699,895,156,156,73,272,5,180,68,92,17,20,100,0,300,150,0,0,1
121,,,20.0,25.0,23.0,31.0,799,1074,643,895,156,179,193,127,105,65,88,62,16,21,100,100,300,450,0,0,1
129,,,22.0,27.0,23.0,31.0,967,1146,811,923,156,223,113,140,5,75,108,65,16,21,150,100,300,450,0,0,1
136,,,22.0,26.0,31.0,39.0,1018,1096,839,895,179,201,218,170,90,85,128,85,16,20,200,100,300,450,25,50,1
143,,,22.0,26.0,31.0,39.0,766,861,587,727,179,134,278,256,130,155,148,101,15,20,250,275,300,450,75,50,1
150,,,24.0,23.0,31.0,39.0,883,665,727,531,156,134,109,337,45,220,64,117,15,19,300,300,300,450,75,200,1
157,,,25.0,23.0,31.0,39.0,939,508,783,419,156,89,184,395,100,270,84,125,16,19,300,300,300,450,75,200,1
164,,,22.0,22.0,31.0,39.0,883,323,727,279,156,44,309,263,205,180,104,83,15,18,200,125,300,550,225,425,1
171,,,22.0,22.0,31.0,39.0,771,290,615,223,156,67,299,301,175,210,124,91,14,18,300,125,300,550,325,425,1
179,,,21.0,21.0,31.0,39.0,631,290,475,223,156,67,314,239,170,190,144,49,13,17,250,125,300,550,425,475,1
186,,,23.0,19.0,31.0,39.0,542,295,363,251,179,44,209,273,45,220,164,53,14,17,300,175,300,550,475,600,1
193,,,21.0,19.0,31.0,39.0,822,368,643,279,179,89,324,325,140,260,184,65,14,17,200,175,550,550,575,600,1
200,,,22.0,22.0,31.0,39.0,995,906,839,727,156,179,300,229,125,190,175,39,15,17,200,175,550,550,575,600,1
207,,,20.0,22.0,31.0,39.0,939,990,783,811,156,179,430,294,235,235,195,59,15,17,200,175,550,550,675,600,1
214,,,21.0,23.0,31.0,39.0,939,967,783,811,156,156,505,154,290,75,215,79,16,18,200,175,550,550,675,600,1
221,,,24.0,25.0,31.0,39.0,1051,990,895,811,156,179,140,103,105,50,35,53,16,18,200,350,625,550,675,600,1
229,,,25.0,26.0,31.0,39.0,1079,1018,923,839,156,179,290,173,235,100,55,73,17,19,200,350,625,550,675,600,1
236,,,25.0,27.0,31.0,39.0,1186,1079,1007,923,179,156,425,258,350,165,75,93,18,20,200,350,625,550,675,600,1
243,,,26.0,25.0,31.0,39.0,1158,1046,979,867,179,179,115,637,20,470,95,167,18,20,200,350,625,550,675,600,1
250,,,26.0,26.0,31.0,31.0,1135,1107,979,839,156,268,151,468,40,365,111,103,19,21,450,350,625,550,675,700,1
257,,,27.0,25.0,31.0,31.0,939,1158,783,867,156,291,211,265,80,130,131,135,19,21,450,350,625,700,675,700,1
264,,,30.0,26.0,31.0,31.0,1275,1186,1119,895,156,291,126,252,75,85,51,167,20,21,450,350,625,700,675,700,1
271,,,31.0,24.0,31.0,31.0,1275,1158,1119,867,156,291,151,384,80,185,71,199,20,21,450,175,625,700,675,875,1
279,,,32.0,24.0,39.0,31.0,1242,1135,1063,867,179,268,226,521,137,290,89,231,21,22,450,175,625,700,675,875,1
286,,,32.0,30.0,39.0,39.0,1242,1180,1063,867,179,313,113,151,109,30,4,121,21,22,450,525,625,950,675,875,1
293,,,33.0,30.0,39.0,39.0,1247,1202,1091,867,156,335,199,291,179,130,20,161,22,22,450,700,625,950,675,875,1
300,,,33.0,30.0,39.0,39.0,1264,1180,1063,867,201,313,292,442,244,245,48,197,22,22,700,700,625,950,675,875,1
307,,,34.0,28.0,39.0,39.0,1387,1230,1119,895,268,335,413,602,329,365,84,237,23,22,700,525,625,950,675,1050,1
314,,,38.0,34.0,54.0,39.0,1275,1236,1007,923,268,313,330,218,314,95,16,123,24,22,700,1050,625,950,675,1050,1
321,,,38.0,34.0,54.0,39.0,1163,1208,895,895,268,313,261,363,209,200,52,163,24,22,700,1050,875,950,675,1050,1
329,,,35.0,34.0,54.0,54.0,1342,1236,1007,923,335,313,286,518,244,315,42,203,25,22,500,1050,875,950,875,1050,1
336,,,32.0,38.0,54.0,54.0,1135,1286,867,951,268,335,314,148,244,55,70,93,21,22,500,1225,875,950,1075,1225,1
343,,,30.0,36.0,54.0,54.0,659,1258,503,923,156,335,334,293,244,160,90,133,18,22,750,1225,875,950,1275,1400,1
350,,,25.0,34.0,54.0,39.0,570,1258,391,923,179,335,339,444,229,275,110,169,16,22,500,1050,875,950,1675,1975,1
357,,,15.0,38.0,54.0,39.0,519,889,363,643,156,246,340,168,214,75,126,93,6,22,550,1050,875,950,2225,1975,1
7,0,2,13.0,13.0,15.0,15.0,377,293,377,293,0,0,45,35,45,35,0,0,12,12,0,0,0,0,0,0,1
14,0,2,14.0,14.0,15.0,15.0,671,643,671,643,0,0,70,65,70,65,0,0,13,13,0,0,0,0,0,0,1
21,0,2,14.0,14.0,15.0,15.0,699,671,699,671,0,0,50,45,50,45,0,0,13,13,0,0,0,0,0,0,1
29,0,2,15.0,15.0,15.0,15.0,671,727,671,727,0,0,90,95,90,95,0,0,14,14,0,0,0,0,0,0,1
36,0,2,15.0,15.0,15.0,15.0,755,755,755,755,0,0,135,135,135,135,0,0,14,14,0,0,0,0,0,0,1
43,0,2,16.0,16.0,23.0,23.0,783,811,783,811,0,0,70,35,70,35,0,0,15,15,0,0,0,0,0,0,1
50,0,2,16.0,17.0,23.0,23.0,783,811,783,811,0,0,90,60,90,60,0,0,15,16,0,0,0,0,0,0,1
57,0,2,17.0,18.0,23.0,23.0,783,839,783,839,0,0,130,100,130,100,0,0,16,17,0,0,0,0,0,0,1
64,0,2,18.0,19.0,23.0,23.0,839,895,839,895,0,0,180,170,180,170,0,0,17,18,0,0,0,0,0,0,1
71,0,2,18.0,19.0,23.0,23.0,850,945,783,923,67,22,277,239,265,235,12,4,17,18,0,0,0,0,0,0,1
79,0,2,19.0,20.0,23.0,23.0,934,984,755,895,179,89,337,346,305,330,32,16,18,19,0,0,0,0,0,0,1
86,0,2,18.0,20.0,23.0,23.0,934,995,755,839,179,156,452,471,400,435,52,36,17,19,0,0,0,150,50,0,1
93,0,2,19.0,20.0,23.0,23.0,934,1023,755,867,179,156,357,447,285,395,72,52,18,20,0,0,150,150,50,0,1
100,0,2,19.0,20.0,23.0,23.0,995,1051,839,895,156,156,478,162,390,90,88,72,18,20,0,0,150,150,50,0,1
107,0,2,19.0,21.0,23.0,23.0,911,1023,755,867,156,156,183,142,75,50,108,92,18,20,50,0,150,150,50,0,1
114,0,2,20.0,21.0,23.0,23.0,939,1051,783,895,156,156,248,187,120,75,128,112,18,20,50,0,150,150,50,0,1
121,0,2,20.0,21.0,23.0,31.0,939,1074,783,895,156,179,108,257,60,125,48,132,18,20,50,0,150,150,50,50,1
129,0,2,21.0,24.0,23.0,31.0,1023,1130,867,951,156,179,88,217,70,90,18,127,19,21,50,0,150,300,50,50,1
136,0,2,21.0,25.0,23.0,31.0,990,1152,811,951,179,201,43,296,5,145,38,151,19,22,50,0,150,300,50,50,1
143,0,2,22.0,26.0,23.0,31.0,1046,1214,867,923,179,291,133,87,75,50,58,37,20,23,50,0,150,300,50,50,1
150,0,2,23.0,26.0,23.0,31.0,1191,1292,1035,979,156,313,234,92,160,65,74,27,21,23,50,0,150,300,50,50,1
157,0,2,23.0,29.0,31.0,31.0,1247,1264,1091,951,156,313,319,108,225,70,94,38,21,24,50,125,150,300,50,50,1
164,0,2,24.0,30.0,31.0,31.0,1253,1314,1007,979,246,335,225,218,195,140,30,78,22,25,50,125,500,300,50,50,1
171,0,2,28.0,32.0,31.0,46.0,1404,1264,1091,951,313,313,126,209,60,95,66,114,22,26,50,125,500,300,50,50,1
179,0,2,29.0,33.0,46.0,46.0,1404,1376,1091,1063,313,313,136,334,30,180,106,154,23,27,50,125,500,300,50,50,1
186,0,2,29.0,39.0,46.0,46.0,1370,1488,1035,1175,335,313,236,94,90,25,146,69,23,29,50,250,500,600,50,50,1
193,0,2,31.0,39.0,46.0,46.0,1376,1566,1063,1231,313,335,102,134,45,25,57,109,24,29,250,250,500,600,50,50,1
200,0,2,34.0,41.0,46.0,46.0,1376,1656,1063,1343,313,313,122,275,50,130,72,145,24,31,250,250,750,600,50,50,1
207,0,2,36.0,44.0,46.0,46.0,1398,1706,1063,1371,335,335,52,185,40,100,12,85,24,32,250,500,750,600,50,50,1
214,0,2,37.0,45.0,46.0,54.0,1510,1762,1175,1427,335,335,147,270,95,145,52,125,25,33,350,500,750,600,50,50,1
221,0,2,42.0,46.0,46.0,54.0,1740,1824,1427,1511,313,313,103,186,65,125,38,61,26,35,450,625,750,600,50,50,1
229,0,2,43.0,49.0,46.0,54.0,1678,1846,1343,1511,335,335,263,281,185,180,78,101,26,35,450,875,750,600,50,50,1
236,0,2,45.0,48.0,54.0,54.0,1706,1902,1371,1567,335,335,263,311,145,170,118,141,28,37,650,625,1000,600,50,300,1
243,0,2,47.0,51.0,54.0,54.0,1768,1908,1455,1595,313,313,154,247,75,170,79,77,28,38,850,875,1000,600,50,300,1
250,0,2,49.0,52.0,54.0,54.0,1706,2020,1371,1595,335,425,284,97,190,60,94,37,30,38,850,875,1000,600,50,300,1
257,0,2,51.0,53.0,54.0,54.0,1846,2070,1511,1511,335,559,274,239,140,130,134,109,30,39,850,875,1000,600,50,300,1
264,0,2,53.0,54.0,62.0,54.0,2132,2026,1819,1399,313,627,330,130,160,45,170,85,32,41,850,1125,1000,600,50,300,1
271,0,2,57.0,57.0,62.0,62.0,2048,2160,1735,1511,313,649,215,201,105,40,110,161,33,41,1175,1125,1075,600,50,300,1
279,0,2,60.0,58.0,70.0,62.0,1958,2294,1623,1623,335,671,155,371,5,130,150,241,34,42,1175,1125,1075,750,50,300,1
286,0,2,56.0,59.0,70.0,70.0,2182,2300,1847,1651,335,649,280,647,90,330,190,317,36,43,875,1375,1075,750,350,300,1
293,0,2,52.0,61.0,70.0,78.0,2160,2311,1847,1707,313,604,341,774,115,460,226,314,36,44,675,1375,1075,1000,550,350,1
300,0,2,55.0,62.0,70.0,78.0,2182,2334,1847,1707,335,627,371,705,130,465,241,240,38,45,775,1375,1075,1000,550,350,1
307,0,2,55.0,63.0,70.0,78.0,2182,2384,1847,1735,335,649,336,545,55,225,281,320,39,46,825,1375,1225,1000,750,350,1
314,0,2,58.0,65.0,70.0,78.0,2132,2362,1819,1735,313,627,497,331,180,110,317,221,40,47,925,1475,1300,1000,750,350,1
321,0,2,56.0,66.0,78.0,78.0,2272,2418,1847,1791,425,627,213,573,140,280,73,293,41,48,825,1475,1575,1000,850,350,1
329,0,2,57.0,67.0,78.0,86.0,2446,2535,1931,1931,515,604,203,535,70,170,133,365,42,49,825,1575,1575,1000,850,350,1
336,0,2,60.0,72.0,86.0,86.0,2339,2474,1847,1847,492,627,179,386,90,45,89,341,43,50,875,1575,1575,1000,850,350,1
343,0,2,64.0,76.0,86.0,86.0,2642,2412,2127,1763,515,649,149,386,50,65,99,321,44,52,875,1725,1675,1000,850,350,1
350,0,2,65.0,78.0,86.0,86.0,2647,2496,2155,1847,492,649,230,382,75,85,155,297,45,54,975,1725,1775,1550,850,350,1
357,0,2,70.0,78.0,86.0,86.0,2709,2524,2239,1875,470,649,306,177,145,50,161,127,45,55,975,1725,1875,1700,850,350,1
364,0,2,74.0,79.0,94.0,86.0,2737,2580,2267,1931,470,649,371,443,200,240,171,203,45,56,1225,1725,1875,1700,850,350,1
371,0,2,79.0,85.0,102.0,94.0,2670,2653,2155,1959,515,694,75,158,40,75,35,83,45,57,1275,2100,1875,1800,850,350,1
379,0,2,84.0,87.0,102.0,109.0,2832,2580,2183,1931,649,649,225,305,160,150,65,155,45,57,1525,2100,1875,1800,850,350,1
386,0,2,86.0,88.0,102.0,117.0,2938,2838,2267,2211,671,627,221,361,105,130,116,231,45,58,1775,2100,1875,1800,850,350,1
393,0,2,89.0,90.0,102.0,117.0,2938,3000,2267,2351,671,649,507,617,315,310,192,307,45,59,1875,2100,1875,1800,850,350,1
400,0,2,93.0,92.0,110.0,117.0,2804,3168,2155,2519,649,649,318,194,250,115,68,79,45,60,2475,2100,1875,1800,850,350,1
407,0,2,100.0,92.0,110.0,117.0,2754,3263,2127,2659,627,604,294,286,225,135,69,151,45,60,2700,2350,1875,1800,850,350,1
414,0,2,103.0,98.0,110.0,117.0,2916,3207,2267,2603,649,604,499,667,375,440,124,227,45,60,2750,2850,1875,1800,850,350,1
421,0,2,103.0,98.0,118.0,117.0,2888,3420,2239,2771,649,649,334,873,130,570,204,303,45,60,2750,2850,1875,1800,850,350,1
429,0,2,109.0,102.0,118.0,117.0,2692,3398,2043,2771,649,627,360,779,130,500,230,279,45,60,3375,2850,1875,1950,850,350,1
436,0,2,113.0,104.0,118.0,117.0,2742,3347,2071,2743,671,604,235,1070,75,715,160,355,45,60,3700,3200,1875,2250,850,350,1
443,0,2,108.0,107.0,126.0,117.0,2658,3392,1987,2743,671,649,546,1275,310,840,236,435,45,60,3325,3300,1875,2250,1225,450,1
450,0,2,106.0,97.0,126.0,117.0,2664,3364,2015,2715,649,649,452,1581,140,1145,312,436,45,62,3425,2700,1875,2450,1425,1050,1
457,0,2,110.0,105.0,126.0,117.0,2558,3358,1931,2687,627,671,468,1171,105,655,363,516,45,62,3425,3200,1875,2750,1425,1050,1
464,0,2,114.0,111.0,126.0,117.0,2664,3258,2015,2631,649,627,328,269,35,35,293,234,45,63,3425,3400,1875,2750,1425,1050,1
471,0,2,117.0,109.0,126.0,117.0,2468,3420,1819,2771,649,649,423,669,75,355,348,314,47,65,3875,3600,1875,2900,1525,1150,1
479,0,2,115.0,116.0,126.0,133.0,2328,3398,1679,2771,649,627,604,861,180,475,424,386,49,65,3800,3700,1875,2900,1725,1150,1
486,0,2,118.0,116.0,126.0,133.0,2378,3442,1707,2771,671,671,615,974,140,650,475,324,49,66,4000,3700,1875,2900,1725,1150,1
493,0,2,122.0,126.0,126.0,133.0,2266,3347,1595,2407,671,940,545,399,15,205,530,194,51,66,4225,4575,1875,2900,1725,1150,1
500,0,2,125.0,126.0,141.0,133.0,2222,3510,1595,2547,627,963,567,812,65,510,502,302,51,66,4225,4575,2175,2900,1725,1150,1
507,0,2,124.0,128.0,141.0,133.0,2390,3510,1763,2547,627,963,707,1067,125,645,582,422,52,66,4300,4575,2175,3350,1775,1225,1
514,0,2,124.0,128.0,141.0,133.0,2524,3403,1875,2575,649,828,742,1444,155,930,587,514,53,66,4350,4675,2400,3350,1875,1225,1
521,0,2,128.0,140.0,141.0,141.0,2714,3409,2043,2603,671,806,477,569,35,155,442,414,55,66,4350,5775,2400,3350,1875,1225,1
529,0,2,129.0,140.0,141.0,141.0,2854,3386,2183,2603,671,783,763,776,245,270,518,506,55,66,4350,5775,2400,3350,1875,1225,1
536,0,2,130.0,140.0,141.0,141.0,2658,3364,1987,2491,671,873,684,1183,165,565,519,618,52,66,4550,5775,2475,3350,2075,1225,1
543,0,2,130.0,140.0,141.0,157.0,2748,3476,2099,2491,649,985,805,2090,285,1160,520,930,52,66,4700,5775,2475,3350,2175,1325,1
550,0,2,133.0,140.0,141.0,165.0,3146,3398,2519,2435,627,963,776,1946,180,900,596,1046,55,65,4400,5775,2575,3350,2475,1375,1
557,0,2,132.0,156.0,141.0,165.0,3420,3347,2771,2407,649,940,986,1202,310,240,676,962,54,65,4400,6575,2575,3350,2525,1375,1
564,0,2,132.0,146.0,141.0,165.0,3308,3370,2659,2407,649,963,821,1593,265,515,556,1078,55,66,4675,6075,2575,3350,2675,1875,1
571,0,2,133.0,138.0,141.0,165.0,3420,3286,2771,2323,649,963,777,1990,195,800,582,1190,56,66,4675,5525,2575,3350,3050,2425,1
579,0,2,127.0,132.0,141.0,165.0,3666,3342,2995,2379,671,963,762,2401,200,1095,562,1306,58,66,4150,5075,2575,3350,3675,2875,1
586,0,2,110.0,132.0,141.0,173.0,3778,3364,3107,2379,671,985,723,1216,135,240,588,976,59,66,2775,5750,2575,3350,4675,3775,1
593,0,2,119.0,126.0,141.0,173.0,3689,3347,2995,2407,694,940,662,1624,140,540,522,1084,59,66,3025,5150,2575,3700,4775,4375,1
600,0,2,125.0,128.0,141.0,173.0,3616,3235,2855,2295,761,940,933,1759,315,555,618,1204,60,66,3250,5150,2575,3700,4775,4375,1
607,0,2,128.0,144.0,141.0,173.0,3560,3218,2687,2211,873,1007,950,539,395,415,555,124,60,66,3575,5150,2825,3700,4775,4375,1
614,0,2,132.0,146.0,141.0,173.0,3666,3274,2659,2267,1007,1007,695,825,95,585,600,240,62,66,3875,5250,2825,3700,4775,4375,1
621,0,2,133.0,148.0,141.0,173.0,3426,3252,2463,2267,963,985,782,862,120,510,662,352,64,66,3725,7050,2825,3700,5100,4375,1
629,0,2,135.0,150.0,141.0,173.0,3532,3280,2547,2295,985,985,1103,553,325,435,778,118,66,65,3925,7300,2825,3700,5100,4425,1
636,0,2,140.0,149.0,141.0,188.0,3448,3314,2463,2351,985,963,1134,839,265,605,869,234,66,64,3925,7400,2825,3700,5100,4575,1
643,0,2,140.0,159.0,141.0,196.0,3370,3263,2407,2323,963,940,895,366,60,270,835,96,66,64,4900,8275,2825,3700,5100,4575,1
650,0,2,140.0,159.0,141.0,196.0,3291,3454,2351,2491,940,963,951,776,175,560,776,216,68,64,5050,8575,2825,3700,5100,4575,1
657,0,2,148.0,172.0,149.0,196.0,3364,3605,2379,2575,985,1030,716,396,20,210,696,186,68,64,5050,8975,2825,3850,5100,4575,1
664,0,2,143.0,168.0,157.0,196.0,3258,3532,2295,2547,963,985,1013,813,205,515,808,298,68,64,4325,8625,2825,3850,5825,4925,1
7,1,0,13.0,13.0,14.0,15.0,251,293,251,293,0,0,30,35,30,35,0,0,12,12,0,0,0,0,0,0,0
14,1,0,13.0,14.0,14.0,15.0,671,671,671,671,0,0,20,70,20,70,0,0,13,13,0,0,0,0,0,0,0
21,1,0,14.0,14.0,14.0,15.0,755,699,755,699,0,0,55,50,55,50,0,0,13,13,0,0,0,0,0,0,0
29,1,0,14.0,15.0,14.0,15.0,755,727,755,727,0,0,145,90,145,90,0,0,13,14,0,0,0,0,0,0,0
36,1,0,16.0,15.0,22.0,15.0,783,755,783,755,0,0,145,135,145,135,0,0,14,14,0,0,0,0,0,0,0
43,1,0,16.0,16.0,22.0,23.0,811,839,811,839,0,0,240,80,240,80,0,0,15,15,0,0,0,0,0,0,0
50,1,0,15.0,16.0,22.0,23.0,895,811,895,811,0,0,40,45,40,45,0,0,15,15,0,0,0,0,0,0,0
57,1,0,17.0,17.0,22.0,23.0,895,783,895,783,0,0,40,135,40,135,0,0,15,16,0,0,0,0,0,0,0
64,1,0,18.0,18.0,22.0,23.0,951,811,951,811,0,0,100,185,100,185,0,0,16,17,0,0,0,0,0,0,0
71,1,0,17.0,18.0,22.0,23.0,951,906,951,839,0,67,185,292,185,280,0,12,17,17,0,0,0,0,0,0,0
79,1,0,17.0,19.0,22.0,23.0,979,939,979,783,0,156,40,352,40,320,0,32,16,18,0,0,0,0,0,0,0
86,1,0,18.0,19.0,22.0,23.0,979,995,979,839,0,156,110,472,110,420,0,52,16,18,0,0,0,0,0,0,0
93,1,0,19.0,20.0,22.0,23.0,923,995,923,839,0,156,150,337,150,315,0,22,18,19,0,0,0,150,0,0,0
100,1,0,20.0,20.0,22.0,23.0,990,1018,923,839,67,179,232,57,220,15,12,42,19,19,0,0,0,150,0,0,0
107,1,0,20.0,20.0,22.0,23.0,1057,939,923,783,134,156,358,68,330,10,28,58,19,19,0,0,0,150,0,0,0
114,1,0,21.0,21.0,22.0,23.0,1079,883,923,727,156,156,438,123,390,45,48,78,20,19,0,0,0,150,0,0,0
121,1,0,27.0,22.0,28.0,23.0,1074,911,895,755,179,156,168,193,100,95,68,98,20,19,0,100,250,150,0,0,0
129,1,0,27.0,22.0,28.0,23.0,1107,1051,951,895,156,156,304,78,220,60,84,18,21,20,0,100,250,150,0,0,0
136,1,0,28.0,23.0,28.0,31.0,1029,1107,895,951,134,156,280,98,180,60,100,38,21,20,0,100,250,150,0,0,0
143,1,0,28.0,24.0,28.0,31.0,1029,1270,1007,1091,22,179,205,108,205,100,0,8,21,21,100,150,250,150,0,0,0
150,1,0,27.0,24.0,28.0,31.0,1063,1242,1063,1063,0,179,40,198,40,170,0,28,21,21,100,150,250,150,0,0,0
157,1,0,29.0,25.0,36.0,31.0,1231,1219,1231,1063,0,156,90,324,90,280,0,44,21,22,400,150,250,150,0,0,0
164,1,0,31.0,25.0,36.0,31.0,1259,1326,1259,1147,0,179,80,438,80,370,0,68,22,22,400,150,250,150,0,0,0
171,1,0,32.0,26.0,36.0,46.0,1343,1477,1343,1231,0,246,85,600,85,500,0,100,23,23,400,150,250,150,0,0,0
179,1,0,32.0,27.0,36.0,46.0,1287,1477,1287,1231,0,246,130,323,130,295,0,28,23,24,400,150,250,400,0,0,0
186,1,0,37.0,31.0,44.0,46.0,1315,1298,1315,1007,0,291,35,268,35,200,0,68,24,24,400,150,250,500,0,0,0
193,1,0,40.0,32.0,44.0,46.0,1399,1454,1399,1119,0,335,50,333,50,250,0,83,24,25,400,150,250,500,0,0,0
200,1,0,43.0,33.0,52.0,46.0,1371,1454,1371,1119,0,335,55,423,55,300,0,123,24,25,550,150,250,500,0,0,0
207,1,0,43.0,38.0,52.0,46.0,1371,1510,1371,1175,0,335,215,304,215,145,0,159,24,26,800,350,250,500,0,0,0
214,1,0,47.0,41.0,52.0,46.0,1371,1622,1371,1287,0,335,135,169,135,70,0,99,24,28,1050,350,250,825,0,0,0
221,1,0,47.0,42.0,58.0,46.0,1371,1712,1371,1399,0,313,205,100,205,40,0,60,26,28,1100,350,250,825,0,0,0
229,1,0,52.0,45.0,58.0,54.0,1399,1796,1399,1483,0,313,65,295,65,195,0,100,26,30,1100,550,250,825,0,0,0
236,1,0,54.0,42.0,66.0,54.0,1427,1712,1427,1399,0,313,145,285,145,170,0,115,26,27,1100,550,250,825,0,150,0
243,1,0,58.0,35.0,66.0,54.0,1483,1734,1483,1399,0,335,85,365,85,210,0,155,29,24,1050,400,250,825,50,600,0
250,1,0,57.0,34.0,66.0,54.0,1623,1404,1623,1091,0,313,120,266,120,125,0,141,29,24,1200,575,250,825,150,650,0
257,1,0,61.0,35.0,66.0,46.0,1735,1286,1735,951,0,335,35,366,35,185,0,181,34,25,1150,575,250,900,200,750,0
264,1,0,60.5,40.0,74.0,46.0,1858,1376,1791,1063,67,313,157,207,145,115,12,92,36,25,1175,625,250,900,325,750,0
271,1,0,64.0,39.0,74.0,46.0,2031,1348,1875,1035,156,313,97,227,65,95,32,132,39,26,1150,525,250,900,350,850,0
279,1,0,65.5,40.0,74.0,46.0,2031,1404,1875,1091,156,313,137,312,85,140,52,172,40,27,1025,475,250,1050,475,950,0
286,1,0,68.5,42.0,74.0,46.0,2311,1538,2155,1203,156,335,117,262,95,50,22,212,46,28,1025,475,250,1050,475,950,0
293,1,0,70.5,44.0,82.0,46.0,2451,1566,2295,1231,156,335,107,367,65,165,42,202,48,30,1175,750,250,1050,475,950,0
300,1,0,71.5,46.0,82.0,46.0,2502,1762,2323,1427,179,335,237,408,175,170,62,238,50,31,1175,900,250,1200,475,950,0
307,1,0,77.5,46.0,74.0,46.0,2642,1874,2463,1539,179,335,152,268,70,115,82,153,54,32,1175,900,250,1200,575,950,0
314,1,0,77.5,46.0,82.0,46.0,2586,2188,2407,1875,179,313,92,259,90,70,2,189,58,32,1175,1000,250,1200,575,950,0
321,1,0,79.5,56.0,82.0,62.0,2782,2188,2379,1875,403,313,172,329,110,100,62,229,58,32,1175,1000,250,1200,575,950,0
329,1,0,80.5,56.0,98.0,62.0,3039,2216,2547,1903,492,313,252,229,130,60,122,169,56,32,1175,1000,250,1200,575,950,0
336,1,0,84.5,61.0,98.0,62.0,3045,2182,2575,1847,470,335,423,59,245,50,178,9,60,34,1175,1000,450,1200,575,950,0
343,1,0,89.5,62.0,98.0,62.0,3073,2317,2603,1959,470,358,438,78,200,25,238,53,63,34,1175,1250,450,1325,575,950,0
350,1,0,93.5,67.0,98.0,70.0,3241,2373,2659,1903,582,470,335,214,25,105,310,109,63,36,1375,1250,450,1325,575,950,0
357,1,0,92.5,69.0,98.0,70.0,3381,2423,2575,1931,806,492,235,179,75,110,160,69,63,36,1625,1525,700,1325,575,950,0
364,1,0,94.5,72.0,106.0,78.0,3442,2535,2659,2043,783,492,503,195,255,195,248,0,63,38,1575,1725,700,1325,625,950,0
371,1,0,99.5,75.0,106.0,78.0,3465,2591,2659,2099,806,492,113,340,15,280,98,60,63,38,1675,2175,950,1325,675,950,0
379,1,0,103.0,76.0,106.0,78.0,3571,2507,2743,2015,828,492,53,431,5,315,48,116,66,38,1650,2075,950,1325,700,1050,0
386,1,0,104.0,78.0,106.0,78.0,3498,2395,2715,1903,783,492,320,411,180,335,140,76,66,38,2450,2175,950,1325,775,1050,0
393,1,0,106.0,78.0,106.0,78.0,3571,2535,2743,2043,828,492,395,672,155,540,240,132,66,40,2500,2225,950,1325,775,1050,0
400,1,0,106.0,78.0,106.0,78.0,3650,2423,2799,1931,851,492,735,587,395,395,340,192,66,40,2600,2600,950,1325,875,1050,0
407,1,0,97.5,78.0,114.0,78.0,3633,2322,2827,1763,806,559,702,870,270,610,432,260,66,40,1325,2325,950,1325,2175,1325,0
414,1,0,94.5,78.0,130.0,78.0,3633,2244,2827,1595,806,649,1073,775,545,560,528,215,65,40,1125,2000,950,1325,2425,1425,0
421,1,0,96.5,77.0,130.0,78.0,3655,2328,2827,1679,828,649,1433,406,880,215,553,191,65,42,1075,1725,950,1325,2325,1700,0
429,1,0,103.0,87.0,130.0,94.0,3549,2278,2743,1651,806,627,1049,383,400,120,649,263,65,42,1550,1875,950,1325,2350,1700,0
436,1,0,108.0,88.0,130.0,94.0,3526,2334,2743,1707,783,627,770,519,300,180,470,339,65,43,1850,2075,950,1325,2375,1700,0
443,1,0,108.0,94.0,130.0,94.0,3459,2384,2631,1735,828,649,1080,356,510,95,570,261,63,44,2150,2225,950,1325,2375,1700,0
450,1,0,111.0,94.0,130.0,94.0,3482,2300,2631,1651,851,649,1370,534,700,193,670,341,63,45,2850,2325,950,1325,2400,1700,0
457,1,0,120.0,98.0,130.0,102.0,3442,2294,2659,1623,783,671,1233,745,525,328,708,417,63,45,2950,2900,950,1325,2400,1700,0
464,1,0,122.0,102.0,130.0,102.0,3493,2322,2687,1651,806,671,1453,700,645,328,808,372,63,47,3100,2950,950,1325,2400,1700,0
471,1,0,112.0,97.0,130.0,102.0,3487,2328,2659,1679,828,649,1888,967,980,523,908,444,63,47,2750,2675,1200,1325,2850,2075,0
479,1,0,116.0,98.0,130.0,102.0,3521,2356,2715,1707,806,649,1209,947,580,523,629,424,63,47,3150,2575,1200,1325,2900,2225,0
486,1,0,116.0,100.0,130.0,102.0,3521,2362,2715,1735,806,627,1625,822,900,322,725,500,63,47,3250,2875,1200,1325,2925,2225,0
493,1,0,123.0,102.0,130.0,102.0,3482,2356,2631,1707,851,649,1220,552,645,122,575,430,68,47,3150,3200,1200,1325,3025,2275,0
500,1,0,127.0,107.0,138.0,117.0,3213,2412,2407,1763,806,649,1307,572,740,62,567,510,70,47,3150,3250,1200,1325,3025,2275,0
507,1,0,131.0,107.0,138.0,117.0,3246,2546,2463,1875,783,671,1393,677,730,187,663,490,71,49,3150,3550,1200,1325,3025,2275,0
514,1,0,138.0,110.0,144.0,117.0,3291,2490,2463,1819,828,671,1073,777,460,207,613,570,71,49,3600,3550,1200,1325,3025,2275,0
521,1,0,141.0,116.0,144.0,125.0,3605,2468,2799,1819,806,649,1119,689,560,172,559,517,71,49,3700,3650,1200,1325,3025,2275,0
529,1,0,145.5,117.0,152.0,125.0,3554,2440,2771,1791,783,649,885,569,230,72,655,497,73,50,4525,3800,1200,1325,3125,2275,0
536,1,0,151.5,117.0,152.0,125.0,3795,2720,2967,2071,828,649,695,610,190,137,505,473,73,50,4725,3850,1200,1625,3150,2275,0
543,1,0,151.5,117.0,160.0,125.0,3958,2664,3107,2015,851,649,765,830,210,277,555,553,73,52,5175,4150,1200,1625,3150,2275,0
550,1,0,157.5,124.0,160.0,125.0,3885,2670,3079,2043,806,627,517,706,45,77,472,629,72,52,5325,4425,1200,1625,3150,2275,0
557,1,0,163.0,128.0,184.0,133.0,3997,2854,3191,2183,806,671,713,706,145,122,568,584,72,52,5850,4425,1200,1750,3175,2275,0
564,1,0,168.5,131.0,184.0,141.0,3991,2664,3163,2015,828,649,898,707,230,197,668,510,76,55,6375,4525,1200,1750,3225,2275,0
571,1,0,169.5,138.0,184.0,141.0,3969,2664,3163,2015,806,649,1114,523,400,87,714,436,76,55,6325,4625,1200,1950,3275,2275,0
579,1,0,174.5,139.0,184.0,149.0,3890,2916,3107,2267,783,649,1155,728,445,212,710,516,76,55,6525,4675,1200,2200,3375,2275,0
586,1,0,173.5,144.0,192.0,149.0,3566,3000,2715,2351,851,649,1260,469,450,52,810,417,71,58,6775,4775,1200,2200,3625,2275,0
593,1,0,175.5,146.0,192.0,149.0,3034,3112,2183,2463,851,649,1515,644,605,147,910,497,71,58,6925,5050,1200,2200,3625,2275,0
600,1,0,176.0,151.0,200.0,157.0,3162,2938,2379,2267,783,671,1668,490,670,42,998,448,71,59,7550,5100,1200,2200,3700,2275,0
607,1,0,188.0,147.0,200.0,157.0,3291,2882,2463,2211,828,671,1133,795,285,267,848,528,73,59,7500,5200,1200,2200,3800,2575,0
614,1,0,191.0,153.0,200.0,165.0,3711,2972,2883,2323,828,649,1363,707,415,257,948,450,75,59,7450,5650,1200,2200,3850,2575,0
621,1,0,195.0,161.0,206.0,165.0,3638,3168,2855,2519,783,649,535,487,20,107,515,380,75,59,7550,5650,1325,2200,3850,2625,0
629,1,0,195.0,164.0,206.0,181.0,3885,3280,3079,2631,806,649,315,368,50,87,265,281,75,59,8500,6075,1325,2200,3850,2625,0
636,1,0,197.0,168.0,206.0,181.0,4042,3448,3191,2799,851,649,680,398,315,162,365,236,75,59,9750,6225,1325,2200,4125,2675,0
643,1,0,188.0,168.0,206.0,181.0,4165,3482,3359,2855,806,627,1177,699,720,387,457,312,75,59,10000,6225,1325,2200,4675,2775,0
650,1,0,153.0,102.0,206.0,173.0,4198,3610,3415,2939,783,671,693,1004,140,612,553,392,75,57,5100,2525,1325,2200,8775,6675,0
7,1,2,13.0,13.0,14.0,15.0,293,293,293,293,0,0,35,35,35,35,0,0,12,12,0,0,0,0,0,0,1
14,1,2,13.0,14.0,14.0,15.0,643,671,643,671,0,0,40,70,40,70,0,0,12,13,0,0,0,0,0,0,1
21,1,2,15.0,14.0,14.0,15.0,699,699,699,699,0,0,94,0,94,0,0,0,14,13,0,0,0,0,0,0,1
29,1,2,15.0,15.0,14.0,15.0,755,699,755,699,0,0,189,35,189,35,0,0,15,14,0,0,0,0,0,0,1
36,1,2,15.0,15.0,14.0,15.0,783,755,783,755,0,0,289,130,289,130,0,0,15,14,0,0,0,0,0,0,1
43,1,2,15.0,16.0,14.0,23.0,755,755,755,755,0,0,23,20,23,20,0,0,14,15,0,0,0,0,0,0,1
50,1,2,15.0,17.0,14.0,23.0,811,811,811,811,0,0,33,45,33,45,0,0,14,16,0,0,0,0,0,0,1
57,1,2,15.0,18.0,14.0,23.0,811,839,811,839,0,0,128,45,128,45,0,0,15,17,0,0,0,0,0,0,1
64,1,2,14.0,18.0,14.0,23.0,811,979,811,979,0,0,28,160,28,160,0,0,14,17,0,0,0,0,0,0,1
71,1,2,16.0,19.0,22.0,23.0,811,979,811,979,0,0,23,220,23,220,0,0,14,18,0,0,0,0,0,0,1
79,1,2,16.0,20.0,22.0,23.0,811,1051,811,1007,0,44,43,343,43,335,0,8,14,19,0,0,0,0,0,0,1
86,1,2,17.0,20.0,22.0,23.0,755,1074,755,1007,0,67,83,66,83,50,0,16,15,19,0,0,0,150,0,0,1
93,1,2,18.0,20.0,22.0,23.0,839,1046,839,979,0,67,143,174,143,150,0,24,17,20,0,0,0,150,0,0,1
100,1,2,19.0,21.0,22.0,23.0,945,1090,923,979,22,111,212,110,208,70,4,40,18,20,0,0,0,150,0,0,1
107,1,2,19.0,21.0,22.0,23.0,1040,995,951,839,89,156,334,85,318,25,16,60,18,20,0,0,0,150,0,0,1
114,1,2,25.0,22.0,28.0,23.0,1113,1074,979,895,134,179,70,125,38,45,32,80,19,21,0,0,250,150,0,0,1
121,1,2,26.0,23.0,28.0,23.0,1062,1079,951,923,111,156,137,196,93,100,44,96,19,22,0,0,250,150,0,0,1
129,1,2,26.0,23.0,28.0,23.0,1141,1074,1007,895,134,179,178,265,118,145,60,120,20,22,0,0,250,150,0,0,1
136,1,2,28.0,26.0,28.0,31.0,1146,1130,1035,839,111,291,210,240,138,105,72,135,21,23,50,0,250,300,0,0,1
143,1,2,30.0,27.0,36.0,31.0,1230,1208,1119,895,111,313,266,40,178,15,88,25,22,24,50,0,250,300,0,0,1
150,1,2,30.0,28.0,36.0,31.0,1253,1230,1119,895,134,335,422,180,318,115,104,65,22,25,400,0,250,300,0,0,1
157,1,2,30.0,30.0,36.0,46.0,1258,1286,1147,951,111,335,364,111,348,60,16,51,24,25,400,125,250,300,0,0,1
164,1,2,31.0,32.0,36.0,46.0,1202,1342,1091,1007,111,335,125,126,93,85,32,41,23,26,400,125,250,300,0,0,1
171,1,2,32.0,34.0,36.0,46.0,1253,1348,1119,1035,134,313,136,182,88,105,48,77,23,28,400,125,250,300,0,0,1
179,1,2,36.0,34.0,36.0,46.0,1314,1404,1203,1091,111,313,98,252,38,135,60,117,25,28,400,125,250,300,0,0,1
186,1,2,36.0,36.0,44.0,46.0,1393,1488,1259,1175,134,313,114,342,38,185,76,157,26,30,400,300,250,600,0,0,1
193,1,2,39.0,41.0,44.0,46.0,1477,1566,1343,1231,134,335,160,127,68,80,92,47,30,31,400,300,250,600,0,0,1
200,1,2,39.0,43.0,44.0,46.0,1566,1729,1455,1371,111,358,152,187,148,100,4,87,30,33,400,300,250,600,0,0,1
207,1,2,42.0,43.0,44.0,46.0,1757,1706,1623,1371,134,335,208,233,188,110,20,123,31,33,400,300,250,600,0,0,1
214,1,2,49.0,45.0,52.0,46.0,1734,1796,1623,1483,111,313,60,254,28,95,32,159,34,35,400,300,250,600,0,0,1
221,1,2,49.0,50.0,52.0,54.0,1818,1880,1707,1567,111,313,296,139,248,90,48,49,34,37,400,650,250,600,0,0,1
229,1,2,49.0,50.0,52.0,54.0,1953,2048,1819,1735,134,313,517,324,453,235,64,89,41,37,550,650,250,600,0,0,1
236,1,2,49.0,52.0,50.0,54.0,1891,2076,1735,1763,156,313,532,424,448,295,84,129,41,39,550,650,250,600,0,0,1
243,1,2,50.0,52.0,50.0,54.0,2031,2098,1875,1763,156,335,747,264,643,95,104,169,41,39,550,650,250,600,0,0,1
250,1,2,51.0,54.0,66.0,54.0,2306,2210,2127,1875,179,335,537,440,413,235,124,205,39,41,550,950,250,600,0,0,1
257,1,2,57.0,54.0,66.0,54.0,2306,2238,2127,1903,179,335,502,190,358,95,144,95,39,43,550,950,250,600,0,0,1
264,1,2,57.0,60.0,66.0,62.0,2171,2244,2015,1931,156,313,553,256,393,125,160,131,47,43,550,950,250,750,0,0,1
271,1,2,59.0,61.0,66.0,62.0,2227,2244,2071,1931,156,313,723,271,543,200,180,71,47,44,550,950,625,750,0,0,1
279,1,2,61.0,62.0,82.0,70.0,2339,2300,2183,1987,156,313,533,341,433,230,100,111,45,45,550,950,625,750,12,0,1
286,1,2,65.0,63.0,74.0,70.0,2311,2294,2155,1959,156,335,468,516,348,365,120,151,44,46,800,950,625,750,162,0,1
293,1,2,67.0,65.0,74.0,70.0,2423,2356,2267,1819,156,537,663,312,523,185,140,127,49,48,800,950,625,750,162,0,1
300,1,2,72.0,70.0,82.0,78.0,2586,2546,2407,1875,179,671,583,259,423,110,160,149,52,49,800,1550,625,750,162,0,1
307,1,2,75.0,71.0,82.0,78.0,2608,2490,2407,1819,201,671,572,444,388,215,184,229,50,50,800,1550,625,750,162,0,1
314,1,2,76.0,73.0,82.0,78.0,2642,2390,2351,1763,291,627,533,731,313,430,220,301,57,52,900,1550,625,750,162,0,1
321,1,2,75.5,79.0,74.0,93.0,2882,2670,2547,2043,335,627,898,726,638,395,260,331,59,53,875,1550,625,1000,287,0,1
329,1,2,74.0,80.0,74.0,93.0,3050,2636,2715,1987,335,649,1268,521,968,110,300,411,60,54,800,1800,625,1150,362,0,1
336,1,2,75.0,84.0,98.0,93.0,3022,2826,2575,2155,447,671,748,676,688,260,60,416,57,57,950,1800,1000,1400,462,0,1
343,1,2,73.5,87.0,98.0,93.0,2916,3106,2267,2435,649,671,939,452,803,160,136,292,53,58,925,1675,1000,1400,587,125,1
350,1,2,74.0,87.0,98.0,93.0,2978,3246,2351,2575,627,671,1245,383,1033,215,212,168,57,60,1000,1850,1000,1400,612,250,1
357,1,2,79.0,89.0,98.0,93.0,2955,3174,2351,2547,604,627,977,200,693,110,284,90,59,62,1000,1950,1000,1400,612,250,1
364,1,2,79.0,92.0,98.0,93.0,2989,3129,2407,2547,582,582,934,337,578,250,356,87,63,64,1000,1950,1000,1500,612,250,1
371,1,2,78.0,92.0,98.0,101.0,3101,3347,2407,2743,694,604,1116,748,768,585,348,163,65,65,1000,1950,1250,1500,612,250,1
379,1,2,92.0,94.0,130.0,117.0,3375,3504,2547,2855,828,649,492,983,398,790,94,193,65,67,1000,2125,1250,1800,612,250,1
386,1,2,93.0,96.0,122.0,125.0,3459,3448,2631,2799,828,649,593,644,503,575,90,69,64,67,800,2225,1450,1800,812,250,1
393,1,2,93.0,97.0,122.0,125.0,3566,3582,2603,2799,963,783,719,429,663,260,56,169,64,68,800,2225,1450,1800,812,250,1
400,1,2,103.0,100.0,122.0,125.0,3448,3610,2463,2603,985,1007,419,464,243,275,176,189,66,69,1850,2225,1450,1800,812,250,1
407,1,2,103.0,103.0,122.0,125.0,3678,3734,2715,2771,963,963,870,612,578,465,292,147,66,70,1850,2225,1450,2100,812,250,1
414,1,2,103.0,111.0,138.0,125.0,3566,3683,2603,2743,963,940,1076,393,768,130,308,263,66,71,1850,2225,1450,2100,812,250,1
421,1,2,111.0,111.0,138.0,133.0,3857,3812,2827,2827,1030,985,1136,758,708,375,428,383,66,71,2350,2875,1700,2450,812,250,1
429,1,2,111.0,111.0,138.0,133.0,3666,3812,2659,2827,1007,985,1132,913,738,560,394,353,66,71,2550,2875,1700,2600,812,250,1
436,1,2,117.0,115.0,138.0,133.0,3734,3739,2771,2799,963,940,1210,1201,708,740,502,461,73,71,2550,3175,1700,2900,812,250,1
443,1,2,117.0,119.0,144.0,141.0,3616,3862,2631,2855,985,1007,1650,871,1028,790,622,81,73,71,2550,3575,1700,3600,812,250,1
450,1,2,121.0,119.0,144.0,149.0,3874,3812,2911,2827,963,985,1911,822,1173,625,738,197,80,72,2550,3575,1700,3600,812,250,1
457,1,2,121.0,123.0,144.0,149.0,3991,3767,3051,2827,940,940,2202,974,1448,815,754,159,84,72,2550,3575,1825,3600,812,250,1
464,1,2,121.0,118.0,144.0,149.0,4170,3846,3163,2883,1007,963,2647,1385,1773,1110,874,275,83,72,2550,3400,1825,3600,862,625,1
471,1,2,125.0,119.0,144.0,149.0,4333,3812,3303,2827,1030,985,2377,1390,1383,1145,994,245,80,74,2550,3700,1825,3600,862,625,1
479,1,2,133.0,119.0,136.0,157.0,4154,3762,3191,2799,963,963,1455,841,853,480,602,361,84,75,2350,3700,1825,3600,1062,625,1
486,1,2,133.0,121.0,136.0,157.0,4378,3840,3415,2855,963,985,1996,1092,1278,765,718,327,88,76,2350,3900,1825,3600,1062,625,1
493,1,2,136.0,138.0,136.0,165.0,4344,3862,3359,2855,985,1007,1851,448,1213,380,638,68,86,76,2850,4300,1950,3600,1162,625,1
500,1,2,134.0,140.0,136.0,165.0,4277,3790,3135,2827,1142,963,1629,650,843,470,786,180,82,76,3250,4900,2300,3600,1162,625,1
507,1,2,134.0,140.0,136.0,165.0,4249,3319,2995,2379,1254,940,1735,941,793,645,942,296,86,76,3250,5000,2300,3750,1162,625,1
514,1,2,133.0,136.0,136.0,173.0,4344,3398,3023,2435,1321,963,1795,951,893,835,902,116,90,78,3050,4600,2300,4400,937,1025,1
521,1,2,129.0,150.0,144.0,181.0,4506,3280,3163,2295,1343,985,2426,637,1368,405,1058,232,86,78,3050,4600,2300,4500,937,1025,1
529,1,2,138.0,150.0,144.0,196.0,4355,3627,3079,2687,1276,940,1499,589,1093,445,406,144,84,78,3050,5750,2300,4500,937,1025,1
536,1,2,136.0,150.0,144.0,196.0,4574,3722,3275,2715,1299,1007,1865,714,1303,600,562,114,82,78,3050,5750,3050,4500,937,1025,1
543,1,2,144.0,150.0,144.0,196.0,4574,3874,3275,2799,1299,1075,1271,1191,728,945,543,246,84,78,3050,5750,3050,4500,937,1025,1
550,1,2,143.5,150.0,144.0,196.0,4557,4226,3303,2995,1254,1231,1303,1684,858,1290,445,394,84,78,2975,5750,3050,4500,1612,1025,1
557,1,2,143.0,150.0,144.0,196.0,4747,4389,3471,3135,1276,1254,1873,1510,1268,1060,605,450,84,78,4600,5750,3175,4500,1812,1025,1
564,1,2,137.0,156.0,176.0,196.0,4618,4322,3275,3023,1343,1299,1908,1425,1143,815,765,610,84,78,4450,6050,3625,4500,1987,1325,1
571,1,2,149.5,150.0,176.0,196.0,4462,4372,3163,3051,1299,1321,1426,1731,663,1115,763,616,81,78,4375,5850,3625,4500,2412,1725,1
579,1,2,149.5,162.0,176.0,196.0,4372,4282,3051,2939,1321,1343,1482,632,563,510,919,122,80,78,4375,5850,4025,5300,2412,1725,1
586,1,2,149.5,172.0,176.0,204.0,4372,4316,3051,2995,1321,1321,1488,640,663,370,825,270,80,78,4375,6350,4025,5300,2412,1725,1
593,1,2,149.5,170.0,176.0,204.0,4131,4098,2855,2799,1276,1299,1670,1111,693,685,977,426,79,78,5225,6250,4025,5300,2412,1825,1
600,1,2,153.5,176.0,176.0,212.0,4025,4137,2771,2883,1254,1254,651,798,118,620,533,178,79,78,5425,6150,4025,5300,2812,1825,1
607,1,2,144.5,174.0,176.0,212.0,4092,4103,2771,2827,1321,1276,1141,694,448,610,693,84,77,78,5075,6050,4325,5300,3412,1925,1
614,1,2,133.0,145.0,176.0,212.0,4109,4282,2743,2939,1366,1343,1631,1194,778,950,853,244,77,78,3550,3750,4025,5300,4862,3725,1
621,1,2,131.5,143.0,176.0,212.0,4215,4232,2939,2911,1276,1321,2080,695,1083,595,997,100,77,78,3175,3450,3875,5600,5012,4025,1
629,1,2,137.5,147.0,176.0,212.0,4154,4154,2855,2855,1299,1299,1911,768,908,520,1003,248,77,78,4525,4860,4175,5600,5012,4125,1
636,1,2,137.5,153.0,176.0,227.0,4204,4260,2883,2939,1321,1321,2446,669,1283,515,1163,154,77,78,4525,5520,4475,5600,5012,4125,1
643,1,2,137.5,153.0,176.0,227.0,4131,3885,2855,2631,1276,1254,2658,932,1343,630,1315,302,77,78,5225,5550,4725,5600,5137,4125,1
650,1,2,159.5,167.0,182.0,227.0,3935,3689,2659,2435,1276,1254,574,657,253,195,321,462,77,78,5225,5880,4725,5600,5137,4125,1
657,1,2,163.5,167.0,182.0,235.0,3890,3790,2547,2491,1343,1299,404,1092,98,470,306,622,75,78,5225,6310,4725,6200,5137,4125,1
664,1,2,162.5,171.0,182.0,235.0,3946,3991,2603,2603,1343,1388,840,581,378,395,462,186,74,78,5225,6340,4725,6500,5137,4125,1
671,1,2,168.5,173.0,182.0,235.0,3739,4294,2463,2771,1276,1523,863,880,253,660,610,220,72,78,8125,6940,4725,6500,5162,4125,1
679,1,2,168.5,179.0,182.0,235.0,3846,4344,2547,2687,1299,1657,634,522,218,360,416,162,72,78,8425,8260,4725,6500,5162,4125,1
686,1,2,172.5,187.0,182.0,235.0,4103,4355,2827,2743,1276,1612,626,609,258,255,368,354,80,78,8425,8690,4850,6500,5162,4125,1
693,1,2,172.5,191.0,182.0,235.0,3997,4282,2743,2715,1254,1567,1097,867,573,325,524,542,80,78,8425,9720,5150,6500,5162,4125,1
700,1,2,180.0,196.0,182.0,243.0,4254,4249,2799,2659,1455,1590,316,727,158,160,158,567,80,78,8400,9635,5150,6500,5187,4225,1
707,1,2,179.0,200.0,182.0,243.0,4506,4462,2827,2827,1679,1635,856,1057,498,290,358,767,80,78,8350,10165,5150,6650,5237,4225,1
714,1,2,178.0,190.0,182.0,243.0,4568,4372,2911,2715,1657,1657,389,1558,243,595,146,963,80,78,8050,9680,5150,6650,5512,4725,1
721,1,2,175.5,188.0,182.0,243.0,4512,4372,2855,2715,1657,1657,591,662,403,365,188,297,80,78,7625,9680,5150,6650,5637,5525,1
729,1,2,177.5,186.0,182.0,243.0,4350,4322,2715,2687,1635,1635,833,894,603,555,230,339,80,78,8625,8780,5150,6650,5637,5625,1
736,1,2,181.5,194.0,182.0,243.0,4361,4193,2771,2603,1590,1590,560,656,338,425,222,231,80,78,8625,10340,5150,6650,5637,5625,1
743,1,2,181.5,200.0,182.0,243.0,4338,4170,2771,2603,1567,1567,926,507,583,230,343,277,80,78,9625,10355,5150,6650,5637,5625,1
750,1,2,180.5,200.0,182.0,243.0,4400,4187,2743,2575,1657,1612,1361,987,818,510,543,477,79,78,10225,10670,5150,6650,5687,5625,1
757,1,2,168.5,200.0,182.0,243.0,4478,4254,2799,2575,1679,1679,1907,1858,1168,1035,739,823,79,78,9475,11020,5150,6650,6637,5625,1
764,1,2,160.0,182.0,214.0,243.0,4378,4316,2743,2659,1635,1657,2415,2340,1488,1325,927,1015,79,78,9000,9335,5150,6650,7612,7325,1
771,1,2,154.0,178.0,214.0,243.0,4434,4204,2799,2547,1635,1657,2932,2823,1813,1620,1119,1203,79,78,8400,9910,5150,6650,8212,7775,1
779,1,2,164.0,180.0,214.0,243.0,4383,4232,2771,2575,1612,1657,469,2374,358,1375,111,999,79,78,6600,9175,5150,6650,10012,8525,1
786,1,2,150.0,170.0,214.0,243.0,4366,4142,2799,2575,1567,1567,1001,1923,698,1140,303,783,79,78,4750,7525,5150,6650,11862,10175,1
793,1,2,126.0,171.0,206.0,243.0,4445,4226,2855,2659,1590,1567,1526,2323,1023,1415,503,908,79,78,1300,7540,5150,6650,15312,10175,1
7,,,13.0,13.0,15.0,15.0,335,251,335,251,0,0,40,30,40,30,0,0,12,12,0,0,0,0,0,0,1
14,,,14.0,14.0,15.0,15.0,671,671,671,671,0,0,70,70,70,70,0,0,13,13,0,0,0,0,0,0,1
21,,,14.0,14.0,15.0,15.0,699,727,699,727,0,0,50,50,50,50,0,0,13,13,0,0,0,0,0,0,1
29,,,15.0,15.0,15.0,15.0,727,727,727,727,0,0,100,85,100,85,0,0,14,14,0,0,0,0,0,0,1
36,,,15.0,16.0,23.0,23.0,783,811,783,811,0,0,140,140,140,140,0,0,14,15,0,0,0,0,0,0,1
43,,,16.0,16.0,23.0,23.0,867,811,867,811,0,0,85,30,85,30,0,0,15,15,0,0,0,0,0,0,1
50,,,17.0,17.0,23.0,23.0,867,867,867,867,0,0,70,65,70,65,0,0,16,16,0,0,0,0,0,0,1
57,,,18.0,18.0,23.0,23.0,979,895,979,895,0,0,55,50,55,50,0,0,17,17,0,0,0,0,0,0,1
64,,,19.0,19.0,23.0,23.0,951,951,951,951,0,0,105,115,105,115,0,0,18,18,0,0,0,0,0,0,1
71,,,19.0,19.0,23.0,23.0,973,979,951,979,22,0,74,25,70,25,4,0,18,18,0,0,0,0,0,0,1
79,,,20.0,20.0,23.0,23.0,1046,1018,979,951,67,67,152,147,140,135,12,12,19,19,0,0,0,0,0,0,1
86,,,21.0,21.0,23.0,23.0,1023,1085,867,839,156,246,61,78,25,30,36,48,20,20,0,0,150,150,0,0,1
93,,,22.0,22.0,23.0,23.0,1096,1068,895,755,201,313,150,153,90,65,60,88,21,21,0,0,150,150,0,0,1
100,,,22.0,22.0,23.0,23.0,1090,1180,867,867,223,313,129,148,45,20,84,128,21,21,0,0,150,150,0,0,1
107,,,23.0,23.0,23.0,23.0,1146,1202,923,867,223,335,271,283,155,115,116,168,22,22,0,0,150,150,0,0,1
114,,,23.0,23.0,31.0,31.0,1124,1258,811,923,313,335,366,433,210,225,156,208,22,23,0,0,150,300,0,0,1
121,,,24.0,27.0,31.0,31.0,1202,1286,867,951,335,335,512,229,320,85,192,144,23,23,0,0,450,450,0,0,1
129,,,29.0,27.0,31.0,31.0,1174,1258,839,923,335,335,152,259,70,125,82,134,24,23,0,0,450,450,0,0,1
136,,,29.0,27.0,31.0,31.0,1236,1236,923,923,313,313,198,160,80,90,118,70,24,23,0,0,450,450,0,0,1
143,,,30.0,27.0,31.0,31.0,1258,1180,923,867,335,313,308,195,150,85,158,110,25,23,0,0,450,450,0,0,1
150,,,30.0,27.0,39.0,31.0,1253,1208,895,895,358,313,153,425,105,275,48,150,25,23,0,0,450,450,0,0,1
157,,,34.0,31.0,39.0,31.0,1264,1258,951,923,313,335,50,220,20,130,30,90,26,23,350,350,450,450,0,0,1
164,,,34.0,31.0,39.0,31.0,1180,1286,867,951,313,335,140,280,70,150,70,130,25,23,350,350,450,450,50,0,1
171,,,34.0,31.0,39.0,31.0,1264,1258,951,923,313,335,305,126,195,110,110,16,25,23,350,350,450,700,50,0,1
179,,,34.0,31.0,39.0,31.0,1264,1314,951,979,313,335,460,281,310,225,150,56,26,23,350,350,450,700,50,0,1
186,,,34.0,31.0,39.0,39.0,1314,1208,979,895,335,313,610,417,420,325,190,92,26,23,350,700,450,700,50,0,1
193,,,38.0,35.0,39.0,39.0,1258,1236,923,923,335,313,61,222,35,190,26,32,26,23,600,700,750,700,50,0,1
200,,,38.0,35.0,39.0,39.0,1320,1236,1007,923,313,313,167,377,105,305,62,72,25,23,425,700,750,700,225,0,1
207,,,38.0,35.0,39.0,39.0,1264,1264,951,951,313,313,322,518,220,410,102,108,25,23,425,700,750,700,225,0,1
214,,,40.0,35.0,47.0,39.0,1337,1270,979,979,358,291,137,170,95,30,42,140,26,23,675,700,750,700,225,0,1
221,,,40.0,35.0,47.0,39.0,1286,1242,951,951,335,291,283,316,205,140,78,176,26,23,1025,1050,750,700,225,0,1
229,,,40.0,34.0,47.0,39.0,1320,1314,1007,979,313,335,444,466,330,250,114,216,26,22,1025,1050,750,700,225,50,1
236,,,40.0,38.0,47.0,39.0,1348,1264,1035,951,313,313,364,262,310,110,54,152,26,22,1025,1400,750,700,225,50,1
243,,,42.0,38.0,47.0,47.0,1326,1292,1035,979,291,313,420,317,330,125,90,192,26,22,1275,1400,850,700,225,50,1
250,,,42.0,38.0,47.0,47.0,1354,1236,1063,923,291,313,336,458,310,230,26,228,26,22,1275,1400,850,700,225,50,1
257,,,42.0,38.0,55.0,47.0,1298,1258,1007,923,291,335,492,574,430,310,62,264,26,22,1525,1400,850,700,225,0,1
264,,,44.0,43.0,55.0,47.0,1426,1163,1091,895,335,268,412,317,410,125,2,192,26,22,1525,1400,850,700,225,0,1
271,,,44.0,43.0,55.0,47.0,1370,1236,1035,923,335,313,167,492,125,260,42,232,26,22,1525,1750,850,700,225,0,1
279,,,44.0,44.0,55.0,47.0,1320,1236,1007,923,313,313,323,597,245,325,78,272,26,23,1525,1750,850,700,225,0,1
286,,,40.0,44.0,55.0,62.0,1342,1286,1007,951,335,335,208,757,140,445,68,312,26,23,1100,1750,850,700,925,0,1
7,0,2,13.0,13.0,15.0,15.0,335,335,335,335,0,0,40,40,40,40,0,0,12,12,0,0,0,0,0,0,0
14,0,2,14.0,14.0,15.0,15.0,643,671,643,671,0,0,65,70,65,70,0,0,13,13,0,0,0,0,0,0,0
21,0,2,14.0,14.0,15.0,15.0,699,699,699,699,0,0,50,50,50,50,0,0,13,13,0,0,0,0,0,0,0
29,0,2,15.0,15.0,15.0,15.0,755,699,755,699,0,0,45,95,45,95,0,0,14,14,0,0,0,0,0,0,0
36,0,2,15.0,16.0,15.0,23.0,755,783,755,783,0,0,130,145,130,145,0,0,14,15,0,0,0,0,0,0,0
43,0,2,16.0,16.0,23.0,23.0,839,839,839,839,0,0,10,45,10,45,0,0,15,15,0,0,0,0,0,0,0
50,0,2,16.0,17.0,23.0,23.0,783,867,783,867,0,0,40,65,40,65,0,0,15,16,0,0,0,0,0,0,0
57,0,2,17.0,18.0,23.0,23.0,839,839,839,839,0,0,15,125,15,125,0,0,16,17,0,0,0,0,0,0,0
64,0,2,18.0,19.0,23.0,23.0,755,979,755,979,0,0,45,190,45,190,0,0,17,18,0,0,0,0,0,0,0
71,0,2,18.0,19.0,23.0,23.0,816,995,727,951,89,44,141,248,125,240,16,8,17,18,0,0,0,0,0,0,0
79,0,2,19.0,20.0,23.0,23.0,743,950,587,839,156,111,217,355,185,335,32,20,18,19,0,0,0,0,0,0,0
86,0,2,19.0,22.0,23.0,23.0,799,1012,531,923,268,89,322,232,250,200,72,32,18,19,0,0,0,150,0,0,0
93,0,2,20.0,22.0,23.0,23.0,922,978,587,867,335,111,82,338,20,290,62,48,19,20,0,0,150,150,0,0,0
100,0,2,20.0,20.0,23.0,23.0,928,1051,615,895,313,156,183,168,85,100,98,68,19,20,0,0,150,150,0,0,0
107,0,2,20.0,21.0,23.0,23.0,956,1023,643,867,313,156,298,144,160,60,138,84,19,20,0,0,150,150,0,0,0
114,0,2,20.0,21.0,23.0,23.0,922,995,587,839,335,156,153,134,75,30,78,104,19,20,0,0,150,150,0,0,0
121,0,2,21.0,24.0,31.0,31.0,962,967,671,811,291,156,110,129,50,30,60,99,19,21,100,0,150,300,0,0,0
129,0,2,22.0,25.0,31.0,31.0,1090,1023,867,867,223,156,144,109,60,40,84,69,20,22,100,0,150,300,0,0,0
136,0,2,22.0,25.0,31.0,31.0,1096,1074,895,895,201,179,292,238,180,145,112,93,20,22,100,0,150,300,0,0,0
143,0,2,23.0,27.0,31.0,31.0,1342,1158,1119,867,223,291,475,54,335,50,140,4,21,23,100,125,150,300,0,0,0
150,0,2,23.0,28.0,31.0,31.0,1370,1180,1147,867,223,313,583,90,415,50,168,40,21,23,100,125,150,300,0,0,0
157,0,2,26.0,29.0,31.0,31.0,1421,1208,1175,895,246,313,240,86,65,60,175,26,22,24,100,125,500,300,0,0,0
164,0,2,29.0,31.0,31.0,31.0,1421,1292,1175,979,246,313,258,61,55,20,203,41,23,24,100,250,500,300,0,0,0
171,0,2,29.0,33.0,31.0,46.0,1449,1320,1203,1007,246,313,276,171,45,90,231,81,23,25,100,250,500,300,0,0,0
179,0,2,30.0,34.0,31.0,46.0,1477,1320,1231,1007,246,313,189,221,30,100,159,121,24,26,300,250,500,300,0,0,0
186,0,2,31.0,39.0,31.0,46.0,1258,1561,1035,1203,223,358,218,66,35,55,183,11,24,28,200,250,500,600,100,0,0
193,0,2,34.0,40.0,39.0,46.0,1359,1533,1091,1175,268,358,240,191,50,140,190,51,25,29,200,250,500,600,100,0,0
200,0,2,35.0,41.0,39.0,46.0,1337,1600,1091,1287,246,313,258,228,40,145,218,83,25,30,250,375,500,600,100,0,0
207,0,2,37.0,42.0,39.0,46.0,1354,1572,1063,1259,291,313,428,144,170,21,258,123,26,32,300,375,500,600,100,0,0
214,0,2,39.0,42.0,39.0,46.0,1454,1600,1119,1287,335,313,413,249,140,86,273,163,26,32,400,675,750,600,100,0,0
221,0,2,39.0,45.0,39.0,46.0,1617,1684,1259,1371,358,313,413,164,200,111,213,53,27,33,500,675,750,600,100,0,0
229,0,2,43.0,46.0,54.0,46.0,1656,1740,1343,1427,313,313,605,170,360,81,245,89,27,33,500,675,750,600,100,0,0
236,0,2,39.0,47.0,54.0,54.0,1656,1846,1343,1511,313,335,645,350,360,221,285,129,27,33,350,675,750,600,350,0,0
243,0,2,38.0,47.0,54.0,54.0,1628,1930,1315,1595,313,335,650,475,350,306,300,169,28,35,250,550,750,600,450,125,0
250,0,2,40.0,48.0,54.0,54.0,1460,1852,1147,1539,313,313,505,646,165,441,340,205,28,36,350,550,750,750,450,125,0
257,0,2,39.0,47.0,54.0,54.0,1286,1936,951,1623,335,313,615,741,235,496,380,245,29,37,250,725,750,1000,550,250,0
264,0,2,42.0,48.0,54.0,54.0,1309,2070,951,1735,358,335,420,981,100,696,320,285,28,38,550,725,825,1000,600,250,0
271,0,2,42.0,47.0,54.0,54.0,1342,2076,1007,1763,335,313,581,1182,225,861,356,321,28,39,550,600,825,1000,650,375,0
279,0,2,46.0,54.0,54.0,54.0,1191,2132,923,1819,268,313,269,307,35,196,234,111,28,41,550,1125,825,1000,650,375,0
286,0,2,48.0,54.0,54.0,54.0,1303,2210,1035,1875,268,335,376,572,110,421,266,151,29,42,600,1125,825,900,650,375,0
293,0,2,49.0,54.0,54.0,54.0,1359,2188,1091,1875,268,313,348,314,50,131,298,183,30,42,850,1125,825,900,650,375,0
300,0,2,49.0,58.0,54.0,62.0,1555,2132,1287,1819,268,313,380,289,50,116,330,173,30,42,900,1125,825,900,650,375,0
307,0,2,52.0,60.0,54.0,62.0,1751,2054,1483,1651,268,403,316,255,75,76,241,179,30,42,950,1475,825,900,700,375,0
314,0,2,52.0,62.0,54.0,62.0,1522,2317,1231,1735,291,582,318,191,45,86,273,105,28,44,950,1475,975,1150,800,375,0
321,0,2,54.0,64.0,54.0,78.0,1583,2306,1315,1679,268,627,391,256,115,71,276,185,29,46,1250,1475,1125,1150,800,375,0
329,0,2,57.0,64.0,62.0,78.0,1863,2468,1595,1819,268,649,339,457,58,196,281,261,30,46,1300,1475,1125,1150,800,375,0
336,0,2,59.0,70.0,62.0,78.0,2171,2434,1903,1763,268,671,411,342,98,101,313,241,31,48,1350,1650,1200,1150,800,375,0
343,0,2,60.0,72.0,62.0,78.0,2423,2496,2155,1847,268,649,292,414,168,151,124,263,32,48,1525,2000,1275,1150,900,375,0
350,0,2,62.0,74.0,70.0,78.0,2507,2384,2239,1735,268,649,109,400,53,61,56,339,33,50,1575,2000,1275,1150,900,375,0
357,0,2,66.0,75.0,70.0,78.0,2272,2479,1959,1875,313,604,130,402,38,91,92,311,35,52,1625,2000,1275,1300,900,375,0
364,0,2,67.0,74.0,70.0,78.0,2278,2395,1987,1791,291,604,97,417,48,76,49,341,36,51,1625,1825,1275,1300,900,600,0
371,0,2,68.0,74.0,70.0,93.0,2059,2065,1791,1483,268,582,315,460,213,101,102,359,37,50,1775,2175,1275,1300,900,700,0
379,0,2,71.0,72.0,78.0,101.0,2194,1611,1903,1119,291,492,315,431,198,66,117,365,38,49,2100,1825,1275,1300,900,1100,0
386,0,2,70.0,70.0,78.0,101.0,2238,1522,1903,1119,335,403,400,595,218,186,182,409,38,48,1950,2000,1400,1300,1050,1200,0
393,0,2,69.0,75.0,78.0,101.0,1768,1566,1455,1231,313,335,305,381,83,36,222,345,37,48,1950,2000,1400,1300,1150,1200,0
400,0,2,67.0,75.0,78.0,101.0,1191,1600,923,1287,268,313,412,572,158,191,254,381,37,49,1700,2350,1400,1550,1450,1200,0
407,0,2,68.0,63.0,78.0,101.0,1830,1600,1539,1287,291,313,399,587,113,216,286,371,36,49,1800,1125,1400,1700,1600,2425,0
7,2,1,13.0,13.0,15.0,14.0,293,293,293,293,0,0,35,35,35,35,0,0,12,12,0,0,0,0,0,0,0
14,2,1,14.0,13.0,15.0,14.0,671,671,671,671,0,0,70,20,70,20,0,0,13,13,0,0,0,0,0,0,0
21,2,1,14.0,14.0,15.0,14.0,727,727,727,727,0,0,50,55,50,55,0,0,13,13,0,0,0,0,0,0,0
29,2,1,15.0,14.0,15.0,14.0,727,755,727,755,0,0,35,150,35,150,0,0,14,13,0,0,0,0,0,0,0
36,2,1,15.0,16.0,15.0,22.0,755,811,755,811,0,0,130,155,130,155,0,0,14,14,0,0,0,0,0,0,0
43,2,1,16.0,16.0,23.0,22.0,783,811,783,811,0,0,20,240,20,240,0,0,15,14,0,0,0,0,0,0,0
50,2,1,17.0,15.0,23.0,22.0,783,811,783,811,0,0,35,40,35,40,0,0,16,15,0,0,0,0,0,0,0
57,2,1,18.0,17.0,23.0,22.0,839,895,839,895,0,0,40,50,40,50,0,0,17,15,0,0,0,0,0,0,0
64,2,1,19.0,18.0,23.0,22.0,923,923,923,923,0,0,145,105,145,105,0,0,18,16,0,0,0,0,0,0,0
71,2,1,19.0,17.0,23.0,22.0,895,839,895,839,0,0,100,175,100,175,0,0,18,17,0,0,0,0,0,0,0
79,2,1,19.0,17.0,23.0,22.0,951,839,951,839,0,0,225,30,225,30,0,0,19,16,0,0,0,0,0,0,0
86,2,1,19.0,18.0,23.0,22.0,939,839,895,839,44,0,333,80,325,80,8,0,19,16,0,0,150,0,0,0,0
93,2,1,19.0,19.0,23.0,22.0,1012,839,923,839,89,0,60,120,40,120,20,0,19,17,0,0,150,0,0,0,0
100,2,1,19.0,20.0,23.0,22.0,1006,861,895,839,111,22,186,169,150,165,36,4,19,18,0,0,150,0,0,0,0
107,2,1,19.0,20.0,39.0,22.0,1040,861,951,727,89,134,204,274,160,250,44,24,19,19,0,0,300,0,0,0,0
114,2,1,19.0,20.0,39.0,22.0,962,939,895,783,67,156,177,84,125,40,52,44,19,20,0,0,300,0,0,0,0
121,2,1,19.0,20.0,39.0,22.0,967,962,923,783,44,179,216,324,160,260,56,64,19,20,0,0,300,250,0,0,0
129,2,1,20.0,22.0,39.0,22.0,1018,995,951,839,67,156,189,285,125,205,64,80,19,20,0,0,300,250,0,0,0
136,2,1,20.0,22.0,39.0,22.0,1012,967,923,811,89,156,306,400,230,300,76,100,19,20,0,0,450,250,0,0,0
143,2,1,20.0,24.0,47.0,30.0,1062,1051,951,895,111,156,155,435,63,315,92,120,20,20,0,0,450,250,0,0,0
150,2,1,20.0,25.0,47.0,30.0,1074,827,895,671,179,156,275,475,163,335,112,140,20,20,0,0,450,250,0,0,0
157,2,1,20.0,25.0,47.0,30.0,1102,827,923,671,179,156,250,385,118,325,132,60,20,20,0,100,600,250,0,0,0
164,2,1,23.0,27.0,47.0,30.0,1051,850,895,671,156,179,314,340,191,260,123,80,20,20,0,300,600,250,0,0,0
171,2,1,23.0,27.0,47.0,30.0,1079,934,923,755,156,179,209,445,66,345,143,100,20,20,0,300,600,250,0,0,0
179,2,1,24.0,27.0,39.0,30.0,1079,995,923,839,156,156,39,221,26,105,13,116,21,19,0,300,600,250,0,0,0
186,2,1,27.0,29.0,39.0,30.0,1135,967,979,811,156,156,294,236,136,100,158,136,22,19,125,300,600,250,0,0,0
193,2,1,27.0,31.0,47.0,36.0,1074,1051,895,895,179,156,73,221,41,65,32,156,22,22,125,300,600,250,0,0,0
200,2,1,28.0,33.0,47.0,36.0,1242,1107,951,951,291,156,69,251,51,75,18,176,23,22,125,450,600,250,0,0,0
207,2,1,29.0,34.0,47.0,36.0,1208,1191,895,1035,313,156,156,341,106,145,50,196,24,23,125,450,600,250,0,0,0
214,2,1,30.0,33.5,47.0,36.0,1208,1186,895,1007,313,179,306,491,216,275,90,216,25,25,250,425,600,250,0,25,0
221,2,1,30.0,35.0,54.0,36.0,1208,1214,895,1035,313,179,406,531,276,295,130,236,25,25,250,400,600,250,0,50,0
229,2,1,29.0,36.0,54.0,36.0,1208,1275,895,1119,313,156,256,482,86,230,170,252,25,27,125,450,600,250,150,150,0
236,2,1,35.0,36.0,54.0,36.0,1242,1040,951,951,291,89,107,595,51,335,56,260,27,28,125,450,900,250,150,150,0
243,2,1,35.0,36.0,62.0,36.0,1314,1018,979,951,335,67,112,518,16,250,96,268,27,28,125,450,900,250,150,150,0
250,2,1,37.0,41.0,62.0,42.0,1421,962,1063,895,358,67,217,331,81,55,136,276,29,28,125,450,900,250,150,150,0
257,2,1,37.0,43.0,62.0,58.0,1488,1214,1175,1147,313,67,264,294,96,10,168,284,29,28,125,450,900,250,150,150,0
264,2,1,39.0,44.0,62.0,58.0,1544,1354,1231,1287,313,67,459,407,251,115,208,292,31,28,475,600,900,250,150,150,0
271,2,1,40.0,46.0,62.0,58.0,1656,1555,1343,1511,313,44,64,361,16,65,48,296,32,27,475,800,900,250,200,150,0
279,2,1,41.0,45.0,62.0,66.0,1662,1550,1371,1483,291,67,115,474,31,170,84,304,33,27,475,850,900,250,200,150,0
286,2,1,42.0,47.0,62.0,66.0,1678,1561,1231,1539,447,22,264,429,116,125,148,304,34,29,475,1000,900,250,200,150,0
293,2,1,43.0,47.0,62.0,66.0,1802,1399,1175,1399,627,0,95,594,21,290,74,304,35,32,475,1000,900,375,200,150,0
300,2,1,45.0,53.0,62.0,66.0,1992,1567,1343,1567,649,0,185,484,81,180,104,304,37,32,475,1000,900,500,200,150,0
307,2,1,45.0,56.0,62.0,58.0,2042,1651,1371,1651,671,0,377,439,201,135,176,304,37,32,475,1000,900,625,200,150,0
314,2,1,52.0,57.0,62.0,58.0,2098,1735,1427,1735,671,0,152,499,71,195,81,304,39,39,475,1000,1400,625,200,150,0
321,2,1,53.0,59.0,62.0,66.0,2166,1987,1539,1987,627,0,214,494,61,190,153,304,40,42,475,1000,1400,625,200,150,0
329,2,1,54.0,59.0,62.0,74.0,2138,2183,1511,2183,627,0,424,504,191,300,233,204,41,42,475,1000,1400,625,200,150,0
336,2,1,56.0,70.0,62.0,82.0,2244,2183,1595,2183,649,0,749,209,436,5,313,204,43,42,475,1000,1700,625,200,150,0
343,2,1,62.0,69.0,70.0,82.0,2350,2121,1679,2099,671,22,429,443,286,235,143,208,43,41,475,1000,1700,625,200,150,0
350,2,1,62.0,71.5,70.0,82.0,2440,2261,1791,2127,649,134,711,403,496,175,215,228,45,49,900,1125,1700,625,200,175,0
357,2,1,67.0,74.0,70.0,82.0,2490,2390,1819,2211,671,179,401,393,356,145,45,248,44,48,900,1250,1700,625,250,200,0
364,2,1,69.0,74.0,70.0,82.0,2530,2451,1903,2295,627,156,388,639,271,375,117,264,44,51,900,1200,1700,625,250,250,0
371,2,1,69.0,79.5,70.0,82.0,2418,2731,1791,2575,627,156,308,369,136,85,172,284,46,52,900,1125,1700,625,250,325,0
379,2,1,71.0,79.5,86.0,82.0,2502,2703,1875,2547,627,156,498,549,246,245,252,304,46,52,900,1125,1700,625,250,325,0
386,2,1,72.0,76.5,94.0,82.0,2546,2619,1875,2351,671,268,861,874,529,530,332,344,46,56,900,1125,1700,875,250,325,0
393,2,1,72.0,77.5,94.0,98.0,2630,2664,1959,2351,671,313,1156,540,744,360,412,180,46,55,1560,1425,1700,1075,250,325,0
400,2,1,79.0,76.5,94.0,106.0,2602,2826,1931,2491,671,335,693,375,459,355,234,20,47,53,1575,1425,1700,1075,250,325,0
407,2,1,84.0,85.0,94.0,114.0,2462,2910,1791,2575,671,335,553,295,389,235,164,60,48,53,2235,1400,1800,1200,250,350,0
414,2,1,84.0,88.5,94.0,114.0,2474,2888,1847,2575,627,313,440,176,204,80,236,96,49,63,2390,1575,1800,1200,250,375,0
421,2,1,84.0,85.5,102.0,114.0,2334,3000,1707,2687,627,313,345,496,179,360,166,136,49,60,2420,1575,1800,1200,250,375,0
429,2,1,84.0,86.5,102.0,114.0,2390,3022,1763,2687,627,335,295,751,199,575,96,176,49,60,2435,1675,1800,1200,250,425,0
436,2,1,88.0,88.5,102.0,114.0,2434,3302,1763,2967,671,335,480,741,304,625,176,116,49,60,2800,1575,1800,1200,250,525,0
443,2,1,88.0,88.0,102.0,122.0,2496,3190,1847,2855,649,335,432,1007,334,855,98,152,49,60,2815,1550,1800,1200,250,550,0
450,2,1,88.0,83.0,110.0,122.0,2546,3330,1875,2995,671,335,707,1262,529,995,178,267,49,63,2710,1550,1800,1200,355,850,0
457,2,1,88.0,87.0,110.0,130.0,2524,3062,1875,2659,649,403,533,1304,429,985,104,319,49,63,2590,1400,1800,1200,505,1000,0
464,2,1,96.0,99.0,110.0,130.0,2446,2978,1819,2351,627,627,549,459,369,360,180,99,49,69,3600,1550,1800,1650,520,1000,0
471,2,1,96.0,99.0,118.0,130.0,2586,3297,1959,2379,627,918,474,864,364,645,110,219,49,69,3645,1550,1800,1650,520,1000,0
479,2,1,96.0,108.0,118.0,130.0,2546,3476,1875,2491,671,985,329,530,139,395,190,135,49,69,3690,1550,1800,1650,520,1000,0
486,2,1,96.0,110.0,118.0,130.0,2518,3599,1847,2659,671,940,294,507,24,460,270,47,49,69,3720,1550,1800,1650,520,1000,0
493,2,1,100.0,110.0,118.0,130.0,2490,3476,1819,2491,671,985,551,477,209,310,342,167,49,69,4100,2550,1800,1650,520,1000,0
500,2,1,104.0,120.0,141.0,130.0,2378,3442,1707,2435,671,1007,491,397,219,310,272,87,49,69,4495,3000,1650,1650,520,1000,0
507,2,1,104.0,122.0,141.0,130.0,1970,3560,1343,2575,627,985,353,564,159,465,194,99,49,69,4510,3500,2100,1525,520,1000,0
514,2,1,104.0,122.0,141.0,130.0,2166,3482,1539,2519,627,963,578,730,304,615,274,115,49,69,4510,3600,2500,1400,550,1275,0
521,2,1,108.0,120.0,125.0,136.0,2390,3560,1763,2575,627,985,663,656,309,625,354,31,49,69,4890,2950,2500,1400,750,1925,0
529,2,1,108.0,116.0,125.0,136.0,2658,3476,1987,2491,671,985,393,776,109,625,284,151,49,69,4890,2900,2500,1400,780,2475,0
535,2,1,108.0,110.0,125.0,136.0,2658,3532,1987,2547,671,985,393,1142,109,895,284,247,49,69,4890,3000,2500,1400,780,3075,0
7,2,2,13.0,13.0,15.0,15.0,251,293,251,293,0,0,30,35,30,35,0,0,12,12,0,0,0,0,0,0,1
14,2,2,14.0,14.0,15.0,15.0,671,643,671,643,0,0,70,65,70,65,0,0,13,13,0,0,0,0,0,0,1
21,2,2,14.0,14.0,15.0,15.0,727,699,727,699,0,0,50,45,50,45,0,0,13,13,0,0,0,0,0,0,1
29,2,2,15.0,15.0,15.0,15.0,727,727,727,727,0,0,85,35,85,35,0,0,14,14,0,0,0,0,0,0,1
36,2,2,16.0,15.0,23.0,23.0,839,839,839,839,0,0,145,140,145,140,0,0,15,14,0,0,0,0,0,0,1
43,2,2,16.0,16.0,23.0,23.0,839,811,839,811,0,0,35,30,35,30,0,0,15,15,0,0,0,0,0,0,1
50,2,2,17.0,17.0,23.0,23.0,895,895,895,895,0,0,70,60,70,60,0,0,16,16,0,0,0,0,0,0,1
57,2,2,18.0,18.0,23.0,23.0,867,923,867,923,0,0,45,40,45,40,0,0,17,17,0,0,0,0,0,0,1
64,2,2,19.0,19.0,23.0,23.0,1007,979,1007,979,0,0,115,100,115,100,0,0,18,18,0,0,0,0,0,0,1
71,2,2,19.0,19.0,23.0,23.0,945,973,923,951,22,22,14,69,10,65,4,4,18,19,0,0,0,0,0,0,1
79,2,2,20.0,20.0,23.0,23.0,1034,1096,923,1007,111,89,95,96,75,80,20,16,19,19,0,0,0,0,0,0,1
86,2,2,21.0,21.0,23.0,23.0,1079,1085,811,951,268,134,220,62,160,30,60,32,20,20,0,0,150,150,0,0,1
93,2,2,22.0,22.0,23.0,23.0,1169,1130,811,951,358,179,150,147,50,95,100,52,21,21,0,0,150,150,0,0,1
100,2,2,22.0,22.0,23.0,23.0,1169,1124,811,923,358,201,190,136,50,60,140,76,21,21,0,0,150,150,0,0,1
107,2,2,23.0,23.0,23.0,23.0,1180,1135,867,867,313,268,267,212,95,100,172,112,22,22,0,0,150,150,0,0,1
114,2,2,23.0,23.0,23.0,31.0,1180,1152,867,839,313,313,357,362,145,210,212,152,22,22,0,0,150,150,0,0,1
121,2,2,24.0,24.0,31.0,31.0,1180,1174,867,839,313,335,497,507,245,315,252,192,23,23,0,0,300,450,0,0,1
129,2,2,27.0,29.0,31.0,31.0,1180,1208,867,895,313,313,242,158,100,80,142,78,23,24,0,0,450,450,0,0,1
136,2,2,27.0,29.0,31.0,31.0,1253,1202,895,867,358,335,397,153,215,35,182,118,23,24,0,0,450,450,0,0,1
143,2,2,27.0,30.0,31.0,31.0,1230,1208,895,895,335,313,283,309,165,155,118,154,23,25,0,0,450,450,0,0,1
150,2,2,27.0,30.0,31.0,31.0,1236,1208,923,895,313,313,322,454,243,260,79,194,23,25,0,0,450,450,0,0,1
157,2,2,27.0,34.0,31.0,39.0,1242,1264,951,951,291,313,463,319,348,285,115,34,23,26,350,350,450,450,0,0,1
164,2,2,26.0,34.0,31.0,39.0,1214,1342,923,1007,291,335,209,84,58,10,151,74,22,26,350,350,450,450,50,0,1
171,2,2,27.0,34.0,31.0,39.0,1214,1342,923,1007,291,335,301,234,118,120,183,114,22,26,350,500,450,450,50,0,1
179,2,2,27.0,34.0,31.0,39.0,1191,1426,923,1091,268,335,293,160,78,110,215,50,22,26,350,650,450,450,50,0,1
186,2,2,28.0,35.0,31.0,39.0,1163,1370,895,1035,268,335,430,260,183,170,247,90,23,26,350,650,450,450,50,0,1
193,2,2,31.0,37.0,31.0,39.0,1264,1348,951,1035,313,313,240,141,103,65,137,76,24,26,350,650,750,450,50,0,1
200,2,2,32.0,38.0,39.0,39.0,1236,1348,923,1035,313,313,135,251,58,135,77,116,24,27,350,650,750,450,50,0,1
207,2,2,33.0,39.0,39.0,47.0,1264,1398,951,1063,313,335,145,366,28,210,117,156,25,28,350,650,750,450,50,0,1
214,2,2,33.0,39.0,39.0,47.0,1281,1398,923,1063,358,335,240,176,83,130,157,46,25,28,350,650,750,700,50,0,1
221,2,2,37.0,42.0,39.0,47.0,1342,1432,1007,1119,335,313,46,167,3,135,43,32,26,29,650,825,750,700,50,0,1
229,2,2,37.0,42.0,39.0,47.0,1292,1454,979,1119,313,335,192,242,113,170,79,72,26,29,650,1000,750,700,50,0,1
236,2,2,38.0,45.0,54.0,62.0,1320,1432,1007,1119,313,313,227,233,108,175,119,58,27,30,650,1000,850,700,50,0,1
243,2,2,40.0,46.0,54.0,62.0,1404,1264,1091,951,313,313,297,218,138,120,159,98,28,30,650,1175,850,700,50,0,1
250,2,2,41.0,50.0,54.0,62.0,1622,1264,1287,951,335,313,387,113,188,25,199,88,29,32,950,1175,1100,700,50,0,1
257,2,2,43.0,54.0,54.0,62.0,1594,1650,1259,1315,335,335,517,98,278,20,239,78,31,34,950,1350,1100,700,50,0,1
264,2,2,47.0,55.0,54.0,62.0,1718,1818,1315,1483,403,335,145,223,58,105,87,118,31,35,950,1525,1100,700,50,0,1
271,2,2,49.0,58.0,54.0,62.0,1695,1852,1203,1539,492,313,161,170,18,70,143,100,33,36,950,1525,1100,700,50,0,1
279,2,2,50.0,59.0,54.0,62.0,1818,1992,1371,1679,447,313,343,465,148,325,195,140,34,37,950,1700,1100,700,50,0,1
286,2,2,52.0,61.0,54.0,70.0,1869,1992,1399,1679,470,313,513,530,258,400,255,130,36,38,950,1875,1100,700,50,0,1
293,2,2,53.0,61.0,54.0,70.0,1953,2020,1483,1707,470,313,554,370,243,200,311,170,37,39,950,1875,1100,700,50,0,1
300,2,2,54.0,63.0,54.0,70.0,1824,2126,1287,1791,537,335,277,430,98,220,179,210,38,39,950,1875,1100,700,50,0,1
307,2,2,54.0,68.0,54.0,70.0,2031,2177,1427,1819,604,358,384,225,133,75,251,150,39,40,1325,1875,1100,700,50,0,1
314,2,2,56.0,69.0,62.0,78.0,2087,2216,1483,1903,604,313,601,377,278,195,323,182,40,41,1325,2225,1100,700,50,0,1
321,2,2,56.0,71.0,62.0,78.0,2250,2104,1623,1791,627,313,658,222,263,0,395,222,40,43,1325,2225,1100,700,50,0,1
329,2,2,61.0,71.0,70.0,78.0,2194,2138,1567,1847,627,291,559,473,188,215,371,258,42,43,1325,2225,1100,700,50,0,1
336,2,2,62.0,72.0,70.0,86.0,2306,2188,1679,1875,627,313,785,403,338,105,447,298,43,45,1325,2225,1100,700,50,0,1
343,2,2,62.0,73.0,70.0,86.0,2356,2222,1707,1931,649,291,970,455,443,125,527,330,43,45,1325,2225,1100,700,50,0,1
350,2,2,70.0,77.0,70.0,86.0,2334,1942,1707,1651,627,291,337,341,138,75,199,266,44,46,1325,2225,1750,700,50,0,1
357,2,2,70.0,79.0,70.0,86.0,2418,2182,1791,1847,627,335,48,406,23,100,25,306,44,47,1325,2575,1750,700,50,0,1
364,2,2,76.0,80.0,86.0,101.0,2462,2188,1791,1875,671,313,333,427,228,85,105,342,44,47,1700,2575,1750,850,50,0,1
371,2,2,76.0,83.0,86.0,101.0,2451,2356,1847,2043,604,313,316,352,293,70,23,282,44,50,1700,2575,1750,1000,50,0,1
379,2,2,76.0,88.0,86.0,101.0,2390,2356,1763,2043,627,313,611,282,508,110,103,172,44,53,1700,2575,1750,1150,50,0,1
386,2,2,76.0,92.0,86.0,101.0,2423,2798,1819,2463,604,335,508,212,333,100,175,112,44,54,1700,2925,1750,1550,50,0,1
393,2,2,77.0,95.0,86.0,101.0,2440,2776,1791,2463,649,313,283,303,203,155,80,148,44,56,1700,3100,1750,1550,50,0,1
400,2,2,77.0,99.0,86.0,101.0,2423,2882,1819,2547,604,335,580,218,428,130,152,88,44,57,1700,3450,1750,1550,50,0,1
407,2,2,77.0,101.0,86.0,101.0,2384,2994,1735,2659,649,335,470,208,238,130,232,78,45,59,1700,3625,1750,1550,50,0,1
414,2,2,77.0,101.0,94.0,101.0,2412,3045,1763,2687,649,358,496,407,188,285,308,122,45,59,1700,3625,2300,1550,50,0,1
421,2,2,83.0,104.0,94.0,109.0,2384,3185,1735,2603,649,582,187,442,53,315,134,127,45,59,1700,3625,2450,1800,50,0,1
429,2,2,84.0,108.0,94.0,125.0,2272,3196,1623,2547,649,649,303,168,93,65,210,103,45,59,2360,3625,2450,1800,50,0,1
436,2,2,84.0,113.0,94.0,133.0,2328,3336,1679,2687,649,649,574,174,288,95,286,79,45,60,3175,3975,2450,1800,50,0,1
443,2,2,88.0,113.0,94.0,133.0,2306,3258,1679,2631,627,627,186,450,78,295,108,155,46,60,2890,4325,2700,1800,350,0,1
450,2,2,88.0,114.0,102.0,133.0,2418,3392,1791,2743,627,649,477,350,293,115,184,235,47,61,2905,4575,2700,1800,350,0,1
457,2,2,89.0,114.0,102.0,133.0,2356,3196,1707,2547,649,649,307,720,43,405,264,315,47,61,2905,4575,2700,2100,350,0,1
464,2,2,89.0,114.0,102.0,141.0,2418,3218,1791,2547,627,671,449,1106,113,715,336,391,48,61,2920,4575,2700,2100,350,0,1
471,2,2,89.0,126.0,102.0,141.0,2468,3252,1819,2603,649,649,734,432,318,265,416,167,48,61,3580,5725,2700,2100,350,0,1
479,2,2,83.0,125.0,117.0,149.0,2418,3252,1791,2603,627,649,406,548,168,305,238,243,48,61,2420,5375,2700,2100,1525,350,1
7,2,0,13.0,13.0,15.0,15.0,293,251,293,251,0,0,35,30,35,30,0,0,12,12,0,0,0,0,0,0,0
14,2,0,14.0,14.0,15.0,15.0,671,671,671,671,0,0,70,70,70,70,0,0,13,13,0,0,0,0,0,0,0
21,2,0,14.0,14.0,15.0,15.0,727,727,727,727,0,0,50,50,50,50,0,0,13,13,0,0,0,0,0,0,0
29,2,0,15.0,15.0,15.0,15.0,671,727,671,727,0,0,85,30,85,30,0,0,14,14,0,0,0,0,0,0,0
36,2,0,15.0,15.0,15.0,15.0,811,811,811,811,0,0,140,140,140,140,0,0,15,14,0,0,0,0,0,0,0
43,2,0,16.0,16.0,23.0,23.0,811,811,811,811,0,0,35,70,35,70,0,0,15,15,0,0,0,0,0,0,0
50,2,0,17.0,16.0,23.0,23.0,839,839,839,839,0,0,5,40,5,40,0,0,16,15,0,0,0,0,0,0,0
57,2,0,18.0,17.0,23.0,23.0,811,755,811,755,0,0,115,80,115,80,0,0,17,16,0,0,0,0,0,0,0
64,2,0,18.0,18.0,23.0,23.0,923,783,923,783,0,0,175,170,175,170,0,0,17,17,0,0,0,0,0,0,0
71,2,0,19.0,18.0,23.0,23.0,917,799,895,755,22,44,234,208,230,200,4,8,18,17,0,0,0,0,0,0,0
79,2,0,20.0,19.0,23.0,23.0,984,855,895,699,89,156,351,318,335,290,16,28,19,18,0,0,0,0,0,0,0
86,2,0,20.0,19.0,23.0,23.0,1034,883,923,727,111,156,332,373,300,325,32,48,19,18,0,0,150,0,0,0,0
93,2,0,23.0,21.0,23.0,23.0,1062,883,951,727,111,156,299,378,255,360,44,18,20,19,0,0,150,150,0,0,0
100,2,0,23.0,21.0,23.0,23.0,922,962,811,783,111,179,396,343,340,305,56,38,20,20,0,0,150,150,0,0,0
107,2,0,23.0,21.0,23.0,23.0,978,906,867,727,111,179,117,448,45,390,72,58,21,20,0,0,150,150,0,0,0
114,2,0,23.0,21.0,23.0,23.0,978,967,867,811,111,156,134,164,50,90,84,74,21,20,100,0,150,150,0,0,0
121,2,0,23.0,21.0,23.0,23.0,1062,967,951,811,111,156,255,174,155,80,100,94,21,20,100,0,150,150,0,0,0
129,2,0,23.0,23.0,23.0,23.0,1074,911,895,755,179,156,260,199,140,85,120,114,21,20,100,100,300,150,0,0,0
136,2,0,25.0,23.0,31.0,23.0,1023,1079,867,923,156,156,96,79,35,45,61,34,21,20,100,100,300,150,0,0,0
143,2,0,26.0,24.0,31.0,31.0,1057,1163,923,1007,134,156,177,164,100,110,77,54,21,21,100,100,300,150,0,0,0
150,2,0,27.0,25.0,31.0,31.0,1102,1270,923,1091,179,179,131,159,55,85,76,74,22,21,100,150,300,150,0,0,0
157,2,0,29.0,26.0,31.0,31.0,1191,1219,923,1063,268,156,277,240,165,150,112,90,22,22,225,150,300,150,0,0,0
164,2,0,29.0,27.0,31.0,31.0,1208,1275,895,1119,313,156,422,340,270,230,152,110,23,22,225,200,400,150,0,0,0
171,2,0,28.0,28.0,31.0,31.0,1214,1275,923,1119,291,156,218,356,130,226,88,130,23,23,125,200,400,150,100,0,0
179,2,0,31.0,28.0,46.0,31.0,1264,1163,951,1007,313,156,78,460,25,310,53,150,24,23,250,200,400,400,100,0,0
186,2,0,32.0,29.0,46.0,46.0,1286,1191,951,1035,335,156,173,460,80,290,93,170,24,24,250,250,400,500,100,0,0
193,2,0,34.0,32.0,46.0,46.0,1393,1214,1035,1035,358,179,243,105,110,90,133,15,26,25,250,250,400,500,100,0,0
200,2,0,34.0,32.0,46.0,46.0,1426,1208,1091,1007,335,201,154,209,85,170,69,39,27,25,250,250,400,500,100,0,0
207,2,0,38.0,33.0,46.0,46.0,1494,1426,1203,1203,291,223,236,378,135,315,101,63,28,26,375,250,650,500,100,0,0
214,2,0,39.0,36.0,46.0,46.0,1572,1186,1259,895,313,291,366,323,225,245,141,78,29,26,375,350,650,500,100,0,0
221,2,0,40.0,37.0,46.0,46.0,1583,1208,1315,895,268,313,208,273,185,155,23,118,30,27,375,350,650,500,100,0,0
229,2,0,41.0,42.0,46.0,46.0,1634,1370,1343,1035,291,335,318,143,255,85,63,58,31,28,375,350,650,850,100,0,0
236,2,0,42.0,43.0,46.0,46.0,1662,1376,1371,1063,291,313,414,264,315,170,99,94,33,29,550,450,650,850,100,0,0
243,2,0,44.0,45.0,46.0,54.0,1510,1454,1175,1119,335,335,499,299,360,165,139,134,34,31,550,400,650,850,100,100,0
250,2,0,44.0,43.0,54.0,54.0,1818,1566,1483,1231,335,335,624,499,445,325,179,174,34,31,550,350,900,850,100,250,0
257,2,0,46.0,44.0,54.0,54.0,1953,1572,1595,1259,358,313,514,520,295,310,219,210,36,32,425,550,900,850,225,250,0
264,2,0,45.0,45.0,54.0,54.0,1958,1544,1623,1231,335,313,535,395,280,195,255,200,37,32,300,600,900,850,350,300,0
271,2,0,48.0,46.0,54.0,54.0,1992,1818,1679,1483,313,335,316,315,75,75,241,240,38,33,475,600,900,850,350,300,0
279,2,0,48.0,49.0,54.0,54.0,2054,2216,1763,1903,291,313,462,416,185,140,277,276,39,33,475,700,900,850,350,300,0
286,2,0,50.0,52.0,62.0,54.0,2132,2070,1819,1735,313,335,567,356,325,165,242,191,40,35,725,700,900,1000,350,300,0
293,2,0,51.0,54.0,70.0,54.0,2042,2154,1707,1819,335,335,498,51,220,20,278,31,41,35,725,700,1200,1000,350,300,0
300,2,0,53.0,57.0,78.0,62.0,2070,2104,1735,1791,335,313,608,122,290,55,318,67,42,36,725,800,1200,1000,350,300,0
307,2,0,54.0,60.0,86.0,62.0,2132,2160,1819,1847,313,313,809,197,455,90,354,107,43,37,825,800,1200,1000,350,300,0
314,2,0,57.0,61.0,86.0,62.0,2048,2154,1735,1819,313,335,704,317,435,170,269,147,44,38,1075,1075,1200,1275,350,300,0
321,2,0,58.0,65.0,86.0,70.0,2110,2126,1595,1791,515,335,560,182,215,120,345,62,45,39,1075,1175,1500,1425,350,300,0
329,2,0,59.0,68.0,86.0,70.0,2322,2210,1651,1875,671,335,540,317,240,215,300,102,46,40,825,1175,1500,1425,600,300,0
336,2,0,64.0,67.0,86.0,70.0,2406,2065,1735,1707,671,358,335,236,205,215,130,21,48,39,1075,1175,1500,1425,600,450,0
343,2,0,65.0,68.0,86.0,70.0,2434,1443,1763,1175,671,268,567,294,365,245,202,49,49,38,1575,1575,1500,1425,600,550,0
350,2,0,64.0,69.0,86.0,70.0,2446,1169,1819,923,627,246,810,367,540,290,270,77,49,39,1325,1575,1500,1500,850,550,0
357,2,0,65.0,70.0,86.0,70.0,2457,1006,1875,783,582,223,763,220,575,140,188,80,51,40,1325,1850,1500,1500,850,550,0
364,2,0,68.0,70.0,86.0,70.0,2518,1505,1959,1259,559,246,370,417,235,305,135,112,51,41,1325,1950,1500,1500,850,550,0
371,2,0,74.0,76.0,86.0,78.0,2541,2042,1959,1707,582,335,56,507,20,355,36,152,53,42,1325,1950,1500,1500,850,550,0
379,2,0,74.0,76.0,94.0,78.0,2636,2070,1987,1623,649,447,231,407,115,295,116,112,53,42,1450,1950,1500,1500,850,550,0
386,2,0,77.0,77.0,94.0,78.0,2737,2205,2043,1623,694,582,256,290,135,235,121,55,55,44,1900,1950,1500,1500,850,550,0
393,2,0,78.0,84.0,117.0,86.0,2429,2300,1735,1651,694,649,317,385,120,275,197,110,55,44,1900,2125,1650,1500,850,600,0
400,2,0,80.0,86.0,117.0,86.0,2222,2322,1595,1651,627,671,380,279,215,219,165,60,57,45,1900,2125,1650,1500,850,600,0
407,2,0,84.0,87.0,133.0,94.0,2642,2412,2015,1763,627,649,395,445,200,371,195,74,59,46,2175,2225,1800,1500,850,600,0
414,2,0,82.0,87.0,133.0,94.0,2782,2776,2155,2127,627,649,580,684,305,542,275,142,60,47,1925,2200,1800,1400,1100,775,0
421,2,0,85.0,93.0,133.0,94.0,3062,3022,2435,2351,627,671,665,269,310,97,355,172,62,48,1925,2325,1800,1400,1100,775,0
429,2,0,93.0,93.0,133.0,94.0,3134,2922,2463,2295,671,627,335,591,100,347,235,244,63,49,2450,2700,1800,1400,1100,775,0
436,2,0,93.0,94.0,133.0,94.0,3375,3000,2659,2351,716,649,745,361,430,162,315,199,63,50,2625,2700,1950,1400,1100,775,0
443,2,0,93.0,94.0,133.0,94.0,3364,3000,2715,2351,649,649,443,601,160,322,283,279,63,50,2625,2950,2100,1400,1100,775,0
450,2,0,99.0,94.0,133.0,94.0,3314,3056,2687,2407,627,649,529,812,170,657,359,155,63,49,2625,3000,2100,1400,1100,525,0
457,2,0,95.0,102.0,149.0,102.0,3286,3028,2659,2379,627,649,769,502,330,367,439,135,63,48,2875,3000,2100,1400,1400,575,0
464,2,0,97.0,108.0,149.0,118.0,3230,2910,2603,2239,627,671,914,463,395,302,519,161,63,49,2975,3000,2100,1400,1400,575,0
471,2,0,97.0,111.0,149.0,118.0,3252,2462,2603,1791,649,671,1299,358,700,117,599,241,63,51,2975,3050,2250,1400,1400,575,0
479,2,0,97.0,111.0,149.0,118.0,3409,2306,2715,1679,694,627,1054,410,375,122,679,288,63,51,2975,3100,2400,1400,1400,575,0
486,2,0,105.0,115.0,149.0,118.0,3269,2384,2575,1735,694,649,615,655,60,287,555,368,63,53,2975,3350,2400,1400,1400,575,0
493,2,0,93.0,111.0,149.0,118.0,3392,2328,2743,1679,649,649,1017,935,390,487,627,448,63,53,2825,3675,2400,1400,2250,975,0
500,2,0,81.0,104.0,141.0,126.0,3342,2328,2715,1679,627,649,1398,776,695,402,703,374,63,55,1675,3025,2400,1400,3600,1625,0
507,2,0,83.0,108.0,141.0,126.0,3286,2362,2659,1735,627,627,1283,787,625,362,658,425,63,55,1925,3100,2550,1400,3600,1675,0
514,2,0,91.0,112.0,141.0,126.0,3174,2490,2547,1819,627,671,1108,592,495,287,613,305,63,55,1925,3150,2700,1700,3600,1675,0
521,2,0,85.0,110.0,149.0,126.0,3246,2468,2575,1819,671,649,1378,658,685,352,693,306,63,57,1950,3150,2800,1700,4125,1850,0
529,2,0,79.0,114.0,149.0,141.0,3263,2446,2547,1819,716,627,1268,444,745,212,523,232,63,56,1575,3450,2800,1700,4500,2000,0
536,2,0,81.0,111.0,157.0,141.0,3246,2356,2575,1707,671,649,1395,709,925,397,470,312,63,54,1575,3450,2800,1800,4500,2150,0
543,2,0,89.0,114.0,157.0,141.0,3174,2300,2547,1651,627,649,1082,710,640,347,442,363,63,53,1650,3800,2800,1875,4675,2250,0
550,2,0,91.0,115.0,172.0,141.0,3090,2216,2463,1567,627,649,1217,625,820,232,397,393,63,53,1950,3750,2800,1875,4675,2525,0
557,2,0,87.0,105.0,172.0,141.0,3090,2350,2463,1679,627,671,1597,801,1120,332,477,469,63,54,2000,2925,2800,1975,5025,3403,0
564,2,0,82.0,104.0,172.0,141.0,3146,2322,2519,1651,627,671,1987,1021,1430,472,557,549,62,55,1725,3100,2800,1975,5350,3728,0
571,2,0,90.0,104.0,172.0,133.0,3078,2390,2407,1763,671,627,1492,1003,1105,382,387,621,62,56,2725,3225,2800,1975,5600,3878,0
579,2,0,88.0,93.0,172.0,133.0,3185,2272,2491,1623,694,649,1873,1213,1410,512,463,701,62,58,2550,2425,2800,1975,5775,4678,0
586,2,0,89.0,93.0,172.0,133.0,3140,2328,2491,1679,649,649,1995,1223,1460,467,535,756,62,58,2125,2250,2800,1975,6200,4978,0
593,2,0,96.0,104.0,172.0,133.0,2922,2412,2295,1763,627,649,1801,569,1190,87,611,482,62,59,2225,2250,2800,2075,6200,4978,0
600,2,0,103.0,105.0,172.0,133.0,3050,2496,2267,1847,783,649,1909,869,1190,307,719,562,66,61,2725,2350,2800,2075,6200,4978,0
607,2,0,104.0,113.0,172.0,133.0,3140,2910,2267,2239,873,671,1732,660,905,97,827,563,66,61,2725,2525,2800,2075,6200,4978,0
614,2,0,107.0,115.0,172.0,133.0,3297,3050,2379,2379,918,671,1749,645,810,127,939,518,70,62,2725,2650,2800,2075,6200,4978,0
621,2,0,117.0,117.0,172.0,133.0,3414,3090,2407,2463,1007,627,1059,807,500,217,559,590,70,62,3825,3200,2950,2075,6200,4978,0
629,2,0,118.0,126.0,172.0,133.0,3750,2972,2743,2323,1007,649,1465,567,790,197,675,370,71,62,2925,3775,2950,2075,6200,4978,0
636,2,0,122.0,131.0,172.0,133.0,3678,3162,2715,2491,963,671,883,372,450,97,433,275,71,62,3825,3900,2950,2075,6200,4978,0
643,2,0,126.0,132.0,172.0,149.0,3812,2972,2827,2323,985,649,983,358,555,57,428,301,72,59,3825,4000,2950,2075,6200,5128,0
650,2,0,128.0,131.0,172.0,149.0,3874,2860,2911,2211,963,649,739,529,395,177,344,352,72,59,3725,3900,2950,2075,6650,5228,0
657,2,0,127.0,133.0,180.0,149.0,3879,2944,2939,2295,940,649,865,680,555,277,310,403,72,54,4325,4425,2950,2075,6750,5533,0
664,2,0,129.0,134.0,180.0,149.0,3980,2619,2995,2127,985,492,975,772,670,317,305,455,73,53,4075,4650,3700,2075,7000,5583,0
671,2,0,128.0,134.0,180.0,149.0,4081,2642,3051,2239,1030,403,1455,815,1030,437,425,378,75,53,4600,5300,3700,2075,7100,5583,0
679,2,0,148.0,143.0,180.0,149.0,3980,2653,2995,2295,985,358,932,244,395,147,537,97,75,53,5600,5600,3950,2075,7100,5583,0
686,2,0,154.0,145.0,180.0,149.0,4042,2642,3079,2239,963,403,404,312,255,192,149,120,75,53,5600,5725,4250,2275,7100,5583,0
693,2,0,154.0,149.0,180.0,149.0,3958,2614,2995,2211,963,403,875,460,610,317,265,143,75,53,5600,6050,4250,2275,7100,5583,0
700,2,0,154.0,155.0,180.0,157.0,3767,2591,2827,2211,940,380,926,330,545,172,381,158,75,53,5600,6175,4250,2275,7100,5583,0
707,2,0,136.0,137.0,180.0,165.0,3902,2423,2939,2043,963,380,1406,438,905,257,501,181,75,53,4975,4800,4250,2275,8325,7133,0
714,2,0,138.0,119.0,180.0,165.0,3980,2451,2995,2071,985,380,781,577,160,377,621,200,75,53,3500,3425,4250,2275,9800,8508,0
721,2,0,131.0,125.0,180.0,173.0,4002,2423,2995,2043,1007,380,947,400,360,327,587,73,75,53,3925,4550,4250,2275,10475,8608,0
729,2,0,127.0,123.0,180.0,181.0,3924,2451,2939,2071,985,380,1409,304,710,237,699,67,75,50,3725,4550,4250,2275,10675,8983,0
736,2,0,146.0,113.0,180.0,181.0,3840,2222,2855,1819,985,403,775,517,110,402,665,115,75,46,3725,4050,4250,2275,10675,9683,0
743,2,0,148.0,117.0,180.0,181.0,3734,1695,2771,1315,963,380,701,541,70,407,631,134,75,46,4350,4400,4250,2275,11025,9733,0
750,2,0,144.0,124.0,180.0,181.0,3823,1527,2883,1147,940,380,882,215,285,187,597,28,75,47,4500,4575,4250,2275,11225,9733,0
757,2,0,129.0,105.0,180.0,181.0,3874,1751,2911,1371,963,380,1362,49,645,27,717,22,75,38,3725,3575,4250,2275,12300,11183,0
764,2,0,111.0,104.0,180.0,181.0,4081,1919,3051,1539,1030,380,1842,312,1005,242,837,70,75,37,2750,3900,4250,2275,13275,11558,0
771,2,0,127.0,110.0,180.0,181.0,3896,2205,2911,1847,985,358,909,181,360,92,549,89,75,37,4450,4125,4250,2275,13275,11558,0
779,2,0,131.0,114.0,195.0,181.0,3986,2311,3023,1931,963,380,1076,299,415,162,661,137,75,39,4650,4450,4250,2275,13375,11558,0
786,2,0,131.0,117.0,195.0,181.0,4008,2306,3023,1903,985,403,1151,272,570,237,581,35,75,39,4950,4750,4250,2275,13375,11558,0
793,2,0,129.0,122.0,195.0,181.0,3930,2278,2967,1875,963,403,1622,296,925,242,697,54,75,42,4700,5025,4250,2275,13625,11558,0
800,2,0,123.0,106.0,195.0,181.0,3879,2395,2939,2015,940,380,2093,455,1280,382,813,73,75,42,4400,3825,4250,2275,13825,12758,0
807,2,0,143.0,105.0,195.0,181.0,4002,2647,2995,2267,1007,380,1458,669,525,552,933,117,75,43,5325,3675,4250,2275,14000,13008,0
814,2,0,155.0,109.0,195.0,181.0,3946,2703,2939,2323,1007,380,929,462,280,447,649,15,75,43,5325,3625,4250,2275,14000,13183,0
821,2,0,155.0,116.0,195.0,181.0,3616,2345,2631,1987,985,358,1031,256,420,247,611,9,75,43,5325,3850,4250,2275,14000,13183,0
829,2,0,167.0,118.0,195.0,181.0,3672,2390,2687,1987,985,403,282,394,55,337,227,57,75,43,5325,4250,4250,2275,14000,13183,0
836,2,0,169.0,121.0,195.0,181.0,3566,2166,2603,1763,963,403,608,257,265,152,343,105,75,45,5625,4375,4250,2275,14000,13183,0
843,2,0,169.0,126.0,195.0,181.0,3739,1975,2799,1595,940,380,979,109,520,93,459,16,75,46,6525,4650,4250,2275,14000,13183,0
850,2,0,167.0,126.0,195.0,181.0,3986,2059,3023,1679,963,380,1459,335,880,282,579,53,75,47,6425,4975,4250,2275,14100,13183,0
857,2,0,172.0,133.0,195.0,181.0,4170,2087,3163,1707,1007,380,1519,177,820,141,699,36,75,47,6425,5100,4250,2275,14100,13183,0
864,2,0,188.0,136.0,203.0,181.0,4064,2171,3079,1791,985,380,236,236,150,189,86,47,75,47,6425,5275,4250,2275,14100,13183,0
871,2,0,190.0,137.0,203.0,181.0,3890,2255,2995,1875,895,380,166,325,130,259,36,66,75,47,8975,5325,4250,2275,14350,13183,0
879,2,0,188.0,133.0,203.0,181.0,3403,2194,2575,1791,828,403,550,584,410,472,140,112,76,47,9400,5325,4250,2275,14450,13783,0
886,2,0,189.0,133.0,203.0,181.0,3487,2138,2659,1735,828,403,934,540,690,513,244,27,76,47,9400,5275,4250,2275,14450,13958,0
893,2,0,195.0,140.0,203.0,181.0,3594,2087,2743,1707,851,380,1067,369,715,323,352,46,76,47,9400,5325,4250,2275,14450,13958,0
900,2,0,187.0,122.0,203.0,181.0,3963,2121,3023,1763,940,358,1530,264,1070,226,460,38,77,47,9150,4325,4250,2275,15000,15083,0
907,2,0,171.0,102.0,203.0,196.0,4058,2087,3051,1707,1007,380,1911,292,1335,231,576,61,77,45,7750,3100,4250,2275,16000,16658,0
914,2,0,167.0,100.0,203.0,196.0,4182,2093,3219,1735,963,358,2405,236,1725,181,680,55,77,45,7550,2775,4250,2275,16200,17178,0
921,2,0,164.0,92.0,203.0,196.0,4019,2087,3135,1707,884,380,2872,319,2090,241,782,78,79,45,7250,2475,4250,2275,16500,17797,0
927,2,0,164.0,97.0,203.0,196.0,4019,2115,3135,1735,884,380,2872,226,2090,141,782,85,79,45,7250,2675,4250,2275,16500,17797,0
7,2,0,13.0,13.0,15.0,15.0,293,293,293,293,0,0,35,35,35,35,0,0,12,12,0,0,0,0,0,0,0
14,2,0,14.0,14.0,15.0,15.0,643,671,643,671,0,0,65,70,65,70,0,0,13,13,0,0,0,0,0,0,0
21,2,0,14.0,14.0,15.0,15.0,727,699,727,699,0,0,50,50,50,50,0,0,13,13,0,0,0,0,0,0,0
29,2,0,15.0,15.0,15.0,15.0,727,671,727,671,0,0,90,80,90,80,0,0,14,14,0,0,0,0,0,0,0
36,2,0,15.0,15.0,23.0,15.0,811,727,811,727,0,0,140,130,140,130,0,0,14,14,0,0,0,0,0,0,0
43,2,0,16.0,16.0,23.0,23.0,839,727,839,727,0,0,35,55,35,55,0,0,15,15,0,0,0,0,0,0,0
50,2,0,17.0,16.0,23.0,23.0,839,755,839,755,0,0,10,65,10,65,0,0,16,15,0,0,0,0,0,0,0
57,2,0,18.0,17.0,23.0,23.0,839,671,839,671,0,0,110,95,110,95,0,0,17,16,0,0,0,0,0,0,0
64,2,0,19.0,18.0,23.0,23.0,979,783,979,783,0,0,175,15,175,15,0,0,18,17,0,0,0,0,0,0,0
71,2,0,19.0,18.0,23.0,23.0,867,721,867,699,0,22,230,49,230,45,0,4,18,17,0,0,0,0,0,0,0
79,2,0,20.0,19.0,23.0,23.0,850,889,783,755,67,134,327,164,315,140,12,24,19,18,0,0,0,0,0,0,0
86,2,0,20.0,19.0,23.0,23.0,788,883,699,727,89,156,379,274,355,230,24,44,19,18,0,0,150,0,0,0,0
93,2,0,21.0,19.0,23.0,23.0,838,934,727,755,111,179,321,229,285,165,36,64,20,19,0,0,150,150,0,0,0
100,2,0,21.0,19.0,23.0,23.0,816,939,727,783,89,156,424,245,380,215,44,30,20,18,0,0,150,150,0,50,0
107,2,0,20.0,19.0,23.0,23.0,861,911,727,755,134,156,170,355,110,305,60,50,20,18,0,0,150,150,0,175,0
114,2,0,21.0,19.0,23.0,23.0,866,967,755,811,111,156,132,80,60,10,72,70,20,18,0,0,150,150,0,175,0
121,2,0,21.0,20.0,23.0,23.0,995,967,839,811,156,156,182,150,90,60,92,90,20,18,0,0,150,150,0,175,0
129,2,0,24.0,21.0,31.0,23.0,1074,1102,895,923,179,179,127,130,40,20,87,110,21,18,0,100,300,150,0,175,0
136,2,0,23.0,22.0,31.0,23.0,1079,1074,923,895,156,179,113,225,60,95,53,130,20,19,0,100,300,150,50,175,0
143,2,0,24.0,22.0,31.0,23.0,1152,1051,951,895,201,156,71,51,40,5,31,46,21,19,0,100,300,150,50,175,0
150,2,0,27.0,24.0,31.0,31.0,1214,1051,923,895,291,156,172,141,105,75,67,66,22,20,125,150,300,150,50,175,0
157,2,0,27.0,25.0,31.0,31.0,1242,1219,951,1063,291,156,268,156,165,70,103,86,22,21,125,150,300,150,50,175,0
164,2,0,28.0,25.0,31.0,31.0,1264,1247,951,1091,313,156,169,306,130,200,39,106,23,21,125,150,300,150,50,175,0
171,2,0,28.0,26.0,31.0,31.0,1270,1359,979,1203,291,156,265,306,190,230,75,76,23,22,300,200,300,150,50,175,0
179,2,0,30.0,26.0,46.0,31.0,1342,1354,1007,1175,335,179,275,456,160,360,115,96,24,22,300,200,300,150,50,175,0
186,2,0,31.0,26.0,46.0,46.0,1342,1242,1007,1063,335,179,125,436,70,320,55,116,25,23,300,200,300,500,50,175,0
193,2,0,33.0,27.0,46.0,46.0,1454,1247,1119,1091,335,156,301,532,210,400,91,132,27,23,300,200,300,500,50,175,0
200,2,0,34.0,28.0,46.0,46.0,1516,1499,1203,1343,313,156,272,132,145,5,127,127,28,24,300,200,550,500,50,175,0
207,2,0,35.0,30.0,46.0,46.0,1516,1415,1203,1259,313,156,97,202,80,55,17,147,30,24,300,200,550,600,50,175,0
214,2,0,37.0,32.0,46.0,46.0,1600,1443,1287,1287,313,156,192,232,135,65,57,167,31,25,300,200,550,675,50,175,0
221,2,0,38.0,32.0,46.0,46.0,1684,1662,1371,1483,313,179,203,362,110,200,93,162,32,25,300,250,550,675,50,175,0
229,2,0,39.0,36.0,46.0,46.0,1634,1774,1343,1595,291,179,140,272,15,90,125,182,33,27,300,300,550,675,50,175,0
236,2,0,41.0,36.0,46.0,46.0,1695,1919,1427,1763,268,156,222,453,140,255,82,198,34,28,300,200,800,675,50,275,0
243,2,0,43.0,38.0,46.0,46.0,1852,1863,1539,1707,313,156,152,438,30,220,122,218,36,29,300,250,800,675,50,275,0
250,2,0,43.0,43.0,46.0,46.0,1886,1863,1595,1707,291,156,353,138,195,25,158,113,37,31,400,300,950,750,50,275,0
257,2,0,47.0,44.0,54.0,46.0,1964,1863,1651,1707,313,156,248,218,50,85,198,133,38,31,400,300,950,750,50,275,0
264,2,0,51.0,46.0,62.0,46.0,2020,1919,1707,1763,313,156,148,203,10,50,138,153,38,33,750,350,950,875,50,275,0
271,2,0,51.0,47.0,62.0,61.0,2121,2054,1763,1875,358,179,408,258,230,85,178,173,38,33,750,400,1250,1025,50,275,0
279,2,0,55.0,52.0,62.0,61.0,2110,1925,1707,1679,403,246,206,145,80,90,126,55,40,35,750,675,1250,1025,50,275,0
286,2,0,58.0,56.0,62.0,61.0,2048,2020,1623,1707,425,313,234,131,110,40,124,91,40,35,1350,725,1250,1125,50,275,0
293,2,0,62.0,57.0,62.0,69.0,2210,2104,1763,1791,447,313,229,36,95,5,134,31,41,37,1700,725,1250,1225,50,275,0
300,2,0,62.0,59.0,70.0,69.0,2210,2272,1763,1959,447,313,145,151,30,80,115,71,41,37,1700,850,1250,1225,50,275,0
307,2,0,61.0,62.0,70.0,69.0,2149,2608,1679,2295,470,313,445,241,270,130,175,111,41,38,1700,950,1250,1225,50,275,0
314,2,0,67.0,63.0,70.0,77.0,2261,2384,1791,2071,470,313,201,201,120,150,81,51,41,40,2050,1275,1250,1225,50,275,0
321,2,0,69.0,66.0,78.0,77.0,2255,2345,1763,1987,492,358,286,241,195,150,91,91,41,41,2500,1325,1250,1225,50,275,0
329,2,0,69.0,66.0,78.0,85.0,2283,2434,1791,2099,492,335,542,252,395,125,147,127,41,42,2500,1325,1350,1225,50,275,0
336,2,0,75.0,68.0,78.0,85.0,2227,2300,1735,1987,492,313,287,133,230,95,57,38,41,39,2500,1425,1450,1225,50,425,0
343,2,0,77.0,68.0,78.0,93.0,2199,1891,1707,1735,492,156,368,249,255,195,113,54,41,39,3025,1425,1450,1225,50,550,0
350,2,0,69.0,64.0,78.0,93.0,2177,1656,1707,1567,470,89,629,232,460,170,169,62,43,39,2325,875,1450,1375,750,1200,0
357,2,0,69.0,62.0,78.0,93.0,2317,1706,1847,1595,470,111,904,373,675,295,229,78,43,35,2325,1025,1450,1375,750,1450,0
364,2,0,75.0,65.0,78.0,93.0,2283,1555,1791,1399,492,156,144,243,5,145,139,98,43,36,2325,1300,1450,1375,750,1450,0
371,2,0,77.0,68.0,78.0,93.0,2367,2171,1875,1903,492,268,334,364,135,230,199,134,43,37,2850,1400,1450,1375,750,1450,0
379,2,0,77.0,74.0,86.0,93.0,2418,2457,1903,2099,515,358,315,102,210,45,105,57,44,39,2850,1400,1450,1525,750,1500,0
386,2,0,82.0,76.0,86.0,93.0,2345,2675,1875,2183,470,492,182,192,125,75,57,117,45,41,3025,1400,1450,1525,750,1500,0
393,2,0,83.0,78.0,86.0,93.0,2345,2597,1875,2127,470,470,263,178,150,105,113,73,45,39,3200,1500,1450,1425,750,1800,0
400,2,0,85.0,79.0,86.0,101.0,2373,2009,1791,1539,582,470,449,313,260,180,189,133,47,39,3200,1550,1450,1425,750,1900,0
407,2,0,85.0,79.0,86.0,101.0,2468,2216,1819,1679,649,537,744,191,475,115,269,76,49,38,3075,1600,1450,1425,875,2050,0
414,2,0,84.0,76.0,86.0,101.0,2446,1751,1819,1259,627,492,636,223,395,95,241,128,50,37,2900,1675,1450,1425,1050,2500,0
421,2,0,76.0,75.0,86.0,101.0,2558,1527,1931,1147,627,380,942,287,625,115,317,172,51,39,2200,1775,1450,1425,1750,2600,0
429,2,0,82.0,78.0,94.0,101.0,2546,1566,1875,1231,671,335,337,102,140,40,197,62,52,39,2025,1925,1750,1425,1925,2650,0
436,2,0,88.0,77.0,117.0,101.0,2608,1729,1959,1371,649,358,153,401,80,220,73,181,52,39,2725,1975,1750,1425,1925,2650,0
443,2,0,91.0,79.0,117.0,101.0,2726,2154,2099,1595,627,559,289,282,140,125,149,157,52,41,2725,2075,1750,1525,1925,2650,0
450,2,0,92.0,80.0,125.0,101.0,2910,2378,2239,1707,671,671,189,407,110,220,79,187,55,43,2725,2125,1750,1525,1925,2650,0
457,2,0,95.0,81.0,125.0,101.0,2888,2625,2239,1931,649,694,215,382,60,115,155,267,56,44,2725,2125,1850,1525,1925,2650,0
464,2,0,97.0,82.0,125.0,101.0,2899,2670,2295,2043,604,627,328,655,105,320,223,335,59,45,2725,2125,1850,1650,1925,2650,0
471,2,0,99.0,87.0,125.0,101.0,2950,2838,2323,2211,627,627,434,400,210,285,224,115,60,46,2725,2125,1850,1650,1925,2650,0
479,2,0,100.0,85.0,125.0,101.0,3084,2832,2435,2183,649,649,814,640,510,445,304,195,63,46,3125,1975,1850,1650,2025,2900,0
486,2,0,100.0,88.0,125.0,101.0,3112,2182,2463,1623,649,559,755,644,475,410,280,234,63,46,2950,1975,2000,1750,2200,2900,0
493,2,0,100.0,95.0,125.0,101.0,3280,2356,2631,1819,649,537,506,453,350,205,156,248,65,48,2950,1975,2000,1750,2200,2900,0
500,2,0,106.0,100.0,125.0,101.0,3280,2787,2631,2183,649,604,397,355,365,85,32,270,66,50,3050,2425,2000,1750,2200,2900,0
507,2,0,106.0,101.0,125.0,101.0,3448,2339,2799,1735,649,604,309,391,205,45,104,346,66,51,3050,2600,2000,2050,2200,2900,0
514,2,0,107.0,101.0,125.0,101.0,3314,2535,2687,1931,627,604,651,329,475,115,176,214,66,52,3050,2850,2300,1950,2200,2925,0
521,2,0,104.0,104.0,125.0,117.0,3286,2866,2435,2239,851,627,1037,540,745,250,292,290,65,53,2875,2725,2300,1950,2425,3225,0
529,2,0,114.0,108.0,125.0,117.0,3342,3090,2379,2463,963,627,689,347,585,185,104,162,66,55,3525,2575,2650,2025,2425,3375,0
536,2,0,114.0,112.0,133.0,133.0,3342,3347,2379,2743,963,604,584,254,360,70,224,184,66,56,3525,2575,2650,2025,2425,3425,0
543,2,0,118.0,117.0,133.0,133.0,3258,3431,2295,2827,963,604,470,491,430,235,40,256,68,58,4225,2800,2950,2025,2425,3425,0
550,2,0,118.0,122.0,133.0,133.0,3470,3588,2463,2939,1007,649,890,116,730,30,160,86,68,59,4025,2900,2950,2125,2425,3425,0
557,2,0,131.0,131.0,133.0,133.0,3426,3538,2463,2911,963,627,383,262,315,75,68,187,67,61,4475,3475,2950,2125,2575,3425,0
564,2,0,131.0,133.0,149.0,133.0,3476,3722,2491,3051,985,671,599,537,415,270,184,267,67,62,4875,3650,3250,2375,2575,3425,0
571,2,0,131.0,133.0,149.0,133.0,3448,3448,2463,2799,985,649,1014,404,710,90,304,314,67,64,4875,3825,3250,2375,2575,3425,0
579,2,0,147.0,133.0,149.0,133.0,3459,3504,2519,2855,940,649,626,514,210,170,416,344,67,64,5175,4000,3250,2375,2575,3425,0
586,2,0,148.0,133.0,180.0,133.0,3515,2877,2575,2407,940,470,1006,412,470,70,536,342,67,62,5675,3950,3250,2375,2575,3700,0
593,2,0,134.0,129.0,180.0,157.0,3241,2770,2211,2323,1030,447,1381,638,725,240,656,398,67,62,4925,3750,3250,2375,3325,4325,0
600,2,0,137.0,103.0,180.0,157.0,3134,3123,2127,2631,1007,492,952,654,180,225,772,429,67,61,3975,2250,3250,2375,4325,6025,0
607,2,0,130.0,96.0,180.0,157.0,3258,2770,2295,2323,963,447,1305,461,425,55,880,406,65,62,4400,1625,3250,2000,4800,7225,0
614,2,0,128.0,104.0,180.0,149.0,3308,2770,2323,2323,985,447,1155,388,155,55,1000,333,65,62,4550,1800,3250,2000,5150,7525,0
621,2,0,126.0,105.0,180.0,141.0,3426,2765,2463,2295,963,470,1156,504,190,115,966,389,66,63,4350,1775,3250,2000,5350,7800,0
629,2,0,124.0,100.0,180.0,141.0,2955,2709,2015,2239,940,470,1167,490,85,70,1082,420,66,65,4250,1350,3250,2000,5650,8375,0
635,2,0,124.0,100.0,180.0,141.0,2955,2726,2015,2211,940,515,1167,626,85,150,1082,476,66,64,4250,1500,3250,2000,5650,8850,0
7,,,13.0,13.0,15.0,14.0,251,251,251,251,0,0,30,30,30,30,0,0,12,12,0,0,0,0,0,0,1
14,,,14.0,13.0,15.0,14.0,643,671,643,671,0,0,65,20,65,20,0,0,13,13,0,0,0,0,0,0,1
21,,,14.0,14.0,15.0,14.0,727,755,727,755,0,0,50,50,50,50,0,0,13,13,0,0,0,0,0,0,1
29,,,15.0,14.0,15.0,14.0,727,755,727,755,0,0,30,140,30,140,0,0,14,13,0,0,0,0,0,0,1
36,,,16.0,13.0,23.0,22.0,783,755,783,755,0,0,130,10,130,10,0,0,15,13,0,0,0,0,0,0,1
43,,,16.0,13.0,23.0,22.0,811,699,811,699,0,0,20,40,20,40,0,0,15,12,0,0,0,0,0,0,1
50,,,17.0,14.0,23.0,22.0,867,671,867,671,0,0,45,70,45,70,0,0,16,12,0,0,0,0,0,0,1
57,,,18.0,14.0,23.0,22.0,839,643,839,643,0,0,0,55,0,55,0,0,17,13,0,0,0,0,0,0,1
64,,,19.0,14.0,23.0,22.0,951,715,951,671,0,44,110,148,110,140,0,8,18,14,0,0,0,0,0,0,1
71,,,19.0,14.0,23.0,30.0,945,771,923,615,22,156,219,243,215,215,4,28,18,14,0,0,0,0,0,0,1
79,,,20.0,14.0,23.0,30.0,1023,827,979,671,44,156,343,344,335,300,8,44,19,14,0,0,0,0,0,0,1
86,,,20.0,17.0,23.0,30.0,1046,743,979,587,67,156,66,234,50,170,16,64,19,14,0,0,150,250,0,0,1
93,,,20.0,16.0,23.0,30.0,1046,799,979,643,67,156,184,179,160,95,24,84,20,13,0,0,150,250,0,0,1
100,,,21.0,18.0,23.0,30.0,1034,777,923,643,111,134,105,175,65,75,40,100,20,13,0,50,150,250,0,0,1
107,,,21.0,20.0,23.0,30.0,939,771,783,615,156,156,90,155,30,35,60,120,20,14,0,50,150,250,0,0,1
114,,,22.0,20.0,23.0,30.0,1079,827,923,671,156,156,85,255,5,115,80,140,21,14,0,100,150,250,0,0,1
121,,,23.0,21.0,23.0,30.0,1046,799,867,643,179,156,110,295,10,135,100,160,22,15,0,250,150,250,0,0,1
129,,,23.0,22.0,23.0,30.0,1124,906,923,727,201,179,244,355,120,175,124,180,22,16,0,300,150,250,0,0,1
136,,,26.0,22.0,31.0,30.0,1186,906,895,727,291,179,120,455,60,255,60,200,23,16,0,300,300,450,0,0,1
143,,,27.0,23.0,31.0,30.0,1242,911,951,755,291,156,221,511,125,295,96,216,24,17,0,300,300,450,0,0,1
150,,,28.0,24.0,31.0,30.0,1186,911,895,755,291,156,62,476,30,240,32,236,25,18,0,300,300,450,0,0,1
157,,,30.0,25.0,46.0,30.0,1219,967,951,811,268,156,93,541,50,285,43,256,25,18,175,300,300,450,0,0,1
164,,,32.0,25.0,46.0,30.0,1270,967,979,811,291,156,108,661,25,385,83,276,26,19,175,300,300,450,0,0,1
171,,,34.0,25.0,46.0,38.0,1454,1023,1119,867,335,156,128,781,5,485,123,296,28,20,175,300,300,450,0,0,1
179,,,35.0,25.0,46.0,38.0,1505,1102,1147,923,358,179,198,916,35,600,163,316,29,20,175,300,300,450,0,0,1
186,,,36.0,25.0,46.0,38.0,1600,1102,1287,923,313,179,145,1046,50,710,95,336,31,20,300,300,550,450,0,0,1
193,,,37.0,25.0,46.0,38.0,1634,1163,1343,1007,291,156,186,1177,55,825,131,352,31,20,300,300,550,450,0,0,1
200,,,39.0,25.0,46.0,38.0,1768,1135,1455,979,313,156,101,1317,80,945,21,372,33,20,300,300,550,450,0,0,1
207,,,39.0,25.0,46.0,38.0,1774,1191,1483,1035,291,156,167,1457,110,1065,57,392,33,20,300,300,550,450,0,0,1
214,,,41.0,25.0,46.0,38.0,1863,1163,1595,1007,268,156,148,1592,55,1180,93,412,35,20,300,300,550,450,0,0,1
221,,,41.0,25.0,46.0,38.0,1886,1158,1595,979,291,179,265,1717,140,1285,125,432,35,20,300,300,700,450,0,0,1
229,,,43.0,25.0,46.0,38.0,1936,1186,1623,1007,313,179,405,1862,240,1410,165,452,37,20,300,300,950,450,0,0,1
236,,,45.0,25.0,54.0,38.0,2070,1163,1735,1007,335,156,260,1993,55,1525,205,468,37,20,300,300,950,450,0,0,1
243,,,47.0,25.0,54.0,38.0,2104,1163,1791,1007,313,156,257,2133,20,1645,237,488,39,20,300,300,950,450,0,0,1
250,,,49.0,25.0,54.0,38.0,2160,1135,1847,979,313,156,258,2263,85,1755,173,508,39,20,300,300,1100,450,0,0,1
257,,,52.0,25.0,54.0,38.0,2154,1135,1819,979,335,156,248,2403,110,1875,138,528,39,20,900,300,1250,450,0,0,1
264,,,52.0,25.0,54.0,38.0,2138,1079,1847,923,291,156,220,2528,50,1980,170,548,39,20,900,300,1250,450,0,0,1
271,,,52.0,25.0,54.0,38.0,2216,1186,1903,1007,313,179,370,2673,160,2105,210,568,41,20,900,300,1250,450,0,0,1
279,,,52.0,25.0,54.0,38.0,2110,1158,1707,979,403,179,632,2803,370,2215,262,588,41,20,1000,300,1250,450,0,0,1
286,,,60.0,25.0,78.0,38.0,2255,1135,1763,979,492,156,213,2944,95,2340,118,604,41,20,1525,300,1550,450,0,0,1
293,,,60.0,27.0,86.0,38.0,2289,1107,1819,951,470,156,390,2644,220,2145,170,499,41,19,1700,300,1550,450,0,0,1
300,,,64.0,28.0,86.0,38.0,2238,1051,1791,895,447,156,311,2729,185,2210,126,519,41,19,1700,300,1550,450,0,0,1
307,,,70.0,29.0,94.0,38.0,2261,1051,1791,895,470,156,76,2709,40,2170,36,539,41,20,2050,300,1550,450,0,0,1
314,,,70.0,30.0,94.0,38.0,2311,1107,1819,951,492,156,351,2779,255,2220,96,559,41,21,2575,400,1550,450,0,0,1
321,,,70.0,30.5,94.0,38.0,2289,1135,1819,867,470,268,262,2870,110,2275,152,595,41,22,2575,375,1550,450,0,25,1
329,,,72.0,30.5,94.0,46.0,2317,1236,1847,923,470,313,439,2867,235,2265,204,602,41,23,2575,225,1550,450,0,175,1
336,,,72.0,28.5,94.0,22.0,2283,1208,1791,895,492,313,714,2857,450,2215,264,642,41,24,2575,25,1550,450,0,675,1
343,,,82.0,21.5,94.0,6.0,2367,1219,1875,951,492,268,115,2809,45,2135,70,674,43,18,2575,125,1550,450,0,1225,1
7,2,2,13.0,13.0,15.0,15.0,335,293,335,293,0,0,40,35,40,35,0,0,12,12,0,0,0,0,0,0,0
14,2,2,14.0,14.0,15.0,15.0,643,643,643,643,0,0,65,65,65,65,0,0,13,13,0,0,0,0,0,0,0
21,2,2,14.0,14.0,15.0,15.0,671,699,671,699,0,0,45,50,45,50,0,0,13,13,0,0,0,0,0,0,0
29,2,2,15.0,15.0,15.0,15.0,699,755,699,755,0,0,85,95,85,95,0,0,14,14,0,0,0,0,0,0,0
36,2,2,15.0,15.0,15.0,23.0,755,783,755,783,0,0,135,130,135,130,0,0,14,14,0,0,0,0,0,0,0
43,2,2,16.0,16.0,23.0,23.0,811,783,811,783,0,0,75,35,75,35,0,0,15,15,0,0,0,0,0,0,0
50,2,2,17.0,17.0,23.0,23.0,783,839,783,839,0,0,50,10,50,10,0,0,16,16,0,0,0,0,0,0,0
57,2,2,18.0,18.0,23.0,23.0,783,867,783,867,0,0,55,35,55,35,0,0,17,17,0,0,0,0,0,0,0
64,2,2,18.0,19.0,23.0,23.0,951,951,951,951,0,0,165,100,165,100,0,0,17,18,0,0,0,0,0,0,0
71,2,2,19.0,19.0,23.0,23.0,979,923,979,923,0,0,225,5,225,5,0,0,18,18,0,0,0,0,0,0,0
79,2,2,20.0,20.0,23.0,23.0,967,1001,923,979,44,22,243,74,235,70,8,4,19,19,0,0,0,0,0,0,0
86,2,2,20.0,21.0,23.0,23.0,967,1062,923,951,44,111,307,50,295,30,12,20,19,20,0,0,0,150,0,0,0
93,2,2,23.0,22.0,23.0,23.0,990,1006,923,895,67,111,170,112,150,80,20,32,20,21,0,0,150,150,0,0,0
100,2,2,23.0,22.0,31.0,23.0,1012,978,923,867,89,111,172,129,140,85,32,44,20,21,0,0,150,150,0,0,0
107,2,2,24.0,23.0,31.0,23.0,1034,939,923,783,111,156,293,83,245,15,48,68,21,22,0,0,150,150,0,0,0
114,2,2,25.0,23.0,31.0,23.0,1107,1057,951,811,156,246,378,220,310,120,68,100,22,22,0,0,150,150,0,0,0
121,2,2,25.0,24.0,31.0,31.0,1079,1046,923,755,156,291,458,291,370,155,88,136,22,23,100,0,150,450,0,0,0
129,2,2,26.0,27.0,31.0,31.0,1146,1146,923,811,223,335,206,111,90,85,116,26,23,23,100,0,300,450,0,0,0
136,2,2,28.0,28.0,31.0,31.0,1214,1146,923,811,291,335,127,197,25,135,102,62,23,23,100,0,300,450,0,0,0
143,2,2,29.0,27.0,31.0,31.0,1242,1180,951,867,291,313,124,283,40,185,84,98,24,23,100,0,300,450,0,0,0
150,2,2,30.0,27.0,31.0,31.0,1264,1180,951,867,313,313,99,428,25,290,74,138,25,23,100,0,300,450,0,0,0
157,2,2,30.0,26.0,31.0,31.0,1292,1186,979,895,313,291,154,315,40,245,114,70,25,22,275,350,300,450,0,0,0
164,2,2,31.0,30.0,31.0,39.0,1236,1180,923,867,313,313,150,114,0,100,150,14,25,22,275,350,300,450,50,0,0
171,2,2,31.0,30.0,31.0,39.0,1298,1281,1007,923,291,358,256,269,70,215,186,54,25,22,275,350,300,450,50,0,0
179,2,2,32.0,30.0,39.0,39.0,1264,1202,951,867,313,335,321,260,95,170,226,90,25,22,275,350,300,450,50,0,0
186,2,2,30.0,30.0,39.0,39.0,1286,1163,951,895,335,268,416,253,150,135,266,118,25,22,175,350,300,450,150,0,0
193,2,2,33.0,30.0,39.0,39.0,1449,1186,1091,895,358,291,146,408,40,250,106,158,26,22,350,700,300,450,150,0,0
200,2,2,35.0,32.0,54.0,39.0,1348,1208,1035,895,313,313,238,374,100,230,138,144,27,22,350,700,300,700,150,0,0
207,2,2,35.0,34.0,54.0,39.0,1404,1180,1091,867,313,313,208,279,30,95,178,184,27,22,350,700,400,700,150,0,0
214,2,2,37.0,34.0,54.0,39.0,1460,1130,1147,839,313,291,388,325,170,105,218,220,29,22,350,700,550,700,150,0,0
221,2,2,41.0,34.0,54.0,39.0,1572,1286,1259,951,313,335,223,475,65,215,158,260,29,22,500,700,550,700,150,0,0
229,2,2,43.0,34.0,54.0,47.0,1622,1264,1287,951,335,313,313,526,115,230,198,296,31,22,500,1125,550,1000,150,0,0
236,2,2,44.0,39.0,54.0,47.0,1706,1242,1371,951,335,291,274,227,115,70,159,157,31,22,500,1475,900,1000,150,0,0
243,2,2,46.0,39.0,54.0,47.0,1824,1264,1511,951,313,313,380,377,185,180,195,197,33,22,850,1475,900,1000,150,0,0
250,2,2,48.0,39.0,54.0,55.0,1796,1264,1483,951,313,313,402,527,225,290,177,237,33,22,850,1475,900,1000,150,0,0
257,2,2,52.0,39.0,62.0,55.0,1936,1258,1623,923,313,335,412,677,245,400,167,277,35,22,1300,1575,900,1000,150,0,0
264,2,2,56.0,39.0,62.0,55.0,1908,1309,1595,951,313,358,167,827,60,510,107,317,36,22,1300,1575,900,1000,150,0,0
271,2,2,58.0,47.0,62.0,55.0,2048,1230,1735,895,313,335,178,468,35,215,143,253,37,22,1300,2075,900,1000,150,0,0
279,2,2,57.0,47.0,54.0,55.0,1589,1264,1343,951,246,313,142,624,75,335,67,289,36,22,1475,2075,900,1000,475,0,0
286,2,2,49.0,41.0,62.0,55.0,715,1208,671,895,44,313,112,519,45,190,67,329,26,22,1475,1300,900,1000,975,775,0
293,2,2,42.0,35.0,62.0,55.0,867,1208,867,895,0,313,182,669,115,300,67,369,26,22,975,875,900,1000,1475,1200,0
300,2,2,42.0,37.0,62.0,55.0,1203,1180,1203,867,0,313,152,474,135,165,17,309,27,22,800,925,900,1000,1650,1325,0
307,2,2,46.0,35.0,62.0,55.0,1370,1258,1259,923,111,335,112,619,75,270,37,349,27,22,975,975,900,1000,1650,1450,0
314,2,2,46.0,38.0,70.0,55.0,1421,1281,1175,923,246,358,229,429,160,140,69,289,27,22,1075,1225,900,1000,1650,1550,0
321,2,2,49.0,38.0,70.0,55.0,1594,1258,1259,923,335,335,174,575,65,250,109,325,29,22,1450,1475,900,1000,1650,1550,0
329,2,2,51.0,42.0,70.0,55.0,1544,1236,1231,923,313,313,185,371,90,110,95,261,29,22,1625,1475,900,1000,1650,1550,0
336,2,2,53.0,42.0,70.0,55.0,1650,1180,1315,867,335,313,195,516,110,215,85,301,30,22,1800,1825,900,1000,1650,1550,0
343,2,2,49.0,40.0,70.0,55.0,1566,1264,1231,951,335,313,245,676,120,335,125,341,30,22,1450,1650,900,1000,2000,1725,0
350,2,2,43.0,38.0,70.0,55.0,1600,1264,1287,951,313,313,441,476,280,195,161,281,30,22,1250,1300,900,1000,2450,2250,0
357,2,2,45.0,34.0,70.0,55.0,1600,1337,1287,979,313,358,91,626,40,305,51,321,30,22,1050,1125,900,1000,2825,2600,0
364,2,2,43.0,38.0,70.0,55.0,1678,1337,1343,979,335,358,111,436,70,175,41,261,30,22,700,1475,900,1000,3175,2600,0
371,2,2,43.0,38.0,70.0,55.0,1622,1236,1287,923,335,313,316,573,235,280,81,293,30,22,875,1475,900,1000,3175,2600,0
379,2,2,47.0,44.0,70.0,55.0,1656,1264,1343,951,313,313,77,323,10,190,67,133,30,22,875,1475,900,1000,3175,2600,0
386,2,2,48.0,44.0,70.0,55.0,1650,1264,1315,951,335,313,282,473,175,300,107,173,32,22,1050,1875,1050,1000,3175,2600,0
393,2,2,50.0,44.0,70.0,55.0,1734,1236,1399,923,335,313,312,623,215,410,97,213,32,22,1225,1875,1050,1000,3175,2600,0
400,2,2,49.0,42.0,70.0,55.0,1550,1314,1259,979,291,335,319,778,240,525,79,253,32,22,1600,1775,1050,1000,3400,2700,0
407,2,2,51.0,50.0,70.0,55.0,1057,1281,811,923,246,358,267,523,210,230,57,293,32,22,1600,2175,1150,1000,3400,2700,0
414,2,2,51.0,48.0,70.0,55.0,1398,1258,1175,923,223,335,171,674,140,345,31,329,32,22,1600,2000,1150,1000,3575,2875,0
421,2,2,53.0,52.0,70.0,55.0,1544,1236,1343,923,201,313,195,395,190,130,5,265,32,22,1775,1900,1150,1000,3575,2975,0
429,2,2,53.0,54.0,70.0,55.0,1729,1264,1483,951,246,313,412,400,375,195,37,205,32,22,1950,2325,1150,1000,3575,2975,0
436,2,2,55.0,54.0,54.0,55.0,1639,1236,1371,923,268,313,199,550,130,305,69,245,32,22,2050,2475,1150,1000,3775,2975,0
443,2,2,55.0,52.0,46.0,55.0,1611,1264,1343,951,268,313,395,700,290,415,105,285,32,22,2050,2325,1250,1000,3875,3125,0
450,2,2,52.0,54.0,46.0,55.0,1578,1258,1287,923,291,335,596,500,455,275,141,225,31,22,1875,2575,1250,1000,4100,3225,0
457,2,2,48.0,46.0,70.0,55.0,1578,1337,1287,979,291,358,423,655,350,390,73,265,31,22,1250,2075,1250,1000,4725,3725,0
464,2,2,47.0,50.0,70.0,55.0,1387,1292,1119,979,268,313,576,452,475,255,101,197,30,22,1425,2425,1250,1000,4775,3725,0
471,2,2,42.0,42.0,70.0,55.0,833,1320,699,1007,134,313,573,602,460,365,113,237,23,22,1600,1800,1250,1000,5125,4350,0
479,2,2,37.0,36.0,70.0,55.0,833,1264,699,951,134,313,574,752,445,475,129,277,20,22,1425,1300,1250,1000,5550,4850,0
486,2,2,41.0,40.0,70.0,55.0,861,1320,727,1007,134,313,95,407,50,190,45,217,20,22,1425,950,1250,1000,5550,5200,0
493,2,2,43.0,40.0,70.0,55.0,1034,1152,923,839,111,313,167,537,110,280,57,257,22,22,1425,1450,1250,1000,5550,5200,0
500,2,2,44.0,44.0,70.0,55.0,1174,1253,1063,895,111,358,268,307,195,110,73,197,23,22,1425,1450,1250,1000,5550,5200,0
507,2,2,45.0,44.0,78.0,55.0,1174,1202,1063,867,111,335,215,448,180,215,35,233,23,22,1425,1450,1250,1000,5650,5200,0
514,2,2,46.0,44.0,78.0,55.0,794,1096,727,783,67,313,203,569,160,300,43,269,23,22,1600,1450,1250,1000,5650,5200,0
521,2,2,47.0,44.0,78.0,55.0,827,1096,783,783,44,313,262,704,215,395,47,309,24,22,1600,1450,1250,1000,5650,5200,0
529,2,2,48.0,50.0,78.0,55.0,822,1096,755,783,67,313,355,339,300,190,55,149,26,22,1975,1825,1250,1000,5650,5200,0
536,2,2,54.0,46.0,78.0,55.0,1102,1040,923,727,179,313,123,299,115,160,8,139,26,22,1975,1900,1250,1000,5650,5800,0
7,0,2,13.0,13.0,15.0,15.0,335,293,335,293,0,0,40,35,40,35,0,0,12,12,0,0,0,0,0,0,0
14,0,2,14.0,14.0,15.0,15.0,643,671,643,671,0,0,65,70,65,70,0,0,13,13,0,0,0,0,0,0,0
21,0,2,14.0,14.0,15.0,15.0,699,699,699,699,0,0,50,0,50,0,0,0,13,13,0,0,0,0,0,0,0
29,0,2,15.0,15.0,15.0,15.0,615,699,615,699,0,0,75,35,75,35,0,0,14,14,0,0,0,0,0,0,0
36,0,2,15.0,15.0,15.0,23.0,755,783,755,783,0,0,135,140,135,140,0,0,14,14,0,0,0,0,0,0,0
43,0,2,16.0,16.0,23.0,23.0,783,811,783,811,0,0,70,30,70,30,0,0,15,15,0,0,0,0,0,0,0
50,0,2,16.0,17.0,23.0,23.0,811,783,811,783,0,0,40,45,40,45,0,0,15,16,0,0,0,0,0,0,0
57,0,2,17.0,18.0,23.0,23.0,727,895,727,895,0,0,135,65,135,65,0,0,16,17,0,0,0,0,0,0,0
64,0,2,18.0,19.0,23.0,23.0,867,923,867,923,0,0,190,170,190,170,0,0,17,18,0,0,0,0,0,0,0
71,0,2,18.0,19.0,23.0,23.0,861,951,839,951,22,0,284,235,280,235,4,0,17,18,0,0,0,0,0,0,0
79,0,2,19.0,20.0,23.0,23.0,945,990,811,923,134,67,354,357,330,345,24,12,18,19,0,0,0,0,0,0,0
86,0,2,19.0,20.0,23.0,23.0,911,956,755,867,156,89,464,319,420,295,44,24,18,19,0,0,0,150,0,0,0
93,0,2,20.0,20.0,23.0,23.0,1018,978,839,867,179,111,379,431,315,395,64,36,19,20,0,0,150,150,0,0,0
100,0,2,20.0,20.0,23.0,23.0,1023,1090,867,979,156,111,495,167,415,115,80,52,19,20,0,0,150,150,0,0,0
107,0,2,21.0,21.0,23.0,23.0,967,1062,811,951,156,111,120,144,70,80,50,64,19,20,50,0,150,150,0,0,0
114,0,2,21.0,21.0,23.0,23.0,939,1107,783,951,156,156,120,139,50,55,70,84,19,20,50,0,150,150,0,0,0
121,0,2,22.0,24.0,23.0,31.0,911,1079,755,923,156,156,190,50,100,25,90,25,19,21,50,0,150,300,0,0,0
129,0,2,22.0,25.0,23.0,31.0,1051,1135,895,979,156,156,65,135,55,90,10,45,20,22,50,0,150,300,0,0,0
136,0,2,23.0,25.0,31.0,31.0,1074,1180,895,979,179,201,155,214,125,145,30,69,20,22,50,0,150,300,0,0,0
143,0,2,24.0,28.0,31.0,31.0,1214,1242,1035,951,179,291,55,190,5,110,50,80,21,23,150,125,150,300,0,0,0
150,0,2,24.0,28.0,31.0,31.0,1163,1242,1007,951,156,291,91,42,75,30,16,12,21,23,150,125,150,300,0,0,0
157,0,2,25.0,29.0,31.0,31.0,1163,1214,1007,923,156,291,171,128,135,80,36,48,22,24,150,125,150,300,0,0,0
164,0,2,25.0,30.0,31.0,31.0,1219,1236,1063,923,156,313,316,229,260,145,56,84,22,25,150,125,150,300,0,0,0
171,0,2,26.0,31.0,31.0,46.0,1124,1186,923,895,201,291,414,325,330,205,84,120,23,25,150,250,250,300,0,0,0
179,0,2,26.0,32.0,46.0,46.0,1236,1107,923,839,313,268,414,352,290,200,124,152,24,26,150,250,500,300,0,50,0
186,0,2,31.0,32.0,46.0,46.0,1286,1253,951,895,335,358,79,142,15,100,64,42,24,26,150,250,600,550,0,50,0
193,0,2,31.0,34.0,46.0,46.0,1449,1342,1091,1007,358,335,259,308,155,230,104,78,25,28,150,250,600,550,0,50,0
200,0,2,32.0,33.0,46.0,46.0,1538,1348,1203,1035,335,313,180,419,65,305,115,114,25,27,150,250,600,550,0,150,0
207,0,2,35.0,34.0,46.0,46.0,1544,1404,1231,1091,313,313,351,290,200,140,151,150,26,28,250,250,600,550,100,150,0
214,0,2,37.0,37.0,46.0,46.0,1572,1522,1259,1231,313,291,386,306,195,170,191,136,26,29,250,250,600,550,100,150,0
221,0,2,41.0,36.0,46.0,46.0,1796,1628,1483,1315,313,313,306,256,175,30,131,226,28,30,350,250,850,550,100,150,0
229,0,2,41.0,38.0,46.0,46.0,1846,1656,1511,1343,335,313,381,311,210,45,171,266,28,32,450,250,850,550,100,150,0
236,0,2,46.0,40.0,46.0,46.0,1986,1706,1651,1371,335,335,276,321,65,115,211,206,30,32,450,400,850,550,100,150,0
243,0,2,46.0,42.0,46.0,46.0,1930,1846,1595,1511,335,335,397,186,150,40,247,146,30,34,450,400,850,550,100,150,0
250,0,2,46.0,43.0,46.0,54.0,1964,1874,1651,1539,313,335,488,302,205,120,283,182,30,35,700,400,850,550,100,150,0
257,0,2,48.0,47.0,62.0,54.0,1852,2048,1539,1735,313,313,503,278,230,110,273,168,30,37,900,400,850,700,100,150,0
264,0,2,52.0,50.0,62.0,54.0,2104,2026,1791,1735,313,291,658,234,345,80,313,154,32,38,900,750,850,700,100,150,0
271,0,2,52.0,51.0,70.0,54.0,2188,2048,1875,1735,313,313,453,274,100,80,353,194,32,39,900,750,925,700,100,150,0
279,0,2,56.0,55.0,70.0,62.0,2098,2048,1763,1735,335,313,388,304,195,120,193,184,34,41,1000,750,1000,700,100,150,0
286,0,2,57.0,55.0,70.0,70.0,2177,2132,1819,1819,358,313,598,451,365,235,233,216,34,41,1000,925,1000,950,100,150,0
293,0,2,61.0,56.0,70.0,70.0,2154,1359,1819,1203,335,156,514,343,370,165,144,178,36,40,900,925,1000,950,200,300,0
300,0,2,58.0,52.0,70.0,85.0,2188,990,1875,923,313,67,675,356,495,170,180,186,38,35,700,1100,1000,950,400,600,0
307,0,2,56.0,51.0,70.0,85.0,2216,911,1903,867,313,44,510,110,415,20,95,90,38,34,550,1100,1000,950,600,700,0
314,0,2,54.0,54.0,70.0,85.0,2104,1398,1791,1287,313,111,325,146,190,40,135,106,39,37,400,1100,1000,950,800,700,0
321,0,2,61.0,59.0,70.0,85.0,1852,1897,1539,1651,313,246,215,38,140,25,75,13,40,39,1025,1100,1000,950,800,700,0
329,0,2,62.0,62.0,70.0,85.0,2154,2020,1819,1707,335,313,250,129,135,80,115,49,41,42,1075,1275,1000,950,800,700,0
336,0,2,62.0,63.0,70.0,85.0,2322,2171,1987,1903,335,268,246,287,95,210,151,77,41,43,1075,1275,1000,950,800,700,0
343,0,2,65.0,68.0,70.0,85.0,2423,2255,2043,1987,380,268,389,288,190,225,199,63,41,46,1125,1550,1000,950,800,700,0
350,0,2,64.0,70.0,101.0,85.0,2653,2474,2183,2183,470,291,390,264,135,165,255,99,41,48,975,1550,1000,950,1000,700,0
357,0,2,68.0,71.0,101.0,85.0,2541,2507,1959,2239,582,268,322,506,120,375,202,131,42,49,1250,1550,1000,950,1100,700,0
364,0,2,70.0,77.0,101.0,85.0,2602,2462,2043,2127,559,335,194,246,120,175,74,71,43,51,1550,1550,1550,1100,1100,750,0
371,0,2,71.0,76.0,101.0,93.0,2832,2098,2183,1763,649,335,249,346,145,235,104,111,44,50,1550,1900,1550,1100,1100,850,0
379,0,2,72.0,79.0,101.0,93.0,2826,2238,2155,1791,671,447,144,467,60,300,84,167,45,53,1600,1900,1550,1100,1100,850,0
386,0,2,73.0,82.0,101.0,93.0,2994,2737,2323,2267,671,470,445,209,285,90,160,119,46,56,1925,1900,1550,1100,1100,850,0
393,0,2,75.0,82.0,101.0,93.0,3196,2490,2547,2043,649,447,656,400,470,225,186,175,48,56,1925,1900,1550,1100,1100,950,0
400,0,2,79.0,87.0,101.0,93.0,3140,2177,2491,1707,649,470,627,310,415,175,212,135,48,57,1925,1900,1550,1100,1125,950,0
407,0,2,84.0,88.0,101.0,93.0,2692,2681,2043,2211,649,470,207,431,115,240,92,191,50,59,1925,2050,1550,1100,1125,1050,0
414,0,2,87.0,90.0,101.0,93.0,2698,2989,2071,2519,627,470,288,237,120,190,168,47,52,61,2025,2050,1550,1100,1125,1050,0
421,0,2,94.0,90.0,101.0,93.0,2888,3095,2239,2603,649,492,203,337,155,230,48,107,53,62,2150,2050,1700,1100,1125,1050,0
429,0,2,99.0,96.0,101.0,101.0,3078,3056,2407,2519,671,537,263,136,185,65,78,71,55,63,2275,2050,1850,1250,1125,1100,0
436,0,2,101.0,94.0,101.0,117.0,3218,3039,2547,2435,671,604,184,393,155,250,29,143,56,61,2325,2400,1950,1550,1125,1300,0
443,0,2,100.0,98.0,117.0,117.0,3028,3084,2379,2435,649,649,150,453,70,230,80,223,57,61,2250,2600,1950,1550,1375,1350,0
450,0,2,107.0,100.0,117.0,117.0,3028,2961,2379,2267,649,694,241,251,110,90,131,161,59,63,2825,2600,1950,2000,1375,1350,0
457,0,2,113.0,102.0,117.0,117.0,3196,3157,2547,2239,649,918,401,537,240,260,161,277,60,66,2875,2600,1950,2000,1375,1350,0
464,0,2,117.0,108.0,117.0,117.0,3577,3414,2883,2407,694,1007,125,293,80,200,45,93,61,67,2925,3000,2125,2000,1375,1350,0
471,0,2,121.0,109.0,133.0,125.0,3554,3599,2659,2659,895,940,221,568,85,375,136,193,61,68,3100,2600,2125,2000,1375,1350,0
479,0,2,123.0,114.0,133.0,125.0,3672,3610,2687,2715,985,895,402,646,200,345,202,301,63,68,3625,3225,2125,2100,1375,1475,0
486,0,2,128.0,115.0,133.0,133.0,3706,3633,2743,2715,963,918,273,1032,180,615,93,417,65,69,3625,3225,2125,2100,1425,1475,0
493,0,2,132.0,117.0,133.0,133.0,3868,3694,2883,2799,985,895,189,839,130,560,59,279,66,71,3950,3225,2125,2400,1425,1475,0
500,0,2,138.0,130.0,149.0,133.0,3846,3717,2883,2799,963,918,165,606,65,248,100,358,67,72,3950,3975,2125,2400,1425,1475,0
507,0,2,139.0,130.0,157.0,133.0,3851,3756,2911,2771,940,985,227,857,190,483,37,374,67,73,4075,3975,2325,2400,1475,1475,0
514,0,2,141.0,131.0,157.0,141.0,3538,3728,2575,2743,963,985,532,989,400,503,132,486,67,71,4475,3975,2800,2400,1475,1575,0
521,0,2,143.0,139.0,157.0,141.0,3448,3465,2463,2547,985,918,417,707,190,113,227,594,67,71,4475,3975,2800,2400,1475,1575,0
529,0,2,148.0,139.0,173.0,141.0,3756,3521,2771,2603,985,918,404,1120,215,418,189,702,67,74,4775,4675,2900,2400,1475,1575,0
536,0,2,150.0,138.0,173.0,141.0,3868,3263,2883,2435,985,828,340,1331,235,533,105,798,67,73,5375,4675,2900,2400,1525,1625,0
543,0,2,152.0,140.0,173.0,141.0,4120,2647,3135,1931,985,716,276,995,205,413,71,582,68,73,5500,4575,2900,2800,1525,1725,0
550,0,2,157.0,140.0,173.0,141.0,4014,2810,3051,2071,963,739,472,1132,310,458,162,674,68,74,5500,4575,2900,2950,1525,1725,0
557,0,2,162.0,141.0,173.0,141.0,3991,2882,3051,1987,940,895,879,1218,605,428,274,790,70,72,6125,4575,2900,3100,1525,1825,0
564,0,2,162.0,141.0,173.0,141.0,4098,2849,3135,1931,963,918,874,1001,630,103,244,898,70,72,6075,4475,2900,3250,1575,1925,0
571,0,2,167.0,138.0,173.0,157.0,4014,2798,3051,1903,963,895,930,1229,620,223,310,1006,70,69,6300,4775,2900,3250,1675,2175,0
579,0,2,168.0,135.0,173.0,173.0,4008,3011,3023,2071,985,940,951,1311,625,243,326,1068,70,63,6150,4950,2900,3250,1875,2525,0
586,0,2,170.0,132.0,173.0,173.0,3734,2754,2771,1903,963,851,733,1577,520,413,213,1164,70,62,6450,5075,2900,3250,2075,2800,0
593,0,2,171.0,143.0,173.0,181.0,3594,2877,2631,2071,963,806,729,848,425,338,304,510,70,64,6700,5075,2900,3250,2175,2800,0
600,0,2,176.0,145.0,188.0,181.0,3398,3157,2435,2351,963,806,910,894,565,438,345,456,73,64,6875,5475,2900,3250,2175,2800,0
607,0,2,179.0,145.0,188.0,181.0,3398,3286,2435,2435,963,851,451,788,315,228,136,560,73,65,6925,5175,2900,3250,2175,2900,0
614,0,2,184.0,148.0,188.0,189.0,3728,3258,2743,2407,985,851,556,872,425,358,131,514,76,66,7325,6075,2900,3250,2175,2900,0
621,0,2,185.0,148.0,188.0,189.0,4036,3347,3051,2519,985,828,557,967,310,353,247,614,77,67,7325,6075,3150,3250,2175,2900,0
629,0,2,186.0,152.0,196.0,189.0,3969,3330,2827,2435,1142,895,762,999,375,423,387,576,79,67,7725,6375,3150,3250,2175,2900,0
636,0,2,190.0,158.0,196.0,189.0,4070,3358,2771,2463,1299,895,573,699,255,223,318,476,81,67,7625,6250,3150,3650,2275,3025,0
643,0,2,196.0,152.0,196.0,189.0,4294,3263,2995,2435,1299,828,284,790,135,368,149,422,81,67,7900,6700,3150,3650,2275,3625,0
650,0,2,196.0,148.0,196.0,204.0,3924,3498,2715,2603,1209,895,682,812,393,428,289,384,81,67,7775,6325,3150,3950,2400,4000,0
657,0,2,196.0,150.0,196.0,204.0,4098,3504,2911,2631,1187,873,896,1061,613,623,283,438,81,67,7775,6500,3450,3950,2400,4000,0
664,0,2,185.0,153.0,196.0,204.0,4400,3504,3191,2631,1209,873,1255,1080,853,538,402,542,81,69,6675,6500,3450,3950,3500,4700,0
671,0,2,187.0,134.0,196.0,204.0,4462,3543,3275,2715,1187,828,1410,1501,893,863,517,638,81,66,7825,5400,3450,3800,3900,5987,0
7,2,2,13.0,13.0,15.0,15.0,293,251,293,251,0,0,35,30,35,30,0,0,12,12,0,0,0,0,0,0,0
14,2,2,14.0,14.0,15.0,15.0,643,643,643,643,0,0,65,65,65,65,0,0,13,13,0,0,0,0,0,0,0
21,2,2,14.0,14.0,15.0,15.0,671,727,671,727,0,0,45,50,45,50,0,0,13,13,0,0,0,0,0,0,0
29,2,2,15.0,15.0,15.0,15.0,699,699,699,699,0,0,35,85,35,85,0,0,14,14,0,0,0,0,0,0,0
36,2,2,15.0,15.0,15.0,15.0,811,699,811,699,0,0,140,125,140,125,0,0,14,14,0,0,0,0,0,0,0
43,2,2,16.0,16.0,23.0,23.0,839,755,839,755,0,0,35,25,35,25,0,0,15,15,0,0,0,0,0,0,0
50,2,2,17.0,17.0,23.0,23.0,839,783,839,783,0,0,5,45,5,45,0,0,16,16,0,0,0,0,0,0,0
57,2,2,18.0,18.0,23.0,23.0,895,783,895,783,0,0,70,45,70,45,0,0,17,17,0,0,0,0,0,0,0
64,2,2,19.0,19.0,23.0,23.0,923,895,923,895,0,0,125,160,125,160,0,0,18,18,0,0,0,0,0,0,0
71,2,2,19.0,19.0,23.0,23.0,951,923,951,923,0,0,10,45,10,45,0,0,18,18,0,0,0,0,0,0,0
79,2,2,20.0,20.0,23.0,23.0,939,967,895,923,44,44,178,118,170,110,8,8,19,19,0,0,0,0,0,0,0
86,2,2,21.0,21.0,23.0,23.0,1018,990,951,923,67,67,96,236,80,220,16,16,20,20,0,0,150,150,0,0,0
93,2,2,24.0,24.0,31.0,31.0,1040,1040,951,951,89,89,78,58,50,30,28,28,21,21,0,0,150,150,0,0,0
100,2,2,24.0,24.0,31.0,31.0,1102,1186,923,1007,179,179,161,152,105,100,56,52,21,21,0,0,150,150,0,0,0
107,2,2,25.0,25.0,31.0,31.0,1225,1180,979,979,246,201,309,276,225,200,84,76,22,22,0,0,150,150,0,0,0
114,2,2,26.0,26.0,31.0,31.0,1197,1152,951,951,246,201,401,365,285,265,116,100,23,23,0,0,150,150,0,0,0
121,2,2,26.0,26.0,31.0,31.0,1264,1225,951,979,313,246,551,511,395,375,156,136,23,23,100,100,300,150,0,0,0
129,2,2,29.0,27.0,31.0,31.0,1286,1219,951,951,335,268,221,199,200,35,21,164,24,24,100,100,300,300,0,0,0
136,2,2,29.0,27.0,31.0,31.0,1309,1214,951,923,358,291,261,354,250,150,11,204,24,24,100,100,300,300,0,0,0
143,2,2,29.0,28.0,31.0,31.0,1286,1236,951,923,335,313,312,144,265,50,47,94,25,25,100,100,300,300,0,0,0
150,2,2,31.0,28.0,31.0,31.0,1292,1230,979,895,313,335,288,199,255,65,33,134,25,25,225,100,300,300,0,0,0
157,2,2,30.0,30.0,39.0,31.0,1314,1264,979,951,335,313,568,175,445,55,123,120,25,26,225,100,300,300,0,0,0
164,2,2,30.0,30.0,39.0,39.0,1286,1236,951,923,335,313,318,176,155,20,163,156,25,25,225,100,300,300,0,50,0
171,2,2,33.0,31.0,39.0,39.0,1236,1242,923,951,313,291,164,278,65,90,99,188,26,26,225,100,600,300,0,50,0
179,2,2,33.0,33.0,39.0,39.0,1314,1275,979,1007,335,268,274,255,135,85,139,170,26,26,225,275,600,300,0,50,0
186,2,2,33.0,35.0,39.0,39.0,1292,1292,979,979,313,313,375,240,200,130,175,110,26,27,225,275,600,600,50,50,0
193,2,2,34.0,35.0,39.0,39.0,1320,1320,1007,1007,313,313,285,195,170,95,115,100,27,27,225,275,600,600,50,50,0
200,2,2,36.0,36.0,39.0,54.0,1348,1264,1035,951,313,313,300,200,145,60,155,140,27,28,475,275,600,700,50,50,0
207,2,2,37.0,37.0,39.0,54.0,1370,1348,1035,1035,335,313,405,201,210,25,195,176,28,28,475,275,600,700,50,50,0
214,2,2,39.0,38.0,39.0,54.0,1342,1404,1007,1091,335,313,270,247,135,35,135,212,28,29,725,575,600,700,50,50,0
221,2,2,40.0,39.0,47.0,54.0,1314,1354,979,1063,335,291,371,199,200,55,171,144,29,30,725,575,600,800,50,50,0
229,2,2,41.0,42.0,47.0,54.0,1180,1516,867,1203,313,313,462,185,255,55,207,130,30,31,725,575,600,800,50,50,0
236,2,2,42.0,44.0,62.0,54.0,1208,1768,895,1455,313,313,262,246,115,80,147,166,30,33,975,575,600,800,50,50,0
243,2,2,43.0,45.0,62.0,54.0,1432,1746,1119,1455,313,291,338,352,155,150,183,202,31,34,975,575,600,800,50,50,0
250,2,2,44.0,46.0,62.0,54.0,1376,1830,1063,1539,313,291,413,268,190,30,223,238,32,35,975,575,600,800,50,50,0
257,2,2,48.0,47.0,62.0,54.0,1813,1802,1455,1511,358,291,308,444,95,170,213,274,34,36,975,750,600,800,50,50,0
264,2,2,49.0,48.0,62.0,54.0,1746,1964,1455,1651,291,313,456,249,215,85,241,164,35,37,1150,750,600,1050,50,50,0
271,2,2,50.0,50.0,62.0,62.0,1830,1986,1539,1651,291,335,451,289,170,85,281,204,36,39,1150,750,850,1050,50,50,0
279,2,2,52.0,51.0,62.0,62.0,1891,1992,1623,1679,268,313,328,471,165,235,163,236,38,40,1150,750,850,1050,50,50,0
286,2,2,53.0,51.0,62.0,62.0,1914,2104,1623,1791,291,313,373,481,170,305,203,176,39,40,1150,750,850,1350,50,100,0
293,2,2,57.0,52.0,62.0,62.0,2020,1998,1707,1707,313,291,393,517,200,305,193,212,41,41,1150,750,850,1350,50,100,0
300,2,2,57.0,56.0,62.0,62.0,2126,2132,1791,1707,335,425,603,452,370,330,233,122,41,42,1325,900,850,1350,50,100,0
307,2,2,59.0,57.0,62.0,62.0,2121,2171,1763,1679,358,492,408,563,135,385,273,178,43,42,1325,1075,1150,1350,50,150,0
314,2,2,61.0,57.0,70.0,62.0,2216,2261,1903,1791,313,470,425,730,220,500,205,230,45,42,1325,1075,1150,1350,50,150,0
321,2,2,63.0,56.0,70.0,62.0,2272,2205,1959,1735,313,470,290,395,145,105,145,290,45,43,1075,925,1150,1350,300,350,0
329,2,2,65.0,60.0,70.0,70.0,2300,2261,1987,1791,313,470,190,405,105,205,85,200,47,44,1425,1250,1150,1350,300,350,0
336,2,2,65.0,62.0,70.0,70.0,2311,2250,2043,1735,268,515,167,520,50,260,117,260,47,45,1425,1250,1150,1650,300,350,0
343,2,2,67.0,64.0,70.0,70.0,2233,2362,1987,1847,246,515,374,281,225,165,149,116,49,45,1425,1250,1150,1650,300,350,0
350,2,2,69.0,65.0,70.0,78.0,2014,2367,1791,1875,223,492,493,337,320,215,173,122,51,47,1425,1300,1150,1650,300,650,0
357,2,2,67.0,70.0,70.0,78.0,1247,2401,1091,1931,156,470,538,208,345,130,193,78,51,48,1300,1650,1150,1650,425,650,0
364,2,2,69.0,71.0,70.0,78.0,1494,2227,1203,1735,291,492,483,283,250,145,233,138,53,49,1300,1650,1150,1650,425,650,0
371,2,2,69.0,76.0,78.0,78.0,2031,2311,1539,1819,492,492,428,148,135,50,293,98,53,50,1300,1825,1250,1650,425,650,0
379,2,2,73.0,75.0,93.0,78.0,2199,2121,1707,1651,492,470,414,339,115,185,299,154,55,51,1300,1900,1500,1650,425,750,0
386,2,2,74.0,75.0,101.0,78.0,2597,2339,2127,1847,470,492,456,144,230,80,226,64,56,53,1550,1750,1650,1650,525,900,0
393,2,2,77.0,76.0,101.0,78.0,2905,2278,2435,1763,470,515,481,279,245,155,236,124,57,54,1550,1750,1650,1650,525,900,0
400,2,2,77.0,77.0,101.0,86.0,2961,2227,2491,1735,470,492,176,395,80,215,96,180,58,55,1725,1750,1650,1650,525,900,0
407,2,2,85.0,78.0,101.0,101.0,3073,2289,2603,1819,470,470,196,526,140,290,56,236,58,56,1825,1750,1800,1650,525,900,0
414,2,2,85.0,84.0,101.0,101.0,3146,2479,2631,1987,515,492,471,141,355,95,116,46,58,57,2175,1750,1800,1950,525,900,0
421,2,2,89.0,86.0,109.0,101.0,3168,2440,2631,1903,537,537,496,219,420,105,76,114,58,59,2350,2250,2200,2100,525,900,0
429,2,2,90.0,85.0,109.0,101.0,3207,2642,2715,2015,492,627,803,455,750,265,53,190,58,60,2525,2250,2200,2100,525,900,0
436,2,2,88.0,85.0,117.0,101.0,3185,3112,2715,2463,470,649,1169,846,1060,580,109,266,58,61,2700,2250,2200,2250,700,900,0
443,2,2,94.0,90.0,117.0,101.0,3073,3146,2603,2519,470,627,914,228,895,90,19,138,58,61,2800,2600,2200,2250,700,900,0
450,2,2,94.0,91.0,117.0,101.0,3129,3050,2659,2491,470,559,499,237,420,135,79,102,58,62,3325,2600,2200,2250,700,900,0
457,2,2,94.0,95.0,117.0,101.0,3090,3039,2575,2435,515,604,859,364,720,290,139,74,58,62,3325,2600,2200,2250,700,900,0
464,2,2,94.0,97.0,125.0,109.0,3202,3190,2687,2519,515,671,694,253,645,95,49,158,58,63,3325,2350,2200,2400,700,900,0
471,2,2,94.0,99.0,125.0,109.0,3067,3218,2575,2435,492,783,906,529,805,275,101,254,58,63,3325,2450,2200,2550,700,1000,0
479,2,2,106.0,103.0,125.0,109.0,3151,3269,2659,2463,492,806,381,234,220,130,161,104,58,63,3725,3000,2200,2700,700,1000,0
486,2,2,110.0,107.0,141.0,109.0,3185,3269,2715,2463,470,806,387,215,270,15,117,200,58,63,3925,3000,2200,2700,700,1000,0
493,2,2,110.0,108.0,141.0,117.0,3050,3129,2603,2323,447,806,543,550,370,250,173,300,58,63,3925,3650,2200,3100,700,1000,0
500,2,2,110.0,114.0,141.0,133.0,3134,3123,2687,2295,447,828,933,171,700,25,233,146,58,63,3925,3650,2800,3100,700,1000,0
507,2,2,122.0,118.0,149.0,133.0,3230,3123,2715,2295,515,828,423,357,230,115,193,242,58,64,4575,3650,2800,3100,700,1000,0
514,2,2,128.0,121.0,149.0,141.0,3179,3101,2687,2295,492,806,599,528,350,190,249,338,58,63,4950,4300,2800,3100,700,1050,0
521,2,2,128.0,125.0,149.0,141.0,2927,3297,2435,2491,492,806,725,434,420,250,305,184,58,63,5150,4750,2900,3100,700,1050,0
529,2,2,128.0,125.0,149.0,141.0,2703,3241,2211,2435,492,806,690,819,525,535,165,284,58,63,5150,4750,3050,3100,700,1050,0
536,2,2,138.0,127.0,164.0,141.0,2765,3213,2295,2407,470,806,446,1010,225,630,221,380,58,63,5750,5225,3200,3100,950,1225,0
543,2,2,142.0,135.0,180.0,141.0,3129,3129,2659,2323,470,806,527,781,250,305,277,476,58,63,5950,5625,3200,3100,950,1225,0
550,2,2,142.0,136.0,180.0,156.0,3207,3230,2715,2379,492,851,902,716,565,340,337,376,58,63,5950,5625,3200,3100,950,1225,0
557,2,2,146.0,130.0,180.0,156.0,3336,3151,2799,2323,537,828,502,597,105,375,397,222,58,64,5950,5125,3200,3100,1550,1725,0
564,2,2,130.0,110.0,188.0,164.0,3319,3218,2827,2435,492,783,549,574,200,260,349,314,58,64,5150,4175,3550,3100,2550,3425,0
571,2,2,104.0,92.0,188.0,172.0,3353,3381,2883,2575,470,806,935,789,530,375,405,414,58,64,3975,2600,3550,3100,4075,5300,0
579,2,2,102.0,86.0,188.0,172.0,3325,3521,2855,2715,470,806,740,845,275,435,465,410,58,64,3425,1600,3550,3100,5225,6300,0
586,2,2,104.0,88.0,188.0,172.0,3353,3549,2883,2743,470,806,780,765,255,255,525,510,58,64,3450,875,3550,3100,5400,7025,0
592,2,2,104.0,90.0,188.0,172.0,3353,3521,2883,2715,470,806,780,544,255,200,525,344,58,64,3450,1525,3550,3100,5400,7375,0
7,1,2,13.0,13.0,14.0,15.0,251,293,251,293,0,0,30,35,30,35,0,0,12,12,0,0,0,0,0,0,0
14,1,2,13.0,14.0,14.0,15.0,671,671,671,671,0,0,20,70,20,70,0,0,13,13,0,0,0,0,0,0,0
21,1,2,14.0,14.0,14.0,15.0,727,699,727,699,0,0,50,50,50,50,0,0,13,13,0,0,0,0,0,0,0
29,1,2,14.0,15.0,14.0,15.0,755,699,755,699,0,0,145,85,145,85,0,0,13,14,0,0,0,0,0,0,0
36,1,2,16.0,15.0,22.0,15.0,727,783,727,783,0,0,135,140,135,140,0,0,14,14,0,0,0,0,0,0,0
43,1,2,16.0,16.0,22.0,23.0,783,811,783,811,0,0,230,75,230,75,0,0,16,15,0,0,0,0,0,0,0
50,1,2,15.0,17.0,22.0,23.0,811,867,811,867,0,0,25,45,25,45,0,0,15,16,0,0,0,0,0,0,0
57,1,2,16.0,18.0,22.0,23.0,783,839,783,839,0,0,70,50,70,50,0,0,15,17,0,0,0,0,0,0,0
64,1,2,18.0,18.0,22.0,23.0,839,951,839,951,0,0,80,110,80,110,0,0,16,17,0,0,0,0,0,0,0
71,1,2,18.0,19.0,22.0,23.0,867,951,867,951,0,0,155,165,155,165,0,0,17,18,0,0,0,0,0,0,0
79,1,2,16.0,20.0,22.0,23.0,923,1023,923,979,0,44,75,293,75,285,0,8,16,19,0,0,0,0,0,0,0
86,1,2,18.0,20.0,22.0,23.0,867,962,867,895,0,67,80,56,80,40,0,16,16,19,0,0,0,0,0,0,0
93,1,2,19.0,20.0,22.0,23.0,951,1006,951,895,0,111,145,173,145,145,0,28,18,20,0,0,0,150,0,0,0
100,1,2,20.0,21.0,22.0,23.0,939,1029,895,895,44,134,208,103,200,55,8,48,19,20,0,0,0,150,0,0,0
107,1,2,20.0,21.0,22.0,23.0,1090,1023,979,867,111,156,344,93,320,25,24,68,19,20,0,0,0,150,0,0,0
114,1,2,20.0,22.0,22.0,23.0,1079,1102,923,923,156,179,474,128,430,40,44,88,20,21,0,0,0,150,0,0,0
121,1,2,21.0,23.0,28.0,23.0,1135,1074,979,895,156,179,559,198,495,90,64,108,20,22,0,0,250,150,0,0,0
129,1,2,26.0,23.0,28.0,23.0,1079,1180,923,979,156,201,234,342,150,210,84,132,21,22,0,0,250,150,0,0,0
136,1,2,28.0,26.0,28.0,31.0,1186,1186,1007,895,179,291,279,308,175,165,104,143,21,23,0,0,250,300,0,0,0
143,1,2,28.0,26.0,36.0,31.0,1191,1242,1035,951,156,291,215,159,195,130,20,29,21,23,50,0,250,300,0,0,0
150,1,2,30.0,26.0,36.0,31.0,1107,1208,1063,895,44,313,240,254,220,185,20,69,23,23,50,0,250,300,0,50,0
157,1,2,30.0,29.0,36.0,46.0,1147,1264,1147,951,0,313,70,79,50,45,20,34,25,23,50,125,250,300,0,50,0
164,1,2,31.0,30.0,36.0,46.0,1315,1286,1315,951,0,335,145,89,125,15,20,74,24,24,350,125,250,300,0,50,0
171,1,2,34.0,32.0,36.0,46.0,1343,1449,1343,1091,0,358,100,259,80,145,20,114,24,26,350,125,250,300,0,50,0
179,1,2,35.0,33.0,36.0,46.0,1371,1432,1371,1119,0,313,110,326,90,180,20,146,24,27,450,250,250,300,0,50,0
186,1,2,36.0,38.0,36.0,46.0,1371,1488,1371,1175,0,313,230,201,210,165,20,36,24,29,500,250,250,600,0,50,0
193,1,2,42.5,38.0,44.0,46.0,1399,1544,1399,1231,0,313,50,341,30,265,20,76,25,29,475,250,250,600,25,50,0
200,1,2,44.0,42.0,44.0,46.0,1455,1628,1455,1315,0,313,120,326,100,260,20,66,26,31,450,250,250,600,50,50,0
207,1,2,43.0,42.0,44.0,46.0,1427,1690,1427,1399,0,291,120,277,100,150,20,127,32,31,600,250,250,600,50,50,0
214,1,2,42.0,44.0,44.0,46.0,1634,1790,1567,1455,67,335,177,147,145,130,32,17,33,33,600,550,250,600,50,50,0
221,1,2,41.5,45.0,52.0,54.0,1734,1874,1623,1539,111,335,338,252,290,195,48,57,32,34,575,425,250,600,75,175,0
229,1,2,49.0,45.0,52.0,54.0,1790,1880,1679,1567,111,313,155,488,95,395,60,93,32,35,550,425,375,600,100,175,0
236,1,2,51.0,47.0,58.0,54.0,1818,1986,1707,1651,111,335,222,618,150,485,72,133,33,35,550,550,500,600,100,175,0
243,1,2,50.0,48.0,58.0,62.0,1790,1936,1679,1623,111,313,298,744,210,575,88,169,40,36,550,550,625,600,100,175,0
250,1,2,55.0,49.0,58.0,62.0,1897,1964,1763,1651,134,313,269,529,165,320,104,209,40,37,550,850,625,600,100,175,0
257,1,2,58.0,50.0,58.0,62.0,2059,1992,1903,1679,156,313,334,684,210,435,124,249,40,38,550,850,625,750,100,175,0
264,1,2,58.0,55.0,58.0,62.0,2059,2126,1903,1791,156,335,224,384,180,245,44,139,45,39,550,850,625,750,100,175,0
271,1,2,58.0,57.0,58.0,62.0,2031,2098,1875,1763,156,335,274,379,210,200,64,179,46,41,700,850,625,750,100,175,0
279,1,2,58.0,60.0,66.0,70.0,2222,2182,2043,1847,179,335,449,235,365,120,84,115,46,42,700,1000,625,750,100,175,0
286,1,2,65.0,61.0,74.0,70.0,2451,2126,2295,1791,156,335,315,180,215,125,100,55,44,43,700,1350,825,750,100,175,0
293,1,2,67.0,62.0,82.0,78.0,2367,2126,2211,1679,156,447,490,405,370,290,120,115,52,44,850,1350,825,750,100,175,0
300,1,2,65.0,63.0,82.0,78.0,2479,2250,2323,1623,156,627,790,630,650,435,140,195,51,45,850,1350,825,750,200,175,0
307,1,2,71.0,64.0,74.0,78.0,2423,2440,2267,1791,156,649,750,936,590,665,160,271,52,46,850,1350,950,850,350,175,0
314,1,2,74.0,66.0,74.0,78.0,2658,2384,2435,1735,223,649,892,726,700,475,192,251,52,48,850,1350,950,850,350,175,0
321,1,2,73.0,71.0,74.0,93.0,2664,2530,2351,1903,313,627,813,534,685,415,128,119,58,49,850,1350,1200,850,350,175,0
329,1,2,72.0,73.0,66.0,93.0,2854,2502,2519,1875,335,627,368,735,200,540,168,195,60,50,850,1650,1200,850,450,175,0
336,1,2,73.0,76.0,74.0,93.0,2916,2602,2603,1931,313,671,289,600,285,325,4,275,57,53,850,1650,1200,1100,450,175,0
343,1,2,84.0,79.0,98.0,93.0,2966,2776,2631,2127,335,649,194,741,150,390,44,351,57,56,850,1650,1200,1100,450,175,0
350,1,2,90.0,80.0,106.0,93.0,2983,2843,2603,2127,380,716,252,578,160,335,92,243,57,57,850,1650,1200,1500,450,175,0
357,1,2,90.0,82.0,106.0,93.0,2905,3045,2435,2239,470,806,578,963,430,620,148,343,68,59,850,1650,1200,1500,450,175,0
364,1,2,93.0,81.0,106.0,101.0,2670,3157,2155,2351,515,806,761,894,545,655,216,239,72,62,850,1350,1450,1500,450,475,0
371,1,2,105.0,86.0,106.0,101.0,3386,3381,2715,2463,671,918,565,1050,415,695,150,355,72,62,1150,1550,1450,1500,450,475,0
379,1,2,104.0,86.0,106.0,101.0,3454,3498,2603,2491,851,1007,675,1466,425,995,250,471,74,64,1300,1550,1450,1500,500,475,0
386,1,2,105.0,88.0,106.0,101.0,3773,3566,2855,2603,918,963,892,1679,580,1100,312,579,73,65,1300,1550,1450,1800,500,475,0
393,1,2,105.0,88.0,106.0,101.0,3913,3515,2995,2575,918,940,1054,1396,730,705,324,691,73,67,1900,1550,1450,1800,500,475,0
400,1,2,105.0,92.0,106.0,101.0,3857,3454,2939,2603,918,851,1436,1421,1000,730,436,691,73,67,1900,1550,1450,1800,500,475,0
407,1,2,104.0,100.0,114.0,109.0,3890,3588,2995,2715,895,873,1233,574,685,375,548,199,72,67,2050,1550,1450,2150,500,475,0
414,1,2,111.0,100.0,122.0,117.0,3890,3638,2883,2743,1007,895,1303,757,735,450,568,307,71,67,2050,2350,1450,2150,500,475,0
421,1,2,127.0,99.0,170.0,125.0,3997,3722,2967,2827,1030,895,554,577,270,170,284,407,71,67,2050,2000,1450,2150,500,825,0
429,1,2,129.0,99.0,170.0,125.0,3907,3638,2967,2743,940,895,258,810,220,295,38,515,69,67,2450,2000,1575,2150,500,825,0
436,1,2,133.0,102.0,170.0,125.0,3846,3711,2883,2771,963,940,418,1482,360,855,58,627,69,70,2450,2375,1700,2300,500,825,0
443,1,2,136.5,104.0,170.0,133.0,3846,3706,2883,2743,963,963,628,1823,450,1080,178,743,69,70,3275,1975,1700,3000,575,825,0
450,1,2,138.0,110.0,170.0,133.0,3739,3622,2799,2659,940,963,979,1159,685,800,294,359,69,73,3700,2475,1700,3000,600,825,0
457,1,2,138.0,111.0,176.0,133.0,3706,3812,2743,2827,963,985,639,1219,625,740,14,479,74,74,4150,2925,1700,3000,600,825,0
464,1,2,146.0,121.0,176.0,133.0,3963,3784,2911,2799,1052,985,614,725,480,530,134,195,76,75,4150,3325,1950,3000,600,825,0
471,1,2,149.0,122.0,176.0,133.0,3868,3784,2883,2799,985,985,767,636,525,475,242,161,76,78,4150,3325,1950,3000,600,825,0
479,1,2,148.0,126.0,184.0,156.0,3683,3834,2743,2827,940,1007,1184,842,830,565,354,277,76,79,4150,3325,1950,3250,600,825,0
486,1,2,147.0,136.0,192.0,156.0,3650,3885,2687,2743,963,1142,1294,801,970,380,324,421,78,79,4500,3325,1950,3350,600,825,0
493,1,2,149.0,138.0,192.0,156.0,3510,3991,2547,2715,963,1276,1304,688,860,265,444,423,78,83,4500,3825,1950,3500,600,825,0
500,1,2,150.0,139.0,192.0,156.0,3599,4120,2659,2799,940,1321,1595,528,1085,120,510,408,77,83,4500,4400,1950,3500,600,825,0
507,1,2,160.0,145.0,192.0,156.0,3890,4316,2771,2995,1119,1321,826,454,730,340,96,114,77,83,4500,4400,1950,3500,600,825,0
514,1,2,162.0,149.0,192.0,156.0,4114,4333,2771,3079,1343,1254,901,763,695,655,206,108,74,83,4600,4700,1950,3500,600,825,0
521,1,2,162.0,155.0,192.0,164.0,3963,4501,2687,3247,1276,1254,1365,1000,1015,740,350,260,74,83,4750,4950,1950,4050,600,825,0
529,1,2,164.0,155.0,192.0,164.0,3997,4585,2743,3331,1254,1254,1566,1329,1160,925,406,404,77,83,5800,5700,1950,4200,600,825,0
536,1,2,161.5,149.0,192.0,164.0,4064,4585,2743,3331,1321,1254,2036,1085,1470,875,566,210,77,83,5825,5400,1950,4200,725,1125,0
543,1,2,157.5,141.0,192.0,164.0,4098,4450,2799,3219,1299,1231,2537,1608,1815,1250,722,358,79,83,5775,5250,1950,4200,975,1525,0
550,1,2,160.0,155.0,192.0,180.0,4159,4602,2883,3303,1276,1299,2744,1464,1970,950,774,514,79,83,5700,5250,2400,4200,1050,1525,0
557,1,2,166.0,149.0,192.0,180.0,4249,4361,2883,3107,1366,1254,2544,1982,1860,1320,684,662,79,83,5650,5650,2750,4200,1100,1825,0
564,1,2,151.5,135.0,192.0,180.0,4254,4411,2911,3135,1343,1276,3050,2520,2210,1710,840,810,79,83,4475,4450,2750,4200,2275,2925,0
571,1,2,156.0,155.0,198.0,180.0,4193,4417,2939,3163,1254,1254,3219,1673,2235,815,984,858,80,83,4300,4250,2750,4200,2450,3125,0
579,1,2,162.0,158.0,198.0,180.0,4355,4495,3079,3219,1276,1276,2969,1305,2125,745,844,560,80,83,5050,4950,2750,5000,2450,3125,0
586,1,2,180.0,158.0,198.0,180.0,4372,4366,3051,3135,1321,1231,1389,1223,1285,515,104,708,80,83,5050,5250,2750,5000,2450,3125,0
593,1,2,183.0,158.0,198.0,180.0,4210,4277,2911,3023,1299,1254,1360,1190,1100,330,260,860,80,83,5450,5250,2750,5000,2450,3125,0
600,1,2,182.0,164.0,198.0,180.0,4204,4355,2883,3079,1321,1276,1717,1111,1355,345,362,766,81,83,6850,5550,2750,5000,2450,3125,0
607,1,2,181.0,172.0,198.0,204.0,4277,4305,2911,3051,1366,1254,2217,1225,1695,315,522,910,80,83,7175,5950,2750,5000,2450,3125,0
614,1,2,178.5,170.0,198.0,228.0,4215,4417,2939,3163,1276,1254,2271,1167,1755,355,516,812,80,83,6600,5925,2750,5000,3025,3525,0
621,1,2,183.5,164.0,198.0,228.0,4249,4378,2995,3079,1254,1299,2242,1664,1720,700,522,964,80,83,6300,5475,2875,5600,3325,3975,0
629,1,2,187.5,178.0,198.0,228.0,4215,4378,2939,3079,1276,1299,1542,1190,1460,320,82,870,80,83,6350,5875,2875,5600,3425,3975,0
636,1,2,186.5,176.0,198.0,228.0,4238,4310,2939,3079,1299,1231,1998,1724,1760,710,238,1014,79,83,6400,5775,3175,5600,3425,4075,0
643,1,2,193.5,182.0,198.0,228.0,4025,4299,2771,3023,1254,1276,1435,1635,1345,715,90,920,77,83,8250,5775,3325,5600,3425,4075,0
650,1,2,196.5,176.0,198.0,228.0,4086,4411,2743,3135,1343,1276,1310,1237,1060,315,250,922,76,83,8150,6235,3325,5600,3525,4475,0
657,1,2,192.0,176.0,198.0,228.0,4030,4322,2687,3023,1343,1299,1746,1754,1340,680,406,1074,74,83,8425,6235,3325,5600,4050,4475,0
664,1,2,184.5,170.0,198.0,243.0,3773,4378,2519,3079,1254,1299,1745,1055,1345,325,400,730,78,83,7850,5650,3325,5600,4725,5075,0
671,1,2,194.5,174.0,198.0,251.0,3823,4322,2547,3023,1276,1299,1305,942,1145,310,160,632,78,83,7900,6200,3325,5600,4725,5200,0
679,1,2,197.5,180.0,198.0,251.0,3728,4411,2407,3023,1321,1388,1595,1083,1275,450,320,633,78,83,7900,6890,3325,5600,4725,5200,0
686,1,2,197.5,178.0,198.0,251.0,3734,4131,2435,2743,1299,1388,2051,1522,1575,725,476,797,78,83,8350,6835,3475,6050,4725,5300,0
693,1,2,197.5,184.0,198.0,251.0,3767,4148,2491,2715,1276,1433,2493,1213,1865,840,628,373,78,83,9400,6650,3775,6200,4725,5500,0
700,1,2,193.5,182.0,198.0,251.0,4193,4260,2715,2827,1478,1433,3008,1666,2200,1125,808,541,78,83,9100,7640,3775,5750,5025,6050,0
707,1,2,195.5,200.0,198.0,235.0,4350,4456,2715,3023,1635,1433,3221,993,2325,530,896,463,78,83,8950,8335,3775,5300,5175,6700,0
714,1,2,193.5,200.0,198.0,235.0,4366,4652,2799,3219,1567,1433,3029,1491,2345,860,684,631,78,83,8550,8675,3775,5150,5575,6925,0
721,1,2,196.5,190.0,198.0,235.0,4277,4758,2687,3303,1590,1455,2194,1413,1810,860,384,553,77,83,7900,7860,3775,5050,6225,7885,0
729,1,2,198.0,192.0,190.0,235.0,4322,4501,2687,3135,1635,1366,1969,1913,1635,1200,334,713,79,83,7525,8265,3775,5050,6900,8185,0
736,1,2,189.0,188.0,190.0,235.0,4411,4680,2799,3247,1612,1433,2301,2439,1775,1550,526,889,79,83,7075,8565,3775,5050,7350,8560,0
743,1,2,186.5,186.0,190.0,227.0,4310,4562,2631,3107,1679,1455,2197,2325,1675,1260,522,1065,79,83,6400,8520,3775,4900,8025,10160,0
750,1,2,195.5,174.0,206.0,227.0,4277,4462,2575,3051,1702,1411,1063,2179,995,1200,68,979,79,83,8150,6885,3775,4900,8425,11840,0
757,1,2,198.5,174.0,206.0,227.0,4271,4014,2659,2603,1612,1411,1217,2626,1065,1475,152,1151,79,83,8000,6930,3775,4800,8575,11940,0
764,1,2,198.5,170.0,206.0,219.0,4389,3829,2799,2463,1590,1366,1299,823,1105,270,194,553,79,79,8000,6290,3775,4800,9175,12940,0
771,1,2,181.5,171.0,206.0,219.0,4378,3756,2743,2435,1635,1321,1519,1042,1275,325,244,717,79,76,6550,6925,4175,4800,10675,13460,0
779,1,2,175.5,166.0,206.0,219.0,4411,3599,2799,2323,1612,1276,1660,1375,1370,510,290,865,79,73,7050,6815,4175,4700,11525,14150,0
786,1,2,173.5,166.0,206.0,219.0,4355,3706,2743,2407,1612,1299,1717,386,1385,15,332,371,81,73,6350,6640,4175,4700,12225,14385,0
793,1,2,185.0,160.0,206.0,219.0,4417,3885,2715,2631,1702,1254,892,774,810,255,82,519,81,73,6325,6735,4175,4700,12700,15195,0
800,1,2,183.0,156.0,206.0,219.0,4366,3963,2687,2687,1679,1276,1244,777,1020,110,224,667,81,73,6025,5355,4175,4700,13000,16650,0
807,1,2,190.0,136.0,206.0,219.0,4282,4025,2715,2771,1567,1254,749,1190,670,375,79,815,81,73,5825,3575,4175,4700,13500,18820,0
814,1,2,191.0,124.0,206.0,219.0,4333,3924,2743,2715,1590,1209,674,1600,595,645,79,955,81,70,6475,3060,4175,4600,14200,20390,0
7,1,0,13.0,13.0,14.0,15.0,293,293,293,293,0,0,35,35,35,35,0,0,12,12,0,0,0,0,0,0,1
14,1,0,13.0,14.0,14.0,15.0,671,671,671,671,0,0,20,70,20,70,0,0,13,13,0,0,0,0,0,0,1
21,1,0,14.0,14.0,14.0,15.0,755,755,755,755,0,0,55,50,55,50,0,0,13,13,0,0,0,0,0,0,1
29,1,0,14.0,15.0,14.0,15.0,783,699,783,699,0,0,145,80,145,80,0,0,13,14,0,0,0,0,0,0,1
36,1,0,16.0,15.0,22.0,15.0,811,755,811,755,0,0,150,125,150,125,0,0,14,14,0,0,0,0,0,0,1
43,1,0,16.0,16.0,22.0,23.0,811,755,811,755,0,0,235,65,235,65,0,0,14,15,0,0,0,0,0,0,1
50,1,0,15.0,16.0,22.0,23.0,811,783,811,783,0,0,25,30,25,30,0,0,15,15,0,0,0,0,0,0,1
57,1,0,17.0,17.0,22.0,23.0,839,783,839,783,0,0,30,75,30,75,0,0,15,16,0,0,0,0,0,0,1
64,1,0,18.0,18.0,22.0,23.0,923,811,923,811,0,0,85,170,85,170,0,0,16,17,0,0,0,0,0,0,1
71,1,0,17.0,18.0,22.0,23.0,951,827,951,783,0,44,170,218,170,210,0,8,16,17,0,0,0,0,0,0,1
79,1,0,17.0,19.0,22.0,23.0,979,883,979,727,0,156,30,328,30,300,0,28,16,18,0,0,0,0,0,0,1
86,1,0,18.0,19.0,22.0,23.0,951,911,951,755,0,156,90,453,90,405,0,48,16,18,0,0,0,0,0,0,1
93,1,0,19.0,20.0,22.0,23.0,951,990,951,811,0,179,145,318,145,300,0,18,18,19,0,0,0,150,0,0,1
100,1,0,20.0,20.0,22.0,23.0,990,995,923,839,67,156,227,39,215,5,12,34,18,19,0,0,0,150,0,0,1
107,1,0,20.0,20.0,22.0,23.0,1057,995,923,839,134,156,348,159,320,105,28,54,19,19,0,0,0,150,0,0,1
114,1,0,20.0,21.0,22.0,23.0,1085,939,951,783,134,156,379,119,335,45,44,74,20,19,0,0,0,150,0,0,1
121,1,0,24.0,22.0,28.0,23.0,1006,939,895,783,111,156,201,179,145,85,56,94,20,19,0,100,250,150,0,0,1
129,1,0,26.0,23.0,36.0,23.0,1102,1107,1035,951,67,156,234,264,170,150,64,114,20,20,0,100,250,150,0,0,1
136,1,0,28.0,23.0,36.0,31.0,1102,1130,1035,951,67,179,267,104,195,70,72,34,20,20,0,100,250,150,0,0,1
143,1,0,27.0,24.0,36.0,31.0,1130,1298,1063,1119,67,179,105,174,25,170,80,4,19,21,100,150,250,150,0,0,1
150,1,0,28.0,25.0,36.0,31.0,1107,1359,1063,1203,44,156,189,270,105,250,84,20,21,22,100,150,250,150,0,0,1
157,1,0,29.5,25.0,36.0,31.0,1270,1359,1203,1203,67,156,232,420,140,380,92,40,21,22,375,150,250,150,25,0,1
164,1,0,32.5,26.0,36.0,31.0,1298,1331,1231,1175,67,156,185,370,85,310,100,60,22,23,375,150,250,150,25,0,1
171,1,0,32.5,26.0,36.0,46.0,1326,1415,1259,1259,67,156,138,535,130,455,8,80,24,23,375,150,250,150,25,0,1
179,1,0,35.5,26.0,36.0,46.0,1326,1415,1259,1259,67,156,41,140,25,40,16,100,25,24,375,150,250,500,25,0,1
186,1,0,35.5,27.0,36.0,46.0,1438,1298,1371,1119,67,179,219,175,195,55,24,120,25,24,375,150,250,500,25,0,1
193,1,0,39.5,32.0,44.0,46.0,1494,1275,1427,1119,67,156,97,146,65,10,32,136,28,25,375,150,250,500,25,0,1
200,1,0,41.5,32.0,44.0,46.0,1527,1387,1483,1231,44,156,126,171,90,40,36,131,28,25,525,150,250,500,25,0,1
207,1,0,45.5,34.0,52.0,46.0,1583,1415,1539,1259,44,156,59,201,15,50,44,151,32,26,525,150,250,500,25,0,1
214,1,0,48.5,35.0,58.0,46.0,1678,1555,1567,1399,111,156,70,351,10,180,60,171,32,27,525,350,250,725,25,0,1
221,1,0,51.5,37.0,58.0,46.0,1813,1639,1679,1483,134,156,141,226,65,135,76,91,34,28,525,350,250,725,25,0,1
229,1,0,55.5,40.0,58.0,46.0,1947,2031,1791,1763,156,268,171,342,75,215,96,127,36,29,525,350,250,725,25,0,1
236,1,0,55.5,42.0,58.0,46.0,1998,2205,1819,1847,179,358,201,97,85,80,116,17,38,30,675,400,250,725,25,0,1
243,1,0,57.5,46.0,58.0,46.0,2031,2188,1875,1875,156,313,197,129,65,80,132,49,42,32,825,500,250,725,25,0,1
250,1,0,57.5,46.0,58.0,46.0,2115,2132,1959,1819,156,313,497,204,345,115,152,89,42,33,975,500,250,725,25,0,1
257,1,0,65.5,49.0,74.0,61.0,2283,2076,2127,1763,156,313,337,199,165,70,172,129,42,34,1075,550,250,725,25,0,1
264,1,0,67.5,52.0,82.0,61.0,2367,2216,2211,1903,156,313,522,269,330,100,192,169,42,35,1075,650,250,725,25,0,1
271,1,0,69.5,54.0,82.0,69.0,2339,2070,2183,1735,156,335,482,404,320,195,162,209,49,36,1075,700,250,1075,25,0,1
279,1,0,74.5,63.0,82.0,69.0,2418,2373,2239,2015,179,358,317,114,135,65,182,49,51,37,1075,800,250,1075,25,0,1
286,1,0,74.5,64.0,74.0,77.0,2502,2322,2323,1987,179,335,387,135,185,50,202,85,50,38,1075,800,250,1075,125,0,1
293,1,0,73.5,67.0,74.0,77.0,2675,2580,2519,2267,156,313,408,201,190,80,218,121,56,40,1225,850,250,1075,125,0,1
300,1,0,72.5,72.0,74.0,77.0,2843,2804,2687,2491,156,313,378,331,140,170,238,161,55,41,1225,1050,250,1075,125,0,1
307,1,0,73.5,74.0,74.0,77.0,3011,2804,2855,2491,156,313,608,246,350,45,258,201,54,42,1225,1500,625,1075,125,0,1
314,1,0,76.5,76.0,90.0,85.0,3067,2681,2799,2211,268,470,198,379,150,135,48,244,54,43,1225,1550,825,1075,125,0,1
321,1,0,83.5,81.0,90.0,85.0,3028,3084,2715,2435,313,649,133,255,45,135,88,120,53,44,1225,1700,825,1075,125,0,1
329,1,0,88.5,84.0,98.0,85.0,3045,3162,2687,2491,358,671,57,285,25,110,32,175,59,47,1225,1700,825,1200,125,0,1
336,1,0,89.5,84.0,106.0,85.0,3146,3034,2631,2407,515,627,316,617,245,370,71,247,61,48,1225,1750,825,1325,125,0,1
343,1,0,89.5,85.0,106.0,85.0,3437,3034,2855,2407,582,627,379,762,340,435,39,327,61,49,1725,1875,825,1400,200,0,1
350,1,0,91.5,90.0,106.0,101.0,3459,3050,2855,2379,604,671,641,402,530,195,111,207,61,49,2075,2125,825,1400,200,0,1
357,1,0,103.0,90.0,114.0,101.0,3392,2944,2743,2295,649,649,290,478,170,245,120,233,61,49,2000,2175,825,1400,275,0,1
364,1,0,105.0,98.0,120.0,101.0,3353,2922,2659,2295,694,627,299,294,95,110,204,184,63,52,2000,2275,825,1400,275,0,1
371,1,0,106.0,101.0,120.0,117.0,3342,2966,2603,2295,739,671,606,564,310,300,296,264,72,55,2150,2275,825,1400,275,0,1
379,1,0,106.0,93.0,120.0,117.0,3465,3112,2659,2463,806,649,633,785,270,445,363,340,75,55,1700,1875,825,1400,550,450,1
386,1,0,110.0,96.0,120.0,117.0,3851,3146,3023,2519,828,627,544,606,185,190,359,416,75,58,1850,1925,825,1400,550,450,1
393,1,0,114.5,95.0,120.0,117.0,3963,3112,3135,2463,828,649,660,776,205,280,455,496,73,58,2175,2050,825,1400,700,600,1
400,1,0,115.5,104.0,120.0,117.0,4086,3330,3303,2659,783,671,957,406,410,155,547,251,73,61,2175,2000,1075,1400,850,700,1
407,1,0,109.5,105.0,128.0,117.0,3974,3336,3191,2687,783,649,1137,427,640,100,497,327,73,63,1775,1950,1075,1400,1175,800,1
414,1,0,113.0,107.0,128.0,117.0,3997,3252,3191,2603,806,649,1082,773,610,370,472,403,72,64,2100,2000,1075,1400,1300,850,1
421,1,0,118.0,108.0,128.0,117.0,3963,3386,3135,2715,828,671,1302,868,730,385,572,483,72,67,2350,2000,1075,1400,1300,850,1
429,1,0,125.0,110.0,128.0,117.0,4103,3314,3275,2687,828,627,603,570,310,115,293,455,72,67,2700,2500,1075,1400,1325,850,1
436,1,0,128.0,112.0,128.0,133.0,4070,3510,3219,2883,851,627,329,895,140,360,189,535,72,68,2950,2825,1075,1850,1325,850,1
443,1,0,128.0,114.0,142.0,141.0,4165,4086,3359,3415,806,671,726,560,445,145,281,415,72,68,3400,2875,1325,1850,1325,850,1
450,1,0,133.0,122.0,142.0,141.0,4030,3974,3247,3303,783,671,847,250,520,55,327,195,75,68,3800,2975,1325,1950,1350,850,1
457,1,0,133.0,123.0,166.0,141.0,4142,4070,3359,3443,783,627,1032,547,755,280,277,267,75,68,3800,3025,1325,1950,1350,850,1
464,1,0,148.0,128.0,166.0,141.0,4187,3974,3359,3303,828,671,462,492,335,145,127,347,74,68,3900,3175,1325,1950,1350,850,1
471,1,0,152.0,134.0,166.0,141.0,4187,4126,3359,3387,828,739,698,444,475,130,223,314,74,68,4200,3275,1325,2200,1400,850,1
479,1,0,148.0,135.0,166.0,149.0,4103,3706,3275,2967,828,739,1139,458,820,235,319,223,74,70,4200,3275,1325,2400,1700,950,1
486,1,0,139.0,125.0,166.0,149.0,4131,3840,3303,3079,828,761,1335,584,1020,440,315,144,77,71,4000,2475,1325,2650,2500,1750,1
493,1,0,152.0,131.0,166.0,149.0,4232,3913,3359,3107,873,806,708,180,685,65,23,115,78,71,4100,3125,1325,2650,2500,1750,1
500,1,0,158.0,134.0,166.0,149.0,4277,3526,3359,2743,918,783,704,492,565,285,139,207,78,71,3850,3225,1325,2650,2750,1850,1
507,1,0,162.0,141.0,166.0,164.0,4316,3470,3331,2687,985,783,629,449,470,350,159,99,78,73,3900,3400,1325,2650,2750,2050,1
514,1,0,161.0,148.0,166.0,164.0,4344,3409,3359,2603,985,806,745,585,520,415,225,170,77,74,5600,3700,1325,2950,2750,2050,1
521,1,0,164.0,150.0,166.0,164.0,4344,3364,3359,2603,985,761,1091,553,750,420,341,133,77,76,5600,3750,1325,2950,2750,2100,1
529,1,0,163.0,156.0,174.0,164.0,4394,3403,3387,2575,1007,828,1322,267,1015,180,307,87,77,76,5950,3950,1325,3025,2800,2100,1
536,1,0,172.0,161.0,190.0,164.0,4232,3806,3247,2799,985,1007,618,672,495,465,123,207,77,79,5900,4675,1325,3025,3000,2150,1
543,1,0,155.0,158.0,174.0,164.0,4271,3857,3331,2827,940,1030,875,837,665,510,210,327,77,79,4500,4175,1325,3025,4775,2600,1
550,1,0,154.0,164.0,174.0,164.0,3734,4098,2883,3135,851,963,1100,505,790,195,310,310,74,81,5700,4475,1325,3025,5025,2600,1
557,1,0,168.0,164.0,174.0,164.0,2614,4176,1987,3191,627,985,228,636,75,210,153,426,73,82,5950,4550,1325,3025,5075,2725,1
564,1,0,157.5,163.0,182.0,164.0,2278,4232,1763,3247,515,985,478,1146,265,600,213,546,72,82,5525,4025,1325,3025,5650,3350,1
571,1,0,162.5,164.0,182.0,164.0,2233,4187,1763,3247,470,940,108,678,60,145,48,533,71,82,6475,4200,1325,3025,5725,3650,1
579,1,0,156.5,170.0,182.0,180.0,2210,4210,1763,3247,447,963,310,903,210,375,100,528,71,83,6125,4475,1325,3025,6075,3700,1
586,1,0,157.5,171.0,188.0,180.0,2832,4086,2407,3079,425,1007,333,688,310,365,23,323,71,83,6525,4575,1325,3025,6350,4000,1
593,1,0,138.5,148.0,188.0,180.0,3717,4058,3247,3051,470,1007,444,899,365,460,79,439,71,82,4025,3250,1325,3025,8625,5425,1
600,1,0,126.0,135.0,188.0,164.0,3722,3734,3275,2771,447,963,691,630,560,93,131,537,71,69,2900,3000,1325,3025,9325,6850,1
607,1,0,128.0,139.0,188.0,164.0,3767,3280,3275,2295,492,985,941,777,750,140,191,637,71,69,3350,3325,1325,3025,9475,6850,1
614,1,0,132.0,146.0,188.0,164.0,3711,3874,3107,2911,604,963,897,759,780,211,117,548,71,72,3600,4150,1325,3025,9475,6850,1
621,1,0,136.0,150.0,188.0,164.0,3795,3991,2967,3051,828,940,1160,205,935,16,225,189,71,72,3800,4250,1325,3025,9475,6850,1
629,1,0,138.0,153.0,188.0,164.0,3851,4176,2911,3191,940,985,1227,340,1040,156,187,184,76,75,3800,4300,1325,3025,9475,6850,1
636,1,0,143.0,163.0,188.0,164.0,3605,4422,2687,3415,918,1007,895,320,850,166,45,154,81,78,3900,4625,1325,3025,9475,6850,1
643,1,0,152.0,163.0,188.0,164.0,3767,4624,2827,3639,940,985,907,627,750,411,157,216,86,78,4100,5025,1325,3250,9475,6850,1
650,1,0,150.5,166.0,188.0,179.0,3958,4630,2995,3667,963,963,1233,1189,960,861,273,328,86,81,4375,5500,1325,3400,9725,6850,1
657,1,0,148.0,151.0,188.0,179.0,4378,4820,3415,3835,963,985,1355,1724,970,1276,385,448,86,81,3550,4700,1325,3400,10400,7650,1
664,1,0,154.5,157.0,188.0,179.0,4383,4943,3443,4003,940,940,1301,1751,800,1416,501,335,83,84,4075,4600,1325,3400,10400,7750,1
671,1,0,159.5,163.0,188.0,179.0,4562,4439,3555,3499,1007,940,1281,566,660,386,621,180,83,85,4225,4875,1325,3600,10400,7750,1
679,1,0,168.5,162.0,188.0,179.0,4702,4086,3695,3079,1007,1007,891,291,500,216,391,75,83,85,4975,4475,1325,3600,10400,8250,1
686,1,0,167.5,165.0,188.0,179.0,4714,3941,3751,2911,963,1030,1074,611,700,416,374,195,88,85,4975,4525,1325,3600,10400,8250,1
693,1,0,167.5,173.0,188.0,179.0,4747,3818,3695,2855,1052,963,1532,419,1080,266,452,153,88,85,5275,5375,1325,3825,10400,8250,1
700,1,0,181.5,176.0,188.0,179.0,4680,3907,3471,2743,1209,1164,185,552,160,376,25,176,87,85,5525,5375,1325,3825,10400,8250,1
707,1,0,181.5,179.0,196.0,179.0,4686,4243,3387,2967,1299,1276,746,678,565,346,181,332,87,85,6225,5825,1325,3825,10400,8250,1
714,1,0,189.5,179.0,196.0,179.0,4859,4366,3471,3023,1388,1343,688,716,460,316,228,400,87,85,7625,6350,1325,4075,10425,8250,1
721,1,0,195.5,179.0,196.0,179.0,4932,4126,3499,2715,1433,1411,970,853,570,456,400,397,87,85,7625,6500,1325,4225,10425,8250,1
729,1,0,195.5,179.0,196.0,179.0,4910,4338,3499,2883,1411,1455,1377,854,805,531,572,323,87,85,8275,6500,1325,4225,10425,8250,1
736,1,0,180.5,177.0,196.0,163.0,4798,4271,3387,2883,1411,1388,1936,1165,1200,686,736,479,87,81,7025,6775,1575,4200,11225,8975,1
743,1,0,165.5,164.0,204.0,148.0,4742,3560,3331,2351,1411,1209,1668,1066,760,451,908,615,87,74,4525,6100,1575,3975,12975,11525,1
750,1,0,172.5,164.0,212.0,163.0,4590,2955,3135,1903,1455,1052,1420,866,490,131,930,735,87,74,4375,6100,1575,3975,13125,11525,1
757,1,0,169.5,164.0,218.0,163.0,4574,3498,3163,2491,1411,1007,1578,1126,580,271,998,855,87,74,3675,6350,1575,3975,13825,11525,1
764,1,0,171.5,166.0,218.0,179.0,4518,3454,3107,2491,1411,963,1696,2737,680,1652,1016,1085,87,74,4525,6350,1575,3975,13825,11525,1
771,1,0,181.5,175.0,218.0,179.0,4394,3426,2939,2351,1455,1075,802,998,185,539,617,459,87,75,5075,6350,1575,3975,13825,11525,1
779,1,0,181.5,181.0,218.0,195.0,4327,3689,2939,2547,1388,1142,1332,884,555,539,777,345,89,76,5525,6350,1575,4200,13950,11525,1
786,1,0,197.5,185.0,218.0,195.0,4680,3756,3247,2659,1433,1097,678,873,125,554,553,319,89,77,6325,6450,1575,4275,14000,11525,1
793,1,0,196.5,187.0,210.0,195.0,4809,3745,3331,2603,1478,1142,799,1179,245,749,554,430,89,77,6875,6450,1575,4275,14300,11525,1
800,1,0,188.0,174.0,186.0,195.0,4982,3784,3527,2687,1455,1097,746,1502,20,969,726,533,89,78,4500,5900,1575,4275,16450,12675,1
807,1,0,185.5,170.0,186.0,195.0,4915,3745,3527,2715,1388,1030,974,976,80,694,894,282,87,78,5525,5100,1575,4275,17075,13475,1
814,1,0,171.0,166.0,186.0,195.0,4641,3874,3275,2799,1366,1075,1509,1252,455,859,1054,393,86,78,4650,5275,1575,4275,17975,13925,1
821,1,0,169.0,171.0,194.0,195.0,4512,3829,3191,2687,1321,1142,2065,223,855,119,1210,104,85,78,5150,5450,1925,4275,18075,14275,1
829,1,0,176.5,167.0,194.0,195.0,4361,3918,3107,2799,1254,1119,1980,415,630,304,1350,111,85,78,5225,5325,1925,4275,18250,14775,1
836,1,0,182.5,169.0,194.0,195.0,4714,3717,3415,2575,1299,1142,566,556,160,434,406,122,85,78,5225,5900,1925,4275,18250,14775,1
843,1,0,182.5,184.0,194.0,210.0,4770,4008,3471,2687,1299,1321,828,466,270,209,558,257,95,79,5225,6475,1925,4275,18250,14775,1
850,1,0,188.5,186.0,202.0,210.0,4798,3963,3499,2687,1299,1276,719,533,155,124,564,409,95,79,5225,6600,1925,4275,18250,14775,1
857,1,0,187.5,189.0,202.0,210.0,4898,4126,3555,2827,1343,1299,767,849,310,284,457,565,94,79,5225,7625,1925,4275,18250,14775,1
864,1,0,197.5,193.0,202.0,210.0,5212,4226,3779,2883,1433,1343,538,649,205,249,333,400,94,79,6425,7925,1925,4275,18275,14775,1
871,1,0,197.5,193.0,210.0,210.0,5212,4176,3779,2855,1433,1321,1146,1151,645,599,501,552,94,79,7075,8050,1925,4275,18350,14775,1
879,1,0,197.5,195.0,210.0,210.0,5262,4047,3807,2771,1455,1276,1572,1208,995,604,577,604,94,79,7075,8500,1925,4600,18350,14775,1
886,1,0,199.5,197.0,210.0,210.0,5335,4098,3835,2799,1500,1299,2068,1419,1315,784,753,635,94,81,7825,8625,1925,4600,18350,14775,1
893,1,0,197.5,195.0,210.0,210.0,5313,3986,3835,2687,1478,1299,2254,1860,1475,1069,779,791,92,81,7875,8800,1925,4600,18600,14875,1
900,1,0,197.5,195.0,210.0,210.0,5134,3823,3723,2603,1411,1220,2882,2316,1935,1379,947,937,92,81,7875,8800,1925,4700,18600,14875,1
907,1,0,199.5,195.0,210.0,210.0,5201,3756,3723,2603,1478,1153,3282,1666,2155,1089,1127,577,91,81,8275,8800,1925,4900,18600,14875,1
914,1,0,199.5,195.0,210.0,210.0,5195,3935,3695,2771,1500,1164,3787,2128,2530,1419,1257,709,91,81,8275,9075,1925,5225,18600,14875,1
921,1,0,199.5,199.0,210.0,210.0,5094,3851,3639,2687,1455,1164,4045,2043,2795,1444,1250,599,91,81,8425,9075,1925,5225,18600,14875,1
929,1,0,197.0,197.0,216.0,225.0,5061,3946,3583,2827,1478,1119,4546,1571,3170,844,1376,727,91,81,8300,8800,2050,5025,18625,15150,1
936,1,0,181.0,194.0,216.0,225.0,5005,3885,3527,2743,1478,1142,5148,2051,3600,1184,1548,867,91,81,7750,8525,2050,5025,19450,15425,1
943,1,0,199.5,189.0,200.0,225.0,4988,3806,3555,2687,1433,1119,2870,367,1550,239,1320,128,89,81,5425,7250,2050,5275,21575,16150,1
950,1,0,198.5,193.0,200.0,225.0,4882,3745,3471,2603,1411,1142,3376,635,1930,425,1446,210,89,81,5275,7800,2050,5525,21725,16150,1
957,1,0,199.5,193.0,200.0,225.0,4803,3633,3303,2491,1500,1142,3816,844,2190,608,1626,236,89,81,5375,7800,2050,5825,21725,16150,1
964,1,0,196.0,200.0,200.0,225.0,4607,3571,3107,2407,1500,1164,4376,578,2570,370,1806,208,89,81,7250,8000,2050,5825,21900,16150,1
971,1,0,197.0,199.0,200.0,225.0,4478,3610,3023,2491,1455,1119,4645,1560,2675,970,1970,590,89,81,7000,8500,2050,5825,22150,16200,1
979,1,0,195.5,200.0,200.0,225.0,4641,3672,3163,2463,1478,1209,4961,2237,2815,1370,2146,867,88,81,6475,9050,2050,5825,22500,16200,1
986,1,0,178.0,186.0,200.0,225.0,4613,4075,3135,2799,1478,1276,5302,2753,2980,1730,2322,1023,88,81,5450,8475,2050,5825,23700,17125,1
993,1,0,180.5,186.0,200.0,225.0,4708,4070,3275,2883,1433,1187,4664,1073,2170,960,2494,113,85,81,4475,7175,2175,5825,24925,18284,1
1000,1,0,179.0,186.0,192.0,225.0,4590,4198,3135,2967,1455,1231,4550,1584,2080,1315,2470,269,85,81,3950,7175,2050,6025,25775,18284,1
1007,1,0,178.0,182.0,186.0,255.0,4411,4400,2911,3079,1500,1321,4330,1715,1830,1490,2500,225,85,81,4650,6925,2050,6025,26625,18534,1
1014,1,0,178.0,182.0,178.0,255.0,3890,4266,2435,2967,1455,1299,3958,1703,1290,1555,2668,148,84,81,4600,6825,2950,6025,26925,18684,1
1021,1,0,178.0,182.0,178.0,255.0,4030,4221,2575,2967,1455,1254,4149,1252,1405,960,2744,292,84,81,4600,6825,2950,6025,26925,18684,1
1029,1,0,172.5,189.0,178.0,255.0,3594,4204,2183,2883,1411,1321,4009,1206,1380,850,2629,356,86,81,4775,6825,2950,5825,27275,18684,1
1036,1,0,172.5,199.0,234.0,255.0,3314,4260,2015,2827,1299,1433,3945,1912,1410,1280,2535,632,86,81,4975,8325,2700,5825,27525,18684,1
1043,1,0,174.5,196.0,242.0,255.0,3577,4243,2323,2743,1254,1500,4142,1698,1455,1240,2687,458,85,81,5425,8750,2575,5825,27800,18834,1
1050,1,0,172.5,195.0,242.0,255.0,3762,4030,2519,2575,1243,1455,4289,1390,1510,760,2779,630,83,81,5425,8750,2575,5825,27800,18884,1
1057,1,0,168.5,198.0,242.0,255.0,3627,3974,2463,2575,1164,1399,4664,1603,1745,940,2919,663,84,81,5425,8750,2575,6025,27850,18884,1
1064,1,0,193.5,194.0,242.0,255.0,3594,3846,2519,2547,1075,1299,1944,2059,105,1240,1839,819,84,81,5475,8850,2575,6025,27900,19184,1
1071,1,0,190.5,191.0,242.0,255.0,3868,3879,2771,2603,1097,1276,2445,2266,470,1420,1975,846,84,81,5275,8525,2700,6025,28100,19384,1
1079,1,0,182.5,193.0,242.0,255.0,3521,3823,2491,2547,1030,1276,2806,2531,715,1625,2091,906,78,81,5125,9125,2700,5825,28550,19384,1
1086,1,0,177.5,193.0,248.0,255.0,2871,3874,2043,2575,828,1299,3156,2982,965,1920,2191,1062,75,81,4975,9125,2850,5825,28850,19384,1
1093,1,0,166.5,196.0,248.0,255.0,1998,3890,1259,2547,739,1343,3359,3182,1080,2085,2279,1097,67,81,7675,9400,2850,5825,29550,19384,1
1100,1,0,165.0,194.0,248.0,285.0,1611,3834,895,2491,716,1343,3548,3354,1185,2230,2363,1124,67,81,7750,9150,2850,5825,29625,19634,1
1107,1,0,163.0,187.0,248.0,285.0,2031,3784,1315,2463,716,1321,3808,2911,1365,1910,2443,1001,67,81,7650,8575,3100,5825,29725,20484,1
1114,1,0,183.0,185.0,248.0,285.0,2238,3571,1567,2295,671,1276,1070,3343,55,2190,1015,1153,67,81,7650,8500,3100,5825,29725,20759,1
1121,1,0,183.5,185.0,248.0,285.0,2373,3627,1679,2351,694,1276,1049,3104,100,2070,949,1034,67,81,7525,8200,3100,5825,29850,21334,1
1129,1,0,186.5,193.0,242.0,300.0,2513,3745,1819,2491,694,1254,1063,2770,230,1755,833,1015,67,81,7525,8475,3100,5925,30200,21334,1
1136,1,0,190.5,196.0,242.0,315.0,2272,3818,1623,2519,649,1299,678,2915,65,1765,613,1150,67,81,10225,8475,3100,6125,30200,21334,1
1143,1,0,192.5,199.0,242.0,315.0,2434,4053,1763,2911,671,1142,732,3139,135,1990,597,1149,67,81,10925,8875,3100,6125,30200,21334,1
1150,1,0,191.0,196.0,242.0,315.0,2378,4641,1707,3667,671,974,517,3536,40,2300,477,1236,67,81,10450,8800,3100,6325,30375,21709,1
1157,1,0,188.5,199.0,242.0,315.0,2541,4910,1847,3947,694,963,831,3936,270,2655,561,1281,67,81,10875,9250,3100,6125,30550,21809,1
1164,1,0,166.0,188.0,242.0,315.0,3045,5022,2351,4059,694,963,1201,4547,560,3150,641,1397,67,80,8200,8650,3100,6125,33475,22309,1
1171,1,0,162.5,190.0,242.0,315.0,3241,5022,2547,4059,694,963,340,3817,115,2750,225,1067,67,80,7175,8400,3100,6025,34750,22834,1
1179,1,0,155.5,181.0,242.0,315.0,3134,5117,2463,4087,671,1030,570,4411,265,3220,305,1191,67,80,6675,7800,3100,5825,35750,23434,1
1186,1,0,148.5,168.0,242.0,315.0,3218,5061,2547,3919,671,1142,560,3623,175,2800,385,823,67,79,4975,6500,3100,5825,37450,24459,1
1193,1,0,146.0,170.0,242.0,315.0,3291,4876,2575,3779,716,1097,499,2171,30,2095,469,76,67,79,4350,5750,3100,5825,38225,25159,1
1200,1,0,138.5,173.0,242.0,315.0,3291,4904,2575,3807,716,1097,903,2404,350,2200,553,204,67,79,5625,6375,3100,6025,38600,25909,1
1207,1,0,138.5,173.0,242.0,315.0,3325,4075,2631,3023,694,1052,988,2882,355,2550,633,332,67,79,5625,6375,3100,6025,38600,25909,1
1214,1,0,140.5,175.0,242.0,315.0,3168,4070,2519,2883,649,1187,1269,2788,560,2575,709,213,67,79,6075,7050,3100,6025,38600,25909,1
1221,1,0,135.5,181.0,242.0,315.0,3252,4243,2659,2967,593,1276,1658,3269,875,2900,783,369,66,79,5525,8150,3100,6025,39150,25909,1
1229,1,0,107.0,178.0,242.0,315.0,3106,4098,2603,2799,503,1299,1977,3375,1130,2975,847,400,66,79,3150,8500,3100,6025,41625,26784,1
1236,1,0,115.0,156.0,234.0,315.0,3045,4030,2631,2687,414,1343,1228,3130,335,2970,893,160,66,79,2100,6175,3100,6025,42675,28834,1
7,2,0,13.0,13.0,15.0,15.0,293,293,293,293,0,0,35,35,35,35,0,0,12,12,0,0,0,0,0,0,0
14,2,0,14.0,14.0,15.0,15.0,671,671,671,671,0,0,70,70,70,70,0,0,13,13,0,0,0,0,0,0,0
21,2,0,14.0,14.0,15.0,15.0,727,699,727,699,0,0,50,50,50,50,0,0,13,13,0,0,0,0,0,0,0
29,2,0,15.0,15.0,15.0,15.0,783,671,783,671,0,0,40,80,40,80,0,0,14,14,0,0,0,0,0,0,0
36,2,0,15.0,15.0,23.0,15.0,783,783,783,783,0,0,145,140,145,140,0,0,14,14,0,0,0,0,0,0,0
43,2,0,16.0,16.0,23.0,23.0,839,811,839,811,0,0,40,75,40,75,0,0,15,15,0,0,0,0,0,0,0
50,2,0,17.0,16.0,23.0,23.0,839,811,839,811,0,0,10,40,10,40,0,0,16,15,0,0,0,0,0,0,0
57,2,0,18.0,17.0,23.0,23.0,839,783,839,783,0,0,65,90,65,90,0,0,17,16,0,0,0,0,0,0,0
64,2,0,19.0,18.0,23.0,23.0,867,839,867,839,0,0,120,135,120,135,0,0,18,17,0,0,0,0,0,0,0
71,2,0,19.0,18.0,23.0,23.0,945,878,923,811,22,67,239,237,235,225,4,12,18,17,0,0,0,0,0,0,0
79,2,0,20.0,19.0,23.0,23.0,928,911,839,755,89,156,351,348,335,320,16,28,19,18,0,0,0,0,0,0,0
86,2,0,20.0,19.0,23.0,23.0,978,934,867,755,111,179,327,453,295,405,32,48,19,18,0,0,150,0,0,0,0
93,2,0,20.0,20.0,23.0,23.0,1001,990,867,811,134,179,48,373,0,305,48,68,20,19,0,0,150,150,0,0,0
100,2,0,20.0,20.0,23.0,23.0,1051,1023,895,867,156,156,168,484,100,400,68,84,20,19,0,0,150,150,0,0,0
107,2,0,21.0,20.0,23.0,23.0,1051,1023,895,867,156,156,148,104,60,50,88,54,20,19,0,50,150,150,0,0,0
114,2,0,21.0,20.0,23.0,23.0,1051,995,895,839,156,156,153,114,45,40,108,74,20,19,0,50,150,150,0,0,0
121,2,0,24.0,21.0,31.0,23.0,1074,911,895,755,179,156,53,174,0,80,53,94,21,19,0,50,300,150,0,0,0
129,2,0,25.0,21.0,31.0,23.0,1158,1163,979,1007,179,156,138,84,65,70,73,14,22,20,0,50,300,150,0,0,0
136,2,0,25.0,22.0,31.0,31.0,1163,1214,1007,1035,156,179,274,94,185,60,89,34,22,20,0,50,300,150,0,0,0
143,2,0,26.0,24.0,31.0,31.0,1135,1130,867,951,268,179,104,119,75,65,29,54,23,21,125,50,300,250,0,0,0
150,2,0,29.0,25.0,31.0,31.0,1236,1191,923,1035,313,156,35,210,20,140,15,70,24,21,125,50,300,250,0,0,0
157,2,0,29.0,26.0,31.0,31.0,1236,1247,923,1091,313,156,135,200,80,110,55,90,24,22,125,50,300,250,0,0,0
164,2,0,30.0,28.0,46.0,31.0,1264,1331,951,1063,313,268,240,305,145,175,95,130,25,22,125,150,300,250,0,0,0
171,2,0,32.0,31.0,46.0,31.0,1286,1432,951,1119,335,313,245,116,110,75,135,41,26,23,125,150,300,500,0,0,0
179,2,0,33.0,31.0,46.0,46.0,1460,1320,1147,1007,313,313,71,131,50,50,21,81,27,23,300,250,550,500,0,0,0
186,2,0,35.0,33.0,46.0,46.0,1510,1258,1175,923,335,335,106,181,45,60,61,121,29,24,300,250,550,500,0,0,0
193,2,0,37.0,35.0,46.0,46.0,1622,1398,1287,1063,335,335,201,177,100,45,101,132,31,25,300,350,550,500,0,0,0
200,2,0,35.0,35.0,46.0,46.0,1628,1404,1315,1091,313,313,47,253,10,85,37,168,31,25,175,350,550,500,125,0,0
207,2,0,37.0,38.0,46.0,46.0,1768,1460,1455,1147,313,313,147,338,70,130,77,208,33,26,175,400,550,750,125,0,0
214,2,0,37.0,42.0,46.0,46.0,1790,1768,1455,1455,335,313,327,103,210,80,117,23,33,26,175,450,550,825,125,0,0
221,2,0,39.0,45.0,46.0,46.0,1874,1936,1539,1623,335,313,447,168,290,105,157,63,35,27,175,500,550,825,125,0,0
229,2,0,40.0,46.0,46.0,46.0,1908,1986,1595,1651,313,335,678,243,485,140,193,103,36,28,175,500,650,825,125,0,0
236,2,0,41.0,47.0,46.0,54.0,2014,1981,1679,1623,335,358,358,188,125,45,233,143,37,29,175,550,800,825,125,0,0
243,2,0,46.0,48.0,46.0,54.0,2020,1902,1707,1567,313,335,199,389,30,210,169,179,38,30,350,1025,800,825,125,0,0
250,2,0,46.0,53.0,46.0,62.0,2076,1880,1763,1567,313,313,194,180,60,90,134,90,39,31,525,1025,1050,825,125,0,0
257,2,0,49.0,55.0,54.0,62.0,2132,1796,1819,1483,313,313,329,230,155,100,174,130,40,32,525,1025,1050,825,125,0,0
264,2,0,52.0,58.0,54.0,62.0,2154,1908,1819,1595,335,313,364,255,200,85,164,170,41,34,700,1075,1050,1025,125,0,0
271,2,0,54.0,56.0,62.0,62.0,2160,1964,1847,1651,313,313,440,295,290,85,150,210,42,34,875,975,1050,1025,125,150,0
279,2,0,53.0,52.0,62.0,62.0,1930,1958,1595,1623,335,335,615,365,425,115,190,250,43,35,800,750,950,1025,400,675,0
286,2,0,54.0,56.0,62.0,62.0,1594,1897,1259,1539,335,358,545,255,315,90,230,165,42,36,800,750,950,1125,450,725,0
293,2,0,55.0,58.0,62.0,62.0,1292,1986,979,1651,313,335,431,171,215,70,216,101,42,37,800,700,950,1125,675,825,0
300,2,0,55.0,56.0,62.0,62.0,1214,1964,923,1651,291,313,467,297,215,160,252,137,42,38,800,500,950,1125,725,1075,0
307,2,0,59.0,57.0,77.0,62.0,1068,2020,755,1707,313,313,277,432,35,255,242,177,43,38,975,550,950,1125,725,1075,0
314,2,0,64.0,59.0,77.0,62.0,1695,2160,1315,1847,380,313,299,127,55,35,244,92,46,40,975,550,950,1125,725,1075,0
321,2,0,66.0,62.0,77.0,62.0,2289,2384,1819,2071,470,313,280,252,80,120,200,132,48,40,1400,875,950,1225,725,1075,0
329,2,0,69.0,64.0,77.0,70.0,2541,2597,2071,2239,470,358,312,262,110,90,202,172,49,42,1400,925,950,1225,725,1075,0
336,2,0,69.0,66.0,77.0,70.0,2619,2630,2127,2295,492,335,628,328,370,220,258,108,51,41,1475,1175,950,1225,825,1125,0
343,2,0,70.0,66.0,77.0,70.0,2787,2334,2295,2043,492,291,919,295,605,280,314,15,53,42,1475,1125,950,1325,825,1175,0
350,2,0,71.0,68.0,77.0,70.0,2815,2294,2323,2071,492,223,1199,453,825,410,374,43,54,42,1475,1200,950,1325,825,1425,0
357,2,0,77.0,67.0,77.0,70.0,2882,2490,2435,2267,447,223,856,281,530,110,326,171,54,42,1475,1250,950,1325,825,1425,0
364,2,0,77.0,69.0,77.0,70.0,2944,2216,2519,2015,425,201,917,325,535,130,382,195,57,43,1825,1300,950,1325,825,1425,0
371,2,0,79.0,70.0,85.0,70.0,2989,2171,2519,1903,470,268,517,352,275,175,242,177,57,45,1825,1300,950,1325,825,1425,0
379,2,0,79.0,72.0,101.0,78.0,2916,1824,2491,1511,425,313,425,368,135,155,290,213,57,45,1825,1350,950,1325,825,1425,0
386,2,0,81.0,70.0,101.0,94.0,3056,1510,2631,1175,425,335,687,513,345,260,342,253,59,43,1825,1675,950,1325,825,1575,0
393,2,0,78.0,72.0,109.0,86.0,3056,1214,2631,811,425,403,399,370,180,165,219,205,58,44,1475,1675,1100,1450,1225,1675,0
400,2,0,77.0,73.0,109.0,102.0,3000,1874,2575,1539,425,335,556,305,285,185,271,120,57,45,1475,1475,1100,1450,1375,1925,0
407,2,0,80.0,73.0,109.0,102.0,3034,2244,2519,1819,515,425,264,335,125,155,139,180,57,46,1775,1525,1100,1600,1375,1925,0
414,2,0,83.0,74.0,117.0,117.0,3084,2602,2435,2043,649,559,480,304,265,85,215,219,59,47,1875,1525,1450,1650,1375,1925,0
421,2,0,83.0,75.0,117.0,117.0,3246,2787,2463,2183,783,604,835,201,520,110,315,91,59,48,1875,1525,1900,1650,1375,1925,0
429,2,0,85.0,78.0,117.0,125.0,3213,2910,2407,2351,806,559,757,185,350,130,407,55,62,48,1875,1750,2050,1725,1375,1975,0
436,2,0,95.0,82.0,117.0,125.0,3241,3028,2435,2491,806,537,307,205,100,115,207,90,63,49,2175,1750,2450,1725,1375,1975,0
443,2,0,95.0,83.0,117.0,125.0,3375,3106,2547,2547,828,559,508,172,205,135,303,37,64,50,2625,1750,2450,1725,1375,1975,0
450,2,0,102.0,87.0,117.0,125.0,3437,3269,2631,2687,806,582,579,455,180,350,399,105,64,51,2625,1875,2450,1725,1375,1975,0
457,2,0,102.0,90.0,125.0,125.0,3577,3297,2771,2715,806,582,595,492,300,340,295,152,64,52,2925,2225,2750,2125,1375,1975,0
464,2,0,110.0,94.0,125.0,125.0,3683,3342,2855,2715,828,627,630,209,235,185,395,24,65,52,3225,2325,2750,2125,1375,1975,0
471,2,0,122.0,99.0,133.0,125.0,3605,3174,2799,2547,806,627,446,131,355,60,91,71,65,53,3525,2450,2900,2125,1375,1975,0
479,2,0,122.0,106.0,133.0,125.0,3577,2625,2771,2043,806,582,872,149,685,110,187,39,65,55,3525,2625,2900,2125,1375,1975,0
486,2,0,130.0,108.0,133.0,141.0,3627,3129,2799,2547,828,582,897,171,610,110,287,61,65,57,4725,2675,2900,2200,1375,1975,0
493,2,0,132.0,109.0,133.0,141.0,3403,3179,2575,2575,828,604,988,257,705,120,283,137,65,58,4825,3000,2900,2200,1375,1975,0
500,2,0,132.0,113.0,133.0,141.0,3129,3291,2323,2687,806,604,1364,264,985,155,379,109,65,60,4925,3175,2900,2400,1375,1975,0
507,2,0,128.0,90.0,148.0,141.0,3151,2826,2323,2267,828,559,1240,386,765,213,475,173,65,59,4150,1475,2900,2400,2150,3501,0
514,2,0,124.0,78.0,148.0,141.0,3263,1970,2435,1455,828,515,1220,243,645,39,575,204,65,54,4450,800,2900,2400,2750,4551,0
521,2,0,122.0,57.0,148.0,149.0,3465,1908,2659,1483,806,425,1637,281,970,33,667,248,65,43,4350,225,2900,2300,2850,6017,0
529,2,0,132.0,54.0,148.0,133.0,3661,1947,2855,1567,806,380,1477,295,710,28,767,267,65,37,4175,250,2900,2300,3025,6742,0
7,1,0,13.0,13.0,14.0,15.0,209,335,209,335,0,0,25,40,25,40,0,0,12,12,0,0,0,0,0,0,1
14,1,0,13.0,14.0,14.0,15.0,671,671,671,671,0,0,20,70,20,70,0,0,13,13,0,0,0,0,0,0,1
21,1,0,14.0,14.0,14.0,15.0,671,727,671,727,0,0,40,0,40,0,0,0,13,13,0,0,0,0,0,0,1
29,1,0,14.0,15.0,14.0,15.0,727,671,727,671,0,0,140,35,140,35,0,0,13,14,0,0,0,0,0,0,1
36,1,0,16.0,15.0,22.0,15.0,755,755,755,755,0,0,135,135,135,135,0,0,14,14,0,0,0,0,0,0,1
43,1,0,16.0,16.0,22.0,23.0,783,755,783,755,0,0,225,70,225,70,0,0,14,15,0,0,0,0,0,0,1
50,1,0,16.0,16.0,22.0,23.0,755,755,755,755,0,0,15,80,15,80,0,0,16,15,0,0,0,0,0,0,1
57,1,0,17.0,17.0,22.0,23.0,783,811,783,811,0,0,15,140,15,140,0,0,15,16,0,0,0,0,0,0,1
64,1,0,18.0,17.0,22.0,23.0,839,811,839,811,0,0,65,175,65,175,0,0,15,16,0,0,0,0,0,0,1
71,1,0,17.0,18.0,22.0,23.0,839,855,839,811,0,44,145,283,145,275,0,8,16,17,0,0,0,0,0,0,1
79,1,0,17.0,19.0,22.0,23.0,867,855,867,699,0,156,5,338,5,310,0,28,16,18,0,0,0,0,0,0,1
86,1,0,18.0,19.0,22.0,23.0,867,934,867,755,0,179,60,468,60,420,0,48,16,18,0,0,0,0,0,0,1
93,1,0,19.0,20.0,22.0,23.0,895,934,895,755,0,179,120,328,120,310,0,18,17,19,0,0,0,150,0,0,1
100,1,0,20.0,20.0,22.0,23.0,990,990,923,811,67,179,197,48,185,10,12,38,18,19,0,0,0,150,0,0,1
107,1,0,20.0,20.0,22.0,23.0,1057,911,923,755,134,156,318,69,290,15,28,54,19,19,0,0,0,150,0,0,1
114,1,0,21.0,20.0,22.0,23.0,1135,939,979,783,156,156,399,174,355,100,44,74,20,19,0,0,0,150,0,0,1
121,1,0,21.0,21.0,22.0,23.0,1023,855,867,699,156,156,519,229,455,135,64,94,20,19,0,100,0,150,0,0,1
129,1,0,27.0,23.0,28.0,23.0,1068,1023,979,867,89,156,242,19,170,5,72,14,21,20,0,100,250,150,0,0,1
136,1,0,27.0,23.0,28.0,31.0,1046,1079,979,923,67,156,375,164,295,130,80,34,21,20,0,100,250,150,0,0,1
143,1,0,26.0,24.0,28.0,31.0,1186,1186,1119,1007,67,179,108,164,20,160,88,4,20,21,100,150,250,150,0,0,1
150,1,0,28.0,24.0,28.0,31.0,1107,1326,1063,1147,44,179,147,334,55,310,92,24,20,21,100,150,250,150,0,0,1
157,1,0,28.0,25.0,28.0,31.0,1102,1331,1035,1175,67,156,270,430,170,390,100,40,20,22,100,150,250,150,0,0,1
164,1,0,28.0,25.0,36.0,31.0,1130,1331,1063,1175,67,156,218,175,210,115,8,60,22,23,400,150,250,150,0,0,1
171,1,0,32.0,27.0,36.0,46.0,1135,1331,1091,1175,44,156,142,230,130,150,12,80,22,23,400,150,250,150,0,0,1
179,1,0,34.0,26.0,36.0,46.0,1270,1443,1203,1287,67,156,65,150,45,50,20,100,26,24,400,150,250,400,0,0,1
186,1,0,36.0,27.0,36.0,46.0,1270,1359,1203,1203,67,156,113,195,85,75,28,120,26,24,400,150,250,500,0,0,1
193,1,0,36.0,32.0,44.0,46.0,1415,1410,1371,1231,44,179,192,175,160,35,32,140,27,25,400,150,250,500,0,0,1
200,1,0,41.0,32.0,44.0,46.0,1443,1443,1399,1287,44,156,115,196,75,65,40,131,28,25,400,150,250,500,0,0,1
207,1,0,44.0,33.0,44.0,46.0,1550,1387,1483,1231,67,156,108,326,60,175,48,151,29,26,400,150,250,500,0,0,1
214,1,0,47.0,39.0,58.0,46.0,1550,1723,1483,1567,67,156,96,251,40,80,56,171,33,27,550,350,250,575,0,0,1
221,1,0,49.0,40.0,58.0,46.0,1768,1779,1679,1623,89,156,213,216,145,125,68,91,34,28,550,350,250,575,0,0,1
229,1,0,51.0,41.0,58.0,46.0,1835,1785,1679,1539,156,246,168,382,80,255,88,127,34,29,550,350,250,725,0,0,1
236,1,0,54.5,41.0,58.0,61.0,1942,2042,1763,1707,179,335,193,377,85,310,108,67,36,30,525,550,250,725,25,0,1
243,1,0,55.5,43.0,58.0,61.0,2054,1953,1875,1595,179,358,300,252,172,195,128,57,37,30,675,600,250,725,25,0,1
250,1,0,57.5,46.0,58.0,61.0,2087,2048,1931,1735,156,313,341,344,197,255,144,89,37,30,925,600,250,725,25,0,1
257,1,0,57.5,48.0,66.0,61.0,2171,2048,2015,1735,156,313,496,239,332,110,164,129,37,32,1075,600,250,725,25,0,1
264,1,0,66.5,51.0,82.0,61.0,2087,2104,1931,1791,156,313,231,511,47,342,184,169,37,32,1225,750,250,725,25,0,1
271,1,0,67.5,56.0,82.0,61.0,2143,2104,1987,1791,156,313,191,168,87,159,104,9,42,34,1325,750,250,975,25,0,1
279,1,0,71.5,56.0,82.0,69.0,2171,2384,2015,2071,156,313,156,138,32,89,124,49,44,34,1325,750,250,975,125,0,1
286,1,0,75.5,64.0,82.0,69.0,2250,2625,2071,2267,179,358,221,238,77,149,144,89,45,37,1325,900,250,1075,125,0,1
293,1,0,76.5,67.0,90.0,69.0,2390,2681,2211,2323,179,358,326,233,162,104,164,129,49,39,1325,900,250,1075,125,0,1
300,1,0,76.0,69.0,90.0,77.0,2451,2748,2295,2435,156,313,332,335,152,174,180,161,52,39,1450,1200,250,1075,150,0,1
307,1,0,79.0,73.0,90.0,77.0,2563,2804,2407,2491,156,313,352,340,152,189,200,151,52,41,1450,1400,250,1075,150,0,1
314,1,0,78.0,76.0,90.0,77.0,2731,2692,2575,2379,156,313,522,335,352,144,170,191,54,41,1450,1450,250,1075,150,0,1
321,1,0,83.0,76.0,90.0,85.0,2703,2580,2547,2267,156,313,407,440,217,309,190,131,54,41,1450,1550,375,1325,150,0,1
329,1,0,86.0,78.0,90.0,85.0,2955,2798,2799,2463,156,335,567,365,357,194,210,171,61,43,1450,1750,625,1325,150,0,1
336,1,0,86.5,77.0,82.0,85.0,2586,2653,2407,2295,179,358,642,665,412,454,230,211,61,43,1225,1700,625,1325,475,100,1
343,1,0,82.0,78.0,82.0,85.0,2087,2395,1931,2015,156,380,583,374,337,119,246,255,61,43,600,1650,750,1475,1100,250,1
7,2,0,13.0,13.0,15.0,15.0,293,293,293,293,0,0,35,35,35,35,0,0,12,12,0,0,0,0,0,0,1
14,2,0,14.0,14.0,15.0,15.0,671,671,671,671,0,0,70,70,70,70,0,0,13,13,0,0,0,0,0,0,1
21,2,0,14.0,14.0,15.0,15.0,727,699,727,699,0,0,55,50,55,50,0,0,13,13,0,0,0,0,0,0,1
29,2,0,15.0,15.0,15.0,15.0,699,699,699,699,0,0,35,85,35,85,0,0,14,14,0,0,0,0,0,0,1
36,2,0,15.0,15.0,15.0,15.0,839,755,839,755,0,0,145,180,145,180,0,0,14,14,0,0,0,0,0,0,1
43,2,0,16.0,16.0,23.0,23.0,811,783,811,783,0,0,35,75,35,75,0,0,15,15,0,0,0,0,0,0,1
50,2,0,17.0,16.0,23.0,23.0,839,811,839,811,0,0,55,50,55,50,0,0,16,15,0,0,0,0,0,0,1
57,2,0,18.0,17.0,23.0,23.0,895,783,895,783,0,0,60,130,60,130,0,0,17,16,0,0,0,0,0,0,1
64,2,0,19.0,18.0,23.0,23.0,951,839,951,839,0,0,170,190,170,190,0,0,18,17,0,0,0,0,0,0,1
71,2,0,19.0,18.0,23.0,23.0,979,861,979,839,0,22,230,289,230,285,0,4,18,17,0,0,0,0,0,0,1
79,2,0,20.0,19.0,23.0,23.0,979,917,979,783,0,134,345,349,345,325,0,24,19,18,0,0,0,0,0,0,1
86,2,0,20.0,19.0,23.0,23.0,967,911,923,755,44,156,303,454,295,410,8,44,19,18,0,0,150,0,0,0,1
93,2,0,20.0,20.0,23.0,23.0,1068,939,979,783,89,156,35,379,15,315,20,64,20,19,0,0,150,150,0,0,1
100,2,0,20.0,20.0,23.0,23.0,1023,962,867,783,156,179,55,479,15,395,40,84,20,19,0,0,150,150,0,0,1
107,2,0,21.0,20.0,23.0,23.0,1079,1051,923,895,156,156,135,210,75,110,60,100,20,19,0,50,150,150,0,0,1
114,2,0,22.0,20.0,23.0,23.0,1074,995,895,839,179,156,135,65,55,45,80,20,21,19,0,50,150,150,0,0,1
121,2,0,24.0,21.0,31.0,23.0,1023,939,867,783,156,156,36,130,15,90,21,40,21,19,0,50,300,150,0,0,1
129,2,0,25.0,22.0,31.0,23.0,1079,1051,923,895,156,156,121,120,80,110,41,10,22,20,0,50,300,150,0,0,1
136,2,0,25.0,22.0,31.0,23.0,1068,1023,867,867,201,156,199,45,130,15,69,30,22,20,0,50,300,150,0,0,1
143,2,0,26.0,23.0,31.0,23.0,1180,1102,867,923,313,179,99,140,90,90,9,50,23,21,125,50,300,150,0,0,1
150,2,0,26.0,23.0,31.0,23.0,1124,1102,811,923,313,179,189,225,140,155,49,70,23,21,125,50,300,150,0,0,1
157,2,0,29.0,24.0,31.0,31.0,1230,1163,895,1007,335,156,164,361,125,275,39,86,24,22,125,50,300,400,0,0,1
164,2,0,30.0,26.0,46.0,31.0,1309,1191,951,1035,358,156,269,151,190,145,79,6,25,22,125,50,300,600,0,0,1
171,2,0,31.0,29.0,46.0,31.0,1292,1275,979,1119,313,156,266,156,155,130,111,26,25,23,125,50,300,600,0,0,1
179,2,0,33.0,30.0,46.0,46.0,1376,1387,1063,1231,313,156,261,276,160,230,101,46,27,23,125,50,300,600,0,0,1
186,2,0,36.0,31.0,46.0,46.0,1432,1331,1119,1175,313,156,336,211,195,145,141,66,28,24,300,150,550,600,0,0,1
193,2,0,37.0,35.0,46.0,46.0,1516,1522,1203,1343,313,179,76,151,45,65,31,86,29,24,300,300,550,600,0,0,1
200,2,0,39.0,37.0,46.0,46.0,1544,1527,1231,1371,313,156,156,207,85,105,71,102,31,25,300,300,550,850,0,0,1
207,2,0,39.0,40.0,46.0,46.0,1589,1527,1231,1371,358,156,196,37,85,15,111,22,31,26,300,300,550,850,0,0,1
214,2,0,41.0,41.0,46.0,46.0,1622,1583,1287,1427,335,156,202,117,55,100,147,17,33,26,475,550,550,850,0,0,1
221,2,0,41.0,45.0,46.0,46.0,1740,1835,1427,1679,313,156,153,137,70,100,83,37,34,28,475,550,550,850,0,0,1
229,2,0,45.0,45.0,46.0,54.0,1762,1818,1427,1595,335,223,93,254,20,185,73,69,35,28,475,550,550,850,0,0,1
236,2,0,47.0,47.0,54.0,54.0,1852,2009,1539,1651,313,358,219,339,110,230,109,109,37,30,650,750,550,850,0,0,1
243,2,0,47.0,52.0,54.0,54.0,1964,2070,1651,1735,313,335,459,150,310,130,149,20,37,30,650,850,700,925,0,0,1
250,2,0,51.0,54.0,54.0,54.0,2014,1992,1679,1679,335,313,314,191,175,135,139,56,39,32,650,850,700,925,0,0,1
257,2,0,51.0,55.0,54.0,62.0,2126,2132,1791,1819,335,313,579,196,400,100,179,96,39,33,825,950,850,925,0,0,1
264,2,0,54.0,58.0,54.0,62.0,1880,1880,1567,1567,313,313,480,161,365,50,115,111,40,34,1175,950,850,925,0,0,1
271,2,0,55.0,59.0,62.0,62.0,1622,2188,1287,1875,335,313,175,206,95,55,80,151,40,35,1175,950,1100,925,0,0,1
279,2,0,57.0,64.0,62.0,70.0,1958,1930,1623,1595,335,335,310,96,190,30,120,66,40,36,1175,1325,1100,1000,0,0,1
286,2,0,60.0,66.0,62.0,70.0,2104,2177,1791,1819,313,358,266,266,185,160,81,106,42,37,1275,1325,1100,1000,0,0,1
293,2,0,60.0,67.0,62.0,70.0,2104,2126,1791,1791,313,335,376,372,255,230,121,142,42,38,1275,1325,1100,1000,0,0,1
300,2,0,66.0,70.0,70.0,70.0,2210,2406,1875,2071,335,335,116,222,105,140,11,82,44,40,1450,1425,1100,1425,0,0,1
307,2,0,68.0,70.0,70.0,70.0,2266,2434,1931,1987,335,447,191,82,140,40,51,42,44,41,1900,1425,1100,1425,0,0,1
314,2,0,70.0,73.0,70.0,78.0,2132,2541,1819,2071,313,470,233,358,150,260,83,98,46,42,1900,1700,1100,1425,0,0,1
321,2,0,70.0,75.0,70.0,86.0,2306,2625,1791,2155,515,470,329,223,270,165,59,58,46,42,1900,1700,1100,1425,0,0,1
329,2,0,72.0,79.0,78.0,86.0,2440,2810,1791,2295,649,515,515,288,380,220,135,68,48,44,1900,1850,1100,1425,0,0,1
336,2,0,72.0,75.0,86.0,86.0,2558,2866,1931,2351,627,515,716,518,505,390,211,128,48,42,1900,1625,1100,1425,0,425,1
343,2,0,72.0,74.0,101.0,86.0,2558,2686,1931,2127,627,559,1021,567,730,400,291,167,48,39,1900,1625,1100,1425,100,575,1
350,2,0,74.0,74.0,101.0,94.0,2580,2132,1931,1595,649,537,1226,527,855,325,371,202,50,39,1900,1675,1100,1425,100,775,1
357,2,0,73.0,71.0,101.0,94.0,2278,2356,1651,1819,627,537,853,465,560,245,293,220,44,39,2250,1425,1100,1425,575,1025,1
364,2,0,72.0,63.0,101.0,94.0,1718,2692,1203,2155,515,537,899,718,550,430,349,288,45,41,2075,950,1100,1525,850,1625,1
371,2,0,73.0,70.0,101.0,94.0,2037,2614,1567,2099,470,515,360,477,155,175,205,302,47,42,2075,1175,1100,1525,850,1625,1
379,2,0,76.0,75.0,101.0,94.0,2468,2395,1931,1791,537,604,284,407,15,75,269,332,49,43,2075,1175,1100,1525,850,1625,1
386,2,0,83.0,77.0,101.0,94.0,2625,2737,2043,2043,582,694,206,627,65,215,141,412,52,45,2375,1175,1100,1525,850,1625,1
393,2,0,84.0,85.0,101.0,94.0,2698,2658,2071,1987,627,671,282,303,65,40,217,263,53,45,2375,1475,1100,1525,850,1625,1
400,2,0,84.0,88.0,101.0,102.0,2860,2720,2211,2071,649,649,568,505,275,195,293,310,55,47,2200,1725,1100,1425,1025,1725,1
407,2,0,83.0,92.0,101.0,102.0,3000,2664,2351,2015,649,649,434,390,265,100,169,290,58,47,2100,1725,1450,1425,1125,1725,1
414,2,0,92.0,93.0,101.0,102.0,3118,2810,2491,2183,627,627,210,451,115,185,95,266,58,48,2500,1925,1450,1425,1125,1725,1
421,2,0,90.0,97.0,101.0,102.0,3162,2642,2491,2015,671,627,370,521,195,275,175,246,58,49,2325,2450,2050,1425,1300,1775,1
429,2,0,96.0,102.0,101.0,102.0,3134,2686,2463,2015,671,671,256,371,155,195,101,176,61,50,2325,2600,2050,1425,1300,1775,1
436,2,0,96.0,101.0,101.0,110.0,3095,2770,2491,2099,604,671,624,447,455,195,169,252,61,50,2725,2400,2150,1425,1300,1975,1
443,2,0,101.0,103.0,101.0,110.0,3330,2580,2659,1931,671,649,584,513,485,210,99,303,61,50,2850,2450,2300,1425,1475,2100,1
450,2,0,105.0,98.0,109.0,125.0,3336,2468,2687,1819,649,649,470,814,295,435,175,379,62,51,2975,2300,2400,1425,1650,2350,1
457,2,0,103.0,103.0,109.0,141.0,3342,2468,2715,1819,627,649,492,294,345,110,147,184,64,51,2675,2625,2400,1425,1950,2600,1
464,2,0,109.0,107.0,109.0,141.0,3319,2530,2715,1903,604,627,349,355,130,95,219,260,64,51,2975,2800,2400,1425,1950,2600,1
471,2,0,114.0,109.0,125.0,141.0,3442,2496,2659,1847,783,649,411,550,80,210,331,340,64,51,3075,2850,2400,1425,1950,2600,1
479,2,0,113.0,109.0,125.0,141.0,3454,2457,2491,1763,963,694,636,835,335,415,301,420,63,53,2975,3100,2400,1425,2100,2600,1
486,2,0,117.0,109.0,133.0,141.0,3599,2518,2547,1847,1052,671,712,916,395,445,317,471,66,53,3900,3350,2400,1425,2100,2875,1
493,2,0,119.0,112.0,133.0,141.0,3638,2524,2631,1875,1007,649,964,913,585,395,379,518,66,53,3900,3450,2200,1425,1925,2875,1
500,2,0,108.0,119.0,133.0,141.0,3118,2692,2267,2043,851,649,516,418,195,95,321,323,59,53,3525,3400,2200,1425,3350,2975,1
507,2,0,98.0,107.0,133.0,141.0,2289,2586,1595,1959,694,627,784,664,375,265,409,399,57,54,2850,2600,2200,1425,4125,4000,1
514,2,0,95.0,103.0,133.0,141.0,2429,2642,1735,2015,694,627,692,639,195,160,497,479,51,55,2850,2150,2200,1425,4125,4450,1
521,2,0,97.0,103.0,133.0,141.0,2619,2720,1903,2071,716,649,455,754,70,245,385,509,53,55,2850,2400,2200,1425,4125,4450,1
529,2,0,98.0,114.0,133.0,141.0,2552,2877,1791,2183,761,694,598,514,125,25,473,489,56,57,2750,2700,2200,1425,4225,4450,1
536,2,0,100.0,116.0,141.0,141.0,2742,3084,1959,2435,783,649,725,721,260,160,465,561,56,57,3000,3100,2200,1425,4225,4450,1
543,2,0,107.0,121.0,141.0,141.0,2742,3112,1847,2463,895,649,493,582,195,145,298,437,59,60,3700,3150,2200,1425,4225,4450,1
550,2,0,104.0,124.0,141.0,141.0,2171,3420,1455,2771,716,649,733,702,355,210,378,492,56,60,3700,3550,2200,1625,4375,4550,1
557,2,0,107.0,123.0,141.0,141.0,2429,3454,1735,2827,694,627,526,988,160,420,366,568,56,62,3700,3450,2200,1625,4375,4650,1
564,2,0,105.0,119.0,141.0,141.0,2989,3644,2295,2995,694,649,675,1073,225,550,450,523,59,63,3425,3125,2550,1775,4950,5175,1
571,2,0,109.0,107.0,141.0,141.0,3039,3442,2323,2771,716,671,134,1378,50,775,84,603,59,54,2900,3350,2550,1925,5475,6000,1
579,2,0,109.0,101.0,141.0,141.0,3067,2434,2351,1763,716,671,133,1274,65,770,68,504,59,48,3800,3275,2550,1925,5475,6425,1
586,2,0,109.0,104.0,141.0,141.0,3179,1942,2463,1315,716,627,503,1141,355,615,148,526,59,49,3800,3325,2550,1925,5475,6425,1
593,2,0,119.0,107.0,141.0,141.0,3157,2070,2463,1399,694,671,382,635,150,300,232,335,59,49,4375,3600,2550,1925,5475,6425,1
600,2,0,121.0,118.0,141.0,141.0,2938,2317,2267,1623,671,694,262,187,100,89,162,98,59,51,4475,3700,2550,1925,5475,6425,1
607,2,0,121.0,125.0,141.0,141.0,3034,3056,2183,2295,851,761,645,410,375,141,270,269,59,54,4675,3975,2550,2000,5475,6425,1
614,2,0,125.0,125.0,157.0,141.0,3011,2961,2071,2267,940,694,183,436,105,112,78,324,59,50,4675,4100,2550,2100,5475,6625,1
621,2,0,123.0,123.0,165.0,141.0,3067,2776,2127,2239,940,537,541,747,355,359,186,388,59,53,4975,3975,2550,2100,5575,6900,1
629,2,0,131.0,130.0,165.0,149.0,2989,3185,2071,2491,918,694,408,657,110,202,298,455,59,53,5250,4200,2550,2100,5675,6900,1
636,2,0,131.0,136.0,165.0,149.0,3129,3459,2211,2631,918,828,776,563,370,187,406,376,59,53,5750,4425,2700,2100,5675,6900,1
643,2,0,131.0,139.0,165.0,149.0,3179,3616,2239,2743,940,873,1158,813,640,362,518,451,59,56,5750,5125,2700,2100,5675,6900,1
650,2,0,121.0,142.0,165.0,149.0,3078,3622,2183,2771,895,851,1526,728,900,327,626,401,59,56,4900,5200,2700,2100,6525,6900,1
657,2,0,137.0,136.0,165.0,157.0,3258,3594,2295,2743,963,851,518,942,180,437,338,505,59,56,6300,4800,2700,2100,6525,7550,1
664,2,0,109.0,120.0,165.0,157.0,3129,2994,2211,2099,918,895,881,743,435,372,446,371,59,56,4525,3900,2700,2100,8300,8675,1
671,2,0,95.0,119.0,165.0,157.0,3263,2882,2323,1987,940,895,1283,662,725,312,558,350,59,56,2875,3825,2700,2100,9550,8975,1
679,2,0,105.0,127.0,165.0,157.0,3073,2972,2155,2099,918,873,790,330,120,197,670,133,59,56,2875,3875,2700,2100,10000,8975,1
686,2,0,109.0,130.0,180.0,165.0,3011,2966,2071,2071,940,895,739,419,265,207,474,212,59,56,3275,3925,2700,2100,10000,8975,1
693,2,0,113.0,137.0,180.0,165.0,2748,3017,1875,2099,873,918,860,503,290,212,570,291,59,56,3875,4575,2700,2100,10000,8975,1
700,2,0,113.0,138.0,180.0,165.0,2815,2922,1987,1959,828,963,824,414,300,107,524,307,63,56,4125,5000,2700,2100,10000,8975,1
707,2,0,121.0,139.0,180.0,173.0,3185,3123,2267,2183,918,940,516,490,380,92,136,398,63,56,4525,5100,2700,2100,10000,8975,1
714,2,0,125.0,144.0,188.0,173.0,3403,3566,2463,2603,940,963,713,800,465,307,248,493,63,56,5025,5375,2700,2100,10000,8975,1
721,2,0,121.0,145.0,180.0,173.0,3269,3532,2351,2547,918,985,1006,1101,650,517,356,584,61,56,4925,6300,2700,2100,10400,9025,1
729,2,0,118.0,143.0,180.0,173.0,3218,3582,2323,2575,895,1007,980,1282,520,607,460,675,60,56,4825,6050,2700,2225,10650,9325,1
736,2,0,120.0,149.0,180.0,181.0,3011,3386,2071,2379,940,1007,662,898,90,307,572,591,50,56,5225,6075,2700,2225,11150,9525,1
743,2,0,120.0,145.0,180.0,181.0,2742,3370,1847,2407,895,963,885,1061,205,387,680,674,50,56,5225,5950,2700,2475,11150,9850,1
750,2,0,128.0,150.0,180.0,181.0,2748,3263,1875,2323,873,940,762,1077,270,362,492,715,54,56,5225,6175,2700,2475,11150,9850,1
757,2,0,138.0,156.0,180.0,181.0,2737,3291,1819,2351,918,940,384,492,80,32,304,460,58,56,5325,6400,2700,2475,11150,9850,1
764,2,0,126.0,159.0,180.0,181.0,2866,3134,1903,2127,963,1007,730,862,310,282,420,580,58,56,4400,6950,2700,2475,12275,9850,1
771,2,0,93.0,141.0,180.0,181.0,2955,2720,2015,1735,940,985,1059,653,535,82,524,571,57,56,3250,5750,2700,2475,14375,11325,1
7,1,0,13.0,13.0,14.0,15.0,335,377,335,377,0,0,40,45,40,45,0,0,12,12,0,0,0,0,0,0,0
14,1,0,13.0,14.0,14.0,15.0,671,699,671,699,0,0,20,75,20,75,0,0,13,13,0,0,0,0,0,0,0
21,1,0,14.0,14.0,14.0,15.0,727,699,727,699,0,0,55,50,55,50,0,0,13,13,0,0,0,0,0,0,0
29,1,0,14.0,15.0,14.0,15.0,727,699,727,699,0,0,150,45,150,45,0,0,13,14,0,0,0,0,0,0,0
36,1,0,16.0,15.0,22.0,15.0,755,727,755,727,0,0,145,125,145,125,0,0,14,14,0,0,0,0,0,0,0
43,1,0,15.0,16.0,22.0,23.0,783,783,783,783,0,0,35,80,35,80,0,0,13,15,0,0,0,0,0,0,0
50,1,0,17.0,16.0,22.0,23.0,783,783,783,783,0,0,30,45,30,45,0,0,15,15,0,0,0,0,0,0,0
57,1,0,17.0,17.0,22.0,23.0,811,783,811,783,0,0,140,35,140,35,0,0,16,16,0,0,0,0,0,0,0
64,1,0,17.0,18.0,22.0,23.0,895,839,895,839,0,0,245,135,245,135,0,0,17,17,0,0,0,0,0,0,0
71,1,0,17.0,18.0,22.0,23.0,923,850,923,783,0,67,0,237,0,225,0,12,16,17,0,0,0,0,0,0,0
79,1,0,17.0,19.0,22.0,23.0,923,967,923,811,0,156,120,352,120,320,0,32,16,18,0,0,0,0,0,0,0
86,1,0,17.0,19.0,22.0,23.0,923,995,923,839,0,156,230,467,230,415,0,52,17,18,0,0,0,0,0,0,0
93,1,0,22.0,20.0,22.0,23.0,923,1051,923,895,0,156,40,337,40,315,0,22,17,19,0,0,250,150,0,0,0
100,1,0,21.0,20.0,22.0,23.0,923,1046,923,867,0,179,25,57,25,15,0,42,16,19,0,0,250,150,0,0,0
107,1,0,21.0,20.0,22.0,23.0,923,1046,923,867,0,179,140,172,140,110,0,62,16,19,150,0,250,150,0,0,0
114,1,0,22.0,21.0,22.0,23.0,923,939,923,783,0,156,205,128,205,50,0,78,16,19,150,0,250,150,0,0,0
121,1,0,23.0,22.0,30.0,23.0,951,1051,951,895,0,156,265,158,265,60,0,98,16,19,150,100,250,150,0,0,0
129,1,0,25.0,23.0,30.0,23.0,872,1191,783,1035,89,156,216,53,200,35,16,18,17,20,300,100,250,150,0,0,0
136,1,0,26.0,23.0,30.0,31.0,962,1219,783,1063,179,156,286,83,250,45,36,38,18,20,300,100,250,150,0,0,0
143,1,0,27.0,25.0,36.0,31.0,939,1219,783,1063,156,156,346,173,290,115,56,58,18,21,300,150,250,150,0,0,0
150,1,0,28.0,25.0,36.0,31.0,1074,1102,895,923,179,179,231,288,155,210,76,78,19,22,250,50,250,150,50,100,0
157,1,0,31.0,25.0,36.0,31.0,995,1102,839,923,156,179,187,273,95,225,92,48,20,22,250,100,250,150,50,100,0
164,1,0,32.0,26.0,36.0,31.0,1107,1079,951,923,156,156,232,389,120,325,112,64,21,23,350,100,250,150,100,100,0
171,1,0,33.0,26.0,44.0,31.0,1113,939,979,783,134,156,58,519,30,435,28,84,24,23,300,100,250,400,150,100,0
179,1,0,34.0,27.0,44.0,31.0,1130,1107,1063,951,67,156,151,204,115,100,36,104,25,24,300,100,250,400,150,100,0
186,1,0,34.0,27.0,44.0,31.0,1298,1079,1231,923,67,156,214,339,170,215,44,124,28,25,450,100,250,400,150,100,0
193,1,0,34.0,28.0,44.0,31.0,1438,1354,1371,1175,67,179,97,139,45,95,52,44,28,25,450,100,250,500,150,100,0
200,1,0,37.0,29.0,52.0,31.0,1555,1438,1511,1259,44,179,76,259,20,195,56,64,27,26,450,100,250,500,150,100,0
207,1,0,40.0,29.0,52.0,46.0,1550,1443,1483,1287,67,156,119,220,55,140,64,80,28,26,450,100,250,500,150,100,0
214,1,0,41.0,34.0,52.0,46.0,1606,1494,1539,1315,67,179,262,189,190,85,72,104,31,27,450,100,250,500,150,100,0
221,1,0,45.0,34.0,52.0,46.0,1662,1583,1595,1315,67,268,210,295,130,180,80,115,34,27,450,100,250,500,150,100,0
229,1,0,48.0,38.0,52.0,46.0,1802,1712,1735,1399,67,313,178,165,90,85,88,80,34,28,500,100,250,750,150,100,0
236,1,0,52.0,42.0,52.0,46.0,1964,1740,1875,1427,89,313,155,170,55,50,100,120,36,29,500,300,250,825,150,100,0
243,1,0,52.0,44.0,52.0,46.0,2003,1902,1847,1567,156,335,395,290,275,130,120,160,36,30,650,300,250,825,150,100,0
250,1,0,58.0,45.0,60.0,61.0,2059,1953,1903,1595,156,358,235,285,95,85,140,200,36,31,750,300,250,825,150,100,0
257,1,0,59.0,47.0,60.0,61.0,2059,2048,1903,1735,156,313,285,292,125,160,160,132,39,32,900,725,250,825,150,100,0
264,1,0,62.0,52.0,68.0,61.0,2054,2272,1875,1959,179,313,375,177,195,55,180,122,43,33,900,725,250,825,150,100,0
271,1,0,64.5,55.0,74.0,61.0,2138,2328,1959,2015,179,313,430,242,230,80,200,162,43,34,1025,775,250,825,175,100,0
279,1,0,67.5,54.0,82.0,61.0,2255,2356,2099,2043,156,313,556,472,340,270,216,202,44,36,1025,675,250,825,175,200,0
286,1,0,68.5,56.0,74.0,61.0,2451,2406,2295,2071,156,335,606,447,420,255,186,192,44,37,1025,875,250,825,275,200,0
293,1,0,72.5,58.0,74.0,69.0,2451,2658,2295,2323,156,335,601,403,395,175,206,228,48,38,1025,925,250,825,275,200,0
300,1,0,73.5,59.0,74.0,69.0,2535,2350,2379,2015,156,335,616,373,490,105,126,268,49,41,1175,925,250,825,275,200,0
307,1,0,74.5,61.0,82.0,69.0,2535,2496,2379,2183,156,313,706,334,560,80,146,254,48,41,1325,975,250,825,275,200,0
314,1,0,76.5,61.0,82.0,69.0,2586,2020,2407,1707,179,313,766,604,600,310,166,294,48,41,1425,975,250,825,425,300,0
321,1,0,82.0,60.0,90.0,69.0,2726,1874,2547,1539,179,335,706,789,520,455,186,334,48,41,1350,975,250,825,500,350,0
329,1,0,85.5,63.0,90.0,69.0,2675,2384,2519,2071,156,313,472,370,270,200,202,170,54,42,1425,1025,450,1175,525,350,0
336,1,0,83.5,64.0,90.0,69.0,2754,2826,2575,2491,179,335,606,360,380,150,226,210,55,43,1425,1025,450,1175,525,350,0
343,1,0,88.5,69.0,90.0,69.0,2849,2938,2603,2603,246,335,608,375,350,125,258,250,57,45,1425,1075,450,1475,525,350,0
350,1,0,89.5,71.0,90.0,77.0,3067,3084,2799,2771,268,313,850,556,560,270,290,286,62,45,1425,1075,450,1475,525,400,0
357,1,0,87.5,74.0,90.0,77.0,3062,3028,2771,2603,291,425,486,387,310,145,176,242,60,47,1575,1075,700,1475,525,400,0
364,1,0,89.5,78.0,98.0,85.0,3190,3039,2855,2435,335,604,686,369,470,155,216,214,62,48,1725,1275,950,1475,525,400,0
371,1,0,96.5,85.0,106.0,85.0,3246,2922,2911,2295,335,627,717,150,465,10,252,140,62,50,1725,1325,950,1475,525,400,0
379,1,0,97.5,88.0,106.0,93.0,3308,2950,2995,2323,313,627,568,240,530,20,38,220,62,52,1825,1375,950,1475,525,400,0
386,1,0,104.5,91.0,114.0,101.0,3241,2938,2883,2267,358,671,461,460,375,160,86,300,61,52,2125,1375,950,1775,525,400,0
393,1,0,108.5,93.0,114.0,109.0,3437,3157,2855,2463,582,694,591,285,425,105,166,180,61,53,2225,1775,950,1775,525,400,0
400,1,0,110.0,100.0,114.0,109.0,3370,3112,2743,2463,627,649,676,218,530,20,146,198,61,54,2500,2175,950,1775,550,400,0
407,1,0,108.0,98.0,120.0,117.0,3442,2978,2771,2351,671,627,791,564,565,290,226,274,61,56,2350,2075,1075,1775,850,500,0
414,1,0,106.5,97.0,128.0,117.0,3437,2698,2743,2071,694,627,796,344,490,140,306,204,61,55,2325,1875,1075,1775,1275,800,0
421,1,0,109.5,106.0,136.0,117.0,3442,3034,2771,2407,671,627,1058,329,680,45,378,284,61,55,2375,2175,1075,1775,1275,800,0
429,1,0,114.5,110.0,142.0,117.0,3314,3280,2687,2631,627,649,1190,329,740,65,450,264,65,56,2625,2175,1075,2075,1275,800,0
436,1,0,109.5,111.0,142.0,117.0,3370,3465,2743,2771,627,694,1360,685,855,345,505,340,65,58,2325,2275,1075,2325,1725,950,0
443,1,0,109.0,115.0,142.0,117.0,3342,3560,2715,2911,627,649,1465,587,930,225,535,362,69,59,2150,2325,1075,2325,1950,1100,0
450,1,0,121.0,117.0,142.0,125.0,3504,3622,2855,2995,649,627,1300,128,685,40,615,88,69,61,2350,2475,1075,2325,1950,1100,0
457,1,0,123.0,120.0,142.0,125.0,3666,3734,2995,3107,671,627,1280,98,760,30,520,68,73,62,2850,2775,1075,2325,1950,1100,0
464,1,0,127.0,125.0,142.0,125.0,3857,3672,3163,3023,694,649,1151,193,755,145,396,48,73,64,2850,3075,1075,2325,1950,1100,0
471,1,0,132.0,127.0,142.0,133.0,3694,3560,3023,2911,671,649,577,229,330,105,247,124,75,65,3700,3225,1075,2325,1950,1100,0
479,1,0,142.0,133.0,142.0,133.0,3790,3605,3163,2911,627,694,179,309,10,155,169,154,76,65,4100,3325,1075,2325,1950,1100,0
486,1,0,140.0,122.0,142.0,141.0,3706,3616,3079,2855,627,761,519,476,270,330,249,146,77,53,3850,3325,1075,2325,2325,1850,0
7,1,2,13.0,13.0,14.0,15.0,293,293,293,293,0,0,35,35,35,35,0,0,12,12,0,0,0,0,0,0,0
14,1,2,13.0,14.0,14.0,15.0,671,615,671,615,0,0,20,60,20,60,0,0,13,13,0,0,0,0,0,0,0
21,1,2,14.0,14.0,14.0,15.0,755,643,755,643,0,0,55,35,55,35,0,0,13,13,0,0,0,0,0,0,0
29,1,2,14.0,15.0,14.0,15.0,783,615,783,615,0,0,145,60,145,60,0,0,13,14,0,0,0,0,0,0,0
36,1,2,16.0,15.0,22.0,15.0,755,755,755,755,0,0,145,115,145,115,0,0,14,14,0,0,0,0,0,0,0
43,1,2,16.0,16.0,22.0,23.0,811,755,811,755,0,0,240,40,240,40,0,0,14,15,0,0,0,0,0,0,0
50,1,2,17.0,17.0,22.0,23.0,839,783,839,783,0,0,290,15,290,15,0,0,16,16,0,0,0,0,0,0,0
57,1,2,17.0,18.0,22.0,23.0,867,755,867,755,0,0,40,60,40,60,0,0,16,17,0,0,0,0,0,0,0
64,1,2,18.0,18.0,22.0,23.0,895,895,895,895,0,0,95,110,95,110,0,0,16,17,0,0,0,0,0,0,0
71,1,2,17.0,19.0,22.0,23.0,951,923,951,923,0,0,190,220,190,220,0,0,17,18,0,0,0,0,0,0,0
79,1,2,17.0,20.0,22.0,23.0,951,1023,951,979,0,44,45,303,45,295,0,8,16,19,0,0,0,0,0,0,0
86,1,2,18.0,20.0,22.0,23.0,923,1001,923,867,0,134,110,408,110,380,0,28,16,19,0,0,0,0,0,0,0
93,1,2,19.0,21.0,22.0,23.0,867,1023,867,867,0,156,160,79,160,35,0,44,18,20,0,0,0,150,0,0,0
100,1,2,20.0,21.0,22.0,23.0,962,1023,895,867,67,156,237,154,225,90,12,64,18,20,0,0,0,150,0,0,0
107,1,2,20.0,22.0,22.0,23.0,973,1051,839,895,134,156,353,124,325,40,28,84,19,21,0,0,0,150,0,0,0
114,1,2,20.0,22.0,22.0,23.0,1107,1135,951,979,156,156,388,184,340,80,48,104,20,21,0,0,0,150,0,0,0
121,1,2,22.0,23.0,22.0,23.0,1102,1102,923,923,179,179,373,154,305,30,68,124,20,22,0,0,250,150,0,0,0
129,1,2,26.0,23.0,36.0,23.0,1051,1018,895,839,156,179,239,279,155,135,84,144,20,22,0,0,250,150,0,0,0
136,1,2,28.0,24.0,36.0,31.0,1141,1046,1007,867,134,179,90,354,90,190,0,164,21,23,0,0,250,150,0,0,0
143,1,2,29.0,26.0,36.0,31.0,1001,1158,979,867,22,291,155,274,155,145,0,129,21,24,50,0,250,300,0,0,0
150,1,2,30.0,27.0,36.0,31.0,1147,1163,1147,895,0,268,255,111,255,50,0,61,23,24,50,0,250,300,0,0,0
157,1,2,30.0,28.0,36.0,31.0,1287,1186,1287,895,0,291,45,216,45,115,0,101,23,25,200,0,250,300,0,0,0
164,1,2,32.0,31.0,36.0,46.0,1421,1208,1399,895,22,313,69,96,65,5,4,91,24,25,350,125,250,300,0,0,0
171,1,2,34.0,32.0,36.0,46.0,1443,1342,1399,1007,44,335,32,261,20,130,12,131,24,26,350,125,250,300,0,0,0
179,1,2,36.0,33.0,36.0,46.0,1522,1354,1455,1063,67,291,100,128,80,65,20,63,24,28,400,125,250,300,0,0,0
186,1,2,36.0,33.0,44.0,46.0,1438,1499,1371,1231,67,268,273,305,245,210,28,95,26,28,400,300,250,550,0,0,0
193,1,2,40.0,34.0,44.0,46.0,1578,1578,1511,1287,67,291,151,96,115,65,36,31,28,29,400,300,250,550,0,0,0
200,1,2,44.0,36.0,44.0,46.0,1544,1667,1455,1399,89,268,73,158,25,120,48,38,32,30,550,300,250,550,0,0,0
207,1,2,44.0,36.0,44.0,46.0,1729,1684,1595,1483,134,201,184,212,120,150,64,62,34,30,550,300,250,550,0,0,0
214,1,2,44.0,38.0,52.0,46.0,1667,1673,1511,1427,156,246,104,164,20,70,84,94,32,30,550,300,250,550,0,0,0
221,1,2,47.0,39.0,52.0,46.0,1802,1785,1623,1539,179,246,169,172,65,50,104,122,32,30,550,300,250,800,0,0,0
229,1,2,49.0,41.0,66.0,46.0,1802,1790,1623,1567,179,223,279,275,155,125,124,150,34,31,550,425,250,800,0,0,0
236,1,2,51.0,41.0,66.0,46.0,1891,1762,1735,1539,156,223,315,383,175,205,140,178,39,31,700,425,250,950,0,0,0
243,1,2,54.0,43.0,66.0,46.0,1942,1740,1763,1539,179,201,409,383,245,185,164,198,39,33,700,425,250,950,0,0,0
250,1,2,54.0,46.0,74.0,46.0,2082,1802,1791,1623,291,179,659,367,455,245,204,122,39,33,800,675,250,1100,0,0,0
257,1,2,66.0,48.0,74.0,54.0,2238,1930,1903,1707,335,223,334,390,165,265,169,125,39,35,950,925,450,1250,0,0,0
264,1,2,65.0,50.0,74.0,62.0,2216,2014,1903,1791,313,223,275,523,70,370,205,153,36,35,950,925,450,1250,0,0,0
271,1,2,68.0,56.0,74.0,70.0,2070,2037,1735,1791,335,246,586,376,341,270,245,106,39,37,1550,1400,450,1250,0,0,0
279,1,2,74.0,60.0,74.0,70.0,2160,2009,1847,1763,313,246,302,404,246,295,56,109,39,37,1550,1525,450,1250,0,0,0
286,1,2,74.0,60.0,74.0,70.0,2188,2070,1875,1847,313,223,567,643,471,510,96,133,39,37,1950,1525,450,1250,0,0,0
293,1,2,81.0,61.0,82.0,70.0,2266,2037,1931,1791,335,246,397,840,261,675,136,165,39,39,1950,1525,450,1250,0,0,0
300,1,2,81.0,70.0,90.0,70.0,2188,2138,1875,1847,313,291,553,346,381,245,172,101,39,39,2100,2025,450,1250,0,0,0
307,1,2,87.0,69.0,98.0,70.0,2244,2166,1931,1875,313,291,528,568,316,435,212,133,39,41,2100,1900,450,1250,0,125,0
314,1,2,87.5,69.0,106.0,70.0,1678,2194,1343,1903,335,291,548,809,296,640,252,169,38,41,2375,1900,450,1250,125,125,0
321,1,2,81.5,64.0,106.0,86.0,1342,2250,1007,1959,335,291,563,901,271,725,292,176,38,42,2225,1400,450,1250,575,625,0
329,1,2,83.0,64.0,106.0,86.0,1818,2115,1483,1847,335,268,494,383,166,250,328,133,36,42,2200,1525,450,1250,700,1000,0
336,1,2,83.0,57.0,106.0,86.0,1852,2250,1539,1959,313,291,490,989,126,820,364,169,36,43,2300,1025,450,1250,900,1500,0
343,1,2,83.5,54.0,106.0,86.0,1404,2138,1091,1847,313,291,445,1240,41,1035,404,205,37,42,2275,900,450,1250,1075,1675,0
350,1,2,84.5,68.0,106.0,86.0,1124,2171,811,1903,313,268,535,122,91,85,444,37,37,43,2275,900,450,1250,1075,1675,0
357,1,2,89.5,70.0,106.0,86.0,1684,2188,1371,1875,313,313,565,698,81,625,484,73,41,45,2275,1400,450,1250,1075,1675,0
364,1,2,95.0,70.0,106.0,86.0,2177,2222,1819,1931,358,291,525,375,76,270,449,105,42,45,2400,1400,450,1250,1100,1675,0
371,1,2,95.0,65.0,106.0,86.0,2210,2194,1875,1903,335,291,796,497,311,360,485,137,49,47,2400,900,450,1250,1100,2175,0
379,1,2,100.0,68.0,106.0,94.0,2440,2300,2127,1987,313,313,497,182,76,105,421,77,48,47,2400,1150,450,1250,1100,2300,0
386,1,2,102.0,69.0,106.0,94.0,2608,2300,2295,1987,313,313,387,402,151,285,236,117,46,48,2700,1150,450,1250,1100,2300,0
393,1,2,104.0,77.0,106.0,102.0,2552,2222,2239,1819,313,403,402,73,126,0,276,73,53,49,3000,1400,450,1250,1100,2300,0
400,1,2,99.5,76.0,106.0,110.0,2826,2261,2491,1791,335,470,647,294,331,165,316,129,53,50,2775,1525,450,1250,1325,2425,0
407,1,2,102.0,63.0,122.0,110.0,2826,2446,2491,1819,335,627,673,454,321,245,352,209,55,51,2600,1025,450,1250,1475,3300,0
414,1,2,103.0,69.0,130.0,94.0,2720,2574,2183,1903,537,671,374,565,46,355,328,210,58,52,2600,1025,575,1250,1475,3250,0
421,1,2,101.5,70.0,130.0,94.0,2894,2558,2267,1931,627,627,740,622,336,340,404,282,58,51,2525,1400,575,1250,1550,3350,0
429,1,2,106.0,66.0,130.0,94.0,3140,2608,2491,1959,649,649,615,717,131,380,484,337,62,51,2250,975,575,1250,1825,3900,0
436,1,2,104.0,68.0,130.0,102.0,3230,2692,2603,2043,627,649,892,503,336,165,556,338,62,51,2050,600,1200,950,2025,4575,0
443,1,2,102.0,68.0,130.0,102.0,3252,2597,2603,2015,649,582,742,506,206,100,536,406,70,51,2050,975,1200,1050,2025,4575,0
450,1,2,100.0,68.0,130.0,102.0,3280,2619,2631,2015,649,604,732,508,316,180,416,328,70,51,2050,975,1200,1050,2025,4575,0
457,1,2,116.0,72.0,130.0,102.0,3392,2580,2743,1931,649,649,353,438,61,130,292,308,70,51,2050,1225,1200,1150,2025,4575,0
464,1,2,116.0,72.0,130.0,102.0,3594,2670,2855,2043,739,627,570,754,286,370,284,384,70,51,2050,1225,1200,1300,2025,4575,0
471,1,2,126.0,72.0,130.0,102.0,3739,2642,2799,2015,940,627,422,859,151,495,271,364,70,51,2550,1225,1200,1300,2025,4575,0
479,1,2,126.0,72.0,130.0,102.0,3868,2462,2883,1791,985,671,663,754,276,310,387,444,70,51,3050,1225,1200,1450,2025,4575,0
486,1,2,130.0,76.0,130.0,102.0,3706,2765,2743,2071,963,694,715,1009,266,585,449,424,70,51,3550,1600,1200,1600,2025,4575,0
493,1,2,132.0,76.0,154.0,102.0,3678,2530,2715,1903,963,627,1045,972,501,580,544,392,70,51,3550,1900,1200,1600,2025,4575,0
500,1,2,144.0,78.0,154.0,102.0,3454,2636,2491,1987,963,649,866,1142,356,770,510,372,70,51,3550,1900,1200,1900,2025,4575,0
507,1,2,157.0,83.0,170.0,110.0,3566,2552,2603,1903,963,649,92,442,16,290,76,152,70,51,3750,2050,1200,1900,2025,4575,0
514,1,2,163.0,83.0,170.0,110.0,3728,2530,2743,1903,985,627,253,543,136,315,117,228,70,51,5150,2050,1200,1900,2025,4575,0
521,1,2,165.0,84.0,192.0,110.0,3616,2468,2631,1819,985,649,359,633,126,325,233,308,70,53,5150,2050,1650,1900,2025,4575,0
529,1,2,165.0,92.0,192.0,110.0,3734,2401,2771,1707,963,694,835,408,486,120,349,288,70,53,5450,2350,1650,1900,2025,4575,0
536,1,2,172.0,90.0,208.0,110.0,3672,2378,2687,1707,985,671,466,699,401,335,65,364,70,54,5750,2725,1650,1900,2075,4700,0
543,1,2,180.5,81.0,208.0,110.0,3790,2418,2827,1791,963,627,427,941,246,505,181,436,70,54,5725,2100,1650,2050,2150,5525,0
550,1,2,183.5,90.0,208.0,110.0,3734,2384,2771,1735,963,649,473,701,376,485,97,216,70,54,5675,2100,1650,2050,2200,5525,0
557,1,2,184.5,92.0,208.0,110.0,3616,2272,2631,1623,985,649,288,396,71,150,217,246,67,55,5675,2625,1650,2350,2200,5525,0
564,1,2,191.0,92.0,208.0,110.0,3470,2278,2463,1651,1007,627,339,677,6,355,333,322,67,55,6950,2800,1650,2350,2225,5525,0
571,1,2,190.0,89.0,208.0,110.0,3498,2328,2491,1679,1007,649,765,657,316,405,449,252,72,54,6950,2625,1650,2350,2225,5700,0
579,1,2,195.0,94.0,208.0,110.0,3426,2373,2463,1679,963,694,767,412,206,230,561,182,72,52,7200,3275,1775,2350,2375,5875,0
586,1,2,173.5,94.0,208.0,102.0,3773,2278,2631,1651,1142,627,1180,680,471,430,709,250,72,52,6175,3275,1775,2250,3575,5975,0
593,1,2,164.5,94.0,208.0,102.0,3907,2300,2743,1651,1164,649,1205,665,356,535,849,130,72,52,5525,3275,1775,1850,4625,6675,0
600,1,2,164.0,64.0,208.0,102.0,3991,1953,2715,1371,1276,582,1185,528,301,430,884,98,72,43,4800,1275,1775,1850,5400,9075,0
7,2,0,13.0,13.0,15.0,15.0,251,335,251,335,0,0,30,40,30,40,0,0,12,12,0,0,0,0,0,0,1
14,2,0,14.0,14.0,15.0,15.0,671,671,671,671,0,0,70,70,70,70,0,0,13,13,0,0,0,0,0,0,1
21,2,0,14.0,14.0,15.0,15.0,643,671,643,671,0,0,40,45,40,45,0,0,13,13,0,0,0,0,0,0,1
29,2,0,15.0,15.0,15.0,15.0,727,727,727,727,0,0,90,95,90,95,0,0,14,14,0,0,0,0,0,0,1
36,2,0,15.0,15.0,23.0,15.0,699,699,699,699,0,0,125,175,125,175,0,0,14,14,0,0,0,0,0,0,1
43,2,0,16.0,16.0,23.0,23.0,755,783,755,783,0,0,20,70,20,70,0,0,15,15,0,0,0,0,0,0,1
50,2,0,17.0,16.0,23.0,23.0,755,755,755,755,0,0,35,85,35,85,0,0,16,15,0,0,0,0,0,0,1
57,2,0,18.0,17.0,23.0,23.0,867,727,867,727,0,0,95,120,95,120,0,0,17,16,0,0,0,0,0,0,1
64,2,0,19.0,18.0,23.0,23.0,895,839,895,839,0,0,140,95,140,95,0,0,18,17,0,0,0,0,0,0,1
71,2,0,19.0,18.0,23.0,23.0,867,715,867,671,0,44,245,173,245,165,0,8,18,17,0,0,0,0,0,0,1
79,2,0,19.0,19.0,23.0,23.0,883,771,839,615,44,156,353,218,345,190,8,28,19,18,0,0,0,0,0,0,1
86,2,0,19.0,19.0,23.0,23.0,1006,799,895,643,111,156,329,303,305,255,24,48,19,18,0,0,150,0,0,0,1
93,2,0,19.0,20.0,23.0,23.0,1029,794,895,503,134,291,445,58,405,20,40,38,19,19,0,0,150,150,0,0,1
100,2,0,19.0,20.0,23.0,23.0,1001,900,867,587,134,313,161,164,105,90,56,74,19,19,0,0,150,150,0,0,1
107,2,0,20.0,20.0,23.0,23.0,950,878,839,587,111,291,123,25,55,15,68,10,19,19,0,0,150,150,0,0,1
114,2,0,20.0,20.0,23.0,31.0,945,861,811,615,134,246,114,127,30,85,84,42,19,19,0,0,150,150,0,0,1
121,2,0,21.0,22.0,31.0,31.0,995,861,839,615,156,246,234,85,130,65,104,20,20,19,0,100,300,150,0,0,1
129,2,0,23.0,23.0,31.0,31.0,995,1079,839,811,156,268,84,172,35,120,49,52,20,20,0,100,300,150,50,0,1
136,2,0,23.0,23.0,31.0,31.0,1040,1029,839,783,201,246,317,300,190,220,127,80,20,20,0,100,300,150,50,0,1
143,2,0,24.0,24.0,31.0,31.0,1074,1085,783,839,291,246,394,398,235,290,159,108,21,21,125,100,300,150,50,0,1
150,2,0,26.0,24.0,31.0,31.0,1074,1174,783,951,291,223,96,546,80,410,16,136,21,21,125,100,300,150,50,0,1
157,2,0,27.0,26.0,31.0,31.0,1158,1197,867,951,291,246,187,189,135,25,52,164,22,22,125,200,300,400,50,0,1
164,2,0,27.0,27.0,31.0,31.0,1124,1365,811,1119,313,246,172,231,130,85,42,146,22,22,125,200,300,400,50,0,1
171,2,0,31.0,27.0,46.0,31.0,1264,1421,951,1175,313,246,102,139,45,65,57,74,23,22,250,200,300,400,50,0,1
179,2,0,32.0,30.0,46.0,31.0,1264,1415,951,1147,313,268,152,140,55,55,97,85,25,23,250,300,300,400,50,0,1
186,2,0,33.0,30.0,46.0,31.0,1365,1292,1007,979,358,313,207,226,70,105,137,121,25,23,250,300,300,400,50,50,1
193,2,0,34.0,30.0,46.0,31.0,1454,1152,1119,839,335,313,383,361,210,200,173,161,27,23,250,300,600,400,50,50,1
200,2,0,37.0,31.0,46.0,31.0,1488,1152,1175,839,313,313,199,451,90,250,109,201,27,24,375,400,600,500,50,50,1
207,2,0,38.0,35.0,46.0,39.0,1488,1152,1175,839,313,313,224,386,75,170,149,216,28,24,375,400,600,500,50,50,1
214,2,0,38.0,36.0,46.0,39.0,1572,1169,1259,811,313,358,174,481,85,225,89,256,30,25,375,400,700,750,50,50,1
221,2,0,40.0,36.0,46.0,39.0,1600,1230,1287,895,313,335,254,432,125,240,129,192,30,25,625,300,700,750,50,150,1
229,2,0,43.0,39.0,46.0,54.0,1678,1236,1343,923,335,313,149,278,80,50,69,228,31,26,625,500,700,750,50,150,1
236,2,0,44.0,41.0,46.0,54.0,1701,1292,1343,979,358,313,234,348,125,105,109,243,32,26,625,500,700,750,50,150,1
243,2,0,44.0,42.0,46.0,54.0,1706,1376,1371,1063,335,313,275,468,130,185,145,283,33,27,625,500,700,750,50,150,1
250,2,0,45.0,44.0,46.0,54.0,1768,1432,1455,1119,313,313,176,418,95,120,81,298,34,27,875,800,700,750,50,150,1
257,2,0,46.0,46.0,54.0,54.0,1762,1454,1427,1119,335,335,251,458,130,145,121,313,34,28,625,900,850,750,300,150,1
264,2,0,46.0,46.0,54.0,54.0,1796,1701,1483,1343,313,358,377,473,220,120,157,353,35,28,625,1000,1100,750,300,150,1
271,2,0,49.0,50.0,54.0,54.0,1818,1734,1371,1399,447,335,396,549,250,160,146,389,36,30,625,1000,1100,825,400,150,1
279,2,0,49.0,53.0,54.0,54.0,1891,1964,1287,1651,604,313,524,275,310,50,214,225,37,32,625,1000,1100,900,400,150,1
286,2,0,49.0,54.0,62.0,54.0,2003,1992,1399,1679,604,313,320,465,30,200,290,265,37,32,625,1100,1100,900,450,150,1
293,2,0,49.0,54.0,62.0,54.0,1998,1992,1371,1679,627,313,551,185,185,5,366,180,37,34,725,1000,1100,900,450,250,1
300,2,0,51.0,54.0,70.0,54.0,2110,2104,1483,1791,627,313,711,345,265,125,446,220,38,34,725,1000,1100,900,450,250,1
307,2,0,52.0,54.0,70.0,54.0,2076,2182,1427,1847,649,335,801,595,350,235,451,360,38,34,975,1000,1100,1050,450,250,1
314,2,0,56.0,58.0,70.0,62.0,2238,2182,1567,1847,671,335,467,601,190,205,277,396,40,34,975,1050,1100,1050,450,250,1
321,2,0,56.0,58.0,70.0,62.0,2182,1964,1511,1651,671,313,517,522,160,140,357,382,40,34,975,1350,1100,1050,450,250,1
329,2,0,58.0,62.0,70.0,62.0,2216,2188,1567,1875,649,313,569,487,140,165,429,322,42,36,1075,1450,1100,1275,450,250,1
336,2,0,62.0,63.0,70.0,78.0,2188,2216,1539,1903,649,313,489,632,80,270,409,362,44,38,1325,1450,1100,1275,450,250,1
343,2,0,63.0,66.0,70.0,86.0,2300,2121,1651,1763,649,358,460,435,50,125,410,310,44,38,1325,1500,1100,1275,450,250,1
350,2,0,65.0,71.0,78.0,86.0,2255,2289,1651,1819,604,470,482,446,100,205,382,241,46,40,1325,1500,1250,1400,450,250,1
357,2,0,67.0,73.0,93.0,86.0,2395,2474,1791,1959,604,515,372,236,10,60,362,176,46,40,1575,1600,1250,1400,450,250,1
364,2,0,70.0,77.0,93.0,94.0,2518,2647,1847,2155,671,492,577,312,135,80,442,232,48,42,1675,1650,1550,1400,450,250,1
371,2,0,71.0,77.0,93.0,94.0,2468,2541,1819,2071,649,470,863,283,345,120,518,163,49,42,1675,1650,1550,1400,450,250,1
379,2,0,78.0,83.0,93.0,94.0,2440,2647,1791,2155,649,492,609,533,215,310,394,223,51,43,1675,2025,1550,1400,450,250,1
386,2,0,78.0,90.0,93.0,102.0,2580,2278,1931,1763,649,515,605,132,285,45,320,87,52,43,1925,2200,1650,1400,450,250,1
393,2,0,79.0,91.0,93.0,102.0,2670,2362,2043,1735,627,627,491,382,195,215,296,167,53,44,1925,2300,1800,1400,450,250,1
400,2,0,83.0,92.0,93.0,102.0,2541,2272,1959,1623,582,649,453,432,285,210,168,222,53,45,1925,2200,1800,1400,500,350,1
407,2,0,83.0,95.0,93.0,110.0,2720,2373,2071,1679,649,694,388,357,140,105,248,252,53,46,2225,2300,1800,1400,500,350,1
414,2,0,82.0,98.0,93.0,110.0,2804,2630,2155,1959,649,671,219,698,95,370,124,328,54,46,2125,3075,1800,1400,600,350,1
421,2,0,93.0,101.0,93.0,110.0,2910,2860,2239,2211,671,649,281,365,185,90,96,275,54,46,2625,3075,1800,1400,600,350,1
429,2,0,93.0,104.0,101.0,110.0,2938,2916,2267,2267,671,649,416,670,240,315,176,355,57,46,2775,3250,2050,1400,600,350,1
436,2,0,93.0,106.0,101.0,110.0,3000,2782,2351,2155,649,627,777,496,525,265,252,231,57,47,2775,3325,2050,1400,600,450,1
443,2,0,98.0,103.0,109.0,110.0,3034,2832,2407,2183,627,649,648,831,420,520,228,311,57,46,2675,3200,2200,1400,700,625,1
450,2,0,98.0,106.0,109.0,110.0,3174,2854,2547,2183,627,671,1043,966,735,600,308,366,57,46,2975,3275,2200,1400,700,675,1
457,2,0,98.0,103.0,109.0,110.0,3218,2882,2547,2211,671,671,1313,1067,925,650,388,417,57,46,2950,3300,2600,1400,825,925,1
464,2,0,98.0,96.0,109.0,110.0,3162,2804,2491,2155,671,649,1188,1408,720,915,468,493,57,46,2700,3350,2600,1400,1575,1275,1
471,2,0,98.0,93.0,109.0,110.0,3084,2608,2435,1959,649,649,1065,1714,725,1145,340,569,57,46,2850,3325,2600,1400,1925,1525,1
479,2,0,86.0,93.0,109.0,110.0,3302,2412,2631,1763,671,649,1455,1069,1035,720,420,349,57,46,2225,2875,2600,1400,2550,1975,1
486,2,0,94.0,93.0,109.0,110.0,3146,2418,2519,1791,627,627,1217,1350,725,925,492,425,57,46,2075,2875,2600,1400,2800,2025,1
493,2,0,92.0,90.0,109.0,125.0,3062,2496,2435,1847,627,649,1592,1430,1020,950,572,480,57,46,2475,2675,2600,1400,2900,2400,1
500,2,0,94.0,89.0,109.0,125.0,3168,2406,2519,1735,649,671,1882,1180,1230,645,652,535,57,46,2475,2225,2600,1400,2900,2975,1
507,2,0,98.0,91.0,109.0,125.0,3022,2406,2351,1735,671,671,1172,1366,540,755,632,611,57,47,2575,2275,2600,1400,2900,2975,1
514,2,0,94.0,96.0,109.0,125.0,2832,2160,2183,1511,649,649,709,1003,155,420,554,583,59,47,2575,2650,2600,1400,3400,2975,1
521,2,0,98.0,100.0,109.0,125.0,2602,2054,1931,1427,671,627,524,774,90,240,434,534,59,47,2325,2825,2600,1400,3650,3025,1
529,2,0,98.0,99.0,117.0,133.0,2793,2222,2099,1707,694,515,863,664,345,95,518,569,59,45,2575,2950,2600,1500,3650,3175,1
536,2,0,101.0,100.0,117.0,133.0,3090,2317,2239,1847,851,470,1086,689,460,60,626,629,59,45,2575,3000,2600,1500,3650,3225,1
543,2,0,103.0,104.0,125.0,133.0,3095,2406,2155,1847,940,559,1207,765,565,60,642,705,62,46,2575,3450,2600,1500,3650,3225,1
550,2,0,115.0,108.0,125.0,133.0,3168,2658,2183,1987,985,671,982,1110,220,325,762,785,62,48,3175,3500,2600,1650,3650,3225,1
557,2,0,115.0,112.0,125.0,141.0,3224,2664,2239,2015,985,649,1372,1361,490,500,882,861,62,49,3175,3600,2600,1750,3650,3225,1
564,2,0,117.0,116.0,125.0,141.0,3308,2742,2323,2071,985,671,1159,1042,465,280,694,762,62,50,3425,3725,3050,2000,3650,3225,1
571,2,0,119.0,119.0,125.0,141.0,3196,2944,2211,2295,985,649,1330,1003,520,215,810,788,62,51,3425,3900,3050,2000,3650,3225,1
579,2,0,121.0,120.0,125.0,141.0,3084,3146,2099,2519,985,627,1441,1359,515,495,926,864,62,53,3925,3950,3050,2000,3650,3225,1
586,2,0,121.0,128.0,125.0,141.0,3196,3314,2211,2687,985,627,1732,1159,690,340,1042,819,64,55,3925,4050,3050,2075,3650,3225,1
593,2,0,125.0,129.0,140.0,141.0,2938,3650,2043,2911,895,739,1276,1275,130,385,1146,890,64,55,4375,4325,3050,2225,3650,3225,1
600,2,0,129.0,136.0,140.0,149.0,3297,3465,2357,2659,940,806,1489,976,231,290,1258,686,64,57,4375,4325,3150,2325,3650,3225,1
607,2,0,139.0,144.0,140.0,149.0,3370,3381,2407,2575,963,806,1191,1028,117,275,1074,753,64,57,4925,4675,3500,2325,3650,3225,1
614,2,0,139.0,144.0,164.0,149.0,3578,3739,2615,2799,963,940,1641,1474,455,605,1186,869,68,59,4925,4775,3500,2450,3650,3225,1
621,2,0,147.0,145.0,188.0,149.0,3706,3767,2721,2827,985,940,1275,1112,569,285,706,827,68,59,5375,4725,3600,2450,3650,3375,1
629,2,0,153.0,148.0,188.0,149.0,3762,3851,2799,2911,963,940,1148,1367,780,420,368,947,68,59,5575,4975,3600,2450,3650,3375,1
636,2,0,153.0,148.0,188.0,149.0,3857,3515,2917,2575,940,940,1618,1767,1134,700,484,1067,68,59,6875,5525,3600,2800,3650,3375,1
643,2,0,157.0,149.0,188.0,149.0,4103,3470,3118,2463,985,1007,1789,2197,1335,1010,454,1187,68,59,6675,5725,3600,2800,3650,3375,1
650,2,0,153.0,162.0,188.0,173.0,3924,3526,2917,2519,1007,1007,1763,842,1289,110,474,732,68,59,6625,5900,3600,2800,3850,3375,1
657,2,0,129.0,138.0,188.0,173.0,4047,3526,3107,2519,940,1007,1833,1245,1255,405,578,840,68,59,5675,4350,3600,2800,5650,4575,1
664,2,0,107.0,115.0,188.0,173.0,4003,3666,3040,2659,963,1007,2007,1390,1313,455,694,935,68,59,3200,2650,3600,2800,8125,6275,1
671,2,0,99.0,109.0,204.0,181.0,3997,3431,3012,2491,985,940,2365,1768,1555,725,810,1043,68,59,2650,2250,3600,2800,9075,6975,1
679,2,0,87.0,99.0,212.0,189.0,3964,3123,3001,2183,963,940,2849,1488,1923,450,926,1038,68,59,1800,1675,3600,2800,9925,7600,1
686,2,0,93.0,99.0,212.0,189.0,3941,3000,3001,2015,940,985,2807,1628,1765,495,1042,1133,68,59,1850,2075,3600,2800,10375,8000,1
693,2,0,101.0,105.0,212.0,189.0,4092,2994,3107,1987,985,1007,2702,1508,1840,380,862,1128,68,59,1850,2300,3600,2800,10375,8000,1
700,2,0,108.0,105.0,212.0,189.0,3896,3000,2956,2015,940,985,1867,1425,1347,310,520,1115,68,59,2050,2300,3600,2800,10375,8000,1
707,2,0,120.0,112.0,212.0,189.0,3902,2994,2984,1987,918,1007,856,1366,528,260,328,1106,68,59,3200,2600,3600,2800,10375,8000,1
714,2,0,120.0,117.0,212.0,189.0,3885,3006,2945,2043,940,963,1329,1318,889,100,440,1218,71,59,2800,2975,3600,2800,10375,8000,1
721,2,0,113.0,125.0,220.0,189.0,3627,2983,2687,2043,940,940,1736,1299,1188,90,548,1209,64,59,3250,3450,3600,2800,10725,8000,1
729,2,0,113.0,128.0,220.0,197.0,2944,3067,2071,2127,873,940,1433,1679,1156,350,277,1329,60,59,3250,3725,3600,2800,10925,8000,1
736,2,0,128.0,132.0,220.0,197.0,3158,3084,2307,2099,851,985,1135,1392,754,144,381,1248,60,60,4250,3725,3600,3000,10925,8000,1
743,2,0,132.0,137.0,220.0,197.0,3476,3190,2581,2183,895,1007,1348,1457,859,251,489,1206,60,60,4250,4025,3600,3000,10925,8000,1
750,2,0,98.0,125.0,220.0,197.0,3403,3162,2396,2155,1007,1007,1765,1675,1148,368,617,1307,60,59,3400,3300,3850,2900,12625,9020,1
757,2,0,106.0,132.0,220.0,197.0,3308,3190,2189,2183,1119,1007,1566,1503,817,202,749,1301,58,59,3900,3625,4150,2800,12825,9170,1
764,2,0,114.0,127.0,220.0,197.0,3152,3179,2077,2239,1075,940,1335,1541,758,132,577,1409,58,59,3900,3375,4600,3000,12825,9420,1
771,2,0,114.0,132.0,220.0,197.0,3258,3095,2161,2155,1097,940,1181,1921,672,392,509,1529,60,59,4100,3625,4900,3000,12825,9420,1
779,2,0,116.0,128.0,220.0,197.0,3510,3067,2435,2127,1075,940,995,2266,358,617,637,1649,58,58,4550,4050,4900,3000,13325,9770,1
786,2,0,96.0,107.0,220.0,197.0,3359,3302,2262,2295,1097,1007,1090,1946,325,302,765,1644,58,58,2800,2975,4900,3000,15375,10995,1
793,2,0,90.0,114.0,220.0,197.0,3460,3196,2385,2211,1075,985,1492,1758,599,127,893,1631,62,58,2250,3450,4900,3000,15925,10995,1
800,2,0,102.0,115.0,220.0,197.0,3443,3162,2346,2155,1097,1007,934,2134,113,387,821,1747,62,58,2425,3500,5050,3000,15925,10995,1
807,2,0,102.0,119.0,220.0,197.0,3510,3448,2413,2463,1097,985,1340,2415,387,552,953,1863,62,58,2925,3700,5050,3000,15925,11095,1
814,2,0,108.0,120.0,220.0,197.0,3510,3599,2413,2659,1097,940,1176,2811,395,839,781,1972,62,58,2925,3750,5050,3000,15925,11095,1
821,2,0,108.0,127.0,220.0,197.0,3264,3515,2167,2575,1097,940,1050,1717,133,87,917,1630,62,58,2925,4225,5050,3000,15925,11095,1
829,2,0,108.0,130.0,220.0,197.0,3398,3364,2122,2379,1276,985,1267,1815,294,201,973,1614,62,58,2925,4700,5050,3000,15925,11095,1
836,2,0,114.0,130.0,220.0,197.0,3432,3302,2111,2295,1321,1007,1132,1974,153,343,979,1631,62,58,3450,4750,5050,3000,15925,11095,1
843,2,0,119.0,134.0,220.0,197.0,3438,3218,2139,2211,1299,1007,1141,1811,160,168,981,1643,62,58,4050,4950,5050,3000,15925,11095,1
850,2,0,119.0,137.0,228.0,197.0,3370,3246,2071,2239,1299,1007,1539,1902,402,143,1137,1759,62,58,4050,5225,5050,3000,15925,11095,1
857,2,0,125.0,144.0,228.0,197.0,3426,2972,2127,2099,1299,873,1290,1903,126,173,1164,1730,60,58,4450,5700,5050,3125,16125,11195,1
864,2,0,113.0,133.0,228.0,197.0,2888,2541,1657,1735,1231,806,1264,2207,56,373,1208,1834,58,58,3925,5200,5050,3275,17000,11962,1
871,2,0,106.0,129.0,228.0,205.0,2978,2283,1747,1455,1231,828,1494,2431,138,493,1356,1938,58,58,3550,5000,5050,3275,17725,12212,1
879,2,0,107.0,137.0,228.0,205.0,2933,2188,1702,1315,1231,873,1535,1970,35,53,1500,1917,60,58,3850,5150,5050,3275,17725,12212,1
886,2,0,110.0,139.0,228.0,205.0,2956,2166,1702,1315,1254,851,1579,1970,52,78,1527,1892,61,59,3850,5150,5050,3275,17725,12212,1
893,2,0,113.0,139.0,228.0,205.0,2776,2776,1545,1903,1231,873,1757,2216,86,228,1671,1988,63,59,4100,5425,5050,3275,17725,12212,1
900,2,0,116.0,141.0,243.0,220.0,2844,3291,1590,2463,1254,828,1802,2497,133,413,1669,2084,64,59,4100,5675,5050,3275,17725,12212,1
907,2,0,117.0,141.0,243.0,220.0,2950,3258,1696,2407,1254,851,1990,2857,173,673,1817,2184,66,59,3850,5675,5300,3475,17975,12212,1
914,2,0,117.0,141.0,243.0,220.0,3152,3179,1943,2239,1209,940,2370,3222,409,918,1961,2304,66,59,3850,6325,5300,3475,17975,12212,1
921,2,0,124.0,145.0,243.0,220.0,3386,2950,2155,1987,1231,963,2136,3077,123,878,2013,2199,69,59,3850,6325,5300,3575,17975,12212,1
929,2,0,124.0,148.0,243.0,220.0,3499,3022,2301,2015,1198,1007,2362,3147,215,953,2147,2194,69,59,3850,6325,5300,3575,17975,12212,1
936,2,0,130.0,157.0,243.0,220.0,3303,3454,2195,2491,1108,963,2237,2524,104,493,2133,2031,74,59,4400,6275,5300,3650,17975,12262,1
943,2,0,130.0,148.0,243.0,220.0,3225,3532,2150,2547,1075,985,2568,2895,315,748,2253,2147,73,59,4925,5725,5300,3650,18025,12852,1
950,2,0,136.0,149.0,251.0,220.0,3225,3006,2150,2099,1075,907,2296,1857,211,158,2085,1699,73,59,4925,6125,5300,3650,18025,12852,1
957,2,0,136.0,149.0,251.0,220.0,3426,2681,2217,1875,1209,806,2197,2168,168,373,2029,1795,74,59,4925,6450,5450,3750,18025,13152,1
964,2,0,136.0,156.0,251.0,220.0,3891,2630,2704,1903,1187,727,2689,2134,516,253,2173,1881,74,59,4925,6500,5450,3750,18025,13152,1
971,2,0,137.0,157.0,251.0,220.0,4025,2692,2816,2043,1209,649,2835,2404,660,443,2175,1961,74,59,4925,6825,5450,3750,18025,13152,1
979,2,0,137.0,165.0,251.0,220.0,4070,2714,2816,2043,1254,671,2499,2019,572,278,1927,1741,74,59,5525,7200,5450,3750,18025,13152,1
986,2,0,137.0,171.0,251.0,220.0,3975,2742,2844,2071,1131,671,2977,1916,928,228,2049,1688,75,59,5525,7325,5450,3750,18025,13152,1
993,2,0,137.0,172.0,251.0,220.0,3891,2770,2816,2099,1075,671,3436,2196,1259,428,2177,1768,75,59,5525,7475,5450,3750,18025,13152,1
1000,2,0,136.0,176.0,251.0,220.0,3919,2782,2867,2155,1052,627,3848,2328,1597,488,2251,1840,74,59,5525,7475,5450,3850,18575,13152,1
1007,2,0,127.0,165.0,251.0,220.0,3644,2698,2592,2071,1052,627,4275,2653,1892,733,2383,1920,73,59,4750,6875,5150,3850,20000,13902,1
1014,2,0,122.0,159.0,251.0,220.0,3896,2838,2844,2211,1052,627,4454,2233,2093,358,2361,1875,73,59,4350,6275,5150,3850,20300,14752,1
1021,2,0,138.0,163.0,251.0,220.0,3835,2798,2760,2127,1075,671,3496,2153,1407,398,2089,1755,73,59,4350,7150,5450,3850,20300,14752,1
1029,2,0,138.0,170.0,251.0,220.0,3913,2804,2816,2155,1097,649,3957,2114,1736,408,2221,1706,73,59,5750,7350,5450,3850,20300,14752,1
1036,2,0,150.0,174.0,251.0,220.0,3516,2742,2441,2071,1075,671,2656,2085,815,303,1841,1782,73,59,5750,7550,5450,3850,20300,14752,1
1043,2,0,150.0,174.0,251.0,220.0,3393,2742,2318,2071,1075,671,2903,1955,934,293,1969,1662,73,59,5750,7825,5800,3850,20300,14752,1
1050,2,0,150.0,179.0,251.0,220.0,3387,2670,2357,2043,1030,627,3333,2262,1240,528,2093,1734,73,59,5750,8425,5800,3850,20300,14752,1
1057,2,0,136.0,170.0,251.0,220.0,3208,2558,2133,1931,1075,627,3718,2567,1489,753,2229,1814,67,59,5050,7775,5800,3850,21300,15602,1
1064,2,0,139.0,178.0,251.0,220.0,2967,2608,1937,1959,1030,649,3469,2307,1416,538,2053,1769,64,59,5050,8150,5800,3850,21450,15652,1
1071,2,0,139.0,179.0,259.0,220.0,2860,2630,1763,1959,1097,671,3211,2567,1326,718,1885,1849,64,59,5050,8150,5800,3850,21450,15652,1
1079,2,0,125.0,179.0,259.0,220.0,2922,2658,1847,1987,1075,671,3560,2878,1551,953,2009,1925,64,59,3825,8600,5950,3850,22675,15652,1
1086,2,0,118.0,168.0,259.0,220.0,3062,2630,1987,1959,1075,671,3908,3179,1771,1178,2137,2001,64,59,4445,8100,5950,4100,23375,16202,1
1093,2,0,132.0,168.0,259.0,220.0,2955,2614,1903,1987,1052,627,2121,3501,456,1428,1665,2073,60,59,4675,8425,6250,4100,24075,16202,1
1100,2,0,133.0,175.0,259.0,220.0,2283,2642,1175,2015,1108,627,2160,2756,411,1003,1749,1753,59,59,6880,8075,6250,4100,24125,16552,1
1107,2,0,133.0,178.0,259.0,220.0,1964,2558,923,1931,1041,627,2385,2496,516,788,1869,1708,59,59,6880,7775,6250,4100,24125,16852,1
1114,2,0,123.0,176.0,251.0,220.0,2199,2658,1147,1987,1052,671,2628,2366,631,578,1997,1788,59,59,5960,7475,6550,4100,25175,17202,1
7,2,1,13.0,13.0,15.0,14.0,335,335,335,335,0,0,40,40,40,40,0,0,12,12,0,0,0,0,0,0,0
14,2,1,14.0,13.0,15.0,14.0,671,671,671,671,0,0,70,20,70,20,0,0,13,13,0,0,0,0,0,0,0
21,2,1,14.0,14.0,15.0,14.0,643,727,643,727,0,0,40,55,40,55,0,0,13,13,0,0,0,0,0,0,0
29,2,1,15.0,14.0,15.0,14.0,643,727,643,727,0,0,75,150,75,150,0,0,14,13,0,0,0,0,0,0,0
36,2,1,15.0,16.0,15.0,22.0,727,755,727,755,0,0,175,145,175,145,0,0,14,14,0,0,0,0,0,0,0
43,2,1,16.0,16.0,23.0,22.0,783,839,783,839,0,0,65,235,65,235,0,0,15,16,0,0,0,0,0,0,0
50,2,1,17.0,15.0,23.0,22.0,839,811,839,811,0,0,40,30,40,30,0,0,16,15,0,0,0,0,0,0,0
57,2,1,18.0,17.0,23.0,22.0,811,867,811,867,0,0,90,35,90,35,0,0,17,15,0,0,0,0,0,0,0
64,2,1,19.0,18.0,23.0,22.0,923,895,923,895,0,0,155,85,155,85,0,0,18,16,0,0,0,0,0,0,0
71,2,1,19.0,17.0,23.0,22.0,923,895,923,895,0,0,210,165,210,165,0,0,18,17,0,0,0,0,0,0,0
79,2,1,20.0,17.0,23.0,22.0,995,895,951,895,44,0,333,20,325,20,8,0,19,16,0,0,0,0,0,0,0
86,2,1,20.0,18.0,23.0,22.0,990,839,923,839,67,0,56,70,40,70,16,0,19,16,0,0,150,0,0,0,0
93,2,1,20.0,19.0,23.0,22.0,984,867,895,867,89,0,168,115,140,115,28,0,20,17,0,0,150,0,0,0,0
100,2,1,21.0,20.0,23.0,22.0,1006,962,895,895,111,67,90,192,50,180,40,12,20,19,0,0,150,0,0,0,0
107,2,1,21.0,20.0,23.0,22.0,1085,950,951,839,134,111,156,304,100,280,56,24,20,19,0,0,150,0,0,0,0
114,2,1,22.0,20.0,23.0,22.0,1062,1079,951,923,111,156,118,334,50,290,68,44,21,20,0,0,150,0,0,0,0
121,2,1,22.0,20.0,23.0,28.0,1102,1051,923,895,179,156,203,459,115,395,88,64,21,20,0,0,150,0,0,0,0
129,2,1,23.0,26.0,31.0,28.0,1107,1079,951,923,156,156,333,189,225,105,108,84,22,20,0,0,150,250,0,0,0
136,2,1,25.0,28.0,31.0,36.0,1113,1102,867,923,246,179,94,19,75,15,19,4,23,20,0,0,300,250,0,0,0
143,2,1,26.0,29.0,31.0,36.0,1236,1068,923,979,313,89,141,93,90,85,51,8,23,20,0,100,300,250,0,0,0
150,2,1,27.0,30.0,31.0,36.0,1236,1079,923,1035,313,44,136,171,95,155,41,16,24,22,0,100,300,250,0,0,0
157,2,1,31.0,30.0,46.0,36.0,1208,1158,895,1091,313,67,56,309,25,285,31,24,25,24,125,100,300,250,0,0,0
164,2,1,32.0,28.5,46.0,36.0,1320,1270,1007,1203,313,67,126,167,55,135,71,32,26,23,125,375,300,250,0,25,0
171,2,1,33.0,30.5,46.0,36.0,1370,1326,1035,1259,335,67,241,70,130,30,111,40,27,23,125,375,550,250,0,25,0
179,2,1,35.0,32.5,46.0,36.0,1482,1354,1147,1287,335,67,107,123,60,75,47,48,29,23,125,375,550,250,0,25,0
186,2,1,38.0,35.5,46.0,36.0,1516,1303,1203,1259,313,44,118,137,60,85,58,52,30,24,300,375,550,250,0,25,0
193,2,1,39.0,37.5,46.0,44.0,1622,1298,1287,1231,335,67,118,185,20,125,98,60,31,25,300,375,550,250,0,25,0
200,2,1,39.0,40.5,46.0,44.0,1684,1382,1371,1315,313,67,319,198,185,130,134,68,32,28,300,375,550,250,0,25,0
207,2,1,41.0,43.5,46.0,44.0,1740,1494,1427,1427,313,67,129,91,105,15,24,76,33,33,300,525,550,250,0,25,0
214,2,1,41.0,39.5,46.0,44.0,1824,1628,1511,1539,313,89,199,268,135,180,64,88,34,32,425,525,550,250,0,25,0
221,2,1,41.0,43.5,46.0,52.0,1869,1695,1511,1539,358,156,279,258,175,150,104,108,35,32,425,525,800,250,0,25,0
229,2,1,43.0,47.5,46.0,52.0,1897,1751,1539,1595,358,156,244,223,100,95,144,128,35,34,425,525,800,250,0,25,0
236,2,1,43.0,47.5,46.0,58.0,1908,1835,1595,1679,313,156,216,348,40,200,176,148,35,36,425,525,800,250,0,25,0
243,2,1,45.0,48.5,46.0,58.0,1902,1846,1567,1623,335,223,256,420,40,240,216,180,35,38,425,525,950,250,0,25,0
250,2,1,45.0,51.5,54.0,66.0,1936,1930,1623,1595,313,335,367,400,115,180,252,220,36,39,425,525,950,250,0,25,0
257,2,1,47.0,58.5,54.0,74.0,1942,2070,1651,1735,291,335,443,315,155,130,288,185,37,40,675,525,1100,450,0,25,0
264,2,1,48.0,61.5,54.0,74.0,2065,2126,1595,1791,470,335,702,291,350,70,352,221,39,39,675,775,1250,450,0,25,0
271,2,1,49.0,59.5,70.0,82.0,2149,2182,1455,1847,694,335,847,401,415,140,432,261,39,37,675,1075,1250,450,0,25,0
279,2,1,58.0,59.5,70.0,82.0,2182,2020,1511,1707,671,313,78,392,70,195,8,197,41,37,675,1325,1550,450,0,25,0
286,2,1,58.0,66.0,70.0,82.0,2166,2048,1539,1735,627,313,350,297,270,60,80,237,41,37,1675,1300,1550,575,0,50,0
293,2,1,59.0,66.0,70.0,82.0,2138,2014,1511,1679,627,335,350,482,290,205,60,277,42,37,1675,1250,1550,825,0,100,0
300,2,1,59.0,68.5,70.0,82.0,2216,2070,1567,1735,649,335,620,287,480,45,140,242,43,44,1675,975,1550,825,0,425,0
307,2,1,59.0,69.5,70.0,82.0,2306,2042,1679,1707,627,335,896,373,680,95,216,278,43,42,1675,975,1550,825,0,525,0
314,2,1,63.0,69.5,70.0,82.0,2350,1706,1679,1371,671,335,811,353,615,35,196,318,43,40,1675,1175,1550,825,0,775,0
321,2,1,59.0,69.5,70.0,82.0,2345,1572,1651,1259,694,313,281,559,5,205,276,354,43,40,1425,1425,1550,825,250,775,0
329,2,1,59.0,73.5,70.0,82.0,2250,2076,1623,1763,627,313,544,619,200,225,344,394,43,40,925,1425,1550,825,250,775,0
336,2,1,59.0,74.5,70.0,82.0,2166,2188,1539,1875,627,313,809,784,385,350,424,434,43,40,1375,1575,1550,1075,250,825,0
343,2,1,69.0,77.5,70.0,82.0,2272,2238,1623,1903,649,335,264,899,160,425,104,474,43,44,1750,1575,1550,1075,250,825,0
350,2,1,68.0,77.5,86.0,82.0,2244,2266,1595,1931,649,335,249,1074,65,610,184,464,42,46,2200,1575,1550,1075,300,825,0
357,2,1,70.0,77.5,86.0,82.0,2362,2322,1735,1987,627,335,375,905,215,505,160,400,42,47,2200,1675,1550,1075,300,825,0
364,2,1,72.0,81.5,86.0,82.0,2317,2462,1623,2127,694,335,545,500,305,110,240,390,42,47,1850,1675,1550,1075,300,825,0
371,2,1,76.0,81.5,102.0,82.0,2350,2496,1679,2183,671,313,326,671,260,245,66,426,42,49,2675,1775,2000,1075,300,825,0
379,2,1,77.0,87.5,110.0,90.0,2390,2664,1763,2351,627,313,408,696,345,305,63,391,44,50,3175,1725,2150,1075,300,875,0
386,2,1,83.0,90.0,110.0,114.0,2395,2692,1791,2379,604,313,189,621,50,290,139,331,44,50,2850,1450,2150,1075,625,1150,0
393,2,1,85.0,102.0,110.0,114.0,2440,2675,1791,2295,649,380,229,334,135,105,94,229,44,50,3200,1450,2150,1075,625,1150,0
400,2,1,85.0,107.0,118.0,114.0,2468,2793,1819,2323,649,470,524,255,350,220,174,35,44,50,3650,2000,2150,1075,625,1150,0
407,2,1,95.0,112.0,118.0,106.0,2434,2770,1763,2211,671,559,305,243,55,165,250,78,44,50,3650,2550,2150,1075,625,1400,0
414,2,1,95.0,108.0,118.0,106.0,2541,2726,1847,2099,694,627,605,570,275,420,330,150,44,50,4150,3000,2150,1075,625,1600,0
421,2,1,87.0,98.5,118.0,106.0,2468,2748,1819,2099,649,649,892,685,490,455,402,230,44,50,3750,2975,2150,1075,1025,2075,0
429,2,1,97.0,96.0,118.0,98.0,2474,2698,1847,2071,627,627,283,821,55,515,228,306,44,50,3650,2850,2150,1075,1125,2300,0
436,2,1,93.0,92.0,118.0,106.0,2496,2804,1847,2155,649,649,368,986,60,650,308,336,44,50,3400,2400,2150,1075,1775,2750,0
443,2,1,91.0,105.0,118.0,106.0,2384,2692,1735,2043,649,649,658,186,270,45,388,141,44,50,3950,1700,2150,1075,1875,3450,0
450,2,1,89.0,91.0,118.0,114.0,2446,2238,1819,1567,627,671,554,232,90,65,464,167,44,39,3400,1300,2150,1075,2425,4600,0
457,2,1,91.0,76.0,118.0,114.0,2457,1645,1763,1063,694,582,634,226,90,45,544,181,44,35,3700,1300,2150,1075,2525,5600,0
464,2,1,83.0,55.0,118.0,114.0,2457,1158,1763,755,694,403,729,250,105,50,624,200,44,21,2950,1200,2150,1075,3575,6800,0
7,2,0,13.0,13.0,15.0,15.0,293,293,293,293,0,0,35,35,35,35,0,0,12,12,0,0,0,0,0,0,1
14,2,0,14.0,14.0,15.0,15.0,671,671,671,671,0,0,70,70,70,70,0,0,13,13,0,0,0,0,0,0,1
21,2,0,14.0,14.0,15.0,15.0,699,699,699,699,0,0,50,0,50,0,0,0,13,13,0,0,0,0,0,0,1
29,2,0,15.0,15.0,15.0,15.0,671,643,671,643,0,0,80,80,80,80,0,0,14,14,0,0,0,0,0,0,1
36,2,0,15.0,15.0,15.0,15.0,783,755,783,755,0,0,190,135,190,135,0,0,14,14,0,0,0,0,0,0,1
43,2,0,16.0,16.0,23.0,23.0,755,727,755,727,0,0,25,65,25,65,0,0,15,15,0,0,0,0,0,0,1
50,2,0,17.0,16.0,23.0,23.0,839,783,839,783,0,0,50,35,50,35,0,0,16,15,0,0,0,0,0,0,1
57,2,0,18.0,17.0,23.0,23.0,839,671,839,671,0,0,100,20,100,20,0,0,17,16,0,0,0,0,0,0,1
64,2,0,19.0,18.0,23.0,23.0,951,811,951,811,0,0,170,115,170,115,0,0,18,17,0,0,0,0,0,0,1
71,2,0,19.0,18.0,23.0,23.0,979,805,979,783,0,22,275,204,275,200,0,4,18,17,0,0,0,0,0,0,1
79,2,0,20.0,19.0,23.0,23.0,995,866,951,755,44,111,343,180,335,160,8,20,19,18,0,0,0,0,0,0,1
86,2,0,20.0,19.0,23.0,23.0,1023,883,979,727,44,156,392,290,380,250,12,40,19,18,0,0,0,0,0,0,1
93,2,0,23.0,20.0,23.0,23.0,934,911,867,755,67,156,90,190,70,130,20,60,20,19,0,0,150,150,0,0,1
100,2,0,23.0,20.0,23.0,23.0,1034,967,923,811,111,156,221,305,185,225,36,80,20,19,0,0,150,150,0,0,1
107,2,0,23.0,20.0,23.0,23.0,1023,1074,867,895,156,179,216,420,160,320,56,100,21,19,100,50,150,150,0,0,1
114,2,0,24.0,20.0,31.0,23.0,1001,995,755,839,246,156,344,436,252,370,92,66,21,19,100,50,150,150,0,0,1
121,2,0,24.0,21.0,31.0,23.0,1012,1051,699,895,313,156,469,516,337,430,132,86,21,19,100,50,150,150,0,0,1
129,2,0,27.0,21.0,31.0,23.0,1062,1079,727,923,335,156,469,146,322,40,147,106,22,20,100,50,300,150,0,0,1
136,2,0,27.0,21.0,31.0,23.0,1040,1051,727,895,313,156,290,281,257,155,33,126,23,20,100,50,300,150,0,0,1
143,2,0,27.0,22.0,31.0,23.0,1146,1130,811,951,335,179,440,150,367,104,73,46,23,20,100,50,300,150,0,0,1
150,2,0,27.0,23.0,31.0,23.0,1124,1107,811,951,313,156,62,141,7,79,55,62,23,21,100,50,300,250,0,0,1
157,2,0,29.0,25.0,31.0,31.0,1191,1135,923,979,268,156,84,276,22,194,62,82,23,21,225,50,300,250,0,0,1
164,2,0,30.0,26.0,31.0,31.0,1141,1135,895,979,246,156,167,316,77,214,90,102,23,21,225,100,300,250,0,0,1
171,2,0,30.0,28.0,31.0,31.0,1247,1264,979,1063,268,201,269,419,147,289,122,130,23,22,225,150,300,250,0,0,1
179,2,0,31.0,28.0,31.0,31.0,1292,1404,979,1091,313,313,105,519,97,349,8,170,24,22,350,150,600,250,0,0,1
186,2,0,31.0,29.0,31.0,31.0,1292,1230,979,895,313,335,211,330,167,249,44,81,25,23,350,200,600,500,0,0,1
193,2,0,31.0,31.0,31.0,31.0,1264,1264,951,951,313,313,153,386,77,269,76,117,25,24,350,250,600,500,0,0,1
200,2,0,31.0,32.0,31.0,46.0,1208,1348,895,1035,313,313,288,356,172,199,116,157,25,24,350,250,600,500,0,0,1
207,2,0,35.0,37.0,39.0,46.0,1264,1376,951,1063,313,313,293,156,137,84,156,72,25,25,350,350,600,575,0,0,1
214,2,0,37.0,38.0,39.0,46.0,1225,1432,867,1119,358,313,263,191,117,79,146,112,25,25,350,350,600,575,0,0,1
221,2,0,38.0,38.0,62.0,46.0,1258,1572,923,1259,335,313,354,386,172,234,182,152,26,25,350,350,700,825,0,0,1
229,2,0,39.0,39.0,62.0,46.0,1264,1617,951,1259,313,358,405,466,187,274,218,192,26,26,350,400,700,825,0,50,1
236,2,0,40.0,40.0,62.0,54.0,1320,1594,1007,1259,313,335,525,442,267,314,258,128,27,25,650,675,700,825,0,100,1
243,2,0,40.0,44.0,62.0,54.0,1460,1488,1147,1175,313,313,611,203,317,164,294,39,29,25,725,775,700,825,100,100,1
250,2,0,41.0,47.0,62.0,54.0,1516,1348,1203,1035,313,313,431,163,197,84,234,79,30,25,725,775,700,825,100,100,1
257,2,0,43.0,48.0,62.0,54.0,1600,1370,1287,1035,313,335,386,238,112,119,274,119,32,26,725,775,700,825,100,100,1
264,2,0,45.0,48.0,62.0,54.0,1701,1488,1343,1175,358,313,536,209,222,129,314,80,34,26,725,975,700,825,100,200,1
271,2,0,45.0,48.0,62.0,54.0,1846,1505,1511,1259,335,246,482,222,182,114,300,108,35,22,725,1350,700,825,275,400,1
279,2,0,49.0,46.0,62.0,62.0,1880,1342,1567,1119,313,223,348,109,162,94,186,15,36,17,725,1350,700,825,275,650,1
286,2,0,49.0,45.0,62.0,62.0,1992,1404,1679,1091,313,313,388,184,162,129,226,55,36,16,725,1450,800,825,275,800,1
293,2,0,53.0,47.0,62.0,62.0,1986,1393,1651,1035,335,358,233,229,67,134,166,95,36,16,725,1450,1050,825,275,800,1
300,2,0,53.0,47.0,70.0,62.0,2048,1404,1735,1091,313,313,374,257,172,137,202,120,36,18,725,1675,1150,825,275,800,1
307,2,0,57.0,49.0,62.0,62.0,2020,1600,1707,1287,313,313,254,118,162,35,92,83,36,18,1075,1675,1300,825,318,800,1
314,2,0,61.0,51.0,70.0,62.0,2037,1460,1679,1147,358,313,289,270,157,151,132,119,36,18,1275,2050,1400,825,318,800,1
321,2,0,61.0,53.0,70.0,62.0,1986,1180,1651,867,335,313,515,298,347,140,168,158,36,18,1275,2050,1400,825,318,800,1
329,2,0,57.0,52.0,70.0,62.0,1908,1174,1595,839,313,335,751,363,547,165,204,198,36,20,925,1875,1250,925,818,1075,1
336,2,0,61.0,55.0,70.0,62.0,1908,1398,1595,1063,313,335,276,154,182,45,94,109,36,20,1300,2100,1250,925,818,1075,1
343,2,0,65.0,57.0,70.0,62.0,1908,1488,1595,1175,313,313,512,225,382,80,130,145,36,20,1850,2100,1150,925,918,1075,1
350,2,0,69.0,58.0,70.0,62.0,1936,1460,1623,1147,313,313,87,340,17,155,70,185,36,21,1850,2200,1150,925,918,1075,1
357,2,0,69.0,61.0,70.0,62.0,1992,1320,1679,1007,313,313,318,130,212,55,106,75,36,22,1850,2200,1150,925,918,1075,1
364,2,0,65.0,61.0,70.0,62.0,1919,1370,1651,1035,268,335,540,305,402,190,138,115,36,22,1500,2250,1000,1025,1418,1075,1
371,2,0,63.0,62.0,70.0,62.0,1914,1544,1623,1231,291,313,772,359,602,220,170,139,36,22,1675,2525,1150,1025,1593,1075,1
379,2,0,65.0,68.0,70.0,78.0,1891,1510,1623,1175,268,335,904,129,702,89,202,40,36,22,1775,2525,1150,1025,1593,1075,1
386,2,0,61.0,68.0,70.0,78.0,1891,1538,1623,1203,268,335,975,300,737,228,238,72,36,23,1425,2525,900,1025,2193,1075,1
393,2,0,61.0,67.0,62.0,78.0,1998,1432,1707,1119,291,313,1216,339,942,241,274,98,36,24,1800,2475,900,1025,2293,1075,1
400,2,0,42.0,64.0,62.0,78.0,1858,1538,1567,1203,291,335,1438,479,1132,355,306,124,35,24,675,2500,1200,1025,3468,1350,1
407,2,0,50.0,64.0,54.0,78.0,1947,1404,1679,1091,268,313,645,299,557,153,88,146,35,22,675,2500,1200,1025,3568,1450,1
414,2,0,47.0,61.0,54.0,78.0,1706,1292,1483,979,223,313,838,435,722,258,116,177,32,18,675,2825,1100,1025,3818,1700,1
421,2,0,47.0,60.0,54.0,78.0,1258,990,1035,699,223,291,637,243,597,161,40,82,28,16,1025,2825,1100,1025,4018,1900,1
429,2,0,47.0,57.0,54.0,78.0,1258,816,1035,615,223,201,785,316,717,222,68,94,28,16,1025,2675,1100,1025,4018,2050,1
436,2,0,47.0,59.0,54.0,78.0,1230,766,1007,587,223,179,633,297,537,188,96,109,28,16,1400,2775,1000,1025,4268,2050,1
443,2,0,49.0,61.0,54.0,78.0,1230,771,1007,615,223,156,581,288,457,170,124,118,28,16,1750,2775,1000,825,4268,1975,1
450,2,0,53.0,63.0,31.0,78.0,1180,715,979,559,201,156,530,368,382,230,148,138,28,18,2050,3150,700,825,5068,1975,1
457,2,0,53.0,63.0,63.0,78.0,1264,799,1063,643,201,156,584,263,412,105,172,158,28,18,2050,3150,850,825,5068,1975,1
464,2,0,59.0,63.0,63.0,86.0,1062,827,839,671,223,156,301,283,97,130,204,153,26,18,2050,3150,1000,825,5168,1975,1
471,2,0,30.0,51.0,63.0,86.0,273,833,139,587,134,246,313,375,97,190,216,185,5,18,1900,2250,1000,825,6768,3042,1
479,2,0,14.0,40.0,71.0,86.0,134,760,0,447,134,313,329,356,97,135,232,221,3,17,875,1275,1000,825,7893,4174,1
486,2,0,11.0,37.0,71.0,86.0,134,816,0,503,134,313,295,531,47,270,248,261,3,16,675,1175,1000,900,8093,4324,1
493,2,0,8.0,40.0,71.0,86.0,111,788,0,475,111,313,307,331,47,155,260,176,3,16,375,1175,1000,900,8393,4324,1
500,2,0,8.0,45.0,71.0,86.0,116,1146,27,811,89,335,324,86,52,70,272,16,4,16,375,1225,1000,900,8393,4374,1
507,2,0,7.0,43.0,71.0,86.0,49,1617,27,1259,22,358,174,261,2,205,172,56,1,18,375,1125,900,900,8643,4474,1
7,2,2,13.0,13.0,15.0,15.0,293,251,293,251,0,0,35,30,35,30,0,0,12,12,0,0,0,0,0,0,0
14,2,2,14.0,14.0,15.0,15.0,671,671,671,671,0,0,70,70,70,70,0,0,13,13,0,0,0,0,0,0,0
21,2,2,14.0,14.0,15.0,15.0,643,671,643,671,0,0,40,45,40,45,0,0,13,13,0,0,0,0,0,0,0
29,2,2,15.0,15.0,15.0,15.0,727,727,727,727,0,0,90,35,90,35,0,0,14,14,0,0,0,0,0,0,0
36,2,2,15.0,15.0,23.0,23.0,755,755,755,755,0,0,135,135,135,135,0,0,14,14,0,0,0,0,0,0,0
43,2,2,16.0,16.0,23.0,23.0,783,811,783,811,0,0,25,25,25,25,0,0,15,15,0,0,0,0,0,0,0
50,2,2,17.0,17.0,23.0,23.0,867,839,867,839,0,0,5,0,5,0,0,0,16,16,0,0,0,0,0,0,0
57,2,2,18.0,18.0,23.0,23.0,895,839,895,839,0,0,30,20,30,20,0,0,17,17,0,0,0,0,0,0,0
64,2,2,19.0,19.0,23.0,23.0,951,867,951,867,0,0,95,75,95,75,0,0,18,18,0,0,0,0,0,0,0
71,2,2,19.0,19.0,23.0,23.0,979,867,979,867,0,0,15,30,15,30,0,0,18,18,0,0,0,0,0,0,0
79,2,2,20.0,20.0,23.0,23.0,1018,945,951,923,67,22,77,44,65,40,12,4,19,19,0,0,0,0,0,0,0
86,2,2,21.0,21.0,23.0,23.0,1085,1034,951,923,134,111,58,175,30,155,28,20,20,20,0,0,150,150,0,0,0
93,2,2,22.0,22.0,23.0,23.0,1051,1006,895,895,156,111,128,92,80,60,48,32,21,21,0,0,150,150,0,0,0
100,2,2,22.0,22.0,23.0,23.0,1062,1068,839,867,223,201,155,79,75,15,80,64,21,21,0,0,150,150,0,0,0
107,2,2,23.0,23.0,23.0,23.0,1130,1163,839,895,291,268,237,221,125,125,112,96,22,22,0,0,150,150,0,0,0
114,2,2,23.0,24.0,31.0,31.0,1158,1135,867,867,291,268,328,318,180,190,148,128,22,23,0,0,150,150,0,0,0
121,2,2,24.0,24.0,31.0,31.0,1202,1152,867,839,335,313,478,458,290,290,188,168,23,23,0,0,300,300,0,0,0
129,2,2,28.0,29.0,31.0,31.0,1264,1202,951,867,313,335,350,98,180,40,170,58,24,24,0,0,450,450,0,0,0
136,2,2,28.0,29.0,31.0,31.0,1236,1124,923,811,313,313,220,139,110,45,110,94,24,24,0,0,450,450,0,0,0
143,2,2,29.0,29.0,31.0,31.0,1242,1180,951,867,291,313,321,284,175,150,146,134,24,25,0,0,450,450,0,0,0
150,2,2,29.0,29.0,39.0,31.0,1292,1230,979,895,313,335,481,429,295,255,186,174,25,25,0,0,450,450,0,0,0
157,2,2,31.0,33.0,39.0,39.0,1292,1264,979,951,313,313,481,230,355,120,126,110,25,25,175,350,450,450,0,0,0
164,2,2,33.0,33.0,39.0,39.0,1342,1236,1007,923,335,313,91,390,25,240,66,150,25,25,350,350,450,450,0,0,0
171,2,2,34.0,33.0,39.0,39.0,1264,1230,951,895,313,335,187,520,85,330,102,190,25,25,350,350,450,450,0,0,0
179,2,2,34.0,33.0,39.0,39.0,1286,1258,951,923,335,335,192,280,50,50,142,230,25,25,350,350,450,450,0,0,0
186,2,2,37.0,37.0,39.0,39.0,1342,1180,1007,867,335,313,147,126,65,60,82,66,26,25,500,700,450,450,0,0,0
193,2,2,38.0,38.0,47.0,39.0,1264,1258,951,923,313,335,198,221,80,115,118,106,27,25,650,700,450,450,0,0,0
200,2,2,38.0,39.0,47.0,39.0,1264,1208,951,895,313,313,98,217,40,75,58,142,27,26,650,700,450,450,0,0,0
207,2,2,39.0,39.0,47.0,39.0,1376,1258,1063,923,313,335,219,377,125,195,94,182,28,26,650,700,450,450,0,0,0
214,2,2,39.0,40.0,47.0,47.0,1320,1236,1007,923,313,313,175,218,45,100,130,118,28,27,800,1000,450,450,0,0,0
221,2,2,40.0,40.0,39.0,47.0,1298,1208,1007,895,291,313,226,219,60,65,166,154,29,27,800,1000,550,450,100,0,0
229,2,2,40.0,41.0,39.0,47.0,1292,1292,979,979,313,313,391,339,185,145,206,194,30,28,800,1000,550,450,100,0,0
236,2,2,44.0,44.0,54.0,47.0,1292,1398,979,1063,313,335,271,304,75,170,196,134,30,29,800,1150,800,450,100,0,0
243,2,2,44.0,45.0,62.0,47.0,1348,1320,1035,1007,313,313,301,260,65,90,236,170,30,30,975,1150,800,450,100,0,0
250,2,2,46.0,45.0,62.0,62.0,1600,1180,1287,867,313,313,56,100,30,40,26,60,32,30,975,1150,950,700,100,0,0
257,2,2,48.0,47.0,62.0,62.0,1813,1449,1455,1091,358,358,111,140,45,40,66,100,34,31,975,1150,950,800,100,0,0
264,2,2,49.0,49.0,62.0,62.0,1897,1617,1539,1259,358,358,231,275,125,135,106,140,35,33,975,1150,950,800,100,0,0
271,2,2,50.0,50.0,62.0,62.0,1908,1712,1595,1399,313,313,298,182,160,110,138,72,36,34,975,1150,950,950,100,0,0
279,2,2,52.0,52.0,62.0,62.0,1936,1740,1623,1427,313,313,488,387,310,275,178,112,38,36,975,1150,950,950,100,0,0
286,2,2,53.0,53.0,62.0,62.0,1880,1852,1567,1539,313,313,308,557,90,405,218,152,39,37,975,1150,950,950,100,0,0
293,2,2,54.0,54.0,62.0,62.0,2020,1880,1707,1567,313,313,318,352,60,160,258,192,40,39,975,1150,950,950,100,0,0
300,2,2,55.0,55.0,62.0,62.0,2093,2076,1735,1763,358,313,358,198,160,70,198,128,41,39,975,1150,950,950,100,0,0
307,2,2,56.0,58.0,62.0,62.0,2149,2126,1791,1791,358,335,258,168,20,50,238,118,42,40,975,1150,950,950,100,0,0
314,2,2,58.0,61.0,70.0,62.0,2110,2126,1819,1791,291,335,386,168,120,60,266,108,44,42,975,1325,950,950,100,0,0
321,2,2,61.0,63.0,70.0,70.0,2216,2098,1903,1763,313,335,426,219,170,75,256,144,45,43,1150,1500,950,950,100,0,0
329,2,2,64.0,64.0,70.0,70.0,2132,2132,1819,1819,313,313,411,275,165,95,246,180,46,44,1325,1500,950,950,100,0,0
336,2,2,65.0,67.0,70.0,70.0,2233,2160,1875,1847,358,313,525,365,235,195,290,170,47,45,1325,1675,950,950,100,0,0
343,2,2,66.0,70.0,70.0,70.0,2322,2250,1875,1847,447,403,446,366,100,190,346,176,48,46,1325,1850,950,1200,100,0,0
350,2,2,69.0,72.0,78.0,78.0,2339,2216,1847,1791,492,425,522,329,195,180,327,149,50,47,1325,1850,1200,1300,100,0,0
357,2,2,72.0,74.0,93.0,78.0,2446,2345,1931,1875,515,470,677,364,290,155,387,209,52,49,1325,1850,1500,1300,100,0,0
364,2,2,73.0,78.0,93.0,93.0,2597,2395,2127,1903,470,492,529,365,240,150,289,215,53,50,1325,2025,1500,1300,100,0,0
371,2,2,79.0,81.0,93.0,93.0,2653,2731,2183,2239,470,492,164,240,15,40,149,200,55,52,1425,2125,1500,1300,100,0,0
379,2,2,81.0,82.0,93.0,93.0,2899,2742,2407,2295,492,447,394,208,185,110,209,98,57,54,1425,2125,1500,1300,100,0,0
386,2,2,82.0,84.0,101.0,93.0,2955,2871,2463,2379,492,492,349,448,80,290,269,158,59,55,1425,2125,1500,1300,100,0,0
393,2,2,83.0,84.0,101.0,93.0,3067,2961,2575,2491,492,470,605,399,280,185,325,214,59,57,1425,2225,1800,1300,100,0,0
400,2,2,85.0,86.0,101.0,93.0,3028,2933,2491,2463,537,470,269,284,80,160,189,124,62,58,1425,2400,1800,1600,100,0,0
407,2,2,86.0,86.0,101.0,93.0,3123,3073,2519,2603,604,470,426,344,165,160,261,184,63,58,1425,2400,1800,1600,100,0,0
414,2,2,88.0,86.0,101.0,101.0,3146,3123,2519,2631,627,492,421,729,130,485,291,244,64,58,1825,2400,1800,1600,350,0,0
421,2,2,94.0,93.0,101.0,101.0,3252,3224,2603,2687,649,537,446,509,125,305,321,204,65,58,2200,2400,1800,1900,350,0,0
429,2,2,95.0,93.0,101.0,101.0,3381,3174,2687,2659,694,515,620,865,215,605,405,260,65,58,2200,2400,1800,1900,350,0,0
436,2,2,95.0,95.0,109.0,101.0,3498,3185,2715,2715,783,470,621,1057,120,745,501,312,68,61,2200,2400,2150,1900,350,0,0
443,2,2,103.0,100.0,109.0,101.0,3409,3045,2603,2575,806,470,432,702,135,530,297,172,68,61,2600,2400,2300,1900,350,0,0
450,2,2,109.0,100.0,117.0,109.0,3482,2748,2631,2211,851,537,238,830,145,590,93,240,68,64,2400,2975,2450,1900,350,0,0
457,2,2,115.0,102.0,117.0,109.0,3330,2966,2547,2295,783,671,152,850,75,530,77,320,68,64,2850,2975,2550,2200,350,0,0
464,2,2,115.0,115.0,133.0,132.0,3386,2910,2603,2239,783,671,563,486,390,90,173,396,70,64,3400,2875,2550,2200,350,100,0
471,2,2,119.0,115.0,148.0,148.0,3330,3274,2547,2603,783,671,508,787,235,315,273,472,70,64,3400,3575,2550,2200,350,100,0
479,2,2,130.0,115.0,148.0,156.0,3661,3090,2855,2463,806,627,203,654,130,110,73,544,71,64,3800,3575,2550,2550,350,100,0
486,2,2,131.0,121.0,148.0,156.0,3627,3308,2799,2659,828,649,483,454,310,280,173,174,74,64,3700,3775,2700,2550,350,100,0
493,2,2,133.0,127.0,148.0,164.0,3896,3498,3023,2827,873,671,839,464,570,360,269,104,75,64,4525,4025,2850,2550,350,100,0
500,2,2,141.0,127.0,148.0,164.0,4098,3476,3247,2827,851,649,290,680,125,500,165,180,77,64,4525,4925,3100,2550,350,100,0
507,2,2,141.0,131.0,156.0,164.0,4002,3448,3219,2799,783,649,743,776,490,520,253,256,78,64,4925,5125,3100,2650,350,100,0
514,2,2,143.0,137.0,156.0,180.0,4002,3498,3219,2827,783,671,743,471,390,335,353,136,78,64,4925,5325,3100,2650,350,100,0
521,2,2,147.0,141.0,156.0,188.0,4103,3398,3275,2771,828,627,591,528,280,320,311,208,78,64,4925,5425,3100,2950,350,100,0
529,2,2,151.0,141.0,164.0,196.0,4131,3370,3191,2743,940,627,582,384,305,350,277,34,80,64,5025,5425,3250,2950,450,100,0
536,2,2,161.0,144.0,180.0,196.0,4232,3454,3247,2827,985,627,383,484,290,370,93,114,80,68,5725,5425,3250,2950,450,100,0
543,2,2,161.0,153.0,188.0,196.0,4170,3314,3163,2687,1007,627,765,286,560,100,205,186,80,70,5675,5425,3250,2950,550,100,0
550,2,2,167.0,156.0,196.0,196.0,4154,3398,3191,2659,963,739,548,482,535,200,13,282,80,71,6475,5825,3250,2950,550,100,0
557,2,2,169.0,156.0,196.0,196.0,4165,3734,3135,2771,1030,963,351,568,210,170,141,398,80,74,6675,5825,3350,2950,650,100,0
564,2,2,169.0,160.0,204.0,196.0,4238,3745,3163,2827,1075,918,853,626,580,420,273,206,80,75,6675,5825,3350,3100,650,100,0
571,2,2,181.0,170.0,204.0,196.0,4260,3862,3163,2967,1097,895,449,498,340,180,109,318,80,75,7125,6325,3350,3550,650,100,0
579,2,2,185.0,176.0,212.0,196.0,4210,4103,3135,3163,1075,940,741,295,500,165,241,130,80,75,7725,6775,3350,3800,650,100,0
586,2,2,192.0,175.0,220.0,196.0,4383,4070,3219,3107,1164,963,718,762,645,520,73,242,80,75,8175,6675,3350,3900,650,200,0
593,2,2,196.0,177.0,228.0,204.0,4148,4109,3051,3191,1097,918,268,976,75,680,193,296,80,75,8175,6675,3350,4150,650,200,0
600,2,2,196.0,189.0,228.0,204.0,4131,3935,3079,2995,1052,940,791,678,470,270,321,408,81,75,8925,7750,3350,4150,650,200,0
607,2,2,196.0,199.0,228.0,204.0,4126,4142,3051,3135,1075,1007,492,381,285,145,207,236,81,75,8925,8050,3350,4250,650,300,0
614,2,2,180.0,187.0,236.0,204.0,4182,4036,3107,2939,1075,1097,1009,869,670,505,339,364,81,75,8125,7650,3350,4250,1450,900,0
621,2,2,178.0,171.0,236.0,196.0,4210,4254,3135,3135,1075,1119,521,565,400,215,121,350,81,75,8325,6850,3350,4250,1950,2300,0
629,2,2,179.0,173.0,244.0,196.0,4277,4142,3135,3023,1142,1119,227,734,70,260,157,474,81,75,8375,6650,3350,4400,2550,2500,0
636,2,2,181.0,176.0,244.0,196.0,4159,4092,2995,2995,1164,1097,365,636,80,180,285,456,81,75,8475,6950,3500,4400,2550,2500,0
643,2,2,179.0,182.0,259.0,196.0,4204,3930,3107,2855,1097,1075,950,539,545,180,405,359,82,78,8475,7550,4100,4400,2550,2500,0
650,2,2,190.0,186.0,259.0,196.0,3958,4086,2883,2967,1075,1119,507,739,220,240,287,499,82,78,9350,7550,4100,4400,2550,2675,0
657,2,2,178.0,166.0,259.0,196.0,4103,4142,3051,3023,1052,1119,1009,1244,590,605,419,639,83,78,8500,6950,4650,4400,3400,3675,0
664,2,2,168.0,174.0,259.0,196.0,4131,4299,3079,3135,1052,1164,1506,1140,955,365,551,775,83,78,7500,6750,4650,4550,4400,3875,0
671,2,2,189.0,166.0,259.0,196.0,4350,4092,3275,2883,1075,1209,233,1625,50,710,183,915,83,78,8725,6950,4900,4550,4400,4275,0
679,2,2,180.0,159.0,259.0,196.0,4534,4215,3415,3051,1119,1164,505,1163,340,420,165,743,83,78,7825,6550,4900,4550,5300,4975,0
686,2,2,171.0,153.0,259.0,196.0,4523,4064,3359,2855,1164,1209,737,1661,590,770,147,891,86,78,6900,6250,4900,4550,6225,5275,0
693,2,2,186.0,165.0,259.0,196.0,4518,4210,3443,2911,1075,1299,432,1102,165,355,267,747,86,79,7000,7300,4900,4550,6225,5275,0
700,2,2,186.0,167.0,259.0,196.0,4562,4159,3443,2883,1119,1276,666,1063,405,310,261,753,86,79,7600,7600,4900,4550,6225,5275,0
707,2,2,190.0,167.0,259.0,196.0,4417,4154,3163,2855,1254,1299,877,1554,460,645,417,909,87,79,7900,7700,4900,4550,6225,5275,0
714,2,2,190.0,165.0,259.0,196.0,4305,4344,3051,3023,1254,1321,1380,2105,815,1023,565,1082,88,79,7900,7825,4900,4850,6225,5450,0
721,2,2,191.0,180.0,251.0,196.0,4350,4282,3051,2939,1299,1343,1595,1607,1020,373,575,1234,88,79,7950,7425,4900,5000,6575,5850,0
729,2,2,189.0,186.0,259.0,196.0,4641,4310,3163,2967,1478,1343,1622,1523,1025,433,597,1090,87,79,7750,8425,4900,5300,7025,5850,0
736,2,2,195.0,181.0,259.0,196.0,4714,4131,3303,2855,1411,1276,1382,2006,775,768,607,1238,87,79,7975,8025,4900,5300,7450,6250,0
743,2,2,196.0,187.0,259.0,196.0,4781,4243,3415,2967,1366,1276,1455,1732,680,338,775,1394,87,79,8175,8325,4900,5300,7550,6250,0
750,2,2,196.0,186.0,259.0,196.0,4585,4187,3219,2911,1366,1276,982,1932,210,528,772,1404,87,78,8075,8325,5200,5300,7650,6300,0
757,2,2,193.0,186.0,259.0,196.0,4523,4014,3135,2715,1388,1299,1548,2003,600,593,948,1410,89,78,8075,8325,5200,5300,7950,6300,0
764,2,2,171.0,172.0,259.0,204.0,4646,4086,3191,2743,1455,1343,2100,2178,980,758,1120,1420,89,78,6375,7500,5200,5300,9650,7725,0
771,2,2,189.0,183.0,267.0,204.0,4646,3924,3191,2603,1455,1321,469,896,85,203,384,693,89,78,7250,7450,5200,5300,9650,8025,0
779,2,2,188.0,183.0,267.0,204.0,4674,3790,3219,2491,1455,1299,616,1153,210,458,406,695,89,78,8450,8950,5500,5300,9750,8025,0
786,2,2,193.0,192.0,267.0,212.0,4658,3902,3247,2603,1411,1299,876,1094,310,243,566,851,89,77,8450,8950,5800,5300,9750,8075,0
793,2,2,190.0,188.0,267.0,212.0,4501,3627,3135,2351,1366,1276,1114,1085,380,78,734,1007,90,77,8450,9250,5800,5300,10050,8275,0
800,2,2,199.0,190.0,275.0,212.0,4439,3717,3051,2463,1388,1254,925,1536,390,373,535,1163,93,77,9300,9850,5800,5300,10100,8275,0
807,2,2,190.0,198.0,275.0,212.0,4697,3840,3219,2519,1478,1321,891,1286,480,163,411,1123,93,77,8300,10550,5800,5300,11150,8275,0
814,2,2,188.0,189.0,275.0,204.0,4680,3739,3247,2463,1433,1276,1459,1715,880,448,579,1267,93,76,8050,9850,5800,5150,11400,9162,0
821,2,2,198.0,197.0,290.0,219.0,4870,3762,3415,2463,1455,1299,983,1461,365,238,618,1223,93,76,8250,10750,5800,5150,12250,9162,0
829,2,2,196.0,189.0,290.0,219.0,4882,3689,3471,2435,1411,1254,1872,1895,940,528,932,1367,93,76,8375,10275,5800,5300,12425,9637,0
836,2,2,200.0,186.0,290.0,219.0,4921,3633,3555,2379,1366,1254,1966,1928,1095,513,871,1415,93,76,8675,9575,5800,5450,12425,10337,0
843,2,2,200.0,196.0,290.0,219.0,4887,3829,3499,2575,1388,1254,2242,1529,1195,208,1047,1321,93,76,8675,10625,6100,5600,12425,10337,0
850,2,2,198.0,196.0,290.0,219.0,5106,3991,3695,2715,1411,1276,2468,2026,1245,553,1223,1473,94,77,8500,10800,6100,5600,12600,10337,0
857,2,2,195.0,191.0,290.0,219.0,5094,3980,3639,2659,1455,1321,2560,2306,1415,773,1145,1533,94,77,8225,10500,6100,5600,12875,10637,0
864,2,2,199.0,197.0,290.0,219.0,5173,3974,3695,2631,1478,1343,2643,1373,1480,88,1163,1285,94,77,8350,9850,6100,5600,13050,11287,0
871,2,2,195.0,194.0,290.0,219.0,5178,3986,3723,2687,1455,1299,3247,1846,1920,413,1327,1433,94,77,8525,10950,6400,5600,13400,11587,0
879,2,2,187.0,191.0,290.0,219.0,5106,4047,3695,2771,1411,1276,3846,2342,2355,753,1491,1589,94,76,8050,10775,6550,5450,13875,11962,0
886,2,2,178.0,198.0,290.0,219.0,5055,3963,3667,2687,1388,1276,4129,2003,2470,533,1659,1470,94,76,7550,10600,6800,5450,14375,12137,0
893,2,2,168.0,185.0,290.0,219.0,4865,4019,3499,2743,1366,1276,4731,2498,2900,868,1831,1630,95,76,6575,10425,6800,5450,15000,13012,0
900,2,2,151.0,185.0,290.0,219.0,4943,3874,3555,2575,1388,1299,4187,2754,2680,968,1507,1786,95,76,4825,9925,7100,5450,16575,13512,0
907,2,2,171.0,200.0,298.0,219.0,4932,3862,3499,2519,1433,1343,3015,1145,1840,103,1175,1042,95,74,6575,10225,7100,5450,16575,13612,0
914,2,2,179.0,196.0,298.0,219.0,4848,3750,3415,2407,1433,1343,2719,1331,1805,133,914,1198,96,69,6825,11925,7100,5450,16575,13912,0
921,2,2,178.0,197.0,298.0,219.0,4669,3504,3247,2239,1422,1265,1530,1428,1075,88,455,1340,96,67,6275,11925,7250,5450,17125,14012,0
929,2,2,178.0,190.0,298.0,219.0,4221,3185,3023,2155,1198,1030,2004,1797,1415,343,589,1454,97,70,7025,11025,7250,5450,17125,15012,0
936,2,2,156.0,169.0,298.0,219.0,4002,3095,2939,2211,1063,884,2477,2176,1760,618,717,1558,97,73,4850,8425,7250,5450,19300,17612,0
943,2,2,157.0,177.0,298.0,219.0,4260,3190,3163,2295,1097,895,1862,1964,1405,298,457,1666,97,73,3925,8825,7750,5450,20225,17612,0
950,2,2,171.0,179.0,298.0,219.0,4389,3297,3247,2379,1142,918,1363,2166,995,538,368,1628,97,73,5825,8825,7600,5750,20550,17612,0
957,2,2,172.0,186.0,298.0,219.0,4568,3420,3359,2435,1209,985,1668,2182,1160,438,508,1744,97,72,5825,8825,8500,5750,20550,17662,0
964,2,2,178.0,186.0,298.0,219.0,4568,3420,3359,2435,1209,985,1019,2344,875,638,144,1706,98,71,5225,9225,8500,5750,21150,17712,0
971,2,2,181.0,188.0,306.0,219.0,4529,3302,3387,2295,1142,1007,1556,2318,1280,488,276,1830,98,72,5325,9425,8500,5750,21150,17712,0
979,2,2,175.0,183.0,306.0,219.0,4590,3230,3471,2043,1119,1187,2101,2710,1685,728,416,1982,98,72,4875,8950,8500,5750,21600,18187,0
986,2,2,185.0,183.0,306.0,219.0,4534,3426,3415,2127,1119,1299,1512,3025,1385,883,127,2142,98,72,5175,8950,8600,5750,21600,18187,0
993,2,2,199.0,187.0,306.0,219.0,4613,3448,3471,2127,1142,1321,1351,1526,1080,128,271,1398,98,72,6075,9150,8600,5750,21600,18187,0
1000,2,2,197.0,187.0,306.0,219.0,4607,3448,3443,2127,1164,1321,1891,1942,1480,388,411,1554,98,72,5900,9650,8600,5750,21775,18187,0
1007,2,2,197.0,193.0,306.0,227.0,4579,3588,3415,2267,1164,1321,2438,1879,1895,173,543,1706,98,68,6200,10050,8600,5550,21775,18587,0
1014,2,2,185.0,189.0,306.0,227.0,4742,3375,3443,2211,1299,1164,3003,2243,2300,413,703,1830,98,67,5525,9800,8600,5550,22450,18987,0
1021,2,2,195.0,193.0,306.0,227.0,4943,3235,3555,2183,1388,1052,1498,1877,1385,298,113,1579,98,67,5810,9700,8600,5550,22825,19087,0
1029,2,2,180.0,188.0,306.0,227.0,4893,3213,3527,2183,1366,1030,2052,2262,1775,563,277,1699,98,67,5785,10150,8600,5550,24400,19387,0
1036,2,2,182.0,176.0,306.0,227.0,4982,3241,3639,2211,1343,1030,1912,2650,1675,823,237,1827,98,67,5365,9550,8600,6350,24850,19987,0
1043,2,2,187.0,178.0,306.0,227.0,4943,3213,3555,2183,1388,1030,1360,1794,1255,193,105,1601,98,67,5570,9875,8600,6650,25775,20887,0
1050,2,2,185.0,170.0,298.0,227.0,4966,3386,3667,2379,1299,1007,1736,2199,1475,478,261,1721,98,67,5820,9250,8500,6650,26500,21512,0
1057,2,2,167.0,165.0,290.0,242.0,4865,3403,3611,2351,1254,1052,1321,2302,1170,603,151,1699,92,67,4875,8625,7500,6650,29375,22137,0
1064,2,2,169.0,175.0,267.0,242.0,4294,3347,3219,2295,1075,1052,715,2072,590,278,125,1794,77,65,5430,9125,7350,6650,30850,22237,0
1071,2,2,169.0,179.0,267.0,242.0,3762,3498,2799,2491,963,1007,1116,2082,875,168,241,1914,77,63,6705,9125,7350,6650,30925,22337,0
1079,2,2,169.0,182.0,267.0,242.0,3622,3588,2659,2603,963,985,1111,1952,900,93,211,1859,77,63,7445,9025,7350,6650,31475,22337,0
1086,2,2,190.0,188.0,267.0,242.0,3672,3398,2687,2435,985,963,256,2288,125,313,131,1975,77,69,7560,9025,7350,6650,31475,22337,0
1093,2,2,190.0,198.0,267.0,242.0,3638,3426,2631,2463,1007,963,651,2198,400,103,251,2095,77,69,8565,9025,7350,6650,31475,22337,0
1100,2,2,187.0,197.0,267.0,242.0,3515,3588,2463,2603,1052,985,361,2639,140,428,221,2211,77,75,8280,9425,7350,6650,31775,22437,0
1107,2,2,182.0,189.0,267.0,242.0,3526,3974,2519,2967,1007,1007,698,3115,365,788,333,2327,77,75,8510,9225,7350,6650,32235,23062,0
1114,2,2,191.0,200.0,267.0,242.0,3476,3812,2491,2827,985,985,329,2621,155,353,174,2268,77,71,9055,9625,7350,6650,32250,23262,0
1121,2,2,190.0,200.0,267.0,242.0,3538,3706,2575,2743,963,963,344,3063,275,683,69,2380,77,71,9185,10050,7350,6650,32450,23262,0
1129,2,2,190.0,200.0,267.0,242.0,3588,3622,2603,2659,985,963,759,3498,570,998,189,2500,77,73,9480,10050,7350,6650,32850,23262,0
1136,2,2,180.0,198.0,267.0,242.0,3330,3678,2323,2715,1007,963,1144,2359,835,268,309,2091,77,73,8845,9075,7350,6650,33500,24237,0
1143,2,2,190.0,181.0,267.0,242.0,3190,3532,2183,2547,1007,985,139,2079,110,68,29,2011,77,73,8320,8250,7350,6650,33850,26287,0
1150,2,2,191.0,178.0,267.0,242.0,3414,3308,2407,2323,1007,985,440,2470,370,343,70,2127,77,70,10120,9375,7350,6650,34050,26437,0
1157,2,2,193.0,187.0,267.0,219.0,3358,3162,2351,2155,1007,1007,171,1981,110,88,61,1893,77,69,10120,9375,7350,6650,34050,26987,0
1164,2,2,193.0,187.0,267.0,219.0,3218,3112,2267,2127,951,985,550,2357,375,348,175,2009,77,69,10370,9375,7350,6650,34050,26987,0
1171,2,2,200.0,187.0,267.0,219.0,3274,3090,2435,2127,839,963,495,2714,345,593,150,2121,77,69,10470,9375,7350,6650,34050,26987,0
1179,2,2,200.0,190.0,267.0,211.0,3230,2905,2379,2043,851,862,854,2207,600,338,254,1869,77,67,10920,9375,7350,6650,34050,27187,0
1186,2,2,197.0,181.0,267.0,211.0,3146,2826,2295,2043,851,783,1130,2557,855,588,275,1969,77,64,10870,8850,6900,6550,34850,27962,0
1193,2,2,179.0,183.0,259.0,203.0,3381,2765,2575,1959,806,806,1528,1487,1165,468,363,1019,61,47,10870,11100,6600,6300,36150,29237,0
1200,2,2,175.0,191.0,228.0,195.0,2238,2412,1679,1539,559,873,1153,727,1030,233,123,494,54,44,10870,9900,6600,6150,37175,29637,0
1207,2,2,177.0,185.0,228.0,172.0,1533,2182,1063,1399,470,783,1226,1656,1130,803,96,853,53,42,10970,11050,6350,4950,37550,31324,0
1214,2,2,189.0,174.0,220.0,164.0,1723,2014,1343,1343,380,671,245,2447,105,1093,140,1354,41,42,10970,11950,6350,3950,38250,32499,0
1221,2,2,186.0,173.0,205.0,156.0,1062,1964,839,1315,223,649,295,2682,135,1248,160,1434,37,42,12170,11850,6250,3650,38950,32999,0
1229,2,2,181.0,163.0,220.0,125.0,654,1970,475,1343,179,627,424,2928,215,1418,209,1510,37,42,11970,11000,6000,3500,39400,34599,0
1236,2,2,180.0,163.0,197.0,125.0,1046,1992,867,1343,179,649,569,3563,340,1973,229,1590,38,42,12170,11000,6000,3500,40000,34599,0
1243,2,2,180.0,163.0,197.0,125.0,878,2042,699,1371,179,671,653,3813,400,2143,253,1670,38,42,12420,11000,5800,3200,40200,34899,0
1250,2,2,163.0,163.0,181.0,125.0,1062,2014,951,1343,111,671,261,4039,150,2293,111,1746,28,42,11345,11000,5650,3200,42225,34899,0
1257,2,2,157.0,163.0,150.0,125.0,1029,1970,1007,1343,22,627,371,3621,260,1803,111,1818,23,42,11420,11000,5650,2900,43325,35199,0
1264,2,2,157.0,163.0,150.0,125.0,923,1919,923,1315,0,604,376,3853,265,1963,111,1890,23,42,11770,11000,5650,2400,43325,35774,0
1271,2,2,147.0,163.0,150.0,125.0,867,1981,867,1399,0,582,476,4090,365,2128,111,1962,17,42,11420,11000,5650,2400,43975,35774,0
1279,2,2,143.0,160.0,150.0,125.0,475,1891,475,1287,0,604,511,4326,400,2288,111,2038,13,42,11420,10700,5650,2050,44175,36424,0
1286,2,2,137.0,121.0,158.0,141.0,83,2054,83,1427,0,627,526,4577,415,2463,111,2114,13,41,10700,7525,5650,2050,44895,39649,0
1293,2,2,141.0,119.0,158.0,141.0,139,1942,139,1315,0,627,31,4349,20,2163,11,2186,13,41,10585,7350,5650,2050,45010,39824,0
1300,2,2,141.0,119.0,158.0,141.0,475,2054,475,1427,0,627,101,4396,90,2138,11,2258,13,41,10950,7350,5650,2050,45010,39824,0
1307,2,2,137.0,127.0,158.0,141.0,699,1925,699,1343,0,582,176,4220,165,1898,11,2322,13,41,10600,7350,5650,2350,45185,39974,0
1314,2,2,137.0,121.0,158.0,133.0,671,1953,671,1371,0,582,256,4456,245,2058,11,2398,13,40,10600,7325,5650,2350,45185,40549,0
1321,2,2,135.0,107.0,158.0,125.0,783,1975,783,1371,0,604,336,4697,325,2223,11,2474,13,40,10470,6050,5800,2200,45315,42174,0
1329,2,2,127.0,93.0,158.0,109.0,699,1914,699,1287,0,627,361,4923,350,2373,11,2550,13,38,9755,5125,5800,2100,46045,43549,0
1336,2,2,123.0,76.0,158.0,94.0,755,1718,755,1091,0,627,411,4415,400,1993,11,2422,13,32,9255,3675,5800,1950,46575,46024,0
1343,2,2,119.0,61.0,158.0,86.0,755,1600,755,951,0,649,451,4592,440,2098,11,2494,13,31,9100,2775,5800,1950,46790,47749,0
1350,2,2,119.0,64.0,158.0,63.0,783,1348,783,923,0,425,486,4038,475,1708,11,2330,13,26,9160,2775,5800,1950,46790,48649,0
7,1,1,13.0,12.0,14.0,14.0,335,251,335,251,0,0,40,80,40,80,0,0,12,12,0,0,0,0,0,0,0
14,1,1,13.0,12.0,14.0,14.0,671,671,671,671,0,0,20,170,20,170,0,0,13,12,0,0,0,0,0,0,0
21,1,1,14.0,11.0,14.0,14.0,727,671,727,671,0,0,55,45,55,45,0,0,13,11,0,0,0,0,0,0,0
29,1,1,14.0,13.0,14.0,14.0,783,671,783,671,0,0,150,25,150,25,0,0,13,11,0,0,0,0,0,0,0
36,1,1,16.0,14.0,22.0,14.0,783,615,783,615,0,0,150,55,150,55,0,0,14,12,0,0,0,0,0,0,0
43,1,1,16.0,14.0,22.0,14.0,811,727,811,727,0,0,235,40,235,40,0,0,14,13,0,0,0,0,0,0,0
50,1,1,15.0,14.0,22.0,14.0,783,783,783,783,0,0,30,130,30,130,0,0,15,14,0,0,0,0,0,0,0
57,1,1,17.0,14.0,22.0,14.0,839,811,839,811,0,0,35,225,35,225,0,0,15,14,0,0,0,0,0,0,0
64,1,1,18.0,14.0,22.0,22.0,895,839,895,839,0,0,95,330,95,330,0,0,16,14,0,0,0,0,0,0,0
71,1,1,17.0,17.0,22.0,22.0,895,839,895,839,0,0,175,275,175,275,0,0,17,14,0,0,0,250,0,0,0
79,1,1,17.0,18.0,22.0,22.0,951,867,951,867,0,0,40,320,40,320,0,0,16,14,0,0,0,250,0,0,0
86,1,1,18.0,18.0,22.0,22.0,951,671,951,671,0,0,100,400,100,400,0,0,16,14,0,150,0,250,0,0,0
93,1,1,19.0,19.0,22.0,22.0,923,251,923,251,0,0,160,365,160,365,0,0,18,14,0,150,0,250,0,0,0
100,1,1,19.0,20.0,22.0,22.0,1006,139,895,139,111,0,285,330,265,330,20,0,18,14,0,200,0,250,0,0,0
107,1,1,19.0,20.0,22.0,22.0,973,139,839,139,134,0,391,345,355,345,36,0,19,14,0,250,0,250,0,0,0
114,1,1,19.0,21.0,22.0,22.0,1040,139,951,139,89,0,528,310,480,310,48,0,19,14,0,300,0,250,0,0,0
121,1,1,22.0,18.0,28.0,22.0,973,139,951,139,22,0,478,25,430,25,48,0,19,11,0,300,250,250,0,0,0
129,1,1,24.0,18.0,28.0,22.0,363,139,363,139,0,0,188,40,140,40,48,0,18,11,0,350,250,250,0,0,0
136,1,1,27.0,18.0,28.0,22.0,27,139,27,139,0,0,168,55,120,55,48,0,19,11,0,350,250,250,0,0,0
143,1,1,26.0,18.0,28.0,22.0,0,139,0,139,0,0,168,70,120,70,48,0,18,11,150,350,250,250,50,0,0
150,1,1,26.5,18.0,28.0,22.0,0,139,0,139,0,0,68,110,20,110,48,0,17,11,175,300,250,250,125,100,0
157,1,1,22.0,18.5,28.0,22.0,0,139,0,139,0,0,68,25,20,25,48,0,16,10,100,275,250,550,350,175,0
164,1,1,19.0,18.5,28.0,22.0,55,111,55,111,0,0,78,35,30,35,48,0,14,10,200,325,250,550,500,175,0
171,1,1,20.0,18.5,28.0,22.0,279,139,279,139,0,0,68,55,20,55,48,0,14,10,250,425,250,550,500,175,0
179,1,1,20.0,19.5,28.0,22.0,671,111,671,111,0,0,113,15,65,15,48,0,13,10,250,425,250,550,550,175,0
186,1,1,20.0,19.0,28.0,22.0,755,111,755,111,0,0,198,30,150,30,48,0,13,10,300,400,0,550,675,200,0
193,1,1,19.5,18.0,28.0,22.0,279,111,279,111,0,0,203,45,155,45,48,0,13,10,375,400,0,550,700,250,0
200,1,1,17.0,17.5,28.0,22.0,0,111,0,111,0,0,203,60,155,60,48,0,11,10,350,375,0,550,825,275,0
207,1,1,9.5,9.0,28.0,22.0,0,111,0,111,0,0,53,25,5,25,48,0,2,5,275,150,0,550,1350,750,0
214,1,1,9.0,4.0,28.0,22.0,0,111,0,111,0,0,53,40,5,40,48,0,2,2,250,50,0,550,1375,1000,0
221,1,1,9.0,5.0,28.0,22.0,0,111,0,111,0,0,53,5,5,5,48,0,5,2,250,100,0,400,1375,1025,0
229,1,1,9.0,5.0,28.0,22.0,0,111,0,111,0,0,53,20,5,20,48,0,5,2,250,100,0,250,1375,1175,0
236,1,1,9.0,5.0,28.0,22.0,223,111,223,111,0,0,93,35,45,35,48,0,5,2,250,100,0,250,1375,1175,0
242,1,1,9.0,5.0,28.0,22.0,223,139,223,139,0,0,93,50,45,50,48,0,5,2,250,150,0,250,1375,1175,0
7,2,2,13.0,13.0,15.0,15.0,293,335,293,335,0,0,35,40,35,40,0,0,12,12,0,0,0,0,0,0,1
14,2,2,14.0,14.0,15.0,15.0,671,671,671,671,0,0,70,70,70,70,0,0,13,13,0,0,0,0,0,0,1
21,2,2,14.0,14.0,15.0,15.0,755,699,755,699,0,0,55,50,55,50,0,0,13,13,0,0,0,0,0,0,1
29,2,2,15.0,15.0,15.0,15.0,755,755,755,755,0,0,90,40,90,40,0,0,14,14,0,0,0,0,0,0,1
36,2,2,16.0,16.0,23.0,23.0,811,811,811,811,0,0,140,145,140,145,0,0,15,15,0,0,0,0,0,0,1
43,2,2,16.0,16.0,23.0,23.0,867,839,867,839,0,0,40,40,40,40,0,0,15,15,0,0,0,0,0,0,1
50,2,2,17.0,17.0,23.0,23.0,839,895,839,895,0,0,5,20,5,20,0,0,16,16,0,0,0,0,0,0,1
57,2,2,18.0,18.0,23.0,23.0,811,923,811,923,0,0,60,10,60,10,0,0,17,17,0,0,0,0,0,0,1
64,2,2,18.0,19.0,23.0,23.0,895,951,895,951,0,0,120,115,120,115,0,0,17,18,0,0,0,0,0,0,1
71,2,2,19.0,19.0,23.0,23.0,917,1001,895,979,22,22,234,34,230,30,4,4,18,18,0,0,0,0,0,0,1
79,2,2,20.0,20.0,23.0,23.0,962,1040,895,951,67,89,357,101,345,85,12,16,19,19,0,0,0,0,0,0,1
86,2,2,20.0,21.0,23.0,23.0,990,1107,923,951,67,156,75,91,55,55,20,36,19,20,0,0,150,150,0,0,1
93,2,2,20.0,22.0,23.0,23.0,990,1079,923,923,67,156,48,157,20,105,28,52,20,21,0,0,150,150,0,0,1
100,2,2,21.0,22.0,23.0,23.0,1062,1130,951,951,111,179,125,145,85,65,40,80,20,21,0,0,150,150,0,0,1
107,2,2,22.0,23.0,23.0,23.0,1090,1141,979,895,111,246,126,283,70,175,56,108,21,22,0,0,150,150,0,0,1
114,2,2,22.0,24.0,23.0,31.0,1135,1158,979,867,156,291,111,373,35,225,76,148,21,23,0,0,150,300,0,0,1
121,2,2,23.0,26.0,23.0,31.0,1186,1202,1007,867,179,335,191,398,95,235,96,163,22,23,0,0,150,450,0,0,1
129,2,2,23.0,28.0,31.0,31.0,1158,1236,979,923,179,313,226,329,110,205,116,124,22,24,0,0,150,450,0,0,1
136,2,2,25.0,28.0,31.0,31.0,1275,1202,1007,867,268,335,197,114,95,50,102,64,23,24,0,0,300,450,0,0,1
143,2,2,25.0,28.0,31.0,31.0,1292,1264,979,951,313,313,247,275,105,175,142,100,23,24,0,0,300,450,0,0,1
150,2,2,25.0,28.0,31.0,39.0,1242,1208,951,895,291,313,143,420,65,280,78,140,23,24,0,0,300,450,0,0,1
157,2,2,25.0,32.0,54.0,39.0,1264,1264,951,951,313,313,288,241,170,215,118,26,23,24,175,250,300,450,0,0,1
164,2,2,26.0,32.0,54.0,39.0,1230,1202,895,867,335,335,159,391,55,325,104,66,22,24,175,250,300,450,50,0,1
171,2,2,27.0,33.0,54.0,39.0,1236,1314,923,979,313,335,150,501,60,395,90,106,22,24,175,250,450,450,50,0,1
179,2,2,29.0,33.0,46.0,39.0,1236,1264,923,951,313,313,205,247,75,105,130,142,23,24,175,400,450,450,150,0,1
186,2,2,30.0,33.0,54.0,39.0,1230,1286,895,951,335,335,255,392,85,210,170,182,24,25,175,575,450,700,150,0,1
193,2,2,31.0,39.0,54.0,39.0,1314,1342,979,1007,335,335,420,37,210,15,210,22,25,25,350,575,450,700,150,0,1
200,2,2,34.0,39.0,54.0,39.0,1320,1320,1007,1007,313,313,251,13,105,5,146,8,26,25,350,575,700,700,150,0,1
207,2,2,36.0,39.0,54.0,39.0,1454,1348,1119,1035,335,313,221,69,35,25,186,44,26,25,350,575,700,700,150,0,1
214,2,2,36.0,39.0,54.0,39.0,1426,1376,1091,1063,335,313,371,234,145,150,226,84,28,25,350,575,700,700,75,0,1
221,2,2,36.0,39.0,54.0,39.0,1516,1398,1203,1063,313,335,442,149,180,25,262,124,28,25,350,1100,700,700,75,0,1
229,2,2,40.0,43.0,54.0,47.0,1600,1398,1287,1063,313,335,257,209,55,45,202,164,28,25,725,1100,700,700,75,0,1
236,2,2,42.0,44.0,54.0,47.0,1594,1370,1259,1035,335,335,412,345,170,195,242,150,28,25,725,1250,700,700,0,0,1
243,2,2,42.0,46.0,54.0,47.0,1622,1398,1287,1063,335,335,507,230,225,90,282,140,28,25,725,1425,700,700,0,0,1
250,2,2,42.0,48.0,54.0,62.0,1544,1236,1231,923,313,313,678,221,360,120,318,101,30,26,725,1675,800,700,0,0,1
257,2,2,42.0,49.0,62.0,62.0,1622,1292,1287,979,335,313,473,281,115,140,358,141,30,26,725,1675,800,800,0,0,1
264,2,2,44.0,54.0,62.0,70.0,1650,1460,1315,1147,335,313,523,106,125,25,398,81,30,27,1100,1675,800,800,0,0,1
271,2,2,50.0,55.0,62.0,70.0,1600,1510,1287,1175,313,335,299,186,65,65,234,121,30,28,1100,2125,800,800,0,0,1
279,2,2,50.0,57.0,62.0,70.0,1600,1510,1287,1175,313,335,514,266,240,105,274,161,30,30,1400,2125,800,800,0,0,1
286,2,2,51.0,58.0,62.0,70.0,1706,1650,1371,1315,335,335,514,457,200,260,314,197,32,32,1400,2125,800,800,0,0,1
293,2,2,53.0,64.0,62.0,70.0,1712,1628,1399,1315,313,313,465,208,190,25,275,183,32,33,1650,2375,800,800,0,0,1
300,2,2,56.0,64.0,62.0,70.0,1678,1852,1343,1539,335,313,385,438,270,215,115,223,33,33,1700,2375,950,800,250,0,1
307,2,2,55.0,64.0,62.0,70.0,1818,1908,1483,1595,335,313,610,653,455,390,155,263,32,35,1700,2375,950,800,350,0,1
314,2,2,57.0,64.0,62.0,78.0,1813,1902,1567,1567,246,335,719,883,540,580,179,303,34,35,1900,2375,1100,800,350,0,1
321,2,2,57.0,62.0,62.0,78.0,1824,1986,1623,1651,201,335,943,1123,740,780,203,343,34,35,1900,2200,1000,800,450,175,1
329,2,2,53.0,69.0,54.0,78.0,1936,1958,1735,1623,201,335,986,569,755,390,231,179,34,35,1650,2400,1000,800,325,325,1
336,2,2,49.0,69.0,54.0,78.0,1818,1986,1595,1651,223,335,1174,804,915,585,259,219,30,35,1650,2400,1150,800,525,325,1
343,2,2,52.0,71.0,54.0,78.0,1594,1908,1371,1595,223,313,677,600,590,445,87,155,25,36,2000,2400,1150,800,775,325,1
7,2,1,13.0,13.0,15.0,14.0,419,377,419,377,0,0,50,45,50,45,0,0,12,12,0,0,0,0,0,0,1
14,2,1,14.0,13.0,15.0,14.0,671,671,671,671,0,0,70,20,70,20,0,0,13,13,0,0,0,0,0,0,1
21,2,1,14.0,14.0,15.0,14.0,699,699,699,699,0,0,50,50,50,50,0,0,13,13,0,0,0,0,0,0,1
29,2,1,15.0,14.0,15.0,14.0,727,783,727,783,0,0,40,150,40,150,0,0,14,13,0,0,0,0,0,0,1
36,2,1,15.0,16.0,15.0,22.0,783,755,783,755,0,0,135,145,135,145,0,0,14,14,0,0,0,0,0,0,1
43,2,1,16.0,16.0,23.0,22.0,783,811,783,811,0,0,70,235,70,235,0,0,15,15,0,0,0,0,0,0,1
50,2,1,17.0,15.0,23.0,22.0,811,783,811,783,0,0,40,30,40,30,0,0,16,15,0,0,0,0,0,0,1
57,2,1,18.0,17.0,23.0,22.0,839,867,839,867,0,0,100,45,100,45,0,0,17,15,0,0,0,0,0,0,1
64,2,1,19.0,18.0,23.0,22.0,867,867,867,867,0,0,145,90,145,90,0,0,18,16,0,0,0,0,0,0,1
71,2,1,19.0,17.0,23.0,22.0,917,895,895,895,22,0,204,170,200,170,4,0,18,17,0,0,0,0,0,0,1
79,2,1,20.0,17.0,23.0,22.0,978,951,867,951,111,0,330,35,310,35,20,0,19,16,0,0,0,0,0,0,1
86,2,1,20.0,18.0,23.0,22.0,950,923,839,923,111,0,37,95,5,95,32,0,19,16,0,0,0,0,0,0,1
93,2,1,20.0,19.0,23.0,22.0,973,895,839,895,134,0,162,145,110,145,52,0,20,18,0,0,150,0,0,0,1
100,2,1,21.0,20.0,23.0,22.0,995,934,839,867,156,67,83,217,15,205,68,12,20,19,0,0,150,0,0,0,1
107,2,1,21.0,20.0,23.0,22.0,995,1057,839,923,156,134,133,348,45,320,88,28,20,19,0,0,150,0,0,0,1
114,2,1,22.0,20.0,23.0,22.0,1023,1023,867,867,156,156,203,368,95,320,108,48,21,20,0,0,150,0,0,0,1
121,2,1,22.0,20.0,23.0,28.0,1079,1051,923,895,156,156,188,493,60,425,128,68,21,20,0,0,150,250,0,0,1
129,2,1,23.0,26.0,23.0,36.0,1158,1135,979,979,179,156,323,228,175,140,148,88,22,20,0,0,150,250,0,0,1
136,2,1,23.0,28.0,23.0,36.0,1230,1113,1007,979,223,134,291,60,140,60,151,0,23,20,0,0,300,250,0,0,1
143,2,1,26.0,30.0,31.0,36.0,1242,1029,951,1007,291,22,78,80,45,80,33,0,23,20,0,100,300,250,0,0,1
150,2,1,27.0,30.0,31.0,36.0,1270,1091,979,1091,291,0,129,215,110,215,19,0,24,22,0,100,300,250,0,0,1
157,2,1,29.0,30.0,46.0,36.0,1264,1147,951,1147,313,0,49,10,40,10,9,0,24,23,125,100,300,250,0,0,1
164,2,1,31.0,31.0,46.0,36.0,1320,1203,1007,1203,313,0,104,110,55,110,49,0,25,23,125,400,300,250,0,0,1
171,2,1,33.0,33.0,46.0,36.0,1264,1259,951,1259,313,0,159,20,70,20,89,0,27,25,125,400,300,250,0,0,1
179,2,1,35.0,36.0,46.0,36.0,1505,1315,1147,1315,358,0,284,30,155,30,129,0,29,25,125,400,300,250,0,0,1
186,2,1,39.0,36.0,46.0,36.0,1505,1427,1147,1427,358,0,119,115,100,115,19,0,30,26,125,400,600,250,0,0,1
193,2,1,40.0,38.0,46.0,44.0,1572,1511,1259,1511,313,0,211,145,160,145,51,0,31,28,300,400,600,250,0,0,1
200,2,1,42.0,43.0,46.0,44.0,1628,1595,1315,1595,313,0,161,80,70,80,91,0,33,28,300,400,600,250,0,0,1
207,2,1,42.0,46.0,46.0,52.0,1684,1623,1371,1623,313,0,221,75,90,75,131,0,33,31,300,550,600,250,0,0,1
214,2,1,44.0,47.0,46.0,52.0,1740,1746,1427,1679,313,67,81,142,60,130,21,12,35,34,600,550,600,250,0,0,1
221,2,1,44.0,48.0,46.0,52.0,1824,1919,1511,1763,313,156,266,322,205,290,61,32,35,34,600,550,600,250,0,0,1
229,2,1,49.0,52.0,54.0,66.0,1869,1891,1511,1735,358,156,431,157,330,105,101,52,37,35,600,700,600,250,0,0,1
236,2,1,51.0,54.0,54.0,66.0,2042,1947,1707,1791,335,156,452,177,315,105,137,72,39,35,600,700,600,250,0,0,1
243,2,1,51.0,55.0,54.0,66.0,2020,1970,1707,1791,313,179,643,357,470,265,173,92,39,37,600,850,600,250,0,0,1
250,2,1,52.0,60.0,54.0,66.0,2020,2026,1707,1847,313,179,173,237,110,125,63,112,41,40,900,850,750,375,0,0,1
257,2,1,53.0,62.5,62.0,66.0,2054,2143,1763,1987,291,156,239,253,140,125,99,128,41,41,900,825,750,500,0,25,1
264,2,1,56.0,63.5,62.0,74.0,2149,2339,1791,2183,358,156,157,378,110,230,47,148,43,44,900,1075,750,500,0,25,1
271,2,1,58.0,64.5,62.0,82.0,2390,2339,1875,2183,515,156,227,393,120,225,107,168,44,45,900,1125,750,500,0,25,1
279,2,1,61.0,68.5,62.0,90.0,2362,2339,1847,2183,515,156,152,478,85,290,67,188,45,47,1150,1125,750,500,0,25,1
286,2,1,62.0,71.5,62.0,90.0,2457,2311,1987,2155,470,156,354,428,235,220,119,208,46,51,1150,1125,750,500,0,25,1
293,2,1,63.0,73.5,70.0,90.0,2373,2558,1791,2379,582,179,234,278,135,150,99,128,47,53,1150,1125,1050,500,0,25,1
300,2,1,68.0,74.5,70.0,90.0,2446,2535,1819,2379,627,156,244,174,165,30,79,144,48,52,1400,1125,1150,500,0,25,1
307,2,1,69.0,72.5,70.0,98.0,2434,2675,1763,2519,671,156,489,179,330,15,159,164,49,52,1400,1125,1150,825,0,25,1
314,2,1,70.0,75.5,70.0,98.0,2468,2619,1819,2463,649,156,740,219,505,35,235,184,51,50,1400,1125,1150,825,0,75,1
321,2,1,78.0,79.5,93.0,106.0,2546,2390,1875,2211,671,179,236,283,175,75,61,208,52,50,1650,1275,1150,825,0,75,1
329,2,1,81.0,82.5,93.0,106.0,2630,2670,1959,2379,671,291,261,313,120,65,141,248,52,54,2150,1275,1150,825,0,75,1
336,2,1,84.0,87.5,93.0,106.0,2670,2843,2043,2463,627,380,43,386,30,90,13,296,55,57,2150,1425,1150,825,0,75,1
343,2,1,90.0,86.5,93.0,106.0,2888,2882,2239,2323,649,559,158,484,65,120,93,364,57,59,2650,1425,1150,825,0,75,1
350,2,1,91.0,85.5,93.0,106.0,3062,3190,2435,2519,627,671,179,650,110,310,69,340,59,61,2650,1425,1150,1200,0,75,1
357,2,1,93.0,87.5,93.0,114.0,3112,3196,2463,2547,649,649,279,431,130,290,149,141,60,59,2900,1575,1300,1200,0,75,1
364,2,1,98.0,101.0,101.0,122.0,3252,3134,2603,2463,649,671,425,100,300,50,125,50,62,59,3150,1550,1300,1200,0,100,1
371,2,1,100.0,107.0,109.0,122.0,3386,3308,2715,2547,671,761,365,211,260,140,105,71,63,59,3150,1700,1300,1200,0,100,1
379,2,1,100.0,113.0,109.0,128.0,3308,3218,2659,2435,649,783,152,286,75,190,77,96,65,59,3150,2200,1300,1200,0,100,1
386,2,1,96.0,115.0,109.0,128.0,3151,3314,2547,2463,604,851,619,441,420,245,199,196,65,59,2900,2500,1300,1200,250,100,1
393,2,1,100.0,125.0,109.0,120.0,3314,3342,2575,2491,739,851,544,171,395,75,149,96,66,59,2900,2950,1300,1800,250,200,1
400,2,1,100.0,125.0,109.0,120.0,3566,3185,2603,2379,963,806,861,259,600,75,261,184,66,59,3150,3250,1300,1800,250,200,1
407,2,1,104.0,125.5,109.0,128.0,3543,3196,2603,2323,940,873,488,492,265,200,223,292,66,59,3025,3175,1450,1950,375,275,1
414,2,1,109.0,128.0,109.0,144.0,3168,3230,2295,2267,873,963,525,528,260,295,265,233,68,59,3025,3650,2000,1950,375,300,1
421,2,1,110.0,137.0,117.0,152.0,2423,3202,1707,2239,716,963,689,318,390,265,299,53,68,59,3775,3800,2000,1950,375,300,1
429,2,1,99.0,147.0,117.0,152.0,2429,3314,1735,2351,694,963,1282,129,745,110,537,19,68,59,3100,4100,1950,2100,1350,400,1
7,0,2,13.0,13.0,15.0,15.0,293,251,293,251,0,0,35,30,35,30,0,0,12,12,0,0,0,0,0,0,1
14,0,2,14.0,14.0,15.0,15.0,671,671,671,671,0,0,70,70,70,70,0,0,13,13,0,0,0,0,0,0,1
21,0,2,14.0,14.0,15.0,15.0,699,727,699,727,0,0,50,45,50,45,0,0,13,13,0,0,0,0,0,0,1
29,0,2,15.0,14.0,15.0,15.0,727,755,727,755,0,0,90,135,90,135,0,0,14,14,0,0,0,0,0,0,1
36,0,2,15.0,14.0,15.0,15.0,783,839,783,839,0,0,140,165,140,165,0,0,14,14,0,0,0,0,0,0,1
43,0,2,16.0,14.0,23.0,23.0,839,811,839,811,0,0,10,95,10,95,0,0,15,14,0,0,0,0,0,0,1
50,0,2,16.0,14.0,23.0,23.0,839,755,839,755,0,0,55,80,55,80,0,0,15,14,0,0,0,0,0,0,1
57,0,2,17.0,14.0,23.0,23.0,811,783,811,783,0,0,145,170,145,170,0,0,16,14,0,0,0,0,0,0,1
64,0,2,18.0,14.0,23.0,31.0,867,771,867,727,0,44,200,258,200,250,0,8,17,14,0,0,0,0,0,0,1
71,0,2,18.0,14.0,23.0,31.0,872,799,783,643,89,156,296,358,280,330,16,28,17,14,0,0,0,0,0,0,1
79,0,2,19.0,14.0,23.0,31.0,939,794,783,615,156,179,362,373,330,325,32,48,18,14,0,0,0,0,0,0,1
86,0,2,19.0,14.0,23.0,31.0,883,827,727,671,156,156,417,469,365,405,52,64,18,14,0,0,0,0,0,0,1
93,0,2,19.0,17.0,23.0,31.0,855,771,699,615,156,156,317,259,295,175,22,84,19,14,0,0,150,150,0,0,1
100,0,2,19.0,18.0,23.0,31.0,939,771,783,615,156,156,442,304,400,200,42,104,19,15,0,0,150,150,0,0,1
107,0,2,19.0,19.0,23.0,31.0,967,743,811,475,156,268,157,344,95,200,62,144,19,16,0,0,150,150,0,0,1
114,0,2,19.0,19.0,23.0,31.0,962,872,783,559,179,313,162,405,80,225,82,180,19,16,0,100,150,150,0,0,1
121,0,2,20.0,20.0,23.0,31.0,962,838,783,503,179,335,232,455,130,235,102,220,19,17,0,100,150,150,0,0,1
129,0,2,23.0,21.0,23.0,31.0,1079,978,923,643,156,335,218,480,100,270,118,210,20,18,0,100,250,300,0,0,1
136,0,2,23.0,22.0,31.0,31.0,1079,956,923,643,156,313,48,546,10,300,38,246,20,19,0,100,250,300,0,0,1
143,0,2,24.0,22.0,31.0,31.0,1051,1034,895,699,156,335,93,666,35,380,58,286,21,19,0,100,250,300,0,0,1
150,0,2,26.0,22.0,31.0,31.0,1107,1090,951,755,156,335,193,801,115,475,78,326,21,20,100,100,250,300,0,0,1
157,0,2,27.0,22.0,31.0,31.0,1135,1068,979,755,156,313,258,927,160,565,98,362,22,20,100,100,250,300,0,0,1
164,0,2,30.0,22.0,31.0,31.0,1354,1146,1175,811,179,335,293,1067,175,665,118,402,23,20,200,100,250,300,0,0,1
171,0,2,30.0,24.0,31.0,31.0,1359,1118,1203,783,156,335,399,1022,265,630,134,392,23,20,200,100,250,300,0,0,1
179,0,2,31.0,24.0,46.0,31.0,1382,1124,1203,811,179,313,403,1153,245,725,158,428,24,20,200,100,500,300,0,0,1
186,0,2,35.0,24.0,46.0,31.0,1331,1146,1063,811,268,335,104,1298,10,830,94,468,24,20,300,100,500,300,0,0,1
193,0,2,36.0,24.0,46.0,31.0,1264,1202,951,867,313,335,209,1433,75,925,134,508,25,20,300,100,500,300,0,0,1
200,0,2,36.0,24.0,46.0,31.0,1398,1124,1063,811,335,313,234,1564,60,1020,174,544,25,20,350,275,500,300,0,0,1
207,0,2,40.0,24.0,46.0,31.0,1617,1124,1259,811,358,313,204,1704,15,1120,189,584,26,20,500,275,500,300,0,0,1
214,0,2,41.0,24.0,46.0,31.0,1482,1174,1147,839,335,335,330,1844,105,1220,225,624,27,20,500,275,500,300,0,0,1
221,0,2,42.0,24.0,54.0,31.0,1796,1040,1483,727,313,313,446,1960,210,1300,236,660,28,20,550,275,750,300,0,0,1
229,0,2,48.0,24.0,54.0,31.0,1880,1068,1567,755,313,313,246,2100,95,1400,151,700,29,20,600,275,825,300,0,0,1
236,0,2,49.0,24.0,54.0,31.0,1964,1057,1651,699,313,358,346,2225,155,1485,191,740,30,20,600,275,900,300,0,0,1
243,0,2,53.0,24.0,54.0,31.0,2104,1118,1791,783,313,335,191,2351,160,1575,31,776,32,20,700,275,900,300,0,0,1
250,0,2,54.0,24.0,54.0,31.0,2266,1040,1931,727,335,313,166,2477,95,1665,71,812,32,20,700,275,900,300,0,0,1
257,0,2,56.0,24.0,62.0,31.0,2177,1096,1819,783,358,313,246,2612,135,1760,111,852,34,20,975,275,900,300,0,0,1
264,0,2,61.0,24.0,62.0,31.0,2406,1068,2071,755,335,313,167,2732,145,1840,22,892,35,20,1025,275,900,300,0,0,1
271,0,2,62.0,24.0,62.0,31.0,2356,1096,2043,783,313,313,163,2867,105,1935,58,932,35,20,1075,275,900,300,0,0,1
279,0,2,62.0,24.0,62.0,31.0,2188,1090,1875,755,313,335,173,2997,75,2025,98,972,37,20,1075,275,900,300,0,0,1
286,0,2,62.0,24.0,62.0,31.0,2272,1141,1959,783,313,358,283,3122,145,2110,138,1012,37,20,1375,275,900,300,0,0,1
293,0,2,66.0,24.0,70.0,31.0,2300,1068,1987,755,313,313,398,3244,220,2200,178,1044,37,20,1700,275,1050,300,0,0,1
300,0,2,69.0,24.0,70.0,31.0,2098,1068,1763,755,335,313,238,3324,170,2240,68,1084,39,19,1700,275,1325,300,0,50,1
307,0,2,69.0,24.0,78.0,31.0,2261,984,1791,671,470,313,198,3434,170,2310,28,1124,39,20,1800,275,1325,300,0,50,1
314,0,2,74.0,24.0,86.0,31.0,2227,1068,1735,755,492,313,70,3574,40,2410,30,1164,41,20,1800,275,1325,300,0,50,1
321,0,2,75.0,24.0,86.0,31.0,2227,1006,1735,671,492,335,125,3684,35,2480,90,1204,41,20,1850,275,1325,300,0,50,1
329,0,2,77.0,24.0,86.0,31.0,2289,1085,1819,727,470,358,86,3814,40,2570,46,1244,43,20,1850,275,1325,300,0,50,1
336,0,2,82.0,24.0,86.0,31.0,2485,1062,1903,727,582,335,111,3940,10,2660,101,1280,44,20,2050,275,1325,300,0,50,1
343,0,2,84.0,24.0,94.0,31.0,2490,1040,1819,727,671,313,296,4066,140,2750,156,1316,45,20,2050,275,1325,300,0,50,1
350,0,2,90.0,24.0,94.0,31.0,2737,1012,2043,699,694,313,116,4191,80,2835,36,1356,46,20,2150,275,1425,300,0,50,1
357,0,2,94.0,24.0,110.0,31.0,2765,1068,2071,755,694,313,157,4321,95,2925,62,1396,46,20,2275,275,1425,300,0,50,1
364,0,2,98.0,24.0,110.0,31.0,2698,984,2071,671,627,313,250,4451,145,3015,105,1436,46,20,2400,275,1425,300,0,50,1
371,0,2,102.0,24.0,110.0,31.0,2726,1090,2099,755,627,335,255,4531,120,3055,135,1476,46,19,2500,275,1425,300,0,100,1
379,0,2,100.0,24.0,118.0,31.0,2866,1057,2239,699,627,358,325,4656,110,3140,215,1516,46,19,3100,275,1425,300,0,100,1
386,0,2,106.0,24.0,118.0,31.0,2922,1062,2295,727,627,335,360,4777,140,3225,220,1552,46,20,3225,275,1425,300,0,100,1
393,0,2,114.0,24.0,118.0,31.0,2944,1096,2295,783,649,313,105,4908,5,3320,100,1588,46,20,3450,275,1425,300,0,100,1
400,0,2,116.0,24.0,118.0,31.0,2983,1040,2267,727,716,313,350,5018,170,3390,180,1628,46,20,3450,275,1425,300,0,100,1
407,0,2,118.0,24.0,118.0,31.0,2849,1096,2155,783,694,313,266,5163,35,3495,231,1668,48,20,3775,275,1425,300,0,100,1
414,0,2,118.0,24.0,118.0,31.0,2978,1068,2351,755,627,313,279,5288,30,3580,249,1708,48,20,4000,275,1425,300,0,100,1
421,0,2,126.0,24.0,126.0,31.0,2782,1113,2155,755,627,358,299,5413,70,3665,229,1748,48,20,4400,275,1425,300,0,100,1
429,0,2,126.0,24.0,126.0,31.0,2810,1062,2183,727,627,335,374,5539,90,3755,284,1784,48,20,4500,275,1425,300,0,100,1
436,0,2,126.0,24.0,126.0,31.0,2810,1040,2183,727,627,313,389,5665,75,3845,314,1820,50,20,4500,275,1425,300,0,100,1
443,0,2,134.0,24.0,134.0,31.0,2849,1040,2155,727,694,313,374,5790,105,3930,269,1860,50,20,4750,275,1425,300,0,100,1
450,0,2,139.0,26.0,149.0,31.0,2765,1012,2071,699,694,313,380,5740,110,3865,270,1875,50,19,4750,275,1425,300,0,150,1
457,0,2,140.0,21.0,157.0,31.0,2664,995,2015,727,649,268,367,5417,100,3510,267,1907,52,20,4950,0,1725,300,0,550,1
464,0,2,144.0,18.0,157.0,23.0,2726,844,2099,643,627,201,708,5052,365,3225,343,1827,53,17,5300,0,1725,300,0,800,1
7,1,1,13.0,13.0,14.0,14.0,293,293,293,293,0,0,35,35,35,35,0,0,12,12,0,0,0,0,0,0,0
14,1,1,13.0,13.0,14.0,14.0,643,615,643,615,0,0,15,10,15,10,0,0,13,13,0,0,0,0,0,0,0
21,1,1,14.0,14.0,14.0,14.0,727,699,727,699,0,0,40,35,40,35,0,0,13,13,0,0,0,0,0,0,0
29,1,1,14.0,14.0,14.0,14.0,727,727,727,727,0,0,130,135,130,135,0,0,13,13,0,0,0,0,0,0,0
36,1,1,16.0,16.0,22.0,22.0,755,755,755,755,0,0,130,125,130,125,0,0,14,14,0,0,0,0,0,0,0
43,1,1,16.0,16.0,22.0,22.0,811,755,811,755,0,0,215,210,215,210,0,0,14,14,0,0,0,0,0,0,0
50,1,1,16.0,15.0,22.0,22.0,727,755,727,755,0,0,300,5,300,5,0,0,16,15,0,0,0,0,0,0,0
57,1,1,17.0,17.0,22.0,22.0,839,895,839,895,0,0,10,15,10,15,0,0,15,15,0,0,0,0,0,0,0
64,1,1,18.0,18.0,22.0,22.0,867,839,867,839,0,0,65,55,65,55,0,0,15,15,0,0,0,0,0,0,0
71,1,1,17.0,17.0,22.0,22.0,867,895,867,895,0,0,135,140,135,140,0,0,16,16,0,0,0,0,0,0,0
79,1,1,17.0,16.0,22.0,22.0,923,867,923,867,0,0,0,45,0,45,0,0,16,16,0,0,0,0,0,0,0
86,1,1,18.0,18.0,22.0,22.0,867,923,867,923,0,0,50,55,50,55,0,0,16,16,0,0,0,0,0,0,0
93,1,1,19.0,19.0,22.0,22.0,923,895,923,895,0,0,105,115,105,115,0,0,17,17,0,0,0,0,0,0,0
100,1,1,20.0,20.0,22.0,22.0,995,934,951,867,44,67,183,177,175,165,8,12,18,18,0,0,0,0,0,0,0
107,1,1,20.0,20.0,22.0,22.0,1006,1029,895,895,111,134,294,307,270,275,24,32,19,19,0,0,0,0,0,0,0
114,1,1,21.0,21.0,22.0,22.0,1107,1023,951,867,156,156,384,377,340,325,44,52,20,20,0,0,0,0,0,0,0
121,1,1,21.0,21.0,22.0,28.0,1051,1051,895,895,156,156,404,507,340,435,64,72,20,20,0,0,0,0,0,0,0
129,1,1,26.0,26.0,28.0,28.0,1163,1102,1007,923,156,179,199,197,115,105,84,92,21,21,0,0,250,250,0,0,0
136,1,1,28.0,28.0,28.0,28.0,1102,1079,923,923,179,156,24,28,20,20,4,8,21,21,0,0,250,250,0,0,0
143,1,1,28.0,29.0,36.0,36.0,1225,1118,1091,1007,134,111,171,110,155,90,16,20,21,21,50,50,250,250,0,0,0
150,1,1,30.0,30.0,36.0,36.0,1174,1174,1063,1063,111,111,207,211,175,175,32,36,23,23,50,50,250,250,0,0,0
157,1,1,32.0,30.0,36.0,36.0,1309,1197,1175,1063,134,134,273,352,225,300,48,52,24,25,50,50,250,250,0,0,0
164,1,1,31.0,31.0,36.0,36.0,1309,1281,1175,1147,134,134,124,113,60,45,64,68,23,24,400,350,250,250,0,0,0
171,1,1,31.0,31.0,36.0,36.0,1337,1309,1203,1175,134,134,75,74,45,40,30,34,24,23,400,350,250,250,0,0,0
179,1,1,32.0,32.0,36.0,36.0,1314,1342,1203,1231,111,111,87,76,45,30,42,46,25,25,400,350,250,250,0,0,0
186,1,1,33.0,33.0,36.0,36.0,1421,1337,1287,1203,134,134,203,192,145,130,58,62,25,27,400,350,250,250,0,0,0
193,1,1,36.0,36.0,44.0,36.0,1426,1477,1315,1343,111,134,175,223,105,145,70,78,27,27,400,350,250,250,0,0,0
200,1,1,40.0,41.0,44.0,44.0,1477,1510,1343,1399,134,111,160,155,70,65,90,90,27,28,400,400,250,250,0,0,0
207,1,1,42.0,41.0,44.0,44.0,1555,1611,1399,1455,156,156,135,240,25,130,110,110,27,29,450,450,250,250,0,0,0
214,1,1,44.0,44.0,44.0,44.0,1583,1639,1427,1483,156,156,235,200,105,95,130,105,30,32,500,550,450,450,0,0,0
221,1,1,43.0,44.5,52.0,52.0,1611,1662,1455,1483,156,179,345,210,195,85,150,125,30,31,550,525,450,450,0,25,0
229,1,1,50.0,49.5,52.0,52.0,1634,1802,1455,1623,179,179,200,170,30,25,170,145,32,32,700,575,450,450,0,50,0
236,1,1,52.0,51.5,58.0,58.0,1779,1807,1623,1651,156,156,241,296,55,135,186,161,31,36,700,575,450,450,0,50,0
243,1,1,52.0,54.5,58.0,58.0,1779,1779,1623,1623,156,156,356,246,150,65,206,181,37,39,750,575,450,450,0,50,0
250,1,1,52.0,56.5,58.0,58.0,1835,1863,1679,1707,156,156,171,181,45,80,126,101,39,42,750,725,575,575,0,50,0
257,1,1,54.0,57.5,66.0,66.0,1970,1891,1791,1735,179,156,315,236,165,115,150,121,39,45,750,725,575,575,0,50,0
264,1,1,59.0,57.0,66.0,66.0,1970,2199,1679,2043,291,156,310,266,120,125,190,141,41,44,750,700,575,575,0,75,0
271,1,1,64.0,59.0,66.0,74.0,2182,2362,1847,2183,335,179,320,366,90,205,230,161,42,44,750,700,575,575,0,75,0
279,1,1,65.5,62.0,66.0,74.0,2317,2586,1959,2407,358,179,195,181,75,100,120,81,42,47,725,700,575,575,25,75,0
286,1,1,65.5,63.0,66.0,74.0,2322,2468,1987,2267,335,201,271,365,115,285,156,80,42,47,1125,800,775,575,25,75,0
293,1,1,65.0,62.5,66.0,82.0,2384,2586,2071,2295,313,291,447,481,255,415,192,66,42,50,1600,775,775,575,100,100,0
300,1,1,61.5,61.5,74.0,82.0,2412,2552,2099,2239,313,313,687,592,455,448,232,144,42,51,1275,575,775,575,275,324,0
307,1,1,60.5,67.0,82.0,90.0,2384,2384,2071,2071,313,313,822,222,550,188,272,34,42,46,1025,400,775,775,450,749,0
314,1,1,75.5,68.0,90.0,98.0,2384,2132,2071,1707,313,425,112,147,25,103,87,44,42,45,1075,550,775,775,450,749,0
321,1,1,78.5,69.0,90.0,92.0,2457,2227,2099,1735,358,492,137,152,60,48,77,104,47,46,1225,550,775,775,450,1099,0
329,1,1,74.0,68.0,90.0,92.0,2429,2250,2071,1735,358,515,332,428,215,268,117,160,47,49,1300,1100,775,775,675,1149,0
336,1,1,82.5,68.0,90.0,108.0,2468,2395,2155,1903,313,492,169,314,95,148,74,166,50,49,1525,1100,775,1025,775,1149,0
343,1,1,81.5,66.0,90.0,116.0,2608,2412,2295,1875,313,537,394,157,280,148,114,9,48,47,1525,1100,775,1025,775,1149,0
350,1,1,87.0,71.0,98.0,116.0,2664,2502,2351,1875,313,627,409,203,280,118,129,85,51,47,1800,1200,775,1025,800,1149,0
357,1,1,95.0,79.0,98.0,116.0,2664,2558,2351,1931,313,627,239,123,170,58,69,65,52,49,1800,1250,775,1025,800,1149,0
364,1,1,97.0,82.0,98.0,116.0,2860,2552,2547,1903,313,649,389,223,305,78,84,145,56,52,1900,1200,775,1025,800,1199,0
371,1,1,97.0,84.0,98.0,116.0,2905,2630,2435,1959,470,671,429,439,385,218,44,221,56,52,2300,1200,1025,1025,800,1199,0
379,1,1,101.0,85.0,106.0,116.0,2983,2546,2379,1875,604,671,453,280,409,133,44,147,56,57,2300,1600,1025,1025,824,1199,0
386,1,1,105.0,86.5,122.0,116.0,3101,2580,2519,1931,582,649,571,336,534,113,37,223,56,58,2400,1575,1025,1025,824,1224,0
393,1,1,113.0,86.5,130.0,124.0,3129,2446,2547,1819,582,627,448,623,439,328,9,295,56,59,2400,1575,1025,1025,824,1224,0
400,1,1,117.0,86.5,130.0,124.0,3162,2558,2603,1931,559,627,635,943,604,568,31,375,56,59,2600,1575,1025,1025,824,1224,0
407,1,1,121.0,86.5,138.0,132.0,3179,2614,2575,1987,604,627,716,1258,659,803,57,455,56,59,3000,1575,1025,1025,824,1224,0
414,1,1,126.0,96.5,138.0,138.0,3230,2692,2603,2043,627,649,568,589,514,558,54,31,55,59,3200,1575,1025,1475,824,1224,0
421,1,1,130.0,107.5,138.0,138.0,3123,2882,2519,2211,604,671,431,185,359,153,72,32,55,57,3400,1725,1025,1475,824,1224,0
429,1,1,137.0,111.5,146.0,138.0,3157,2938,2575,2267,582,671,404,221,364,163,40,58,55,62,3750,1725,1025,1475,874,1224,0
436,1,1,143.0,113.5,162.0,138.0,3112,3062,2463,2435,649,627,378,453,329,373,49,80,55,62,3950,1725,1025,1475,874,1224,0
443,1,1,149.0,116.5,186.0,146.0,3006,3062,2267,2435,739,627,430,663,364,528,66,135,55,62,4350,3025,1025,1475,874,1224,0
450,1,1,155.0,120.5,194.0,154.0,3196,3123,2435,2295,761,828,418,664,364,488,54,176,55,60,4350,3225,1025,1475,974,1324,0
457,1,1,160.5,131.5,194.0,154.0,3106,2782,2323,1931,783,851,379,379,329,253,50,126,55,61,4475,3275,1025,1475,1099,1474,0
464,1,1,160.5,121.5,194.0,162.0,3106,2518,2323,1735,783,783,442,586,379,393,63,193,55,59,4475,3125,1025,1475,1399,2124,0
471,1,1,162.5,99.5,194.0,162.0,3134,1970,2351,1231,783,739,115,276,64,128,51,148,55,49,4275,2025,1025,1475,1899,3724,0
479,1,1,146.5,75.0,194.0,162.0,3090,1370,2351,811,739,559,488,231,424,73,64,158,55,23,3775,2450,1025,1475,2799,5124,0
486,1,1,146.5,57.0,194.0,162.0,3118,1158,2379,643,739,515,255,265,249,68,6,197,55,23,3575,1650,1025,1475,3399,6224,0
7,2,2,13.0,13.0,15.0,15.0,335,251,335,251,0,0,40,30,40,30,0,0,12,12,0,0,0,0,0,0,1
14,2,2,14.0,14.0,15.0,15.0,643,671,643,671,0,0,65,70,65,70,0,0,13,13,0,0,0,0,0,0,1
21,2,2,14.0,14.0,15.0,15.0,671,727,671,727,0,0,45,45,45,45,0,0,13,13,0,0,0,0,0,0,1
29,2,2,15.0,14.0,15.0,15.0,699,727,699,727,0,0,90,135,90,135,0,0,14,14,0,0,0,0,0,0,1
36,2,2,15.0,14.0,23.0,15.0,839,811,839,811,0,0,145,160,145,160,0,0,14,14,0,0,0,0,0,0,1
43,2,2,16.0,14.0,23.0,23.0,755,727,755,727,0,0,25,90,25,90,0,0,15,14,0,0,0,0,0,0,1
50,2,2,17.0,14.0,23.0,23.0,811,727,811,727,0,0,50,75,50,75,0,0,16,14,0,0,0,0,0,0,1
57,2,2,18.0,14.0,23.0,23.0,839,643,839,643,0,0,30,160,30,160,0,0,17,14,0,0,0,0,0,0,1
64,2,2,19.0,14.0,23.0,23.0,951,771,951,727,0,44,90,253,90,245,0,8,18,14,0,0,0,0,0,0,1
71,2,2,19.0,14.0,23.0,31.0,923,743,923,587,0,156,45,348,45,320,0,28,18,14,0,0,0,0,0,0,1
79,2,2,20.0,14.0,23.0,31.0,995,822,951,643,44,179,73,368,65,320,8,48,19,14,0,0,0,0,0,0,1
86,2,2,21.0,14.0,23.0,31.0,1113,738,979,559,134,179,49,458,25,390,24,68,20,14,0,0,150,0,0,0,1
93,2,2,22.0,15.0,23.0,31.0,1107,743,951,587,156,156,129,359,85,275,44,84,21,14,0,0,150,150,0,0,1
100,2,2,22.0,18.0,23.0,31.0,1141,771,895,615,246,156,106,299,30,195,76,104,21,15,0,0,150,150,0,0,1
107,2,2,23.0,19.0,23.0,31.0,1158,827,867,559,291,268,242,350,130,210,112,140,22,16,0,0,150,150,0,0,1
114,2,2,24.0,20.0,31.0,31.0,1230,872,895,559,335,313,347,392,195,220,152,172,23,17,0,0,150,150,0,0,1
121,2,2,26.0,20.0,31.0,31.0,1230,928,895,615,335,313,333,462,245,250,88,212,23,17,0,100,450,150,0,0,1
129,2,2,28.0,21.0,31.0,31.0,1230,1012,895,699,335,313,203,587,175,335,28,252,24,18,0,100,450,150,0,0,1
136,2,2,28.0,22.0,31.0,31.0,1208,1012,895,699,313,313,249,552,185,310,64,242,24,19,0,100,450,300,0,0,1
143,2,2,28.0,22.0,31.0,31.0,1236,1062,923,727,313,335,304,677,200,395,104,282,24,20,0,100,450,300,0,0,1
150,2,2,28.0,22.0,31.0,31.0,1208,1141,895,783,313,358,449,817,305,495,144,322,24,20,150,100,450,300,0,0,1
157,2,2,32.0,22.0,39.0,31.0,1230,1174,895,839,335,335,244,948,160,590,84,358,24,20,325,100,450,300,0,0,1
164,2,2,32.0,24.0,39.0,31.0,1236,1124,923,811,313,313,470,904,350,560,120,344,24,20,325,100,450,300,0,0,1
171,2,2,32.0,24.0,39.0,31.0,1230,1124,895,811,335,313,215,1039,55,655,160,384,24,20,325,100,450,300,0,0,1
179,2,2,32.0,24.0,39.0,31.0,1208,1124,895,811,313,313,261,1179,65,755,196,424,24,20,325,100,450,300,0,0,1
186,2,2,35.0,24.0,39.0,31.0,1264,1096,951,783,313,313,216,1304,80,840,136,464,24,20,675,100,450,300,0,0,1
193,2,2,37.0,24.0,39.0,31.0,1236,1146,923,811,313,335,116,1449,40,945,76,504,25,20,675,275,450,300,0,0,1
200,2,2,38.0,24.0,39.0,31.0,1342,1113,1007,755,335,358,226,1574,110,1030,116,544,25,20,675,275,450,300,0,0,1
207,2,2,39.0,24.0,39.0,31.0,1337,1152,979,839,358,313,326,1711,170,1135,156,576,26,20,675,275,550,300,0,0,1
214,2,2,39.0,24.0,47.0,31.0,1342,1124,1007,811,335,313,487,1841,295,1225,192,616,26,20,975,275,550,300,0,0,1
221,2,2,44.0,24.0,47.0,31.0,1348,1152,1035,839,313,313,238,1986,110,1330,128,656,27,20,975,275,550,300,0,0,1
227,2,2,44.0,24.0,47.0,31.0,1370,1113,1035,755,335,358,355,2073,195,1385,160,688,27,20,1325,275,550,300,0,0,1
7,1,0,13.0,13.0,14.0,15.0,251,293,251,293,0,0,30,35,30,35,0,0,12,12,0,0,0,0,0,0,1
14,1,0,14.0,14.0,14.0,15.0,643,671,643,671,0,0,40,70,40,70,0,0,13,13,0,0,0,0,0,0,1
21,1,0,14.0,14.0,14.0,15.0,727,699,727,699,0,0,65,40,65,40,0,0,13,13,0,0,0,0,0,0,1
29,1,0,14.0,15.0,14.0,15.0,643,671,643,671,0,0,140,75,140,75,0,0,14,14,0,0,0,0,0,0,1
36,1,0,13.0,15.0,14.0,15.0,699,755,699,755,0,0,25,120,25,120,0,0,13,14,0,0,0,0,0,0,1
43,1,0,14.0,16.0,14.0,23.0,721,755,699,755,22,0,44,50,40,50,4,0,13,15,0,0,0,0,0,0,1
50,1,0,15.0,16.0,14.0,23.0,693,783,559,783,134,0,93,10,69,10,24,0,14,15,0,0,0,0,0,0,1
57,1,0,15.0,17.0,14.0,23.0,715,755,559,755,156,0,79,115,39,115,40,0,15,16,0,0,0,0,0,0,1
64,1,0,15.0,18.0,14.0,23.0,771,727,615,727,156,0,174,140,114,140,60,0,15,17,0,0,0,0,0,0,1
71,1,0,15.0,18.0,22.0,23.0,827,827,671,783,156,44,284,243,204,235,80,8,15,17,0,0,0,0,0,0,1
79,1,0,15.0,19.0,22.0,23.0,827,911,671,755,156,156,379,303,279,275,100,28,15,18,0,0,0,0,0,0,1
86,1,0,18.0,19.0,22.0,23.0,799,883,755,727,44,156,124,353,124,305,0,48,15,18,0,0,250,0,0,0,1
93,1,0,18.0,20.0,22.0,23.0,867,911,867,755,0,156,229,268,229,250,0,18,15,19,0,0,250,150,0,0,1
100,1,0,18.0,20.0,22.0,23.0,811,1018,811,839,0,179,24,393,24,355,0,38,15,19,150,0,250,150,0,0,1
107,1,0,17.0,20.0,22.0,23.0,811,967,811,811,0,156,119,99,119,45,0,54,14,19,150,0,250,150,0,0,1
114,1,0,20.0,20.0,22.0,23.0,811,939,811,783,0,156,14,114,14,40,0,74,14,19,150,0,250,150,0,0,1
121,1,0,22.0,22.0,22.0,23.0,811,911,811,755,0,156,9,134,9,40,0,94,14,19,150,100,250,150,0,0,1
129,1,0,22.0,22.0,22.0,23.0,811,1051,811,895,0,156,99,264,99,150,0,114,14,19,150,100,250,150,0,0,1
136,1,0,22.0,23.0,22.0,31.0,811,1191,811,1035,0,156,104,99,104,65,0,34,14,20,250,100,250,150,0,0,1
143,1,0,22.0,23.0,22.0,31.0,783,1102,783,923,0,179,194,69,194,65,0,4,14,20,300,150,250,150,0,0,1
150,1,0,26.0,23.0,30.0,31.0,783,1130,783,951,0,179,34,199,34,175,0,24,14,21,450,150,250,150,0,0,1
157,1,0,26.0,22.0,30.0,31.0,783,1079,783,923,0,156,129,130,129,90,0,40,14,20,450,150,250,150,0,0,1
164,1,0,27.0,23.0,30.0,31.0,783,1023,783,867,0,156,179,215,179,155,0,60,16,20,450,150,250,150,0,0,1
171,1,0,28.0,24.0,30.0,31.0,867,1012,867,811,0,201,229,298,229,210,0,88,17,21,450,150,250,150,0,0,1
179,1,0,28.0,27.0,36.0,31.0,867,1079,867,811,0,268,229,39,229,15,0,24,17,21,450,150,250,500,0,0,1
186,1,0,31.0,28.0,36.0,31.0,951,1158,951,867,0,291,199,140,199,80,0,60,18,22,600,150,250,500,0,0,1
193,1,0,33.0,28.0,36.0,31.0,923,1158,923,867,0,291,204,192,204,100,0,92,21,22,600,150,250,600,0,0,1
200,1,0,34.0,28.0,44.0,31.0,979,1264,979,951,0,313,274,323,274,195,0,128,21,22,600,350,250,600,0,0,1
207,1,0,35.0,30.0,44.0,31.0,1063,1236,1063,923,0,313,359,263,359,95,0,168,24,22,600,350,250,600,0,0,1
214,1,0,34.0,35.0,44.0,39.0,1231,1174,1231,839,0,335,189,163,189,55,0,108,24,22,600,350,250,850,0,0,1
221,1,0,39.0,36.0,44.0,39.0,1287,1286,1287,951,0,335,49,168,49,20,0,148,24,22,600,350,250,850,0,0,1
229,1,0,41.0,38.0,44.0,54.0,1343,1292,1343,979,0,313,4,229,4,45,0,184,24,23,600,450,250,850,0,0,1
236,1,0,43.0,40.0,44.0,54.0,1371,1398,1371,1063,0,335,64,429,64,205,0,224,27,23,600,550,250,750,0,25,1
243,1,0,43.0,42.0,52.0,54.0,1387,1426,1343,1091,44,335,227,559,219,295,8,264,29,23,600,800,250,750,0,25,1
250,1,0,49.0,42.0,52.0,54.0,1561,1348,1427,1035,134,313,82,320,54,120,28,200,31,23,600,900,250,750,0,25,1
257,1,0,49.0,45.0,52.0,54.0,1639,1348,1483,1035,156,313,172,195,124,105,48,90,31,24,750,1050,250,750,0,25,1
264,1,0,49.0,47.0,52.0,62.0,1718,1258,1539,923,179,335,262,230,194,100,68,130,35,24,750,1050,250,750,0,25,1
271,1,0,50.0,50.0,60.0,62.0,1695,1236,1539,923,156,313,183,231,149,65,34,166,34,24,750,1050,250,750,0,25,1
279,1,0,53.0,51.0,68.0,62.0,1779,1264,1623,951,156,313,248,346,194,140,54,206,34,24,750,1050,250,750,0,25,1
286,1,0,56.0,51.0,74.0,62.0,1919,1314,1763,979,156,335,268,491,194,245,74,246,34,26,850,1150,250,750,50,25,1
293,1,0,58.0,55.0,74.0,62.0,1835,1314,1679,979,156,335,243,351,149,65,94,286,34,26,1000,1250,250,1000,50,25,1
300,1,0,60.0,59.0,74.0,62.0,1919,1404,1763,1091,156,313,318,422,204,100,114,322,34,28,1000,1550,250,1000,50,25,1
307,1,0,58.5,62.0,66.0,62.0,1914,1482,1735,1147,179,335,243,297,109,85,134,212,34,28,1175,1550,250,1000,256,25,1
314,1,0,53.5,58.0,74.0,62.0,1914,1510,1735,1175,179,335,263,477,134,225,129,252,34,30,775,1450,450,1000,656,225,1
321,1,0,58.5,62.0,90.0,62.0,1919,1544,1763,1231,156,313,249,393,104,130,145,263,36,30,775,1550,450,1000,656,225,1
329,1,0,57.5,62.0,90.0,62.0,1919,1650,1763,1315,156,335,289,593,174,290,115,303,35,30,1125,1550,450,1000,681,225,1
336,1,0,57.5,61.0,84.0,62.0,1919,1706,1763,1371,156,335,319,488,184,145,135,343,35,30,1275,1500,450,1000,1031,275,1
343,1,0,59.0,61.0,84.0,62.0,1891,1572,1735,1259,156,313,422,669,248,290,174,379,35,30,1575,1700,450,1000,1068,275,1
350,1,0,49.0,59.0,84.0,62.0,1919,1544,1763,1231,156,313,662,769,468,350,194,419,35,30,875,1800,575,1075,1768,475,1
357,1,0,48.0,56.0,100.0,62.0,1942,1594,1763,1259,179,335,627,744,413,285,214,459,35,30,475,1300,575,1075,2168,975,1
364,1,0,47.0,55.0,100.0,62.0,1998,1594,1819,1259,179,335,512,634,278,135,234,499,35,32,175,1100,575,1075,2468,1175,1
371,1,0,47.0,53.0,100.0,62.0,1555,1628,1399,1315,156,313,573,830,323,295,250,535,33,32,425,1000,575,1075,2568,1275,1
379,1,0,47.0,56.0,100.0,62.0,1051,1678,895,1343,156,335,298,1035,28,460,270,575,33,34,225,1150,575,1075,2968,1325,1
386,1,0,46.5,58.0,100.0,62.0,995,1790,839,1455,156,335,313,750,48,135,265,615,34,34,200,1150,575,1375,3043,1325,1
393,1,0,45.5,58.0,100.0,62.0,1141,1712,1007,1399,134,313,364,641,83,190,281,451,31,34,200,1150,575,1375,3193,1325,1
400,1,0,45.5,61.0,100.0,62.0,771,1762,727,1427,44,335,289,871,8,380,281,491,30,36,500,1300,575,1375,3468,1375,1
407,1,0,43.0,59.0,100.0,62.0,671,1874,671,1539,0,335,334,841,53,310,281,531,30,38,425,1000,575,1375,3643,1675,1
414,1,0,43.0,57.0,100.0,62.0,1315,1852,1315,1539,0,313,519,797,238,230,281,567,31,38,675,800,575,1375,3643,1875,1
421,1,0,40.5,61.0,100.0,62.0,1511,1824,1511,1511,0,313,529,832,248,225,281,607,27,40,650,900,575,1375,3918,1875,1
429,1,0,35.5,61.0,100.0,62.0,1035,1874,1035,1539,0,335,634,857,353,210,281,647,26,40,400,1000,575,1575,4218,1875,1
7,2,2,13.0,13.0,15.0,15.0,293,251,293,251,0,0,35,30,35,30,0,0,12,12,0,0,0,0,0,0,0
14,2,2,14.0,14.0,15.0,15.0,671,671,671,671,0,0,70,70,70,70,0,0,13,13,0,0,0,0,0,0,0
21,2,2,14.0,14.0,15.0,15.0,671,671,671,671,0,0,45,45,45,45,0,0,13,13,0,0,0,0,0,0,0
29,2,2,15.0,15.0,15.0,15.0,727,671,727,671,0,0,90,80,90,80,0,0,14,14,0,0,0,0,0,0,0
36,2,2,15.0,15.0,23.0,15.0,755,755,755,755,0,0,130,135,130,135,0,0,14,14,0,0,0,0,0,0,0
43,2,2,16.0,16.0,23.0,23.0,783,755,783,755,0,0,25,20,25,20,0,0,15,15,0,0,0,0,0,0,0
50,2,2,17.0,17.0,23.0,23.0,811,839,811,839,0,0,50,45,50,45,0,0,16,16,0,0,0,0,0,0,0
57,2,2,18.0,18.0,23.0,23.0,839,783,839,783,0,0,25,95,25,95,0,0,17,17,0,0,0,0,0,0,0
64,2,2,19.0,18.0,23.0,23.0,895,923,895,923,0,0,85,155,85,155,0,0,18,17,0,0,0,0,0,0,0
71,2,2,19.0,19.0,23.0,23.0,895,951,895,951,0,0,45,220,45,220,0,0,18,18,0,0,0,0,0,0,0
79,2,2,20.0,20.0,23.0,23.0,923,967,923,923,0,44,105,333,105,325,0,8,19,19,0,0,0,0,0,0,0
86,2,2,21.0,20.0,23.0,23.0,950,1012,839,923,111,89,165,355,145,335,20,20,20,19,0,0,150,0,0,0,0
93,2,2,22.0,23.0,23.0,23.0,1012,1001,811,867,201,134,94,116,50,80,44,36,21,20,0,0,150,150,0,0,0
100,2,2,22.0,23.0,23.0,31.0,1062,1023,839,867,223,156,117,166,45,110,72,56,21,20,0,0,150,150,0,0,0
107,2,2,23.0,24.0,23.0,31.0,1057,1023,811,867,246,156,189,222,85,150,104,72,22,21,0,0,150,150,0,0,0
114,2,2,23.0,25.0,23.0,31.0,1130,1051,839,895,291,156,180,307,40,215,140,92,23,22,0,100,150,150,0,0,0
121,2,2,24.0,26.0,31.0,31.0,1107,1124,839,923,268,201,397,445,225,325,172,120,23,23,0,100,300,150,0,0,0
129,2,2,26.0,26.0,31.0,31.0,1152,1191,839,923,313,268,347,187,185,35,162,152,24,23,0,100,450,300,0,0,0
136,2,2,28.0,28.0,31.0,31.0,1146,1130,811,839,335,291,222,77,120,35,102,42,24,24,0,100,450,300,0,0,0
143,2,2,29.0,29.0,31.0,31.0,1180,1258,867,923,313,335,308,183,170,105,138,78,24,24,0,100,450,300,0,0,0
150,2,2,29.0,31.0,31.0,31.0,1180,1258,867,923,313,335,458,158,280,90,178,68,24,25,0,250,450,300,0,0,0
157,2,2,29.0,31.0,31.0,31.0,1152,1264,839,951,313,313,303,204,235,100,68,104,25,25,175,250,450,300,0,0,0
164,2,2,31.0,30.0,31.0,31.0,1186,1264,895,951,291,313,220,114,170,70,50,44,24,24,350,250,450,300,0,50,0
171,2,2,31.0,31.0,31.0,31.0,1158,1292,867,979,291,313,270,39,180,5,90,34,24,24,350,250,450,300,0,50,0
179,2,2,31.0,31.0,31.0,31.0,1314,1342,979,1007,335,335,431,274,305,150,126,124,25,25,350,425,450,300,0,50,0
186,2,2,31.0,31.0,39.0,31.0,1230,1286,895,951,335,335,171,265,5,105,166,160,25,25,350,425,450,400,0,50,0
193,2,2,32.0,31.0,39.0,31.0,1376,1320,1063,1007,313,313,287,376,85,180,202,196,25,25,525,425,450,400,0,50,0
200,2,2,32.0,32.0,39.0,54.0,1348,1264,1035,951,313,313,452,526,210,290,242,236,25,25,525,425,450,400,0,50,0
207,2,2,36.0,33.0,39.0,54.0,1398,1337,1063,979,335,358,207,481,75,205,132,276,26,25,525,425,750,400,0,50,0
214,2,2,37.0,36.0,39.0,54.0,1292,1202,979,867,313,335,253,322,85,85,168,237,27,27,525,425,750,650,0,50,0
221,2,2,37.0,37.0,39.0,54.0,1320,1208,1007,895,313,313,318,423,110,150,208,273,27,28,525,425,750,650,0,50,0
229,2,2,38.0,37.0,39.0,54.0,1370,1292,1035,979,335,313,419,483,175,170,244,313,28,29,525,425,750,650,0,50,0
236,2,2,38.0,39.0,47.0,54.0,1370,1264,1035,951,335,313,534,363,250,60,284,303,28,30,825,425,750,900,0,150,0
243,2,2,42.0,40.0,47.0,54.0,1404,1488,1091,1175,313,313,350,513,180,170,170,343,29,31,825,600,750,900,0,150,0
250,2,2,46.0,43.0,47.0,54.0,1398,1650,1063,1315,335,335,210,393,50,60,160,333,29,32,825,775,750,900,0,150,0
257,2,2,47.0,45.0,62.0,54.0,1426,1813,1091,1455,335,358,380,508,180,210,200,298,30,33,1075,775,750,1000,0,150,0
264,2,2,49.0,49.0,62.0,54.0,1460,1740,1147,1427,313,313,506,425,270,145,236,280,31,35,1075,950,750,1150,0,150,0
271,2,2,49.0,53.0,62.0,54.0,1544,1740,1231,1427,313,313,601,425,325,155,276,270,31,37,1075,950,750,1150,0,150,0
279,2,2,51.0,52.0,62.0,54.0,1706,1970,1371,1679,335,291,311,296,95,90,216,206,33,36,1075,1225,750,1150,0,200,0
286,2,2,51.0,54.0,62.0,54.0,1774,1975,1483,1707,291,268,533,322,285,130,248,192,33,38,1375,1400,750,1150,0,200,0
293,2,2,53.0,53.0,62.0,54.0,1802,1544,1511,1343,291,201,694,477,410,265,284,212,35,36,1375,1400,750,1150,0,300,0
300,2,2,55.0,53.0,62.0,54.0,1880,1141,1567,1007,313,134,369,523,145,295,224,228,37,35,1475,1400,750,1150,250,350,0
307,2,2,55.0,55.0,62.0,62.0,1908,1382,1595,1203,313,179,304,427,40,175,264,252,37,37,1475,1400,750,1150,250,350,0
314,2,2,57.0,55.0,62.0,62.0,1998,1606,1707,1315,291,291,550,278,250,90,300,188,39,34,1475,1400,900,1400,250,550,0
321,2,2,54.0,53.0,62.0,62.0,2098,1583,1763,1427,335,156,790,430,450,230,340,200,39,32,1175,1750,1150,1400,550,700,0
329,2,2,60.0,55.0,70.0,62.0,2182,1734,1847,1623,335,111,105,186,75,120,30,66,41,33,1525,1750,1350,1400,550,700,0
336,2,2,60.0,56.0,70.0,62.0,2132,1841,1819,1707,313,134,186,357,120,275,66,82,41,34,1525,1750,1350,1400,550,700,0
343,2,2,60.0,58.0,70.0,62.0,2250,1729,1959,1595,291,134,438,443,340,345,98,98,43,36,1525,1750,1350,1550,550,700,0
350,2,2,60.0,60.0,70.0,62.0,2110,1880,1819,1567,291,313,693,241,555,95,138,146,43,38,1525,1750,1500,1550,550,700,0
357,2,2,62.0,60.0,78.0,62.0,2362,1942,1959,1539,403,403,290,169,150,75,140,94,43,38,1525,1750,1500,1550,550,750,0
364,2,2,66.0,61.0,78.0,62.0,2423,2104,1931,1679,492,425,300,326,150,180,150,146,43,39,1875,1750,1500,1550,550,750,0
371,2,2,67.0,62.0,78.0,62.0,2395,2132,1903,1707,492,425,272,434,170,240,102,194,44,40,1875,1750,1500,1550,550,750,0
379,2,2,67.0,62.0,86.0,62.0,2451,2199,1959,1819,492,380,267,534,105,300,162,234,45,41,1875,1750,1500,1550,550,750,0
386,2,2,69.0,62.0,86.0,62.0,2373,2076,1903,1763,470,313,284,735,70,465,214,270,46,42,1875,1750,1500,1550,550,750,0
393,2,2,69.0,68.0,86.0,78.0,2457,2188,1987,1763,470,425,134,480,10,250,124,230,46,42,1875,1750,1500,1550,550,750,0
400,2,2,71.0,74.0,86.0,86.0,2356,2154,1931,1707,425,447,261,332,85,150,176,182,48,44,1875,2100,1500,1550,550,750,0
407,2,2,71.0,76.0,86.0,86.0,2255,2289,1763,1819,492,470,521,287,285,95,236,192,48,44,1875,2275,1500,1550,550,750,0
414,2,2,79.0,78.0,86.0,86.0,2283,2233,1791,1763,492,470,181,512,110,260,71,252,50,46,2400,2275,1750,1550,550,750,0
421,2,2,79.0,80.0,86.0,109.0,2451,2395,1959,1903,492,492,487,392,360,180,127,212,51,46,2400,2475,1750,1650,550,925,0
429,2,2,71.0,81.0,101.0,109.0,2367,2412,1875,1875,492,537,767,512,580,240,187,272,51,48,1700,2650,2200,1650,1250,1100,0
436,2,2,70.0,80.0,101.0,109.0,2563,2418,2071,1903,492,515,1038,533,795,255,243,278,51,49,1625,2300,2200,1650,1425,1450,0
443,2,2,82.0,86.0,101.0,109.0,2731,2485,2239,2015,492,470,203,150,150,20,53,130,51,51,2500,2475,2350,1650,1425,1450,0
450,2,2,85.0,89.0,101.0,109.0,2765,2709,2295,2239,470,470,279,435,170,245,109,190,52,54,2500,2475,2350,1650,1425,1450,0
457,2,2,87.0,93.0,101.0,109.0,2871,2546,2379,2099,492,447,584,381,415,235,169,146,54,55,2500,2475,2350,1650,1425,1450,0
464,2,2,87.0,96.0,101.0,109.0,2759,2149,2267,1791,492,358,384,430,305,240,79,190,57,57,2500,2825,2650,1650,1425,1450,0
471,2,2,85.0,94.0,101.0,109.0,2882,2535,2435,2155,447,380,182,443,55,205,127,238,57,57,2325,2675,2750,1650,1600,1600,0
479,2,2,81.0,91.0,101.0,109.0,2714,2961,2267,2491,447,470,483,410,300,220,183,190,57,60,2225,2325,2750,1650,1950,1950,0
486,2,2,83.0,95.0,101.0,109.0,3039,2966,2547,2519,492,447,613,222,495,130,118,92,57,60,2225,2700,2750,1650,1950,1950,0
493,2,2,95.0,101.0,109.0,109.0,3151,3073,2659,2603,492,470,229,192,180,40,49,152,57,61,2725,2700,2750,1650,1950,1950,0
500,2,2,97.0,101.0,109.0,109.0,3112,2961,2575,2491,537,470,292,538,275,330,17,208,57,61,3225,3000,3050,1650,1950,1950,0
507,2,2,95.0,101.0,109.0,117.0,3062,2933,2435,2463,627,470,658,813,565,545,93,268,59,61,2975,3000,3200,1650,2200,1950,0
514,2,2,92.0,99.0,109.0,125.0,3218,2955,2547,2463,671,492,948,983,775,655,173,328,59,58,2425,3375,3350,1550,2750,2200,0
521,2,2,108.0,99.0,109.0,125.0,3162,2894,2491,2379,671,515,343,868,190,480,153,388,59,58,3025,3375,3350,1850,2750,2200,0
529,2,2,108.0,109.0,109.0,125.0,3308,2983,2659,2491,649,492,425,379,300,135,125,244,61,59,3025,3775,3350,2000,2750,2200,0
536,2,2,108.0,109.0,109.0,125.0,3162,2832,2491,2295,671,537,395,618,190,310,205,308,61,59,3025,3875,3350,2000,2750,2200,0
543,2,2,108.0,111.0,109.0,125.0,3084,2804,2435,2155,649,649,381,613,200,225,181,388,61,59,3025,3875,3350,2000,2750,2200,0
550,2,2,117.0,111.0,117.0,125.0,3062,2916,2435,2267,627,649,262,964,105,500,157,464,61,59,3025,3875,3350,2300,2750,2200,0
557,2,2,117.0,115.0,117.0,133.0,3196,2944,2547,2295,649,649,447,719,210,175,237,544,61,59,3850,4075,3350,2300,2750,2200,0
564,2,2,117.0,115.0,117.0,141.0,3062,2972,2435,2323,627,649,549,1060,240,440,309,620,62,59,3850,4075,3350,2300,2750,2200,0
571,2,2,117.0,123.0,117.0,141.0,2955,3022,2351,2351,604,671,650,325,265,225,385,100,62,59,3850,4075,3350,2950,2750,2200,0
579,2,2,124.0,127.0,133.0,141.0,2804,2916,2155,2267,649,649,940,316,475,140,465,176,62,59,3850,4525,3350,2950,2750,2200,0
586,2,2,132.0,130.0,133.0,141.0,2854,3056,2183,2407,671,649,290,382,245,130,45,252,62,59,4850,5425,3350,2950,2750,2200,0
593,2,2,135.0,134.0,141.0,141.0,2994,2894,2323,2267,671,627,251,513,130,185,121,328,65,59,4850,5625,3500,2950,2750,2200,0
600,2,2,138.0,134.0,141.0,141.0,3056,2972,2407,2323,649,649,392,858,195,450,197,408,66,62,5050,5625,3600,3250,2750,2200,0
607,2,2,136.0,132.0,164.0,141.0,3084,2994,2435,2323,649,671,353,913,280,425,73,488,67,62,4950,5375,3600,3250,2850,2750,0
614,2,2,114.0,132.0,180.0,141.0,3336,3106,2687,2435,649,671,573,774,420,210,153,564,67,62,3175,5150,3600,3250,4625,3475,0
621,2,2,98.0,114.0,180.0,141.0,3504,3028,2855,2379,649,649,889,1130,660,490,229,640,67,62,2875,4250,3500,3250,5700,4375,0
629,2,2,98.0,99.0,180.0,156.0,3778,2821,3107,2239,671,582,549,1444,490,740,59,704,67,51,2250,4050,3500,3400,6325,5275,0
636,2,2,90.0,99.0,180.0,156.0,3756,2339,3107,1847,649,492,800,844,665,230,135,614,67,48,2000,4025,3500,3400,7375,5975,0
643,2,2,82.0,103.0,180.0,148.0,3784,2345,3135,1875,649,470,1146,1020,935,425,211,595,67,51,1450,4025,3500,3400,8125,6075,0
650,2,2,82.0,102.0,180.0,148.0,3728,2479,3079,1987,649,492,1151,1155,985,500,166,655,67,50,800,4025,3500,3400,8875,6125,0
657,2,2,84.0,105.0,180.0,148.0,3868,2367,3219,1875,649,492,827,1381,685,670,142,711,67,53,1000,4025,3500,3400,9125,6125,0
664,2,2,94.0,104.0,180.0,148.0,3706,2451,3079,1959,627,492,263,1441,170,670,93,771,67,55,1000,3650,3500,3400,9125,6500,0
671,2,2,94.0,123.0,180.0,148.0,3756,2541,3107,2071,649,470,723,342,550,265,173,77,67,58,1150,4650,3500,3400,9125,6500,0
679,2,2,98.0,125.0,180.0,148.0,3829,2647,3135,2155,694,492,442,312,410,175,32,137,67,60,1950,4150,3500,3400,9125,6500,0
686,2,2,106.0,127.0,196.0,156.0,3801,2731,3107,2239,694,492,496,627,380,430,116,197,67,63,2150,4150,3500,3400,9125,6500,0
693,2,2,110.0,133.0,196.0,156.0,3767,2899,3051,2407,716,492,945,318,745,215,200,103,67,65,2725,5050,3900,3250,9125,6700,0
700,2,2,108.0,131.0,196.0,156.0,3711,2922,2995,2407,716,515,1389,663,1105,500,284,163,67,64,2475,5575,3900,3250,9375,6800,0
707,2,2,120.0,133.0,196.0,156.0,3767,2955,3051,2463,716,492,537,459,415,390,122,69,67,64,2975,5875,3900,3400,9375,6800,0
714,2,2,125.0,141.0,196.0,156.0,3633,3185,2939,2715,694,470,581,295,375,170,206,125,67,64,3275,5475,4050,3400,9375,6800,0
721,2,2,127.0,148.0,196.0,156.0,3616,3185,2855,2715,761,470,912,325,610,140,302,185,67,64,3275,5975,4050,3550,9375,6800,0
729,2,2,140.0,148.0,196.0,164.0,3638,3437,2855,2855,783,582,689,636,295,375,394,261,68,64,3650,6425,4050,3550,9375,6800,0
736,2,2,136.0,152.0,196.0,164.0,3638,3459,2855,2855,783,604,1127,568,645,285,482,283,71,67,4050,6950,4050,3650,9575,7000,0
743,2,2,120.0,122.0,196.0,172.0,3728,3487,2855,2883,873,604,1059,985,615,630,444,355,71,67,3125,4700,3800,3800,10925,9250,0
750,2,2,118.0,113.0,196.0,172.0,3997,3543,2967,2939,1030,604,479,1412,215,985,264,427,71,67,3825,3950,3800,3800,11625,10000,0
757,2,2,116.0,109.0,196.0,172.0,4137,3571,2995,2967,1142,604,975,1839,575,1340,400,499,71,67,3650,3500,4250,3800,11800,10450,0
764,2,2,124.0,133.0,196.0,172.0,4008,3549,2911,2967,1097,582,429,111,405,40,24,71,71,67,3650,5250,4500,3800,11800,10450,0
771,2,2,124.0,133.0,196.0,172.0,4036,3482,2939,2855,1097,627,916,527,760,380,156,147,71,67,4650,5250,4500,3800,11800,10450,0
779,2,2,129.0,134.0,188.0,172.0,3874,3566,2799,2939,1075,627,759,718,475,495,284,223,64,71,4650,5000,4400,3800,12325,10700,0
786,2,2,116.0,123.0,188.0,172.0,3280,3459,2295,2855,985,604,1136,1126,740,835,396,291,61,71,4750,4000,4400,3800,12975,11700,0
793,2,2,106.0,132.0,188.0,172.0,3039,3616,2099,2967,940,649,1502,681,990,310,512,371,61,71,3925,4500,4400,3800,13800,12150,0
800,2,2,106.0,122.0,173.0,172.0,3011,3638,2071,2967,940,671,1849,1117,1225,670,624,447,61,71,3925,3675,4400,3650,14200,13125,0
807,2,2,109.0,122.0,173.0,172.0,2966,3750,2071,3079,895,671,1002,1062,570,735,432,327,60,71,3675,3500,4400,3650,14500,13300,0
814,2,2,113.0,122.0,173.0,172.0,2905,3510,1987,2771,918,739,545,948,405,675,140,273,60,71,4175,3750,4400,3650,14500,13300,0
821,2,2,113.0,137.0,173.0,172.0,2905,3549,1987,2743,918,806,893,469,645,175,248,294,60,73,4175,3575,4400,3650,14500,13475,0
829,2,2,113.0,137.0,181.0,172.0,2793,3532,1875,2771,918,761,826,491,470,105,356,386,60,73,4175,4375,4400,3650,14500,13475,0
836,2,2,119.0,141.0,189.0,172.0,2815,3532,1875,2771,940,761,449,513,285,335,164,178,60,73,3775,4375,4400,3650,14500,13475,0
843,2,2,119.0,141.0,189.0,172.0,2849,3594,1931,2743,918,851,498,641,380,355,118,286,60,73,4675,4925,4400,3800,14500,13475,0
850,2,2,119.0,148.0,189.0,172.0,2843,3661,1903,2631,940,1030,558,670,470,335,88,335,60,73,4675,5225,4400,3800,14500,13475,0
857,2,2,130.0,148.0,189.0,172.0,3045,3818,2015,2743,1030,1075,358,1143,150,680,208,463,60,73,4675,5225,4400,3950,14500,13475,0
864,2,2,134.0,158.0,189.0,172.0,2894,3885,1931,2743,963,1142,699,1084,375,485,324,599,60,73,5525,5825,4900,4500,14750,13475,0
871,2,2,134.0,158.0,189.0,172.0,2860,3812,1875,2715,985,1097,1050,1387,610,660,440,727,61,73,5525,5825,4900,4800,14750,12950,0
879,2,2,136.0,164.0,204.0,172.0,2961,3694,1931,2575,1030,1119,389,993,225,280,164,713,61,73,5350,6350,4900,4800,14925,12950,0
886,2,2,144.0,164.0,204.0,172.0,2933,3638,1903,2519,1030,1119,357,1443,165,590,192,853,61,73,6450,6350,4900,4800,14925,12950,0
893,2,2,148.0,172.0,212.0,172.0,3213,3549,2071,2407,1142,1142,398,849,170,460,228,389,61,73,5550,6750,4900,4800,14925,12950,0
900,2,2,148.0,172.0,212.0,172.0,3302,3521,2183,2379,1119,1142,800,1275,440,750,360,525,61,73,7400,6350,4900,4800,14925,12950,0
907,2,2,145.0,171.0,212.0,172.0,3381,3633,2239,2491,1142,1142,1201,1497,705,840,496,657,61,73,7100,6900,5000,4800,15225,13500,0
914,2,2,154.0,161.0,212.0,180.0,3431,3655,2267,2491,1164,1164,921,1687,285,990,636,697,61,73,6700,6400,5000,4950,15625,14000,0
921,2,2,154.0,177.0,212.0,188.0,3336,3560,2295,2463,1041,1097,1309,1105,555,430,754,675,61,72,7400,6400,5000,4950,15625,14050,0
929,2,2,152.0,175.0,212.0,188.0,3151,3638,2211,2519,940,1119,1375,1541,505,730,870,811,61,72,7300,6925,4850,5100,15875,14225,0
936,2,2,158.0,171.0,212.0,188.0,3224,3476,2239,2379,985,1097,1015,1643,400,850,615,793,61,72,8050,6725,4700,5100,16025,14425,0
943,2,2,161.0,171.0,212.0,188.0,3118,3358,2211,2239,907,1119,682,1314,115,460,567,854,61,72,8050,6725,4700,5100,16025,14425,0
950,2,2,164.0,171.0,212.0,188.0,2994,3302,2211,2239,783,1063,725,1706,220,730,505,976,61,72,8050,6725,4700,5250,16025,14425,0
957,2,2,164.0,172.0,212.0,188.0,3017,3302,2211,2295,806,1007,1096,1333,495,545,601,788,61,72,8050,7025,4700,5250,16025,14425,0
964,2,2,176.0,172.0,212.0,188.0,2966,3207,2183,2267,783,940,398,1461,5,640,393,821,61,72,8050,7025,5000,5500,16025,14425,0
971,2,2,176.0,170.0,212.0,188.0,3101,3151,2295,2211,806,940,778,1536,285,745,493,791,61,72,9700,6325,5150,5500,16025,15225,0
979,2,2,182.0,170.0,212.0,188.0,3213,3174,2407,2211,806,963,774,1517,185,835,589,682,61,72,9150,6325,5400,5650,16275,15225,0
986,2,2,188.0,170.0,212.0,188.0,3314,3263,2463,2323,851,940,559,1913,170,1115,389,798,61,72,9800,6325,5400,5650,16275,15225,0
993,2,2,192.0,163.0,212.0,188.0,3235,3168,2407,2239,828,929,450,2288,215,1380,235,908,61,64,10300,6525,5100,5650,16575,16275,0
1000,2,2,186.0,173.0,204.0,180.0,3190,2972,2407,2155,783,817,823,1055,500,505,323,550,55,61,10300,6275,4850,5650,17125,17225,0
1007,2,2,153.0,166.0,188.0,180.0,2446,2927,1819,2099,627,828,1095,1410,700,760,395,650,33,60,9300,7325,4750,5950,19600,17800,0
1014,2,2,151.0,165.0,173.0,172.0,1785,2782,1315,2043,470,739,1301,1644,850,910,451,734,33,60,9200,7250,4750,5800,20175,18225,0
1021,2,2,165.0,165.0,165.0,164.0,1757,2748,1287,1987,470,761,416,1671,55,695,361,976,33,51,9800,7250,4750,5300,20375,19275,0
1029,2,2,161.0,132.0,165.0,164.0,1779,2283,1287,1567,492,716,636,1935,215,875,421,1060,33,48,10000,5925,4750,5300,20875,21450,0
1036,2,2,161.0,121.0,165.0,172.0,1830,2222,1315,1595,515,627,861,1511,380,525,481,986,33,48,10000,4375,4750,5300,20875,23000,0
1043,2,2,157.0,104.0,165.0,172.0,1723,2171,1231,1567,492,604,1047,1473,510,565,537,908,33,48,9800,3800,4750,5300,21075,23975,0
1050,2,2,165.0,108.0,165.0,157.0,1611,2138,1119,1511,492,627,258,770,165,115,93,655,33,47,9800,4025,4750,5300,21075,24900,0
1057,2,2,163.0,110.0,165.0,157.0,1751,2059,1259,1455,492,604,463,1023,310,300,153,723,33,46,10700,4575,4750,4850,21175,25400,0
1064,2,2,161.0,89.0,165.0,141.0,1645,1919,1175,1427,470,492,654,1240,445,465,209,775,33,27,10900,4400,4750,4450,21275,27125,0
1071,2,2,160.0,75.0,165.0,126.0,1617,1158,1147,867,470,291,344,1052,325,395,19,657,31,21,10600,3925,4750,4450,21625,28450,0
1079,2,2,160.0,69.0,165.0,126.0,1331,911,839,643,492,268,299,1159,220,470,79,689,29,21,11050,3625,4750,4450,21975,28750,0
1086,2,2,150.0,55.0,165.0,126.0,1410,889,895,643,515,246,459,1271,320,550,139,721,29,21,10100,2850,4750,4450,22925,29525,0
1093,2,2,150.0,58.0,165.0,126.0,1225,1023,755,755,470,268,601,1388,410,635,191,753,29,21,10100,3150,4750,4450,22925,29525,0
1100,2,2,148.0,58.0,165.0,126.0,1191,1051,699,783,492,268,741,1505,490,720,251,785,29,21,10000,3150,4750,4450,23025,29525,0
1107,2,2,140.0,53.0,165.0,126.0,1197,995,727,727,470,268,882,1607,575,790,307,817,29,21,9600,2750,4750,4450,23425,29925,0
1114,2,2,146.0,49.0,165.0,126.0,1309,911,839,643,470,268,652,214,285,115,367,99,29,18,9425,1400,4750,4450,23600,31425,0
1121,2,2,137.0,47.0,165.0,126.0,1527,939,1035,671,492,268,837,326,410,195,427,131,29,16,9075,3200,4750,4450,24350,31525,0
1129,2,2,129.0,44.0,165.0,118.0,1522,911,1007,643,515,268,1012,428,525,265,487,163,29,16,8525,2900,4750,4200,24350,32175,0
1136,2,2,136.0,41.0,165.0,118.0,1505,861,1035,615,470,246,89,531,50,340,39,191,28,13,8425,2900,4750,3750,24500,32775,0
1143,2,2,127.0,20.0,165.0,118.0,1382,536,979,447,403,89,248,576,165,385,83,191,25,2,9225,2025,4750,3500,24950,34450,0
7,0,2,13.0,13.0,15.0,15.0,293,251,293,251,0,0,35,30,35,30,0,0,12,12,0,0,0,0,0,0,0
14,0,2,14.0,14.0,15.0,15.0,671,671,671,671,0,0,70,70,70,70,0,0,13,13,0,0,0,0,0,0,0
21,0,2,14.0,14.0,15.0,15.0,699,671,699,671,0,0,0,45,0,45,0,0,13,13,0,0,0,0,0,0,0
29,0,2,15.0,15.0,15.0,15.0,699,727,699,727,0,0,40,90,40,90,0,0,14,14,0,0,0,0,0,0,0
36,0,2,15.0,15.0,15.0,15.0,811,811,811,811,0,0,145,145,145,145,0,0,14,14,0,0,0,0,0,0,0
43,0,2,16.0,16.0,23.0,23.0,783,867,783,867,0,0,75,90,75,90,0,0,15,15,0,0,0,0,0,0,0
50,0,2,16.0,17.0,23.0,23.0,783,839,783,839,0,0,40,60,40,60,0,0,15,16,0,0,0,0,0,0,0
57,0,2,17.0,18.0,23.0,23.0,755,895,755,895,0,0,15,120,15,120,0,0,16,17,0,0,0,0,0,0,0
64,0,2,18.0,19.0,23.0,23.0,755,923,755,923,0,0,45,175,45,175,0,0,17,18,0,0,0,0,0,0,0
71,0,2,18.0,19.0,23.0,23.0,794,945,727,923,67,22,147,284,135,280,12,4,17,18,0,0,0,0,0,0,0
79,0,2,19.0,20.0,23.0,23.0,855,1018,699,951,156,67,252,362,220,350,32,12,18,19,0,0,0,0,0,0,0
86,0,2,19.0,20.0,23.0,23.0,883,990,615,923,268,67,357,480,285,460,72,20,18,19,0,0,0,0,0,0,0
93,0,2,20.0,20.0,23.0,23.0,922,1018,587,951,335,67,122,48,60,20,62,28,19,20,0,0,150,150,0,0,0
100,0,2,20.0,21.0,23.0,23.0,978,1062,643,951,335,111,247,134,145,90,102,44,19,20,0,0,150,150,0,0,0
107,0,2,20.0,21.0,23.0,23.0,956,1079,643,923,313,156,108,84,70,20,38,64,19,20,0,0,150,150,0,0,0
114,0,2,20.0,22.0,31.0,23.0,967,1158,699,979,268,179,226,164,160,80,66,84,19,21,0,0,150,150,0,0,0
121,0,2,22.0,22.0,31.0,31.0,950,1051,727,895,223,156,150,280,110,180,40,100,19,21,100,0,150,150,0,0,0
129,0,2,23.0,25.0,31.0,31.0,1169,1107,923,951,246,156,297,145,225,100,72,45,20,22,100,0,150,300,0,0,0
136,0,2,23.0,26.0,31.0,31.0,1281,1096,1035,895,246,201,400,228,300,155,100,73,20,23,100,0,150,300,0,0,0
143,0,2,24.0,26.0,31.0,31.0,1180,1214,979,923,201,291,154,209,30,150,124,59,21,23,100,0,150,300,0,0,0
150,0,2,26.0,29.0,31.0,31.0,1393,1264,1147,951,246,313,186,299,30,200,156,99,21,24,100,125,400,300,0,0,0
157,0,2,27.0,29.0,31.0,31.0,1365,1258,1119,923,246,335,234,304,100,165,134,139,22,24,200,125,400,300,0,0,0
164,0,2,28.0,30.0,31.0,31.0,1454,1236,1231,923,223,313,107,225,45,100,62,125,23,25,200,300,400,300,0,0,0
171,0,2,30.0,32.0,31.0,46.0,1421,1370,1175,1035,246,335,65,90,0,25,65,65,23,25,300,300,400,300,0,50,0
179,0,2,31.0,33.0,31.0,46.0,1393,1342,1147,1007,246,335,178,200,85,95,93,105,24,25,300,300,400,300,0,50,0
186,0,2,31.0,33.0,31.0,46.0,1281,1432,1035,1119,246,313,270,121,145,80,125,41,24,26,300,300,400,300,0,50,0
193,0,2,34.0,35.0,39.0,46.0,1354,1432,1063,1119,291,313,346,191,210,110,136,81,25,27,400,300,500,300,0,50,0
200,0,2,34.0,35.0,39.0,46.0,1488,1566,1175,1231,313,335,521,221,345,100,176,121,25,28,400,475,750,300,0,50,0
207,0,2,39.0,37.0,39.0,46.0,1645,1594,1287,1259,358,335,351,301,235,140,116,161,26,29,400,475,750,450,0,50,0
214,0,2,38.0,33.0,54.0,46.0,1566,1600,1231,1287,335,313,477,388,325,195,152,193,26,25,400,475,750,450,100,250,0
221,0,2,39.0,36.0,54.0,46.0,1628,1505,1315,1259,313,246,283,419,120,273,163,146,27,27,400,475,750,950,200,250,0
229,0,2,40.0,42.0,54.0,46.0,1544,1494,1231,1203,313,291,358,204,155,118,203,86,27,29,400,825,750,950,200,250,0
236,0,2,41.0,43.0,54.0,46.0,1600,1494,1287,1203,313,291,485,330,242,208,243,122,28,30,600,825,750,950,200,250,0
243,0,2,44.0,45.0,54.0,46.0,1656,1712,1343,1399,313,313,148,145,90,133,58,12,28,32,700,925,825,950,200,250,0
250,0,2,47.0,46.0,54.0,54.0,1701,1678,1343,1343,358,335,183,185,85,133,98,52,29,33,700,925,825,950,200,250,0
257,0,2,48.0,48.0,54.0,54.0,1785,1762,1427,1427,358,335,188,305,50,213,138,92,29,35,750,925,925,950,200,250,0
264,0,2,52.0,48.0,54.0,54.0,1992,1790,1679,1455,313,335,100,476,55,348,45,128,31,35,800,925,1000,950,200,250,0
271,0,2,53.0,48.0,54.0,54.0,1992,1902,1679,1567,313,335,140,646,55,478,85,168,31,37,800,800,1000,950,200,375,0
279,0,2,53.0,47.0,54.0,62.0,2076,1516,1763,1203,313,313,345,747,220,543,125,204,31,36,750,800,1000,950,300,475,0
286,0,2,54.0,48.0,54.0,62.0,1964,1488,1651,1175,313,313,390,397,225,153,165,244,33,37,1100,800,1000,950,300,475,0
293,0,2,56.0,52.0,62.0,62.0,2020,1930,1707,1595,313,335,465,352,260,118,205,234,33,39,1100,800,1150,950,300,475,0
300,0,2,57.0,52.0,62.0,62.0,2065,2070,1707,1735,358,335,525,387,280,113,245,274,33,39,1475,975,1150,950,300,475,0
307,0,2,62.0,54.0,70.0,70.0,2070,2076,1735,1763,335,313,351,504,195,198,156,306,35,41,1475,975,1300,950,300,475,0
314,0,2,65.0,55.0,70.0,70.0,2160,2104,1847,1791,313,313,332,455,165,113,167,342,36,43,1475,975,1300,950,300,475,0
321,0,2,67.0,59.0,70.0,70.0,2177,2244,1819,1931,358,313,140,465,75,183,65,282,37,44,1525,1125,1425,950,300,475,0
329,0,2,69.0,59.0,70.0,70.0,2238,2233,1791,1875,447,358,161,640,90,318,71,322,38,44,1700,1125,1425,950,300,475,0
336,0,2,74.0,61.0,78.0,78.0,2457,2289,1987,1931,470,358,186,300,105,38,81,262,39,46,1825,1125,1425,1100,300,475,0
343,0,2,76.0,62.0,78.0,78.0,2535,2289,2043,1819,492,470,96,420,55,98,41,322,40,47,1925,1125,1425,1100,300,475,0
350,0,2,78.0,63.0,86.0,86.0,2642,2317,2127,1847,515,470,301,655,200,273,101,382,41,49,1925,1125,1425,1100,300,475,0
357,0,2,80.0,65.0,86.0,101.0,2681,2177,2211,1707,470,470,268,520,165,78,103,442,42,50,2125,1125,1425,1250,420,475,0
364,0,2,88.0,66.0,94.0,101.0,2647,2474,2155,1959,492,515,178,480,65,78,113,402,43,50,2175,1125,1525,1250,420,475,0
371,0,2,90.0,69.0,94.0,101.0,2731,2580,2239,2043,492,537,208,385,135,123,73,262,44,53,2175,1125,1525,1350,420,475,0
379,0,2,94.0,70.0,94.0,101.0,2541,2675,2071,2183,470,492,49,557,20,243,29,314,45,54,2525,1125,1525,1350,420,475,0
386,0,2,98.0,72.0,102.0,101.0,2653,2737,2183,2267,470,470,244,638,155,268,89,370,47,56,2725,1125,1525,1650,420,475,0
393,0,2,103.0,80.0,110.0,101.0,2530,2905,2015,2435,515,470,149,493,50,63,99,430,47,58,2775,1425,1525,1650,420,475,0
400,0,2,108.0,79.0,110.0,101.0,2530,2961,2015,2491,515,470,154,798,95,308,59,490,47,59,3125,1425,1525,1800,420,475,0
407,0,2,108.0,83.0,118.0,101.0,2703,3050,2211,2603,492,447,191,284,180,38,11,246,47,60,3125,1425,1525,2400,420,475,0
414,0,2,116.0,87.0,118.0,109.0,2843,3095,2351,2603,492,492,121,284,100,278,21,6,47,60,3625,1425,1525,2550,420,475,0
421,0,2,118.0,95.0,126.0,117.0,2821,3258,2351,2743,470,515,232,264,180,198,52,66,47,60,3725,2225,1525,2550,420,475,0
429,0,2,120.0,95.0,134.0,125.0,2821,3045,2351,2575,470,470,317,502,280,388,37,114,47,60,3775,2225,1525,2550,420,475,0
436,0,2,123.0,98.0,134.0,125.0,2899,3017,2407,2547,492,470,267,502,170,328,97,174,47,60,4325,2325,1525,2550,420,475,0
443,0,2,126.0,106.0,142.0,133.0,2894,2938,2379,2491,515,447,222,363,190,283,32,80,47,61,4525,3200,1525,2550,420,475,0
450,0,2,133.0,106.0,142.0,133.0,2787,3157,2295,2687,492,470,268,628,230,488,38,140,47,61,4700,3200,1525,2550,420,475,0
457,0,2,133.0,114.0,142.0,133.0,2675,3291,2183,2799,492,492,569,383,475,333,94,50,47,61,4800,3200,1525,2550,420,475,0
464,0,2,135.0,106.0,142.0,133.0,2731,2972,2239,2435,492,537,294,608,240,498,54,110,47,53,4750,3200,1525,2550,520,875,0
471,0,2,138.0,113.0,142.0,141.0,2317,2670,1847,2155,470,515,210,464,125,298,85,166,47,53,5350,3850,1525,2550,520,975,0
479,0,2,137.0,95.0,142.0,149.0,2177,2434,1707,1875,470,559,305,255,185,171,120,84,49,45,5150,3050,1525,2450,720,2175,0
486,0,2,139.0,94.0,142.0,141.0,2362,1902,1847,1455,515,447,215,774,160,496,55,278,49,47,5150,3350,1525,2300,770,2349,0
7,2,0,13.0,13.0,15.0,15.0,377,377,377,377,0,0,45,45,45,45,0,0,12,12,0,0,0,0,0,0,0
14,2,0,14.0,14.0,15.0,15.0,671,643,671,643,0,0,70,65,70,65,0,0,13,13,0,0,0,0,0,0,0
21,2,0,14.0,14.0,15.0,15.0,699,699,699,699,0,0,50,50,50,50,0,0,13,13,0,0,0,0,0,0,0
29,2,0,15.0,15.0,15.0,15.0,783,643,783,643,0,0,110,85,110,85,0,0,14,14,0,0,0,0,0,0,0
36,2,0,16.0,15.0,23.0,15.0,811,755,811,755,0,0,150,130,150,130,0,0,15,14,0,0,0,0,0,0,0
43,2,0,16.0,16.0,23.0,23.0,839,783,839,783,0,0,45,70,45,70,0,0,15,15,0,0,0,0,0,0,0
50,2,0,17.0,16.0,23.0,23.0,839,755,839,755,0,0,20,35,20,35,0,0,16,15,0,0,0,0,0,0,0
57,2,0,18.0,17.0,23.0,23.0,839,699,839,699,0,0,80,80,80,80,0,0,17,16,0,0,0,0,0,0,0
64,2,0,19.0,18.0,23.0,23.0,979,811,979,811,0,0,150,175,150,175,0,0,18,17,0,0,0,0,0,0,0
71,2,0,19.0,18.0,23.0,23.0,945,855,923,811,22,44,249,228,245,220,4,8,18,17,0,0,0,0,0,0,0
79,2,0,20.0,19.0,23.0,23.0,990,939,923,783,67,156,377,343,365,315,12,28,19,18,0,0,0,0,0,0,0
86,2,0,20.0,19.0,23.0,23.0,1006,995,895,839,111,156,103,468,75,420,28,48,19,18,0,0,150,0,0,0,0
93,2,0,20.0,20.0,23.0,23.0,1034,1023,923,867,111,156,75,329,35,315,40,14,20,19,0,0,150,150,0,0,0
100,2,0,21.0,20.0,23.0,23.0,1051,1023,895,867,156,156,75,444,15,410,60,34,20,19,0,0,150,150,0,0,0
107,2,0,22.0,20.0,23.0,23.0,1130,967,951,811,179,156,160,164,80,110,80,54,21,19,0,0,150,150,0,0,0
114,2,0,22.0,21.0,23.0,23.0,1051,995,895,839,156,156,186,144,90,70,96,74,21,19,0,0,150,150,0,0,0
121,2,0,23.0,21.0,23.0,23.0,1107,883,951,727,156,156,266,144,150,100,116,44,22,19,0,100,150,150,0,0,0
129,2,0,25.0,22.0,31.0,23.0,1169,1102,923,923,246,179,292,99,165,35,127,64,22,20,0,100,300,150,0,0,0
136,2,0,26.0,22.0,31.0,31.0,1236,1158,923,979,313,179,92,254,75,170,17,84,23,20,0,100,300,150,0,0,0
143,2,0,27.0,23.0,31.0,31.0,1258,1163,923,1007,335,156,92,185,85,85,7,100,24,21,0,100,300,150,0,0,0
150,2,0,29.0,23.0,31.0,31.0,1286,1191,951,1035,335,156,113,230,95,110,18,120,25,21,125,100,300,150,0,0,0
157,2,0,31.0,24.0,46.0,31.0,1286,1275,951,1119,335,156,113,330,55,190,58,140,25,22,125,100,300,250,0,0,0
164,2,0,32.0,27.0,46.0,31.0,1320,1331,1007,1175,313,156,229,325,135,165,94,160,26,23,125,100,300,250,0,0,0
171,2,0,34.0,27.0,46.0,31.0,1488,1331,1175,1175,313,156,309,475,175,295,134,180,28,23,125,100,300,250,0,0,0
179,2,0,38.0,30.0,46.0,46.0,1544,1354,1231,1175,313,179,149,260,125,85,24,175,29,24,125,200,600,500,0,0,0
186,2,0,39.0,30.0,46.0,46.0,1622,1303,1287,1147,335,156,299,271,235,105,64,166,30,24,250,200,600,650,0,0,0
193,2,0,41.0,31.0,46.0,46.0,1678,1359,1343,1203,335,156,394,346,290,160,104,186,32,25,250,200,600,650,0,0,0
200,2,0,41.0,36.0,46.0,46.0,1762,1723,1427,1567,335,156,255,226,215,120,40,106,32,26,250,300,600,725,0,0,0
207,2,0,43.0,37.0,46.0,46.0,1768,1667,1455,1511,313,156,426,116,350,90,76,26,34,26,250,300,600,800,0,0,0
214,2,0,44.0,39.0,54.0,46.0,1936,1891,1623,1735,313,156,456,236,340,190,116,46,35,28,550,350,600,800,0,100,0
221,2,0,47.0,39.0,54.0,46.0,1964,1998,1651,1819,313,179,311,216,205,150,106,66,36,28,550,350,600,800,0,100,0
229,2,0,47.0,44.0,54.0,46.0,1992,2082,1679,1903,313,179,546,146,400,60,146,86,37,30,550,400,600,800,0,100,0
236,2,0,48.0,44.0,54.0,46.0,2014,2143,1679,1987,335,156,346,292,160,190,186,102,38,31,550,400,600,800,0,150,0
243,2,0,49.0,44.0,54.0,46.0,2149,2003,1791,1847,358,156,441,347,215,225,226,122,38,30,550,550,850,800,0,250,0
250,2,0,50.0,51.0,54.0,54.0,2098,1863,1763,1707,335,156,247,257,135,165,112,92,39,32,725,550,850,925,0,250,0
257,2,0,54.0,51.0,54.0,62.0,2048,2115,1735,1959,313,156,128,142,30,130,98,12,41,32,725,600,850,925,0,250,0
264,2,0,54.0,55.0,62.0,62.0,2048,2395,1735,2239,313,156,373,212,235,180,138,32,41,34,900,650,1000,925,0,250,0
271,2,0,55.0,58.0,62.0,62.0,2126,2334,1791,2155,335,179,287,222,105,195,182,27,43,35,900,900,1150,925,0,250,0
279,2,0,59.0,61.0,62.0,62.0,2289,2250,1819,2071,470,179,202,57,60,35,142,22,43,36,1075,950,1150,925,0,250,0
286,2,0,61.0,62.0,62.0,62.0,2283,2182,1791,1959,492,223,207,20,55,20,152,0,44,38,1250,1000,1150,925,0,250,0
293,2,0,62.0,62.0,62.0,62.0,2362,2328,1847,2015,515,313,238,195,30,155,208,40,44,38,1425,1125,1250,1125,0,250,0
300,2,0,63.0,68.0,70.0,70.0,2362,2384,1847,2071,515,313,523,280,255,200,268,80,44,38,1425,1200,1250,1125,0,300,0
307,2,0,69.0,68.0,85.0,78.0,2317,2322,1847,1987,470,335,310,170,90,150,220,20,45,38,1775,1250,1250,1125,0,300,0
314,2,0,73.0,71.0,93.0,78.0,2233,2401,1763,2043,470,358,420,100,240,65,180,35,47,40,1775,1250,1250,1125,0,300,0
321,2,0,74.0,76.0,93.0,78.0,2289,2350,1819,2015,470,335,520,141,280,95,240,46,48,40,1925,1550,1550,1125,0,300,0
329,2,0,72.0,76.0,93.0,86.0,2513,2395,2043,1903,470,492,681,374,385,260,296,114,51,42,1575,1450,1550,1125,350,450,0
336,2,0,79.0,77.0,93.0,86.0,2703,2591,2211,1987,492,604,331,416,125,255,206,161,51,42,2100,1500,1550,1125,350,450,0
343,2,0,81.0,83.0,101.0,86.0,2782,2675,2267,2071,515,604,461,558,195,350,266,208,53,44,2100,1750,1550,1125,350,450,0
350,2,0,86.0,86.0,101.0,86.0,2922,2765,2407,2183,515,582,462,375,240,145,222,230,56,46,2100,1800,1650,1375,350,450,0
357,2,0,82.0,75.0,101.0,94.0,2927,2843,2435,2239,492,604,804,212,530,35,274,177,56,46,2125,1200,1650,1375,675,1100,0
364,2,0,89.0,73.0,101.0,94.0,3101,2950,2631,2323,470,627,335,233,155,55,180,178,57,48,2475,1000,1650,1375,850,1600,0
371,2,0,87.0,74.0,101.0,94.0,2994,3118,2547,2491,447,627,311,335,175,185,136,150,57,48,2475,1050,1650,1375,850,1600,0
379,2,0,87.0,75.0,101.0,94.0,3112,2787,2687,2183,425,604,223,272,135,125,88,147,58,49,2475,1050,1800,1375,850,1650,0
386,2,0,87.0,80.0,101.0,94.0,3056,2647,2631,2043,425,604,594,369,450,150,144,219,58,50,2475,1300,1800,1375,850,1675,0
393,2,0,88.0,79.0,101.0,94.0,3174,2698,2659,2071,515,627,768,595,560,300,208,295,58,50,2300,1225,1800,1375,1025,1800,0
400,2,0,98.0,81.0,109.0,94.0,3202,2843,2463,2239,739,604,230,632,130,315,100,317,58,52,2875,1275,1800,1625,1025,1825,0
407,2,0,101.0,91.0,109.0,110.0,3179,3022,2351,2351,828,671,400,367,200,195,200,172,61,52,2875,1575,1800,1625,1025,1825,0
414,2,0,98.0,89.0,109.0,110.0,3050,3140,2267,2491,783,649,762,749,470,505,292,244,64,54,2525,1450,1950,1625,1375,1950,0
421,2,0,106.0,90.0,117.0,110.0,3246,3174,2463,2547,783,627,672,335,280,240,392,95,64,54,2750,1500,2100,1625,1550,1950,0
429,2,0,110.0,93.0,117.0,110.0,3218,3118,2435,2491,783,627,572,280,80,80,492,200,65,54,2950,1800,2250,1625,1550,1950,0
436,2,0,114.0,97.0,117.0,110.0,3454,3028,2603,2379,851,649,782,595,190,315,592,280,67,55,2950,2200,2250,1625,1550,2000,0
443,2,0,112.0,97.0,117.0,110.0,3448,3062,2575,2435,873,627,1202,741,510,410,692,331,67,52,2975,2250,2250,1725,1725,2200,0
450,2,0,124.0,97.0,125.0,110.0,3515,2938,2687,2267,828,671,1030,1026,250,615,780,411,67,52,2975,2250,2250,1725,1725,2250,0
457,2,0,122.0,104.0,133.0,110.0,3521,2905,2715,2211,806,694,1451,456,575,265,876,191,67,53,3450,2250,2250,2025,1850,2250,0
464,2,0,122.0,112.0,141.0,118.0,3470,2664,2687,2015,783,649,1872,473,900,260,972,213,67,54,3450,2825,2250,2025,1850,2250,0
471,2,0,118.0,110.0,141.0,118.0,3582,2726,2799,2099,783,627,2307,544,1235,255,1072,289,67,55,3250,2675,2250,2025,2050,2500,0
479,2,0,110.0,108.0,141.0,126.0,3498,2944,2715,2295,783,649,1982,724,1185,380,797,344,67,56,2550,2575,2550,2100,2750,2800,0
486,2,0,122.0,108.0,141.0,126.0,3650,2748,2799,2099,851,649,1197,484,650,210,547,274,67,57,2550,2750,2550,2100,2750,2800,0
493,2,0,123.0,115.0,141.0,142.0,3627,2502,2799,1875,828,627,1169,310,530,60,639,250,67,57,4175,3200,2550,2200,2750,2800,0
500,2,0,123.0,118.0,141.0,142.0,3487,2518,2659,1847,828,671,1060,375,425,145,635,230,70,57,4175,3375,2550,2200,2750,2800,0
507,2,0,123.0,119.0,141.0,142.0,3246,2602,2463,1931,783,671,1442,516,715,235,727,281,70,56,4175,3375,2550,2200,2750,2900,0
514,2,0,123.0,119.0,141.0,157.0,3386,2748,2603,2099,783,649,1867,662,1040,305,827,357,70,54,4175,3700,2550,2525,2750,3050,0
521,2,0,116.0,118.0,149.0,157.0,3330,2782,2547,2155,783,627,1767,943,1090,510,677,433,61,52,3925,3750,2550,2525,3450,3150,0
529,2,0,126.0,116.0,142.0,157.0,2888,2636,2239,1987,649,649,1476,923,735,435,741,488,59,50,5025,3825,2550,2525,3950,3550,0
536,2,0,122.0,116.0,142.0,149.0,2664,2328,2127,1679,537,649,1391,1056,590,513,801,543,59,51,4825,3750,3250,2775,4150,3912,0
543,2,0,126.0,116.0,134.0,141.0,2625,2462,2155,1791,470,671,734,862,285,443,449,419,59,52,4825,3525,3250,2775,4650,4287,0
550,2,0,126.0,117.0,134.0,133.0,2496,2597,2071,1903,425,694,1026,1118,525,619,501,499,59,53,4825,3700,3250,2775,4650,4387,0
557,2,0,118.0,125.0,134.0,125.0,2468,2468,2043,1819,425,649,918,546,365,375,553,171,51,54,4825,3700,3250,2775,5050,4487,0
564,2,0,122.0,125.0,134.0,125.0,2546,2474,2099,1847,447,627,924,303,315,181,609,122,51,56,4875,3700,3250,2775,5300,4487,0
571,2,0,125.0,125.0,134.0,125.0,2636,2496,2211,1847,425,649,931,302,395,225,536,77,51,56,5125,3700,3250,2775,5300,4487,0
579,2,0,134.0,125.0,134.0,125.0,2653,2496,2183,1847,470,649,788,379,200,222,588,157,51,56,5525,4200,3250,2775,5300,4587,0
586,2,0,134.0,131.0,134.0,133.0,2647,2418,2155,1791,492,627,1089,438,445,205,644,233,53,56,5925,5025,3550,2775,5300,4587,0
593,2,0,125.0,133.0,134.0,133.0,2188,2378,1763,1707,425,671,968,523,380,235,588,288,40,58,5925,4825,3800,2775,5950,4787,0
600,2,0,117.0,127.0,134.0,133.0,1796,2261,1371,1567,425,694,1175,538,535,270,640,268,40,58,5575,4225,3800,2775,6650,5487,0
607,2,0,116.0,118.0,134.0,149.0,1930,2272,1483,1623,447,649,1261,415,565,125,696,290,39,59,5400,3350,3800,2775,6875,6362,0
614,2,0,116.0,125.0,134.0,149.0,1684,2166,1259,1539,425,627,1243,287,495,46,748,241,39,60,5400,4075,3800,2775,6875,6362,0
621,2,0,118.0,126.0,134.0,149.0,1622,2104,1175,1455,447,649,1385,380,585,59,800,321,41,62,5400,4075,3800,2775,6875,6362,0
629,2,0,118.0,126.0,141.0,149.0,1785,2272,1315,1623,470,649,1151,610,295,209,856,401,41,61,5400,4425,3800,2775,6975,6412,0
636,2,0,120.0,129.0,141.0,149.0,1964,2541,1539,1959,425,582,1135,458,360,39,775,419,43,57,5150,4775,3800,2775,7225,6662,0
643,2,0,128.0,126.0,141.0,149.0,2110,2317,1707,1735,403,582,892,649,65,162,827,487,45,54,5150,4975,3950,2775,7475,6862,0
650,2,0,104.0,113.0,141.0,149.0,2300,2586,1875,1959,425,627,1173,856,290,297,883,559,45,52,4300,3775,3950,2775,8825,8312,0
657,2,0,82.0,99.0,141.0,149.0,2356,2272,1931,1623,425,649,1460,1056,525,417,935,639,45,50,3050,3175,3950,2775,10075,9112,0
664,2,0,72.0,86.0,141.0,149.0,2362,2026,1959,1399,403,627,1757,637,770,22,987,615,45,48,2475,1800,3950,2775,10650,10637,0
671,2,0,72.0,80.0,141.0,149.0,2317,1936,1847,1287,470,649,1718,902,675,182,1043,720,41,46,2525,1500,3950,2775,11100,11137,0
679,2,0,83.0,74.0,141.0,149.0,2205,1774,1735,1147,470,627,1000,293,180,22,820,271,41,47,3050,1200,3950,2775,11100,11437,0
686,2,0,83.0,72.0,141.0,149.0,2076,1706,1651,1035,425,671,1208,413,340,62,868,351,41,47,3300,1000,3950,2775,11100,11637,0
693,2,0,85.0,74.0,141.0,149.0,1964,1533,1539,839,425,694,1130,388,360,57,770,331,44,47,3300,1000,3950,2775,11100,11637,0
700,2,0,85.0,77.0,156.0,149.0,2182,1320,1735,671,447,649,1401,390,575,12,826,378,46,47,3300,1150,3950,2875,11100,11637,0
707,2,0,95.0,80.0,156.0,149.0,2356,1774,1931,1147,425,627,388,531,60,102,328,429,46,46,3050,2225,3950,2875,11350,11687,0
714,2,0,95.0,85.0,156.0,149.0,2496,2496,2071,1847,425,649,680,471,300,12,380,459,46,46,3050,2275,3950,2875,11350,11687,0
721,2,0,99.0,90.0,156.0,149.0,2563,2720,2071,2071,492,649,586,596,150,82,436,514,46,46,3050,2575,3950,2875,11350,11687,0
729,2,0,102.0,91.0,156.0,149.0,2429,2726,1959,2099,470,627,658,657,170,92,488,565,50,46,3050,2725,3950,2875,11350,11687,0
736,2,0,101.0,97.0,156.0,149.0,2457,2770,1875,2099,582,671,759,652,195,57,564,595,53,46,2750,3275,3950,2875,11650,11687,0
743,2,0,103.0,101.0,164.0,149.0,2580,2765,1931,2071,649,694,834,622,315,97,519,525,54,46,2750,3500,3950,2875,11650,11687,0
750,2,0,109.0,105.0,164.0,149.0,2798,2776,2127,2127,671,649,645,904,200,307,445,597,55,46,4525,3700,3950,2875,11650,11687,0
757,2,0,107.0,111.0,164.0,149.0,2910,2838,2239,2211,671,627,994,870,465,397,529,473,55,46,4350,3875,4100,2875,11825,11687,0
764,2,0,105.0,112.0,164.0,149.0,2961,2888,2267,2239,694,649,1364,1040,755,512,609,528,55,46,4175,3950,4100,2875,12000,11887,0
771,2,0,115.0,117.0,164.0,149.0,2854,2692,2183,2043,671,649,709,805,420,247,289,558,55,46,4050,4125,4200,2875,12125,11887,0
779,2,0,121.0,117.0,164.0,149.0,2882,2602,2211,1931,671,671,524,876,305,267,219,609,55,46,4575,4125,4200,2875,12125,11887,0
786,2,0,123.0,116.0,164.0,149.0,2994,2434,2323,1763,671,671,484,951,185,287,299,664,55,46,4600,4650,4100,2875,12600,12362,0
793,2,0,123.0,117.0,164.0,149.0,3045,2328,2351,1679,694,649,598,593,290,32,308,561,55,43,4600,4725,4100,2875,12600,12562,0
800,2,0,123.0,116.0,164.0,149.0,2944,1796,2295,1147,649,649,684,703,425,62,259,641,55,41,4600,4775,4100,2875,13000,12662,0
807,2,0,118.0,124.0,164.0,149.0,3056,2020,2407,1371,649,649,1059,914,720,197,339,717,55,41,4800,5175,4100,2875,13300,12662,0
814,2,0,115.0,118.0,156.0,149.0,3028,2188,2379,1539,649,649,1114,814,695,42,419,772,52,42,5225,4750,4100,2875,13925,13137,0
821,2,0,117.0,121.0,156.0,149.0,3045,2222,2463,1595,582,627,1222,860,810,37,412,823,52,41,5325,5400,4100,2875,13925,13237,0
829,2,0,118.0,114.0,156.0,149.0,2944,2098,2407,1427,537,671,1262,1110,915,207,347,903,52,41,5475,5200,4100,2875,14025,13837,0
836,2,0,116.0,115.0,156.0,149.0,2832,2205,2295,1511,537,694,1070,1025,805,92,265,933,53,41,5250,5150,4100,2875,14775,13937,0
843,2,0,126.0,116.0,148.0,149.0,2983,2216,2379,1567,604,649,437,1067,425,87,12,980,54,41,5600,5200,4100,2875,14775,14037,0
850,2,0,137.0,119.0,156.0,149.0,2905,2339,2323,1735,582,604,239,989,155,37,84,952,54,38,6000,5450,4100,2875,14775,14187,0
857,2,0,135.0,118.0,156.0,149.0,2866,1930,2239,1483,627,447,561,1172,405,172,156,1000,54,34,5750,5725,4100,2875,15025,14387,0
864,2,0,143.0,117.0,156.0,149.0,2877,1919,2183,1539,694,380,356,1235,245,212,111,1023,57,34,6000,5675,4100,2875,15025,14487,0
871,2,0,135.0,110.0,156.0,149.0,2692,1975,2043,1595,649,380,422,1238,235,217,187,1021,57,34,5950,5350,4100,2875,15750,15062,0
879,2,0,126.0,88.0,156.0,149.0,2653,1970,1959,1567,694,403,442,1081,175,62,267,1019,57,34,5375,3525,4100,2875,17000,17337,0
7,0,2,13.0,13.0,15.0,15.0,335,251,335,251,0,0,40,30,40,30,0,0,12,12,0,0,0,0,0,0,0
14,0,2,14.0,14.0,15.0,15.0,643,671,643,671,0,0,65,70,65,70,0,0,13,13,0,0,0,0,0,0,0
21,0,2,14.0,14.0,15.0,15.0,699,671,699,671,0,0,40,35,40,35,0,0,13,13,0,0,0,0,0,0,0
29,0,2,15.0,15.0,15.0,15.0,615,699,615,699,0,0,20,30,20,30,0,0,14,14,0,0,0,0,0,0,0
36,0,2,15.0,15.0,15.0,15.0,727,755,727,755,0,0,115,120,115,120,0,0,14,15,0,0,0,0,0,0,0
43,0,2,16.0,16.0,23.0,23.0,727,811,727,811,0,0,45,10,45,10,0,0,15,15,0,0,0,0,0,0,0
50,0,2,16.0,17.0,23.0,23.0,755,783,755,783,0,0,15,25,15,25,0,0,15,16,0,0,0,0,0,0,0
57,0,2,17.0,18.0,23.0,23.0,755,839,755,839,0,0,55,85,55,85,0,0,16,17,0,0,0,0,0,0,0
64,0,2,18.0,18.0,23.0,23.0,811,923,811,923,0,0,100,145,100,145,0,0,17,17,0,0,0,0,0,0,0
71,0,2,18.0,19.0,23.0,23.0,855,867,811,867,44,0,198,190,190,190,8,0,17,18,0,0,0,0,0,0,0
79,0,2,19.0,20.0,23.0,23.0,855,967,699,923,156,44,293,318,265,310,28,8,18,19,0,0,0,0,0,0,0
86,0,2,19.0,20.0,23.0,23.0,883,934,727,867,156,67,404,26,360,10,44,16,18,19,0,0,0,150,0,0,0
93,0,2,20.0,20.0,23.0,23.0,827,962,671,895,156,67,299,139,235,115,64,24,19,20,0,0,150,150,0,0,0
100,0,2,20.0,21.0,23.0,23.0,855,1034,699,923,156,111,399,70,315,30,84,40,19,20,0,0,150,150,0,0,0
107,0,2,20.0,21.0,23.0,23.0,827,1085,671,951,156,134,514,116,410,60,104,56,19,20,50,0,150,150,0,0,0
114,0,2,20.0,22.0,23.0,23.0,878,1006,699,895,179,111,214,83,90,15,124,68,19,21,50,0,150,150,0,0,0
121,0,2,21.0,22.0,23.0,23.0,878,1062,699,951,179,111,174,159,80,75,94,84,19,21,50,0,150,150,0,0,0
129,0,2,22.0,23.0,23.0,23.0,995,1029,839,895,156,134,140,285,30,185,110,100,20,22,50,0,150,150,0,0,0
136,0,2,22.0,26.0,23.0,31.0,1023,1062,867,839,156,223,240,132,110,75,130,57,20,23,50,0,150,300,0,0,0
143,0,2,23.0,26.0,23.0,31.0,1135,1096,979,783,156,313,225,217,75,120,150,97,21,23,50,0,150,300,0,0,0
150,0,2,23.0,27.0,31.0,31.0,1107,1158,951,867,156,291,310,118,140,85,170,33,21,24,50,0,150,300,0,0,0
157,0,2,26.0,29.0,31.0,46.0,1247,1208,1091,895,156,313,260,88,70,65,190,23,22,24,50,125,250,300,0,0,0
164,0,2,27.0,31.0,31.0,46.0,1382,1258,1203,923,179,335,165,84,55,25,110,59,23,25,50,125,250,300,0,0,0
171,0,2,29.0,32.0,31.0,46.0,1326,1348,1147,1035,179,313,45,200,15,105,30,95,23,26,150,125,250,300,0,0,0
179,0,2,30.0,36.0,31.0,46.0,1354,1488,1175,1175,179,313,200,160,150,75,50,85,24,28,150,300,250,300,0,0,0
186,0,2,30.0,37.0,46.0,46.0,1303,1544,1035,1231,268,313,146,235,60,110,86,125,24,29,150,300,250,550,0,0,0
193,0,2,31.0,38.0,46.0,46.0,1382,1628,1091,1315,291,313,187,140,90,125,97,15,25,30,150,300,400,550,0,0,0
200,0,2,32.0,39.0,46.0,46.0,1488,1617,1175,1259,313,358,207,175,70,120,137,55,26,31,150,300,400,550,0,0,0
207,0,2,35.0,40.0,46.0,46.0,1454,1729,1119,1371,335,358,352,130,175,35,177,95,26,32,350,475,725,550,0,0,0
214,0,2,40.0,41.0,46.0,46.0,1566,1712,1231,1399,335,313,123,72,60,45,63,27,27,34,350,475,725,550,0,0,0
221,0,2,42.0,42.0,46.0,46.0,1768,1768,1455,1455,313,313,134,147,35,80,99,67,28,34,450,475,725,550,0,0,0
229,0,2,43.0,43.0,46.0,46.0,1824,1880,1511,1567,313,313,194,242,55,135,139,107,29,35,450,475,725,650,0,0,0
236,0,2,45.0,45.0,46.0,46.0,1852,1852,1539,1539,313,313,234,283,80,140,154,143,30,37,575,475,725,650,100,0,0
243,0,2,47.0,45.0,54.0,54.0,1958,1908,1623,1595,335,313,279,428,85,245,194,183,30,37,575,475,725,650,200,0,0
250,0,2,50.0,47.0,54.0,54.0,1986,1902,1651,1567,335,335,259,458,50,235,209,223,31,39,575,475,725,650,200,0,0
257,0,2,53.0,50.0,54.0,54.0,1846,1874,1511,1427,335,447,255,288,35,105,220,183,33,40,750,625,850,800,200,0,0
264,0,2,54.0,52.0,54.0,62.0,1902,2059,1567,1455,335,604,310,149,50,115,260,34,33,41,800,625,850,1050,200,0,0
271,0,2,57.0,55.0,62.0,62.0,1768,2222,1455,1595,313,627,291,130,95,70,196,60,35,43,900,800,850,1050,200,0,0
279,0,2,59.0,57.0,62.0,70.0,1684,2272,1371,1623,313,649,116,256,5,195,111,61,35,43,1025,900,950,1050,200,0,0
286,0,2,60.0,59.0,62.0,70.0,2076,2350,1763,1679,313,671,146,261,45,170,101,91,36,44,1025,1075,950,1150,200,0,0
293,0,2,62.0,59.0,62.0,78.0,2406,2395,2071,1791,335,604,186,239,45,80,141,159,36,45,1125,1175,950,1150,200,0,0
300,0,2,62.0,62.0,62.0,78.0,2378,2362,2043,1735,335,627,301,244,120,130,181,114,38,45,1250,1175,950,1150,200,0,0
307,0,2,68.0,64.0,70.0,86.0,2294,2362,1959,1735,335,627,287,214,95,70,192,144,38,45,1300,1350,950,1150,200,0,0
314,0,2,68.0,64.0,70.0,86.0,2378,2468,2043,1819,335,649,362,510,230,290,132,220,38,45,1300,1525,1200,1450,200,0,0
321,0,2,72.0,70.0,78.0,86.0,2563,2356,2183,1707,380,649,160,285,80,185,80,100,40,45,1300,1625,1300,1450,200,0,0
329,0,2,76.0,70.0,78.0,86.0,2541,2434,2071,1763,470,671,125,291,85,265,40,26,40,45,1525,1625,1300,1450,200,0,0
336,0,2,78.0,70.0,78.0,86.0,2675,2429,2183,1735,492,694,205,581,130,475,75,106,42,45,1525,1625,1300,1450,200,0,0
343,0,2,80.0,70.0,86.0,86.0,2754,2390,2239,1763,515,627,350,149,240,75,110,74,42,45,1625,1625,1300,1900,200,0,0
350,0,2,82.0,72.0,86.0,86.0,2429,2418,1959,1791,470,627,362,359,200,205,162,154,42,45,1625,1625,1300,1900,200,0,0
357,0,2,84.0,72.0,94.0,86.0,2367,2362,1875,1735,492,627,292,494,70,260,222,234,44,45,2150,1625,1375,1900,200,0,0
364,0,2,87.0,78.0,94.0,94.0,2485,2384,2015,1735,470,649,303,284,150,170,153,114,46,47,2250,2125,1525,1900,200,0,0
371,0,2,92.0,82.0,102.0,94.0,2597,2390,2127,1763,470,627,248,215,85,125,163,90,46,47,2250,2475,1525,1900,200,0,0
379,0,2,94.0,84.0,102.0,94.0,2429,2541,1959,1847,470,694,318,425,95,255,223,170,47,47,2250,2475,1525,1900,200,0,0
386,0,2,96.0,84.0,102.0,94.0,2362,2518,1847,1847,515,671,318,621,110,375,208,246,47,47,2250,2475,1600,2050,200,0,0
393,0,2,99.0,92.0,102.0,94.0,2479,2474,1987,1847,492,627,424,388,185,220,239,168,49,49,2475,2475,1600,2050,200,0,0
400,0,2,104.0,94.0,110.0,94.0,2451,2558,1959,1931,492,627,230,493,60,245,170,248,50,49,2750,3100,1600,2050,200,0,0
407,0,2,105.0,94.0,110.0,94.0,2507,2468,2015,1819,492,649,215,148,85,20,130,128,50,50,2875,3600,1600,2050,200,50,0
414,0,2,109.0,101.0,110.0,109.0,2457,2552,1987,1903,470,649,206,148,70,40,136,108,51,50,2950,3600,1600,2050,250,50,0
421,0,2,113.0,104.0,118.0,117.0,2496,2574,1959,1903,537,671,138,224,30,90,108,134,52,51,3000,3775,1600,2050,250,50,0
429,0,2,116.0,110.0,141.0,117.0,2608,2457,1959,1763,649,694,213,54,125,40,88,14,52,52,3325,3775,1600,2050,250,50,0
436,0,2,122.0,114.0,141.0,125.0,2518,2524,1847,1875,671,649,143,116,25,30,118,86,53,54,3575,4075,1600,2050,250,50,0
443,0,2,121.0,116.0,149.0,125.0,2686,2670,2015,2043,671,627,434,232,215,70,219,162,54,56,3625,4175,1600,2050,250,50,0
450,0,2,125.0,118.0,149.0,125.0,2518,2838,1847,2211,671,627,230,282,60,40,170,242,55,58,3675,4175,1600,2050,250,50,0
457,0,2,126.0,119.0,149.0,125.0,2334,2860,1707,2211,627,649,347,523,105,205,242,318,56,59,4250,4175,1600,2050,250,50,0
464,0,2,129.0,124.0,149.0,125.0,2530,3062,1903,2435,627,627,377,409,55,115,322,294,56,61,4250,5025,1600,2150,250,50,0
471,0,2,134.0,124.0,149.0,133.0,3062,3190,2435,2519,627,671,402,389,50,165,352,224,57,62,4250,5025,1600,2150,250,50,0
479,0,2,134.0,126.0,149.0,133.0,3470,3442,2799,2771,671,671,362,439,30,135,332,304,59,63,4250,5025,1700,2150,250,50,0
486,0,2,135.0,130.0,149.0,141.0,3409,3174,2715,2547,694,627,617,601,205,225,412,376,59,63,4575,5225,1700,2150,300,50,0
493,0,2,132.0,131.0,149.0,149.0,3498,3364,2827,2715,671,649,759,801,300,345,459,456,59,60,4400,5425,1850,2450,725,200,0
500,0,2,118.0,122.0,165.0,157.0,3532,2994,2883,2323,649,671,510,1151,150,615,360,536,61,59,3175,4725,2000,2450,2000,950,0
507,0,2,117.0,122.0,165.0,157.0,3510,3196,2883,2547,627,649,546,1532,185,920,361,612,61,59,3175,4975,2000,2450,2050,950,0
514,0,2,126.0,128.0,165.0,157.0,3566,2888,2939,2239,627,649,321,1063,130,575,191,488,63,59,3350,4975,2125,2450,2050,950,0
521,0,2,126.0,140.0,165.0,157.0,3762,3050,3135,2379,627,671,536,728,265,160,271,568,63,59,3400,5575,2200,2450,2050,950,0
529,0,2,129.0,140.0,165.0,157.0,3918,2950,3247,2323,671,627,421,685,220,45,201,640,63,59,3400,5575,2450,2450,2050,950,0
536,0,2,138.0,140.0,165.0,157.0,3694,3056,3023,2407,671,649,322,1050,220,330,102,720,63,59,3975,5575,2450,2450,2050,950,0
543,0,2,139.0,150.0,165.0,165.0,3515,2832,2799,2183,716,649,346,880,160,80,186,800,63,59,4425,5575,2850,2450,2050,950,0
550,0,2,140.0,149.0,165.0,165.0,3588,2916,2715,2267,873,649,374,1226,80,350,294,876,64,59,4600,5975,2950,2450,2050,1050,0
557,0,2,144.0,151.0,173.0,165.0,3655,2916,2715,2267,940,649,335,1491,50,535,285,956,64,59,4850,6075,2950,2450,2050,1050,0
564,0,2,145.0,151.0,189.0,165.0,3706,2798,2743,2127,963,671,175,1592,45,660,130,932,64,59,5225,6575,3050,2750,2050,1050,0
571,0,2,149.0,157.0,189.0,165.0,4064,2658,3079,1987,985,671,280,1427,155,415,125,1012,65,59,5175,6875,3050,2750,2100,1250,0
579,0,2,129.0,117.0,189.0,165.0,3974,2586,2967,1959,1007,627,756,1739,515,655,241,1084,65,59,4100,4625,2975,2750,4050,3500,0
586,0,2,118.0,99.0,189.0,165.0,3728,2664,2743,2015,985,649,1014,1459,690,295,324,1164,64,59,3325,2750,2975,2750,4975,5675,0
593,0,2,124.0,101.0,189.0,165.0,3874,2608,2911,1959,963,649,245,1219,155,175,90,1044,64,59,3025,3150,2975,2750,5025,5775,0
600,0,2,122.0,101.0,189.0,180.0,3823,2580,2883,1931,940,649,696,1540,490,420,206,1120,64,59,2925,3150,2975,2750,5125,5775,0
607,0,2,124.0,109.0,189.0,180.0,3655,2776,2715,2127,940,649,756,1066,430,70,326,996,64,59,3225,2650,2975,2750,5275,6275,0
614,0,2,128.0,109.0,189.0,180.0,3622,2854,2659,2183,963,671,581,1411,210,335,371,1076,64,59,3625,3450,2975,2750,5275,6275,0
621,0,2,130.0,113.0,189.0,180.0,3605,2726,2575,2099,1030,627,546,1338,280,190,266,1148,64,59,4075,3450,2975,2750,5275,6275,0
629,0,2,138.0,121.0,189.0,180.0,3801,2944,2771,2295,1030,649,312,993,55,215,257,778,64,59,4300,3550,2975,3100,5275,6275,0
636,0,2,143.0,129.0,189.0,188.0,3532,3112,2547,2463,985,649,625,578,260,320,365,258,64,63,4700,3750,2975,3100,5275,6275,0
643,0,2,145.0,132.0,189.0,196.0,3762,3000,2799,2351,963,649,736,469,305,135,431,334,65,63,4800,5100,3075,3100,5275,6275,0
650,0,2,151.0,140.0,189.0,196.0,3795,3224,2855,2575,940,649,772,169,375,105,397,64,65,63,5075,5300,3375,3100,5275,6275,0
657,0,2,154.0,140.0,197.0,196.0,3823,3218,2883,2547,940,671,942,530,450,390,492,140,65,66,5525,4900,3375,3100,5275,6275,0
664,0,2,155.0,140.0,197.0,196.0,4036,3330,3051,2659,985,671,652,830,390,610,262,220,65,66,5575,5350,3475,3100,5275,6275,0
671,0,2,163.0,150.0,197.0,196.0,4058,3454,3051,2827,1007,627,658,377,430,335,228,42,65,66,6250,6225,3575,3100,5275,6275,0
679,0,2,168.0,150.0,197.0,204.0,3946,3448,2939,2799,1007,649,494,672,300,550,194,122,65,66,6250,6225,3575,3100,5275,6275,0
686,0,2,168.0,155.0,212.0,204.0,3846,3616,2883,2967,963,649,367,812,165,610,202,202,65,65,6300,6525,3575,3250,5275,6325,0
693,0,2,171.0,155.0,212.0,196.0,3538,3504,2575,2855,963,649,107,558,60,480,47,78,65,65,6675,7025,3575,3400,5275,6425,0
700,0,2,173.0,163.0,220.0,204.0,3319,3504,2379,2855,940,649,408,333,245,275,163,58,65,65,7225,7575,3575,3400,5275,6425,0
707,0,2,179.0,169.0,220.0,204.0,3230,3442,2267,2771,963,671,303,424,170,290,133,134,65,65,7900,7875,3575,3400,5325,6425,0
714,0,2,182.0,169.0,220.0,212.0,3465,3442,2435,2771,1030,671,523,819,270,605,253,214,66,65,8075,7875,3575,3400,5325,6425,0
721,0,2,186.0,161.0,220.0,212.0,3493,3230,2463,2603,1030,627,169,1206,50,920,119,286,69,65,8175,7475,3575,3400,5325,6825,0
729,0,2,188.0,181.0,220.0,212.0,3196,3308,2211,2659,985,649,127,606,50,240,77,366,70,65,8350,7975,3575,3650,5325,6825,0
736,0,2,190.0,187.0,220.0,212.0,2922,3392,1959,2743,963,649,378,512,185,270,193,242,71,65,8350,8475,3575,3650,5325,6825,0
743,0,2,191.0,185.0,220.0,212.0,3515,3420,2575,2771,940,649,654,902,370,580,284,322,70,65,8525,8375,3675,3650,5575,6925,0
750,0,2,166.0,171.0,220.0,212.0,3655,3364,2715,2715,940,649,864,608,485,210,379,398,62,65,7125,6375,3575,3650,7675,8925,0
757,0,2,148.0,137.0,235.0,212.0,3196,3358,2211,2687,985,671,789,798,440,320,349,478,61,65,5800,4825,3575,3650,9100,11375,0
764,0,2,146.0,115.0,235.0,212.0,2989,3370,1959,2743,1030,627,764,1195,307,645,457,550,61,65,5475,3725,3575,3650,9374,12475,0
771,0,2,138.0,103.0,235.0,212.0,2826,3336,1819,2687,1007,649,1056,1085,487,455,569,630,61,65,5500,1950,3575,3650,9924,14250,0
779,0,2,141.0,87.0,235.0,212.0,2860,3420,1875,2771,985,649,584,455,53,245,531,210,61,65,5425,200,3575,3650,10099,15200,0
786,0,2,148.0,97.0,235.0,212.0,2838,3336,1875,2687,963,649,570,646,73,360,497,286,61,65,6000,1950,3575,3650,10099,15200,0
793,0,2,152.0,99.0,235.0,212.0,2871,3280,1931,2631,940,649,712,861,99,545,613,316,63,65,6175,1950,3575,3650,10099,15200,0
800,0,2,158.0,99.0,235.0,212.0,3426,3302,2463,2631,963,671,708,752,127,360,581,392,63,65,6400,2125,3575,3650,10099,15200,0
807,0,2,161.0,109.0,235.0,212.0,3504,3274,2519,2603,985,671,687,432,18,260,669,172,63,65,6575,2825,3675,3650,10099,15200,0
814,0,2,164.0,117.0,235.0,212.0,3750,3202,2743,2575,1007,627,843,424,165,180,678,244,63,65,7200,2425,3675,3650,10099,15200,0
821,0,2,167.0,117.0,235.0,212.0,3952,3336,2967,2687,985,649,851,329,222,205,629,124,63,65,7475,3275,3675,3650,10099,15200,0
829,0,2,171.0,123.0,235.0,220.0,4210,3330,3247,2659,963,671,842,169,99,115,743,54,63,65,7750,3775,3675,3650,10149,15200,0
836,0,2,176.0,130.0,235.0,220.0,4187,3336,3247,2687,940,649,923,225,214,95,709,130,63,65,7975,3975,3900,3650,10149,15200,0
843,0,2,182.0,131.0,235.0,220.0,4271,3202,3331,2575,940,627,743,341,89,135,654,206,63,65,8100,3975,3900,3650,10149,15200,0
850,0,2,185.0,134.0,235.0,220.0,4294,3336,3331,2687,963,649,793,407,169,225,624,182,63,69,8250,3975,3900,3650,10149,15200,0
857,0,2,189.0,134.0,235.0,220.0,4557,3056,3527,2407,1030,649,1318,477,574,365,744,112,63,69,8400,3975,3900,3900,10149,15200,0
864,0,2,192.0,141.0,235.0,220.0,4165,3084,3135,2435,1030,649,1369,578,509,390,860,188,63,72,8825,4475,3900,3900,10149,15200,0
871,0,2,198.0,149.0,235.0,220.0,4120,3179,3135,2463,985,716,997,561,79,285,918,276,63,73,8875,4875,3900,3900,10149,15200,0
879,0,2,198.0,149.0,235.0,235.0,3818,3498,2855,2603,963,895,1433,669,399,435,1034,234,63,76,9300,4875,3900,3900,10274,15200,0
886,0,2,200.0,152.0,235.0,235.0,3683,3426,2743,2463,940,963,1649,1074,574,720,1075,354,63,76,9700,5175,3900,3900,10274,15200,0
893,0,2,196.0,166.0,235.0,212.0,2944,3398,2183,2435,761,963,1632,260,519,140,1113,120,56,76,9925,5175,3800,3650,10999,15950,0
900,0,2,183.0,151.0,250.0,212.0,2574,3392,1959,2407,615,985,1766,665,604,425,1162,240,52,73,9375,5750,3475,3900,12274,16750,0
907,0,2,185.0,146.0,250.0,204.0,2653,3482,2127,2519,526,963,1421,1071,399,715,1022,356,52,73,9150,5650,3375,3750,12649,17400,0
914,0,2,187.0,155.0,250.0,204.0,2418,3448,1903,2463,515,985,1507,608,454,140,1053,468,52,69,9275,5250,3825,3400,13224,18425,0
921,0,2,179.0,146.0,235.0,189.0,1303,3101,811,2295,492,806,1438,936,354,380,1084,556,41,62,9725,6050,3725,3050,14654,19625,0
929,0,2,182.0,145.0,235.0,181.0,945,2675,475,2127,470,548,1279,1264,264,650,1015,614,41,61,9775,6050,3500,2900,14879,19925,0
936,0,2,185.0,153.0,235.0,173.0,917,2468,447,2043,470,425,1214,771,164,105,1050,666,41,61,9975,5650,3500,2900,14979,20575,0
943,0,2,182.0,150.0,235.0,173.0,917,2513,447,2155,470,358,1334,1066,224,360,1110,706,41,58,9875,6450,3500,2900,15254,20725,0
950,0,2,164.0,116.0,235.0,173.0,962,2401,447,2043,515,358,1449,1346,279,600,1170,746,41,58,8575,4175,3500,2900,16684,23000,0
957,0,2,152.0,116.0,235.0,173.0,956,2440,419,2127,537,313,1204,853,24,75,1180,778,41,58,7450,3225,3500,2900,17809,23950,0
964,0,2,146.0,116.0,235.0,173.0,799,2289,307,1987,492,302,1296,1111,64,295,1232,816,41,58,7250,4025,3500,2900,18284,23950,0
971,0,2,139.0,110.0,235.0,173.0,805,2345,335,2155,470,190,1392,1406,104,570,1288,836,41,58,6700,3500,3500,2900,18834,24475,0
979,0,2,138.0,110.0,235.0,173.0,777,2255,307,2099,470,156,1387,1671,39,815,1348,856,41,58,6875,3500,3500,2900,19009,24475,0
986,0,2,138.0,126.0,235.0,173.0,917,2283,447,2127,470,156,1507,351,99,275,1408,76,41,58,6875,4200,3500,2900,19009,24475,0
993,0,2,140.0,126.0,235.0,165.0,1393,2250,923,2071,470,179,1602,621,134,525,1468,96,41,58,6975,5100,3500,2900,19009,24575,0
1000,0,2,143.0,125.0,235.0,165.0,1158,2334,643,2155,515,179,1452,896,24,780,1428,116,41,57,6975,5100,3500,2900,19009,24625,0
1007,0,2,138.0,131.0,235.0,173.0,1382,2283,867,2127,515,156,1653,477,169,345,1484,132,41,55,6500,5200,3500,2900,19584,25025,0
1014,0,2,115.0,93.0,235.0,173.0,1813,2339,1399,2183,414,156,1850,752,324,600,1526,152,41,55,5100,3275,3500,2900,20734,27250,0
1021,0,2,108.0,59.0,235.0,173.0,1600,2395,1287,2239,313,156,1701,932,189,760,1512,172,41,55,4450,300,3500,2900,21434,30325,0
7,2,0,13.0,13.0,15.0,15.0,251,335,251,335,0,0,30,40,30,40,0,0,12,12,0,0,0,0,0,0,1
14,2,0,14.0,14.0,15.0,15.0,671,671,671,671,0,0,70,70,70,70,0,0,13,13,0,0,0,0,0,0,1
21,2,0,14.0,14.0,15.0,15.0,755,671,755,671,0,0,50,45,50,45,0,0,13,13,0,0,0,0,0,0,1
29,2,0,15.0,15.0,15.0,15.0,755,671,755,671,0,0,85,30,85,30,0,0,14,14,0,0,0,0,0,0,1
36,2,0,15.0,15.0,15.0,15.0,783,755,783,755,0,0,140,130,140,130,0,0,14,14,0,0,0,0,0,0,1
43,2,0,16.0,16.0,23.0,23.0,783,755,783,755,0,0,20,60,20,60,0,0,15,15,0,0,0,0,0,0,1
50,2,0,17.0,16.0,23.0,23.0,811,783,811,783,0,0,45,25,45,25,0,0,16,15,0,0,0,0,0,0,1
57,2,0,18.0,17.0,23.0,23.0,783,671,783,671,0,0,95,115,95,115,0,0,17,16,0,0,0,0,0,0,1
64,2,0,18.0,18.0,23.0,23.0,839,755,839,755,0,0,65,150,65,150,0,0,17,17,0,0,0,0,0,0,1
71,2,0,19.0,18.0,23.0,23.0,811,755,811,755,0,0,165,115,165,115,0,0,18,17,0,0,0,0,0,0,1
79,2,0,20.0,19.0,23.0,23.0,838,850,727,783,111,67,220,172,200,160,20,12,19,18,0,0,0,0,0,0,1
86,2,0,20.0,19.0,23.0,23.0,900,799,699,643,201,156,133,267,85,235,48,32,19,18,0,0,150,0,0,0,1
93,2,0,21.0,20.0,23.0,23.0,866,850,643,671,223,179,141,162,65,110,76,52,20,19,0,0,150,150,0,0,1
100,2,0,23.0,20.0,23.0,23.0,962,934,671,755,291,179,166,177,50,105,116,72,20,19,0,0,150,150,0,0,1
107,2,0,23.0,20.0,23.0,23.0,1034,911,699,755,335,156,286,278,130,190,156,88,21,19,0,0,150,150,0,0,1
114,2,0,23.0,21.0,31.0,23.0,1068,855,755,699,313,156,422,78,230,70,192,8,21,19,0,50,150,150,0,0,1
121,2,0,23.0,22.0,31.0,23.0,1090,799,755,643,335,156,247,48,165,20,82,28,21,19,0,50,300,150,0,0,1
129,2,0,24.0,23.0,31.0,31.0,1118,939,783,783,335,156,152,118,55,70,97,48,20,19,100,100,300,150,50,0,1
136,2,0,25.0,23.0,31.0,31.0,1040,1074,727,895,313,179,228,133,95,65,133,68,20,20,100,100,300,150,50,0,1
143,2,0,25.0,24.0,31.0,31.0,1068,1018,755,839,313,179,253,208,80,120,173,88,21,20,100,100,300,150,50,0,1
150,2,0,26.0,26.0,31.0,31.0,1090,1018,755,839,335,179,333,143,120,35,213,108,21,21,225,150,300,150,50,0,1
157,2,0,26.0,26.0,31.0,31.0,1118,1102,783,811,335,291,368,208,165,85,203,123,22,21,225,150,400,400,50,0,1
164,2,0,27.0,26.0,39.0,31.0,1124,1096,811,783,313,313,454,98,215,35,239,63,22,22,225,150,400,400,50,0,1
171,2,0,31.0,28.0,39.0,31.0,1146,1264,811,951,335,313,144,173,15,70,129,103,23,22,225,200,700,500,50,0,1
179,2,0,31.0,28.0,39.0,39.0,1180,1348,867,1035,313,313,280,318,115,175,165,143,23,22,225,200,700,575,50,0,1
186,2,0,31.0,31.0,39.0,39.0,1180,1230,867,895,313,335,305,193,100,110,205,83,23,23,225,200,700,575,50,0,1
193,2,0,31.0,32.0,39.0,39.0,1208,1197,895,839,313,358,450,183,205,60,245,123,23,23,225,250,700,575,50,0,1
200,2,0,35.0,33.0,39.0,39.0,1202,1258,867,923,335,335,150,294,15,135,135,159,23,24,575,250,700,825,50,0,1
207,2,0,36.0,35.0,39.0,39.0,1230,1404,895,1091,335,313,245,225,70,105,175,120,23,24,575,250,700,825,50,0,1
214,2,0,36.0,35.0,39.0,39.0,1230,1096,895,783,335,313,391,360,180,200,211,160,23,24,575,550,900,825,50,100,1
221,2,0,36.0,38.0,39.0,39.0,1258,1040,923,727,335,313,191,208,90,108,101,100,24,24,575,500,900,825,50,150,1
229,2,0,40.0,38.0,47.0,39.0,1208,1090,895,755,313,335,227,248,90,108,137,140,24,24,925,500,900,825,50,150,1
236,2,0,38.0,39.0,47.0,39.0,1264,1090,951,755,313,335,262,337,85,157,177,180,24,25,825,725,900,825,150,150,1
243,2,0,38.0,39.0,47.0,39.0,1258,1230,923,895,335,335,407,258,190,117,217,141,24,25,825,725,900,825,150,150,1
250,2,0,38.0,40.0,47.0,47.0,1230,1320,895,1007,335,313,397,358,140,184,257,174,24,25,825,800,900,825,150,381,1
257,2,0,38.0,43.0,47.0,47.0,1208,1348,895,1035,313,313,198,263,55,149,143,114,24,25,825,800,900,825,150,381,1
264,2,0,42.0,43.0,47.0,47.0,1230,1264,895,951,335,313,243,308,60,154,183,154,24,25,1175,800,1100,825,150,381,1
271,2,0,42.0,44.0,47.0,47.0,1230,1124,895,811,335,313,388,162,165,43,223,119,24,25,1175,850,1100,825,150,381,1
279,2,0,42.0,43.0,47.0,47.0,1208,1230,895,895,313,335,434,308,175,149,259,159,24,25,1175,825,1100,825,150,631,1
286,2,0,38.0,40.0,55.0,55.0,1236,1169,923,811,313,358,589,341,290,143,299,198,24,25,825,600,1100,825,500,908,1
293,2,0,38.0,44.0,55.0,55.0,1230,1202,895,867,335,335,324,281,85,147,239,134,24,25,1175,850,1250,825,500,908,1
300,2,0,40.0,44.0,55.0,55.0,1258,1124,923,811,335,313,309,310,80,140,229,170,24,25,1350,850,1250,825,500,908,1
307,2,0,40.0,43.0,55.0,55.0,1208,1124,895,811,313,313,345,420,80,210,265,210,24,25,1350,1025,1250,825,500,958,1
314,2,0,40.0,45.0,55.0,55.0,1286,1012,951,699,335,313,495,314,190,139,305,175,24,25,1350,1075,1350,925,500,958,1
321,2,0,44.0,46.0,55.0,63.0,1124,1012,811,699,313,313,281,339,90,140,191,199,24,25,1350,1325,1350,925,500,958,1
329,2,0,44.0,49.0,55.0,63.0,1236,1146,923,811,313,335,141,200,60,86,81,114,24,26,1350,1325,1600,925,500,958,1
336,2,0,44.0,51.0,55.0,63.0,1208,1174,895,839,313,335,106,221,35,79,71,142,24,26,1225,1325,1700,925,625,958,1
343,2,0,46.0,53.0,55.0,63.0,1258,1174,923,839,335,335,81,105,20,18,61,87,24,26,1400,1550,1850,925,625,958,1
350,2,0,46.0,53.0,55.0,63.0,1258,1152,923,839,335,313,236,246,135,123,101,123,24,27,1575,1600,1750,925,625,958,1
357,2,0,48.0,55.0,55.0,63.0,1230,1376,895,1063,335,313,187,231,100,68,87,163,24,27,2100,1600,1750,925,625,958,1
364,2,0,48.0,54.0,55.0,63.0,1258,1348,923,1035,335,313,347,375,220,172,127,203,24,27,2100,1825,1750,925,625,1008,1
371,2,0,48.0,58.0,55.0,63.0,1180,1426,867,1091,313,335,488,245,325,102,163,143,24,28,2100,1875,1750,925,625,1008,1
379,2,0,44.0,60.0,55.0,71.0,1180,1398,867,1063,313,335,628,175,425,67,203,108,24,28,1750,2100,1650,925,1025,1008,1
386,2,0,38.0,57.0,55.0,71.0,1230,1482,895,1147,335,335,253,328,160,191,93,137,24,28,700,1825,1650,925,2075,1293,1
393,2,0,38.0,59.0,55.0,71.0,1202,1432,867,1119,335,313,208,354,75,194,133,160,24,28,1225,1875,1650,925,2075,1293,1
400,2,0,38.0,62.0,55.0,71.0,1236,1432,923,1119,313,313,354,139,185,64,169,75,24,28,1225,2125,1650,925,2075,1293,1
407,2,0,42.0,63.0,55.0,71.0,1230,1404,895,1091,335,313,149,254,40,139,109,115,24,29,1225,2350,1650,925,2075,1293,1
414,2,0,42.0,63.0,47.0,71.0,1230,1432,895,1119,335,313,269,249,120,119,149,130,24,29,1575,2400,1650,925,2125,1293,1
421,2,0,44.0,64.0,47.0,79.0,1236,1482,923,1147,313,335,240,364,105,194,135,170,24,30,1575,2400,1750,925,2125,1293,1
429,2,0,44.0,64.0,47.0,79.0,1236,1561,923,1203,313,358,385,529,210,319,175,210,24,30,1750,2400,1750,925,2125,1293,1
436,2,0,48.0,66.0,55.0,87.0,1258,1510,923,1175,335,335,185,405,70,359,115,46,24,30,1925,2725,1750,1000,2125,1293,1
443,2,0,48.0,66.0,55.0,87.0,1230,1544,895,1231,335,313,330,571,175,489,155,82,24,30,2100,2725,1550,1000,2300,1293,1
450,2,0,50.0,67.0,55.0,87.0,1230,1376,895,1063,335,313,291,276,150,154,141,122,24,30,2275,2725,1550,1000,2300,1293,1
457,2,0,52.0,67.0,55.0,87.0,1230,1152,895,839,335,313,261,411,130,249,131,162,24,30,2450,2725,1550,1000,2300,1293,1
464,2,0,54.0,67.0,55.0,87.0,1208,1208,895,895,313,313,222,566,105,364,117,202,24,30,2625,2775,1550,1000,2300,1293,1
471,2,0,48.0,61.0,55.0,87.0,1236,1174,923,839,313,335,372,431,215,314,157,117,24,30,2100,2000,1550,1000,2825,2170,1
479,2,0,50.0,61.0,55.0,79.0,1202,1230,867,895,335,335,157,577,60,424,97,153,24,30,1925,2300,1550,1000,3000,2383,1
486,2,0,39.0,60.0,55.0,71.0,721,956,475,643,246,313,211,676,90,487,121,189,15,30,2100,2250,1550,1000,3625,2533,1
493,2,0,32.0,57.0,47.0,71.0,134,760,0,447,134,313,227,504,90,375,137,129,14,30,1575,1750,1550,1000,4300,3072,1
500,2,0,32.0,58.0,47.0,71.0,134,872,0,559,134,313,243,456,90,287,153,169,14,30,1575,2025,1550,900,4300,3085,1
507,2,0,28.0,58.0,47.0,71.0,44,1040,0,727,44,313,243,285,90,201,153,84,12,29,1400,1925,1550,900,4575,3235,1
514,2,0,26.0,54.0,47.0,71.0,0,962,0,671,0,291,243,313,90,205,153,108,12,28,1225,1650,1550,900,4750,3577,1
521,2,0,22.0,52.0,47.0,71.0,0,430,0,251,0,179,243,279,90,155,153,124,12,24,875,1700,1550,900,5100,3788,1
529,2,0,22.0,49.0,47.0,71.0,0,357,0,223,0,134,243,334,90,194,153,140,12,23,875,1600,1550,1000,5100,3939,1
536,2,0,13.0,47.0,47.0,71.0,0,833,0,699,0,134,243,390,90,234,153,156,7,24,525,1750,1550,1000,5700,4089,1
542,2,0,2.0,48.0,47.0,71.0,0,922,0,811,0,111,243,229,90,190,153,39,2,24,0,1925,1550,1000,6550,4189,1
7,0,2,13.0,12.0,15.0,15.0,335,251,335,251,0,0,40,80,40,80,0,0,12,12,0,0,0,0,0,0,0
14,0,2,14.0,13.0,15.0,15.0,671,615,671,615,0,0,70,10,70,10,0,0,13,12,0,0,0,0,0,0,0
21,0,2,14.0,13.0,15.0,15.0,699,699,699,699,0,0,50,85,50,85,0,0,13,12,0,0,0,0,0,0,0
29,0,2,15.0,13.0,15.0,23.0,643,699,643,699,0,0,85,170,85,170,0,0,14,13,0,0,0,0,0,0,0
36,0,2,15.0,14.0,15.0,23.0,755,755,755,755,0,0,135,60,135,60,0,0,14,13,0,0,0,0,0,0,0
43,0,2,16.0,15.0,23.0,23.0,755,755,755,755,0,0,100,10,100,10,0,0,15,14,0,0,0,0,0,0,0
50,0,2,16.0,16.0,23.0,23.0,811,727,811,727,0,0,45,50,45,50,0,0,15,15,0,0,0,0,0,0,0
57,0,2,17.0,16.0,23.0,23.0,671,895,671,895,0,0,70,110,70,110,0,0,16,15,0,0,0,0,0,0,0
64,0,2,18.0,17.0,23.0,23.0,811,895,811,895,0,0,170,215,170,215,0,0,17,16,0,0,0,0,0,0,0
71,0,2,18.0,18.0,23.0,23.0,771,917,727,895,44,22,208,269,200,265,8,4,17,17,0,0,0,0,0,0,0
79,0,2,19.0,18.0,23.0,23.0,911,878,755,811,156,67,192,222,160,210,32,12,18,17,0,0,0,150,0,0,0
86,0,2,19.0,19.0,23.0,23.0,939,743,783,699,156,44,303,251,255,235,48,16,18,18,0,0,0,150,0,0,0
93,0,2,19.0,19.0,23.0,23.0,967,603,811,559,156,44,413,334,345,310,68,24,19,18,0,0,0,150,0,0,0
100,0,2,20.0,20.0,23.0,23.0,995,738,839,671,156,67,228,277,140,245,88,32,19,19,0,0,150,150,0,0,0
107,0,2,20.0,20.0,23.0,23.0,1023,715,867,671,156,44,187,351,179,315,8,36,19,19,0,0,150,150,0,0,0
114,0,2,21.0,20.0,23.0,23.0,939,738,783,671,156,67,252,449,224,405,28,44,19,20,50,0,150,150,0,0,0
121,0,2,21.0,22.0,31.0,31.0,990,861,811,727,179,134,357,384,309,370,48,14,19,20,50,0,150,300,0,0,0
129,0,2,21.0,23.0,31.0,31.0,990,967,811,811,179,156,372,45,354,15,18,30,19,20,50,0,150,300,0,0,0
136,0,2,21.0,23.0,31.0,31.0,1079,1051,923,895,156,156,113,105,79,55,34,50,19,20,50,0,150,300,0,0,0
143,0,2,22.0,24.0,31.0,31.0,1303,1079,1147,923,156,156,133,80,79,60,54,20,20,21,50,175,150,300,0,0,0
150,0,2,22.0,26.0,31.0,31.0,1275,1079,1119,923,156,156,228,95,154,80,74,15,20,21,50,175,400,300,0,0,0
157,0,2,23.0,27.0,31.0,31.0,1275,1107,1119,951,156,156,373,170,279,135,94,35,21,22,50,175,400,300,0,0,0
164,0,2,28.0,27.0,31.0,31.0,1191,1163,1035,895,156,268,268,261,179,190,89,71,22,22,50,175,500,300,0,0,0
171,0,2,29.0,30.0,31.0,31.0,1202,1197,979,839,223,358,121,226,104,165,17,61,22,23,50,300,500,300,0,0,0
179,0,2,30.0,31.0,31.0,31.0,1264,1264,951,951,313,313,132,328,79,235,53,93,23,24,50,300,500,300,0,0,0
186,0,2,30.0,31.0,31.0,31.0,1286,1236,951,923,335,313,247,283,154,150,93,133,23,24,250,300,500,300,0,0,0
193,0,2,30.0,31.0,31.0,31.0,1264,1264,951,951,313,313,198,133,94,60,104,73,24,25,250,300,500,300,50,0,0
200,0,2,34.0,33.0,39.0,46.0,1152,1348,839,1035,313,313,298,253,154,140,144,113,24,25,250,475,500,300,50,0,0
207,0,2,37.0,35.0,54.0,46.0,1236,1292,923,979,313,313,103,108,19,55,84,53,25,27,250,475,750,300,50,0,0
214,0,2,38.0,37.0,54.0,46.0,1370,1533,1035,1175,335,358,238,198,114,105,124,93,26,29,250,475,750,300,50,0,0
221,0,2,38.0,37.0,54.0,46.0,1482,1482,1147,1147,335,335,428,329,264,200,164,129,26,29,450,475,750,300,50,0,0
229,0,2,43.0,39.0,54.0,46.0,1628,1684,1315,1371,313,313,379,385,229,220,150,165,26,31,500,475,750,700,50,0,0
236,0,2,43.0,40.0,54.0,46.0,1706,1628,1371,1315,335,313,499,545,334,340,165,205,27,32,500,475,750,700,50,0,0
243,0,2,43.0,41.0,54.0,46.0,1768,1768,1455,1455,313,313,700,180,499,85,201,95,27,33,700,475,750,700,50,0,0
250,0,2,43.0,43.0,54.0,46.0,1936,1768,1623,1455,313,313,910,350,669,215,241,135,27,35,900,475,750,700,50,0,0
257,0,2,44.0,46.0,54.0,46.0,1936,1925,1623,1567,313,358,1005,255,749,205,256,50,27,35,900,475,825,950,50,0,0
264,0,2,49.0,48.0,54.0,54.0,1561,1986,1203,1651,358,335,719,391,548,305,171,86,27,37,900,650,825,950,50,0,0
271,0,2,50.0,50.0,54.0,54.0,1370,1964,1035,1651,335,313,895,402,688,330,207,72,28,37,900,650,825,950,50,0,0
279,0,2,53.0,50.0,54.0,54.0,1432,2014,1119,1679,313,335,261,392,218,280,43,112,29,39,900,750,900,950,50,175,0
286,0,2,51.0,52.0,54.0,62.0,1488,1970,1175,1567,313,403,441,584,358,420,83,164,29,41,900,750,900,950,150,175,0
293,0,2,53.0,51.0,54.0,62.0,1600,1074,1287,783,313,291,551,631,428,435,123,196,30,40,900,750,900,950,150,225,0
300,0,2,53.0,52.0,54.0,70.0,1628,654,1315,475,313,179,561,621,398,405,163,216,30,41,1075,750,900,950,250,275,0
307,0,2,55.0,52.0,62.0,70.0,1869,1774,1511,1595,358,179,321,410,243,170,78,240,32,41,975,750,900,950,350,275,0
314,0,2,55.0,53.0,62.0,70.0,1762,2138,1315,1847,447,291,272,875,138,595,134,280,32,42,1075,750,900,950,350,325,0
321,0,2,57.0,58.0,62.0,70.0,1757,2328,1287,1903,470,425,359,761,173,525,186,236,33,43,1375,1100,900,950,350,325,0
329,0,2,59.0,59.0,70.0,70.0,1757,2294,1287,1847,470,447,374,1017,128,725,246,292,33,44,1375,1100,900,950,350,325,0
336,0,2,61.0,61.0,70.0,70.0,1925,2311,1455,1819,470,492,504,552,198,300,306,252,35,46,1650,1100,900,950,350,325,0
343,0,2,64.0,66.0,70.0,70.0,2143,2328,1651,1791,492,537,379,377,138,165,241,212,35,47,1750,1100,1000,950,350,325,0
350,0,2,68.0,68.0,93.0,78.0,2115,2373,1623,1903,492,470,389,560,88,300,301,260,37,49,1750,1450,1000,1100,350,325,0
357,0,2,68.0,68.0,93.0,78.0,2138,2429,1623,1959,515,470,415,750,58,430,357,320,38,49,1750,1450,1150,1100,350,325,0
364,0,2,70.0,70.0,93.0,78.0,1970,2429,1455,1959,515,470,545,950,128,570,417,380,39,51,1800,1450,1300,1100,350,325,0
371,0,2,70.0,70.0,93.0,78.0,2205,2518,1735,2071,470,447,637,671,268,535,369,136,39,52,2125,1350,1300,1100,350,425,0
379,0,2,78.0,71.0,93.0,78.0,2429,2563,1959,2071,470,492,387,376,58,180,329,196,41,53,2125,1350,1300,1100,350,425,0
386,0,2,78.0,74.0,93.0,78.0,2849,2418,2379,1903,470,515,152,402,63,225,89,177,41,55,2125,1350,1550,1100,350,425,0
393,0,2,78.0,78.0,93.0,78.0,2955,2311,2463,1819,492,492,347,428,248,195,99,233,43,55,2225,1350,1450,1100,350,425,0
400,0,2,76.0,78.0,93.0,78.0,2843,2401,2351,1931,492,470,517,714,358,425,159,289,43,57,2275,1550,1450,1100,550,425,0
407,0,2,83.0,81.0,93.0,93.0,2922,2513,2407,2043,515,470,408,869,243,520,165,349,45,57,2225,1650,1450,1100,600,425,0
414,0,2,89.0,84.0,101.0,93.0,2933,2714,2463,2155,470,559,160,496,143,275,17,221,46,60,2225,1650,1450,1450,600,425,0
421,0,2,88.0,88.0,101.0,93.0,2933,2698,2463,2071,470,627,565,412,488,115,77,297,47,60,2225,1850,1450,1450,600,425,0
429,0,2,90.0,90.0,101.0,93.0,3034,3134,2519,2463,515,671,833,792,688,415,145,377,48,62,2575,1850,1550,1450,600,475,0
436,0,2,94.0,85.0,109.0,93.0,2916,3157,2379,2463,537,694,816,1062,653,605,163,457,48,57,2475,1850,1550,1450,700,725,0
443,0,2,92.0,86.0,109.0,93.0,2966,2479,2407,1875,559,604,764,1211,533,690,231,521,50,58,2675,1850,1550,1450,916,825,0
450,0,2,99.0,92.0,109.0,93.0,2905,2597,2323,2015,582,582,728,709,483,420,245,289,52,60,2775,2250,1550,1450,916,825,0
457,0,2,105.0,92.0,109.0,93.0,2742,2916,2183,2267,559,649,527,1040,268,675,259,365,52,61,3025,2250,1550,1900,916,825,0
464,0,2,109.0,92.0,109.0,93.0,2866,3006,2351,2379,515,627,327,531,208,290,119,241,55,63,3025,2250,1550,2050,916,825,0
471,0,2,109.0,96.0,109.0,117.0,3140,3039,2603,2435,537,604,291,707,216,390,75,317,55,63,3225,2250,1550,2350,916,825,0
479,0,2,116.0,104.0,125.0,125.0,3280,3398,2743,2547,537,851,704,418,571,285,133,133,55,63,3575,2850,1550,2350,916,825,0
486,0,2,120.0,108.0,125.0,141.0,3442,3554,2883,2547,559,1007,728,445,579,200,149,245,55,63,3450,2500,1550,2350,1041,1175,0
493,0,2,123.0,106.0,133.0,141.0,3442,3482,2883,2519,559,963,486,838,369,485,117,353,58,63,3850,2725,1850,2350,1041,1350,0
500,0,2,123.0,110.0,133.0,141.0,3470,3431,2911,2491,559,940,361,1059,309,590,52,469,61,63,4050,3300,1850,2350,1041,1350,0
507,0,2,129.0,110.0,133.0,149.0,3465,3403,2883,2463,582,940,449,1459,379,870,70,589,61,63,4400,3300,1850,2450,1041,1350,0
514,0,2,127.0,122.0,141.0,157.0,3420,3588,2883,2603,537,985,854,1294,724,585,130,709,61,63,4300,3900,1850,2450,1141,1350,0
521,0,2,134.0,124.0,141.0,157.0,3151,3532,2547,2547,604,985,894,1455,734,630,160,825,61,63,4400,3900,1925,2450,1141,1350,0
529,0,2,134.0,129.0,149.0,157.0,3017,3560,2323,2575,694,985,856,1407,604,770,252,637,61,63,4650,3900,1925,2450,1141,1350,0
536,0,2,136.0,141.0,149.0,157.0,3090,3364,2239,2379,851,985,1140,1093,784,490,356,603,64,64,4650,4100,2475,2450,1141,1350,0
543,0,2,143.0,141.0,149.0,157.0,3190,3487,2295,2547,895,940,608,1510,519,795,89,715,64,64,4800,5050,2475,2450,1191,1350,0
550,0,2,140.0,135.0,149.0,157.0,3353,3487,2435,2547,918,940,632,1540,439,805,193,735,64,64,4625,4750,2675,2450,1466,1650,0
557,0,2,131.0,109.0,165.0,157.0,3336,3168,2463,2295,873,873,758,1899,519,1060,239,839,64,60,4200,3525,2675,2450,1866,3225,0
564,0,2,116.0,101.0,165.0,157.0,2983,2838,2155,2099,828,739,818,1527,504,600,314,927,59,60,3175,2275,2675,2450,2841,4775,0
571,0,2,103.0,73.0,165.0,157.0,2255,2860,1539,2099,716,761,561,1324,234,455,327,869,50,58,3250,975,2675,2450,3341,6625,0
579,0,2,105.0,73.0,165.0,149.0,2367,2742,1651,1959,716,783,550,996,139,485,411,511,50,57,3175,525,2675,2450,3516,7400,0
586,0,2,107.0,81.0,165.0,149.0,2877,2563,2183,1847,694,716,924,595,429,200,495,395,53,54,3275,2200,2675,2450,3516,7600,0
593,0,2,110.0,76.0,165.0,149.0,3465,2395,2771,1679,694,716,880,789,359,310,521,479,53,47,3500,2200,2675,2450,3666,7950,0
600,0,2,108.0,78.0,165.0,149.0,3213,2401,2519,1707,694,694,539,688,159,275,380,413,53,48,3300,2200,2675,2450,4016,7950,0
607,0,2,109.0,80.0,165.0,149.0,3302,2485,2631,1791,671,694,615,837,309,340,306,497,53,50,3350,2200,2675,2450,4016,7950,0
614,0,2,122.0,93.0,165.0,149.0,3179,2513,2575,1707,604,806,427,196,249,45,178,151,53,51,3825,2900,2675,2450,4016,7950,0
621,0,2,124.0,98.0,180.0,149.0,3235,2804,2631,1819,604,985,356,351,269,80,87,271,56,53,3925,3075,2675,2450,4016,7950,0
629,0,2,126.0,100.0,180.0,149.0,3325,2854,2631,1847,694,1007,760,593,589,210,171,383,56,55,4025,3725,2675,2450,4016,7950,0
636,0,2,139.0,100.0,180.0,149.0,3627,2983,2911,2043,716,940,464,926,384,435,80,491,56,56,4275,3725,2675,2450,4016,7950,0
643,0,2,139.0,98.0,180.0,149.0,3661,2955,2967,2015,694,940,865,806,709,195,156,611,59,57,4775,3475,2675,2450,4016,8200,0
650,0,2,142.0,104.0,180.0,149.0,3078,3011,2407,2071,671,940,871,261,764,130,107,131,59,57,4900,3475,2675,2450,4016,8200,0
657,0,2,141.0,112.0,180.0,157.0,2983,3062,2267,2099,716,963,1138,136,939,35,199,101,59,57,5275,4075,2675,2450,4066,8200,0
664,0,2,141.0,114.0,180.0,157.0,3140,3134,2267,2127,873,1007,1506,357,1199,240,307,117,59,57,5600,3775,2675,2450,4066,8200,0
671,0,2,139.0,112.0,180.0,157.0,3034,3241,2183,2211,851,1030,1855,753,1444,520,411,233,59,57,5325,4225,2775,2450,4341,8400,0
679,0,2,148.0,108.0,180.0,157.0,2972,3146,2099,2183,873,963,1693,801,1249,460,444,341,59,57,5600,3875,2775,2450,4341,9200,0
686,0,2,142.0,98.0,180.0,157.0,2994,3039,2099,2099,895,940,1707,477,1209,220,498,257,59,47,5225,3450,2775,2450,4716,10425,0
693,0,2,138.0,84.0,180.0,157.0,2994,2647,2099,1707,895,940,1101,792,799,415,302,377,59,47,4250,3200,2775,2750,5841,10825,0
700,0,2,126.0,70.0,180.0,157.0,3000,2692,2127,1707,873,985,1456,407,1054,110,402,297,59,47,3400,1175,2775,2750,7164,12850,0
706,0,2,126.0,60.0,180.0,157.0,3000,2647,2127,1707,873,940,1456,682,1054,285,402,397,59,47,3400,1000,2775,2750,7164,13725,0
7,0,0,13.0,13.0,15.0,15.0,251,335,251,335,0,0,30,40,30,40,0,0,12,12,0,0,0,0,0,0,1
14,0,0,14.0,14.0,15.0,15.0,643,671,643,671,0,0,65,70,65,70,0,0,13,13,0,0,0,0,0,0,1
21,0,0,14.0,14.0,15.0,15.0,671,671,671,671,0,0,35,45,35,45,0,0,13,13,0,0,0,0,0,0,1
29,0,0,15.0,15.0,15.0,15.0,755,643,755,643,0,0,80,85,80,85,0,0,14,14,0,0,0,0,0,0,1
36,0,0,15.0,15.0,15.0,15.0,727,699,727,699,0,0,115,125,115,125,0,0,14,14,0,0,0,0,0,0,1
43,0,0,16.0,16.0,23.0,23.0,811,783,811,783,0,0,55,60,55,60,0,0,15,15,0,0,0,0,0,0,1
50,0,0,16.0,16.0,23.0,23.0,755,755,755,755,0,0,75,35,75,35,0,0,15,15,0,0,0,0,0,0,1
57,0,0,17.0,17.0,23.0,23.0,755,727,755,727,0,0,105,125,105,125,0,0,16,16,0,0,0,0,0,0,1
64,0,0,17.0,17.0,23.0,23.0,755,839,755,839,0,0,205,180,205,180,0,0,16,16,0,0,0,0,0,0,1
71,0,0,18.0,18.0,23.0,23.0,699,827,699,783,0,44,240,218,240,210,0,8,17,17,0,0,0,0,0,0,1
79,0,0,18.0,19.0,23.0,23.0,782,911,671,755,111,156,340,338,320,310,20,28,18,18,0,0,0,0,0,0,1
86,0,0,19.0,19.0,23.0,23.0,794,934,615,755,179,179,290,443,250,395,40,48,18,18,0,0,0,0,0,0,1
93,0,0,19.0,19.0,23.0,23.0,850,934,671,755,179,179,285,293,275,275,10,18,18,19,0,0,150,150,0,0,1
100,0,0,19.0,19.0,23.0,23.0,799,883,643,727,156,156,391,399,365,365,26,34,19,19,0,0,150,150,0,0,1
107,0,0,19.0,19.0,31.0,23.0,855,939,699,783,156,156,341,114,295,60,46,54,19,19,0,0,150,150,0,0,1
114,0,0,19.0,19.0,31.0,23.0,883,995,727,839,156,156,456,129,390,55,66,74,19,19,0,0,150,150,0,0,1
121,0,0,19.0,20.0,31.0,23.0,883,939,727,783,156,156,161,194,75,100,86,94,19,19,0,0,150,150,0,0,1
129,0,0,21.0,20.0,31.0,23.0,995,995,839,839,156,156,136,309,30,195,106,114,19,19,0,0,250,250,0,0,1
136,0,0,21.0,22.0,31.0,31.0,934,1102,755,923,179,179,231,334,105,200,126,134,19,20,0,0,250,250,0,0,1
143,0,0,22.0,23.0,31.0,31.0,1018,1191,839,1035,179,156,211,315,65,165,146,150,19,20,0,0,250,250,0,0,1
150,0,0,24.0,25.0,31.0,31.0,939,1135,783,979,156,156,317,395,155,225,162,170,19,20,100,100,250,250,0,0,1
157,0,0,25.0,26.0,31.0,31.0,1107,1219,951,1063,156,156,147,295,65,205,82,90,20,21,100,100,250,250,0,0,1
164,0,0,26.0,27.0,31.0,31.0,1051,1247,895,1091,156,156,287,160,185,50,102,110,21,22,200,100,250,250,0,0,1
171,0,0,27.0,29.0,31.0,31.0,1051,1219,895,1063,156,156,167,145,45,15,122,130,21,22,200,200,250,250,0,0,1
179,0,0,28.0,30.0,31.0,46.0,1079,1130,923,951,156,179,202,290,60,140,142,150,21,23,200,200,250,250,0,0,1
186,0,0,30.0,30.0,31.0,46.0,1130,1214,951,1035,179,179,347,250,185,80,162,170,22,23,250,200,250,250,0,0,1
193,0,0,31.0,31.0,46.0,46.0,1135,1281,979,1035,156,246,393,412,215,210,178,202,23,24,300,300,250,250,0,0,1
200,0,0,33.0,33.0,46.0,46.0,1163,1544,1007,1231,156,313,283,487,85,245,198,242,23,25,350,300,500,250,0,0,1
207,0,0,34.0,35.0,46.0,46.0,1219,1538,1063,1203,156,335,293,442,75,185,218,257,24,25,350,300,500,500,0,0,1
214,0,0,35.0,35.0,46.0,46.0,1051,1594,895,1259,156,335,238,497,25,225,213,272,24,25,400,400,650,650,0,0,1
221,0,0,37.0,37.0,46.0,46.0,1247,1740,1091,1427,156,313,328,698,120,390,208,308,25,27,450,400,650,725,0,0,1
229,0,0,38.0,42.0,54.0,46.0,1326,1762,1147,1427,179,335,273,438,45,215,228,223,25,28,500,400,650,800,0,0,1
236,0,0,41.0,45.0,54.0,46.0,1578,1762,1399,1427,179,335,373,373,125,110,248,263,26,29,550,400,800,800,0,0,1
243,0,0,45.0,46.0,54.0,46.0,1723,1936,1567,1623,156,313,304,369,165,170,139,199,28,30,550,400,800,800,0,0,1
250,0,0,45.0,47.0,54.0,54.0,1774,1958,1595,1623,179,335,293,509,130,270,163,239,29,31,600,550,800,800,0,0,1
257,0,0,48.0,50.0,54.0,62.0,1818,2042,1595,1707,223,335,211,509,20,230,191,279,29,32,650,550,800,800,0,0,1
264,0,0,50.0,54.0,54.0,62.0,1886,1992,1595,1679,291,313,341,470,110,280,231,190,29,33,650,825,800,800,0,0,1
271,0,0,52.0,58.0,62.0,70.0,1880,2266,1567,1931,313,335,311,505,140,275,171,230,31,34,925,925,925,800,0,0,1
279,0,0,53.0,59.0,62.0,70.0,2233,2098,1875,1763,358,335,596,590,385,320,211,270,32,35,1075,925,925,800,0,0,1
286,0,0,59.0,61.0,62.0,70.0,2294,2356,1959,2043,335,313,412,496,290,290,122,206,33,37,1075,975,925,800,0,0,1
293,0,0,60.0,65.0,62.0,70.0,2300,2412,1987,2099,313,313,323,471,265,225,58,246,35,38,1075,1350,925,800,0,0,1
300,0,0,61.0,68.0,62.0,70.0,2216,2490,1903,2155,313,335,323,366,225,205,98,161,35,38,1075,1350,925,800,0,0,1
307,0,0,62.0,71.0,62.0,78.0,1992,2546,1679,2211,313,335,468,551,330,350,138,201,35,40,1225,1400,925,800,0,0,1
314,0,0,62.0,72.0,62.0,78.0,2020,2384,1707,2071,313,313,503,752,325,515,178,237,36,40,1225,1500,925,800,0,0,1
321,0,0,65.0,74.0,70.0,78.0,1925,2468,1567,2043,358,425,753,808,535,515,218,293,36,42,1550,1550,925,1050,0,0,1
329,0,0,66.0,78.0,70.0,86.0,2009,2619,1651,2127,358,492,893,493,635,415,258,78,36,42,1550,1875,1175,1050,0,0,1
336,0,0,70.0,78.0,86.0,86.0,1936,2485,1623,2015,313,470,350,509,310,425,40,84,37,42,1550,1875,1175,1200,0,0,1
343,0,0,72.0,80.0,86.0,86.0,1880,2485,1567,2015,313,470,475,524,395,380,80,144,37,42,1650,1975,1325,1200,0,0,1
350,0,0,73.0,81.0,86.0,86.0,1768,2502,1455,1987,313,515,490,379,470,300,20,79,38,42,1700,2025,1325,1200,0,0,1
357,0,0,75.0,83.0,86.0,102.0,1936,2457,1623,1987,313,470,620,566,560,435,60,131,38,42,1800,2125,1325,1200,0,0,1
364,0,0,79.0,89.0,94.0,102.0,1975,2479,1595,1987,380,492,218,546,210,455,8,91,38,42,2125,2450,1325,1200,0,0,1
371,0,0,79.0,91.0,94.0,102.0,2143,2479,1651,1987,492,492,369,491,305,440,64,51,38,42,2125,2450,1325,1300,0,0,1
379,0,0,81.0,93.0,94.0,102.0,2115,2317,1623,1847,492,470,620,542,500,435,120,107,38,42,2225,2550,1325,1300,0,0,1
386,0,0,82.0,97.0,94.0,118.0,2093,2199,1623,1707,470,492,671,237,495,195,176,42,38,42,2275,2600,1425,1300,0,0,1
393,0,0,86.0,102.0,102.0,118.0,2031,2423,1539,1931,492,492,446,338,435,240,11,98,38,43,2375,3175,1425,1600,0,0,1
400,0,0,92.0,109.0,102.0,118.0,2115,2591,1623,2099,492,492,321,278,250,220,71,58,38,43,2700,3525,1425,1600,0,0,1
407,0,0,95.0,109.0,102.0,134.0,2121,2653,1651,2183,470,470,432,604,305,490,127,114,39,43,2700,3525,1425,1600,0,0,1
414,0,0,100.0,113.0,102.0,134.0,2143,2843,1651,2351,492,492,232,604,145,430,87,174,40,43,2800,3725,1425,1600,0,0,1
421,0,0,102.0,116.0,102.0,134.0,2244,2894,1707,2379,537,515,486,359,335,250,151,109,41,43,2850,3875,1425,1600,0,0,1
429,0,0,102.0,121.0,102.0,134.0,2216,2849,1679,2379,537,470,551,676,440,515,111,161,42,43,3525,4450,1425,1600,0,0,1
436,0,0,102.0,128.0,102.0,134.0,2384,2877,1847,2407,537,470,575,611,400,490,175,121,43,43,3575,4700,1425,1600,0,0,1
443,0,0,102.0,128.0,102.0,150.0,2272,2843,1735,2351,537,492,529,376,290,195,239,181,43,43,3775,4700,1425,1600,0,0,1
450,0,0,102.0,132.0,102.0,150.0,2188,2703,1651,2211,537,492,402,676,295,435,107,241,43,43,3775,4900,1425,1600,0,0,1
457,0,0,102.0,135.0,102.0,150.0,2188,2451,1651,1959,537,492,641,912,470,615,171,297,43,43,3775,5325,1425,1600,0,0,1
464,0,0,105.0,137.0,126.0,150.0,2154,2451,1595,1959,559,492,905,878,670,525,235,353,43,43,3250,5625,1425,1600,525,0,1
471,0,0,100.0,147.0,126.0,150.0,2160,2423,1623,1931,537,492,1164,248,865,60,299,188,43,43,3000,5875,1425,1600,775,0,1
479,0,0,72.0,140.0,126.0,150.0,2272,2317,1735,1847,537,470,1443,514,1080,270,363,244,45,43,1400,5525,1425,1600,2625,350,1
486,0,0,60.0,124.0,126.0,150.0,2300,2423,1763,1931,537,492,1721,809,1290,505,431,304,45,43,425,4725,1425,1600,3600,1350,1
493,0,0,49.0,129.0,126.0,150.0,2250,2306,1735,1791,515,515,1981,209,1490,70,491,139,35,43,675,4875,1425,1600,4250,1350,1
7,2,1,13.0,13.0,15.0,14.0,293,293,293,293,0,0,35,35,35,35,0,0,12,12,0,0,0,0,0,0,1
14,2,1,14.0,13.0,15.0,14.0,671,671,671,671,0,0,70,20,70,20,0,0,13,13,0,0,0,0,0,0,1
21,2,1,14.0,14.0,15.0,14.0,699,699,699,699,0,0,50,55,50,55,0,0,13,13,0,0,0,0,0,0,1
29,2,1,15.0,14.0,15.0,14.0,727,755,727,755,0,0,90,145,90,145,0,0,14,13,0,0,0,0,0,0,1
36,2,1,15.0,16.0,15.0,22.0,783,755,783,755,0,0,135,150,135,150,0,0,14,14,0,0,0,0,0,0,1
43,2,1,16.0,16.0,23.0,22.0,811,811,811,811,0,0,30,245,30,245,0,0,15,16,0,0,0,0,0,0,1
50,2,1,17.0,16.0,23.0,22.0,839,811,839,811,0,0,50,40,50,40,0,0,16,16,0,0,0,0,0,0,1
57,2,1,18.0,17.0,23.0,22.0,839,867,839,867,0,0,105,45,105,45,0,0,17,15,0,0,0,0,0,0,1
64,2,1,19.0,18.0,23.0,22.0,923,923,923,923,0,0,165,100,165,100,0,0,18,16,0,0,0,0,0,0,1
71,2,1,19.0,18.0,23.0,22.0,945,979,923,979,22,0,229,215,225,215,4,0,18,18,0,0,0,0,0,0,1
79,2,1,20.0,17.0,23.0,22.0,990,951,923,951,67,0,352,35,340,35,12,0,19,16,0,0,0,0,0,0,1
86,2,1,20.0,18.0,23.0,22.0,1029,923,895,923,134,0,68,90,40,90,28,0,19,16,0,0,150,0,0,0,1
93,2,1,21.0,19.0,23.0,22.0,1006,951,895,951,111,0,135,155,95,155,40,0,20,18,0,0,150,0,0,0,1
100,2,1,21.0,20.0,23.0,22.0,995,945,839,923,156,22,105,209,45,205,60,4,21,19,0,0,150,0,0,0,1
107,2,1,22.0,20.0,23.0,22.0,1102,950,923,839,179,111,120,320,40,300,80,20,21,19,0,0,150,0,0,0,1
114,2,1,22.0,20.0,23.0,22.0,1135,1023,979,867,156,156,141,345,45,305,96,40,22,20,0,0,150,0,0,0,1
121,2,1,23.0,22.0,23.0,22.0,1113,1051,979,895,134,156,172,325,60,265,112,60,22,20,0,0,150,250,0,0,1
129,2,1,23.0,26.0,23.0,28.0,1113,1130,979,951,134,179,303,205,175,125,128,80,23,20,0,0,150,250,0,0,1
136,2,1,26.0,28.0,31.0,36.0,1152,1214,951,1035,201,179,166,250,85,150,81,100,23,20,0,0,300,250,0,0,1
143,2,1,27.0,28.0,31.0,36.0,1242,1068,951,979,291,89,321,174,200,170,121,4,24,21,0,50,300,250,0,0,1
150,2,1,27.0,30.0,31.0,36.0,1208,1214,895,1147,313,67,116,217,105,205,11,12,24,23,0,50,300,250,0,0,1
157,2,1,30.0,29.0,46.0,36.0,1264,1270,951,1203,313,67,101,70,100,50,1,20,25,24,125,200,300,250,0,0,1
164,2,1,32.0,31.0,46.0,36.0,1286,1326,951,1259,335,67,101,128,60,100,41,28,26,24,125,350,300,250,0,0,1
171,2,1,33.0,32.0,46.0,36.0,1477,1466,1119,1399,358,67,136,151,55,115,81,36,28,25,125,350,300,250,0,0,1
179,2,1,35.0,34.0,46.0,36.0,1482,1438,1147,1371,335,67,207,149,90,105,117,44,29,26,125,350,300,250,0,0,1
186,2,1,36.0,36.0,46.0,44.0,1600,1522,1287,1455,313,67,308,247,155,195,153,52,30,27,125,350,300,250,0,0,1
193,2,1,41.0,41.0,46.0,44.0,1628,1555,1315,1511,313,44,153,176,110,120,43,56,31,29,300,350,600,250,0,0,1
200,2,1,43.0,43.0,46.0,44.0,1690,1690,1399,1623,291,67,160,124,85,60,75,64,33,29,300,350,600,250,0,0,1
207,2,1,43.0,44.0,46.0,44.0,1886,1606,1595,1539,291,67,340,267,225,195,115,72,33,33,300,400,600,250,0,0,1
214,2,1,45.0,44.0,54.0,44.0,1908,1690,1595,1623,313,67,515,225,360,145,155,80,35,33,300,550,600,250,0,0,1
221,2,1,50.0,47.0,54.0,52.0,2042,1734,1707,1623,335,111,350,381,305,285,45,96,36,34,650,550,750,250,0,0,1
229,2,1,51.0,49.0,54.0,58.0,1992,1891,1679,1735,313,156,126,526,45,410,81,116,37,34,650,550,750,250,0,0,1
236,2,1,52.0,55.0,54.0,66.0,2070,1835,1735,1679,335,156,166,401,45,265,121,136,38,36,650,700,750,250,0,0,1
243,2,1,53.0,57.0,54.0,66.0,2042,1947,1707,1791,335,156,211,486,50,330,161,156,39,40,650,750,750,250,0,0,1
250,2,1,54.0,63.0,62.0,66.0,2076,2026,1763,1847,313,179,47,186,0,10,47,176,40,40,650,750,750,250,0,0,1
257,2,1,59.0,63.5,62.0,66.0,2132,2115,1819,1959,313,156,107,282,20,90,87,192,41,45,1000,875,750,250,0,25,1
264,2,1,61.0,65.5,62.0,66.0,2210,2283,1875,2127,335,156,332,312,205,100,127,212,43,45,1000,875,750,250,0,25,1
271,2,1,61.0,66.5,62.0,74.0,2222,2311,1707,2155,515,156,194,297,145,65,49,232,43,42,1000,1025,750,250,0,25,1
279,2,1,63.0,68.5,70.0,74.0,2311,2423,1707,2267,604,156,270,387,145,135,125,252,45,44,1000,1175,750,250,0,25,1
286,2,1,64.0,70.0,70.0,82.0,2384,2395,1735,2239,649,156,160,322,105,150,55,172,46,48,1000,1150,750,250,0,50,1
293,2,1,69.0,74.0,70.0,90.0,2502,2524,1875,2323,627,201,321,316,190,120,131,196,47,50,1350,1300,750,575,0,50,1
300,2,1,72.0,78.0,93.0,90.0,2541,2670,1847,2267,694,403,416,437,205,185,211,252,49,56,1350,1300,750,575,0,50,1
307,2,1,74.0,75.5,93.0,90.0,2625,2737,1931,2267,694,470,671,724,380,420,291,304,51,54,1350,1275,850,575,0,75,1
314,2,1,76.0,79.5,93.0,98.0,2586,2849,1959,2379,627,470,529,774,270,410,259,364,53,58,1350,1275,1150,575,0,75,1
321,2,1,82.0,77.5,93.0,98.0,2759,2927,2155,2435,604,492,100,1024,15,600,85,424,55,60,1350,1275,1150,575,0,75,1
329,2,1,84.0,86.0,93.0,98.0,2832,3095,2183,2603,649,492,255,969,90,485,165,484,57,60,1350,1250,1150,575,0,100,1
336,2,1,86.0,87.0,93.0,98.0,3028,3062,2379,2435,649,627,271,1278,30,710,241,568,59,69,1700,1250,1150,575,0,100,1
343,2,1,88.0,86.0,93.0,106.0,3134,3291,2463,2463,671,828,540,1173,215,555,325,618,61,68,1700,1250,1300,950,0,100,1
350,2,1,89.0,92.0,93.0,106.0,3252,3465,2491,2547,761,918,219,629,110,145,109,484,62,68,1700,1300,1550,950,0,100,1
357,2,1,92.0,91.0,93.0,114.0,3196,3599,2435,2659,761,940,156,751,55,255,101,496,65,67,2050,1400,1550,950,0,100,1
364,2,1,93.0,90.0,101.0,114.0,3392,3683,2519,2743,873,940,515,606,310,190,205,416,67,68,2050,1400,1550,950,0,100,1
371,2,1,93.0,90.0,101.0,114.0,3571,3745,2631,2715,940,1030,951,1051,630,515,321,536,68,68,2050,1400,1550,950,0,100,1
379,2,1,93.0,102.0,101.0,130.0,3594,3666,2631,2659,963,1007,733,672,400,120,333,552,69,68,2050,1200,1700,1075,0,300,1
386,2,1,93.0,102.0,101.0,130.0,3706,3728,2743,2743,963,985,633,625,180,115,453,510,69,67,2050,1500,1850,1075,0,300,1
393,2,1,97.0,100.0,101.0,130.0,3728,3616,2743,2631,985,985,274,945,205,315,69,630,69,76,2050,1500,2350,1075,0,300,1
400,2,1,99.0,106.0,101.0,130.0,3750,3599,2743,2659,1007,940,374,1057,335,315,39,742,69,78,2450,1500,2350,1075,0,300,1
407,2,1,99.0,106.5,101.0,130.0,3728,3711,2743,2771,985,940,386,1447,235,585,151,862,69,78,2650,1475,2600,1075,0,325,1
414,2,1,99.0,108.5,101.0,136.0,3756,3896,2771,2911,985,985,727,1327,460,345,267,982,69,79,2650,1725,2600,1325,0,325,1
421,2,1,100.0,109.5,109.0,136.0,3700,4165,2715,3135,985,1030,678,1412,370,460,308,952,69,80,2650,1725,2600,1575,0,325,1
429,2,1,104.0,109.5,109.0,176.0,3650,4322,2687,3359,963,963,604,1925,380,865,224,1060,69,82,2650,1725,2900,1575,0,325,1
436,2,1,104.0,128.0,117.0,176.0,3818,4484,2855,3499,963,985,519,1461,175,535,344,926,69,83,2750,1650,3200,2225,0,400,1
443,2,1,106.0,127.5,125.0,176.0,3750,4512,2743,3527,1007,985,550,1691,390,795,160,896,69,83,3025,1625,3650,2225,125,425,1
450,2,1,102.0,137.5,125.0,176.0,3834,4411,2827,3471,1007,940,525,1673,245,665,280,1008,69,83,3175,2025,3950,2225,475,425,1
457,2,1,106.0,135.5,125.0,176.0,3784,4350,2799,3387,985,963,558,1898,470,770,88,1128,69,81,3175,2625,3950,2225,475,425,1
464,2,1,114.0,134.5,125.0,176.0,3762,4366,2799,3359,963,1007,179,2048,75,1000,104,1048,69,90,3575,2625,4250,2225,475,425,1
471,2,1,117.0,135.5,125.0,176.0,3739,4450,2799,3443,940,1007,481,2389,265,1225,216,1164,69,89,3775,2625,4500,2225,475,425,1
479,2,1,124.0,137.5,140.0,176.0,3818,4462,2855,3499,963,963,601,2057,265,1010,336,1047,72,91,4075,2725,4750,2225,475,425,1
486,2,1,127.0,138.5,148.0,176.0,3762,4574,2799,3387,963,1187,382,2168,130,1015,252,1153,72,91,4075,2725,5000,2225,475,425,1
493,2,1,127.0,147.0,148.0,192.0,3582,4770,2575,3471,1007,1299,648,1444,280,935,368,509,73,94,4450,2700,5150,2575,475,450,1
500,2,1,128.0,147.0,148.0,224.0,3532,4803,2547,3527,985,1276,1014,1015,530,850,484,165,76,93,4450,2800,5150,2575,475,450,1
507,2,1,130.0,146.0,148.0,224.0,3930,4826,2967,3527,963,1299,1091,1285,645,1110,446,175,76,92,4450,2800,5150,2725,475,450,1
514,2,1,134.0,145.0,148.0,224.0,4154,4781,3191,3415,963,1366,1206,1486,740,1155,466,331,77,92,4450,2800,5150,2725,475,450,1
521,2,1,134.0,153.0,148.0,224.0,4350,4624,3387,3303,963,1321,1722,1028,1140,945,582,83,79,92,4450,3700,5150,2725,475,450,1
529,2,1,146.0,163.0,148.0,224.0,4238,4658,3275,3359,963,1299,657,996,630,765,27,231,79,92,4450,3700,5650,2725,475,450,1
536,2,1,148.0,163.0,148.0,224.0,4310,4714,3303,3415,1007,1299,788,1401,645,1010,143,391,79,92,4550,3700,5650,2725,475,450,1
543,2,1,146.0,158.0,148.0,224.0,4249,4579,3107,3303,1142,1276,1203,1413,920,1120,283,293,79,98,4450,3650,5650,2725,575,500,1
550,2,1,148.0,169.5,156.0,224.0,4271,4663,2995,3387,1276,1276,1587,1228,1160,775,427,453,79,98,4550,4475,5800,3125,725,675,1
557,2,1,154.0,169.5,180.0,224.0,4406,4708,3107,3387,1299,1321,1533,1189,1200,880,333,309,79,98,4925,4475,5800,3125,725,675,1
564,2,1,156.0,173.5,180.0,224.0,4378,4590,3079,3247,1299,1343,1058,685,815,520,243,165,79,96,4925,5225,5800,3250,725,675,1
571,2,1,162.0,170.5,180.0,224.0,4383,4669,3107,3415,1276,1254,1260,1039,865,730,395,309,79,93,5585,5225,5800,3700,725,675,1
579,2,1,168.0,182.5,180.0,224.0,4322,4624,3023,3303,1299,1321,1155,578,850,505,305,73,79,93,6245,5225,5800,3850,725,675,1
586,2,1,168.0,188.5,180.0,230.0,4445,4518,3079,3219,1366,1299,1666,638,1205,605,461,33,79,93,6260,5225,5800,3850,725,675,1
593,2,1,172.0,191.5,196.0,230.0,4422,4602,3079,3191,1343,1411,1257,884,890,675,367,209,79,93,6740,5825,5800,3850,1000,825,1
600,2,1,178.0,195.0,196.0,236.0,4411,4691,3135,3303,1276,1388,1131,967,870,790,261,177,79,93,7430,5800,5800,4150,1000,850,1
607,2,1,184.0,199.0,196.0,236.0,4350,4898,3051,3331,1299,1567,1171,1041,750,980,421,61,79,93,7475,6100,5800,4600,1000,850,1
614,2,1,182.0,197.5,196.0,236.0,4406,5111,3107,3499,1299,1612,1387,1652,810,1395,577,257,79,93,7705,6025,5800,4600,1100,925,1
621,2,1,166.0,187.5,196.0,236.0,4299,5190,3023,3555,1276,1635,1898,2276,1165,1835,733,441,79,93,6755,6525,5650,4600,2200,1425,1
629,2,1,188.0,181.5,196.0,236.0,4428,5352,3107,3695,1321,1657,479,2271,90,1955,389,316,79,93,7740,7225,5650,4600,2550,1725,1
636,2,1,188.0,177.0,196.0,236.0,4361,5094,2995,3527,1366,1567,659,1805,260,1705,399,100,79,93,8485,6600,5500,4600,2700,2350,1
643,2,1,188.0,191.0,196.0,236.0,4294,5061,2995,3471,1299,1590,547,1485,250,1385,297,100,79,92,8515,7100,5950,4600,2700,2350,1
650,2,1,188.0,189.5,196.0,236.0,4260,5173,2939,3583,1321,1590,628,2116,475,1820,153,296,79,91,8345,7075,5950,4600,2900,2375,1
657,2,1,184.0,187.0,196.0,236.0,4182,5206,2883,3527,1299,1679,714,2111,405,1915,309,196,79,91,8905,6950,5950,4600,3400,2500,1
664,2,1,194.0,196.5,196.0,236.0,4159,5027,2883,3415,1276,1612,426,1299,115,1115,311,184,79,91,8950,8375,5950,4600,3400,2525,1
671,2,1,195.0,197.5,196.0,236.0,4215,4792,2939,3135,1276,1657,1231,1566,760,1290,471,276,78,89,9465,8375,5950,4600,3450,2525,1
679,2,1,195.0,190.5,196.0,236.0,4226,4792,2883,3135,1343,1657,1792,1796,1165,1520,627,276,78,90,10885,8275,5950,4600,3450,2625,1
686,2,1,196.0,198.0,196.0,236.0,4114,4730,2771,3051,1343,1679,2273,1796,1490,1320,783,476,78,88,10800,8750,5950,4600,3550,2825,1
693,2,1,190.0,195.0,196.0,236.0,4075,4770,2799,3023,1276,1747,2751,2372,1820,1680,931,692,78,85,10445,9250,5950,4850,3950,2825,1
700,2,1,196.0,195.0,196.0,236.0,4042,4714,2743,2855,1299,1859,1632,2877,1095,1965,537,912,78,84,10275,9500,5950,5350,4150,2850,1
707,2,1,196.0,194.0,196.0,236.0,3963,4697,2687,2771,1276,1926,1893,3340,1200,2200,693,1140,78,84,10605,10050,5950,5350,4150,2850,1
714,2,1,194.0,192.0,196.0,236.0,3823,4602,2547,2743,1276,1859,1829,3600,980,2390,849,1210,78,84,10535,9950,5950,5350,4250,2950,1
721,2,1,194.0,200.0,196.0,236.0,3879,4674,2603,2771,1276,1903,1840,3747,985,2305,855,1442,78,84,11195,9950,5950,5350,4250,2950,1
729,2,1,199.0,200.0,212.0,236.0,3834,4652,2491,2771,1343,1881,1870,3856,930,2415,940,1441,78,84,11510,10250,5950,5475,4250,2950,1
736,2,1,199.0,200.0,212.0,236.0,3818,4596,2519,2715,1299,1881,2063,4398,975,2725,1088,1673,78,84,11875,10250,5950,5475,4400,2950,1
743,2,1,187.0,198.0,220.0,236.0,3739,4618,2463,2715,1276,1903,2490,4974,1250,3065,1240,1909,78,84,10350,10850,5950,5475,6040,3225,1
750,2,1,181.0,193.5,220.0,236.0,3790,4702,2491,2687,1299,2015,2975,4735,1575,2790,1400,1945,78,84,9645,9325,5950,5475,6760,4750,1
757,2,1,185.0,193.5,220.0,236.0,3846,4607,2547,2659,1299,1948,2726,5283,1470,3110,1256,2173,78,84,9645,9325,6100,5475,6760,4750,1
764,2,1,197.0,183.0,220.0,236.0,3773,4546,2519,2575,1254,1971,2683,5831,1275,3430,1408,2401,78,84,10395,8350,6050,5475,7310,5650,1
771,2,1,199.0,183.0,220.0,236.0,3840,4635,2519,2687,1321,1948,1688,6162,570,3525,1118,2637,78,84,10095,8400,5750,5475,7910,5900,1
779,2,1,199.0,195.5,220.0,236.0,3857,4697,2491,2771,1366,1926,2488,5385,1060,2895,1428,2490,78,84,10845,8375,5750,5475,7910,5925,1
786,2,1,199.0,195.5,220.0,236.0,3767,4697,2491,2771,1276,1926,2192,5585,620,3030,1572,2555,78,84,10845,8625,5750,5475,7910,5925,1
793,2,1,199.0,195.5,235.0,236.0,3627,4714,2351,2743,1276,1971,2804,6167,930,3380,1874,2787,78,84,11195,9125,5750,5475,7910,5925,1
800,2,1,183.0,191.0,235.0,236.0,3711,4730,2435,2715,1276,2015,2855,5813,1025,3240,1830,2573,78,84,10395,9550,5750,5475,8710,6125,1
807,2,1,185.0,191.0,235.0,236.0,3666,4562,2435,2659,1231,1903,3279,6248,1305,3505,1974,2743,78,84,10645,9550,5750,5475,8810,6125,1
814,2,1,186.0,188.0,235.0,236.0,3918,4506,2687,2603,1231,1903,3402,6561,1430,3590,1972,2971,78,81,10645,10550,5900,5475,8810,6125,1
821,2,1,196.0,200.0,235.0,236.0,3930,4148,2631,2379,1299,1769,2698,5558,1070,3075,1628,2483,78,81,10645,10550,6350,5475,8810,6125,1
829,2,1,196.0,198.0,235.0,236.0,3963,4193,2687,2379,1276,1814,3181,5524,1405,2825,1776,2699,79,79,10645,10550,6500,5475,8810,6125,1
836,2,1,200.0,179.5,235.0,236.0,3896,4193,2687,2379,1209,1814,2536,6099,620,3180,1916,2919,79,75,10345,9525,6400,5850,9460,7150,1
843,2,1,196.0,185.0,235.0,236.0,4025,4187,2771,2351,1254,1836,3177,6186,1105,3055,2072,3131,79,75,10795,9400,6400,5850,9660,7275,1
850,2,1,194.0,187.0,235.0,236.0,3918,4075,2687,2239,1231,1836,3636,6556,1420,3205,2216,3351,77,75,10795,10400,6400,6350,9760,7275,1
857,2,1,194.0,192.5,235.0,236.0,3874,3750,2687,1959,1187,1791,3400,6560,1040,3005,2360,3555,77,77,10795,11225,6400,6850,9760,7300,1
864,2,1,199.0,192.5,235.0,236.0,3879,3806,2715,2015,1164,1791,3445,6680,1120,3080,2325,3600,77,77,11645,11225,6400,6850,9760,7300,1
871,2,1,193.0,199.5,235.0,236.0,3952,3918,2519,2127,1433,1791,3924,6789,1415,2954,2509,3835,75,77,11445,11200,7000,6850,10060,7337,1
879,2,1,193.0,198.0,235.0,236.0,3823,4137,2323,2211,1500,1926,4380,7144,1695,3069,2685,4075,75,77,11445,11775,7150,6975,10060,7437,1
886,2,1,193.0,195.0,251.0,236.0,3834,3963,2379,2015,1455,1948,4852,7126,1995,3069,2857,4057,75,75,11445,12125,7450,6975,10060,7487,1
893,2,1,199.0,193.0,259.0,236.0,3902,4092,2379,2099,1523,1993,3381,7617,715,3324,2666,4293,75,75,11445,11975,7450,6975,10060,7637,1
900,2,1,190.0,193.0,259.0,236.0,3913,3997,2435,2071,1478,1926,3538,7335,850,3114,2688,4221,75,75,11170,11425,7300,6975,11435,7962,1
907,2,1,188.0,200.0,259.0,236.0,3862,3991,2407,2043,1455,1948,3265,7162,780,2859,2485,4303,67,75,12345,11425,7150,7225,11985,7962,1
914,2,1,183.0,197.5,259.0,236.0,3459,3958,2239,1987,1220,1971,3634,7647,1015,3104,2619,4543,62,75,12345,11300,7150,7225,12235,8087,1
921,2,1,181.0,192.5,259.0,236.0,2938,3963,1875,2015,1063,1948,3713,7510,1095,3039,2618,4471,58,75,12595,11150,7350,7225,12735,8337,1
929,2,1,180.0,199.0,251.0,236.0,2670,3958,1707,1987,963,1971,2975,6781,245,2674,2730,4107,57,75,12595,12175,7750,7225,12885,8412,1
936,2,1,164.0,196.0,266.0,236.0,2272,3896,1399,1903,873,1993,3384,7069,550,2734,2834,4335,41,75,12595,11725,7550,7225,13985,8412,1
943,2,1,169.0,193.5,266.0,236.0,1757,3734,1063,1763,694,1971,3338,7510,420,2939,2918,4571,41,73,12595,11650,7300,7225,14235,8487,1
950,2,1,163.0,199.5,243.0,236.0,1757,3666,1063,1763,694,1903,3372,6929,370,2534,3002,4395,45,73,11595,12550,7300,7225,15735,8562,1
957,2,1,163.0,199.5,243.0,236.0,1779,3706,1063,1735,716,1971,3416,6839,330,2204,3086,4635,45,73,11580,12550,7300,7100,15750,8687,1
964,2,1,161.0,193.5,243.0,236.0,1734,3661,1063,1735,671,1926,3583,7342,425,2479,3158,4863,48,67,11225,12550,7300,7100,16105,8937,1
971,2,1,167.0,192.5,243.0,236.0,1936,3683,1287,1735,649,1948,3214,7378,280,2279,2934,5099,48,67,11270,12500,7900,7100,16105,8987,1
979,2,1,167.0,197.5,243.0,236.0,2378,3532,1595,1595,783,1937,3273,6787,235,1854,3038,4933,48,64,11300,13500,8100,7100,16205,8987,1
986,2,1,167.0,197.0,235.0,236.0,2720,3465,1735,1595,985,1870,3587,7204,425,2059,3162,5145,48,64,11330,13475,8100,7850,16455,9012,1
993,2,1,170.0,195.5,235.0,236.0,2720,3437,1735,1623,985,1814,3776,7610,490,2249,3286,5361,48,64,11345,13400,8250,7850,16455,9087,1
1000,2,1,169.0,185.5,251.0,236.0,2748,3392,1763,1623,985,1769,4121,7989,715,2424,3406,5565,50,64,11345,12650,7500,7975,17255,9762,1
1007,2,1,168.0,197.0,235.0,228.0,2849,3330,1819,1539,1030,1791,4345,6899,890,1714,3455,5185,48,64,11945,13425,7350,7975,17705,9987,1
1014,2,1,163.0,197.0,227.0,220.0,2726,3330,1763,1539,963,1791,4673,7296,1110,1899,3563,5397,48,64,11520,13225,7200,7975,18455,10187,1
1021,2,1,162.0,182.0,219.0,220.0,2776,3493,1791,1567,985,1926,5003,7711,1320,2074,3683,5637,47,64,11520,12075,7200,7975,18605,11337,1
1029,2,1,165.0,177.0,219.0,220.0,2860,3498,1875,1595,985,1903,5194,7974,1395,2109,3799,5865,47,64,11620,11825,7200,7975,18605,11587,1
1036,2,1,181.0,176.0,219.0,220.0,2804,3420,1819,1539,985,1881,3528,8362,605,2289,2923,6073,47,63,11620,13325,7000,7975,18805,11587,1
1043,2,1,184.0,199.0,219.0,220.0,2888,3386,1903,1595,985,1791,3618,5922,575,829,3043,5093,50,62,13620,13325,6900,7975,18905,11587,1
1050,2,1,181.0,199.0,219.0,226.0,2759,3386,1763,1595,996,1791,3941,6306,780,1009,3161,5297,50,62,13320,13325,6900,7975,19205,11587,1
1057,2,1,180.0,195.0,219.0,226.0,2843,3297,1903,1483,940,1814,4289,6699,1020,1174,3269,5525,53,58,13220,13625,6900,8100,19305,11787,1
1064,2,1,178.0,182.0,227.0,226.0,2972,2910,1987,1119,985,1791,4581,7022,1200,1289,3381,5733,53,45,12930,15425,6900,8100,19595,12562,1
1071,2,1,178.0,182.0,227.0,220.0,2950,2541,1987,839,963,1702,4868,7326,1375,1389,3493,5937,53,45,12780,16175,6900,7350,19790,13812,1
1079,2,1,160.0,174.0,227.0,220.0,2854,2642,1959,895,895,1747,5137,7640,1540,1499,3597,6141,53,45,10875,15375,6900,7100,21755,14862,1
1086,2,1,178.0,172.0,227.0,220.0,2826,2574,1931,895,895,1679,2308,7941,220,1604,2088,6337,53,45,9695,15125,6900,7100,22995,15112,1
1093,2,1,154.0,190.0,227.0,220.0,2933,2546,2015,867,918,1679,2625,6102,425,169,2200,5933,53,45,8180,14325,6900,7100,25585,15912,1
1099,2,1,129.0,190.0,219.0,220.0,2989,2625,2071,923,918,1702,2956,6377,660,264,2296,6113,53,45,5690,14325,6700,7100,28405,15912,1
7,2,2,13.0,13.0,15.0,15.0,251,251,251,251,0,0,30,30,30,30,0,0,12,12,0,0,0,0,0,0,1
14,2,2,14.0,14.0,15.0,15.0,671,643,671,643,0,0,70,65,70,65,0,0,13,13,0,0,0,0,0,0,1
21,2,2,14.0,14.0,15.0,15.0,699,727,699,727,0,0,0,50,0,50,0,0,13,13,0,0,0,0,0,0,1
29,2,2,15.0,15.0,15.0,15.0,727,755,727,755,0,0,35,95,35,95,0,0,14,14,0,0,0,0,0,0,1
36,2,2,15.0,15.0,23.0,15.0,783,839,783,839,0,0,140,140,140,140,0,0,14,14,0,0,0,0,0,0,1
43,2,2,16.0,16.0,23.0,23.0,811,783,811,783,0,0,35,30,35,30,0,0,15,15,0,0,0,0,0,0,1
50,2,2,17.0,17.0,23.0,23.0,811,895,811,895,0,0,0,15,0,15,0,0,16,16,0,0,0,0,0,0,1
57,2,2,18.0,18.0,23.0,23.0,839,923,839,923,0,0,30,35,30,35,0,0,17,17,0,0,0,0,0,0,1
64,2,2,19.0,19.0,23.0,23.0,923,979,923,979,0,0,90,105,90,105,0,0,18,18,0,0,0,0,0,0,1
71,2,2,19.0,20.0,23.0,23.0,951,951,951,951,0,0,55,15,55,15,0,0,18,19,0,0,0,0,0,0,1
79,2,2,20.0,20.0,23.0,23.0,973,990,951,923,22,67,119,82,115,70,4,12,19,19,0,0,0,0,0,0,1
86,2,2,21.0,21.0,23.0,23.0,1034,1068,923,867,111,201,45,70,25,30,20,40,20,20,0,0,150,150,0,0,1
93,2,2,22.0,22.0,23.0,23.0,1057,1040,923,839,134,201,121,135,85,75,36,60,21,21,0,0,150,150,0,0,1
100,2,2,22.0,22.0,23.0,23.0,1169,1085,923,839,246,246,118,167,50,75,68,92,21,21,0,0,150,150,0,0,1
107,2,2,23.0,23.0,23.0,23.0,1130,1236,839,923,291,313,240,258,140,130,100,128,22,22,0,0,150,150,0,0,1
114,2,2,24.0,23.0,31.0,31.0,1202,1208,867,895,335,313,335,354,195,190,140,164,23,22,0,0,150,150,0,0,1
121,2,2,26.0,24.0,31.0,31.0,1180,1314,867,979,313,335,301,504,175,300,126,204,23,23,0,0,450,300,0,0,1
129,2,2,29.0,28.0,31.0,31.0,1236,1264,923,951,313,313,116,70,50,30,66,40,24,24,0,0,450,450,0,0,1
136,2,2,29.0,28.0,31.0,31.0,1208,1264,895,951,313,313,161,120,55,90,106,30,24,24,0,0,450,450,0,0,1
143,2,2,29.0,29.0,31.0,31.0,1230,1242,895,951,335,291,306,41,160,25,146,16,25,24,0,0,450,450,0,0,1
150,2,2,29.0,29.0,31.0,31.0,1236,1292,923,979,313,313,107,201,25,145,82,56,25,24,0,0,450,450,0,0,1
157,2,2,33.0,29.0,39.0,39.0,1258,1348,923,1035,335,313,247,356,125,260,122,96,25,25,350,175,450,450,0,0,1
164,2,2,33.0,29.0,39.0,39.0,1314,1314,979,979,335,335,407,506,245,370,162,136,25,25,350,175,450,450,0,0,1
171,2,2,33.0,32.0,39.0,39.0,1264,1292,951,979,313,313,553,262,355,240,198,22,25,25,350,350,450,750,0,0,1
179,2,2,34.0,32.0,39.0,39.0,1264,1314,951,979,313,335,348,412,310,350,38,62,25,25,350,350,450,750,0,0,1
186,2,2,38.0,32.0,39.0,39.0,1258,1314,923,979,335,335,403,167,325,65,78,102,26,25,700,350,450,750,0,0,1
193,2,2,38.0,32.0,39.0,47.0,1264,1292,951,979,313,313,504,173,390,35,114,138,25,24,700,350,450,750,50,50,1
200,2,2,39.0,34.0,39.0,47.0,1348,1292,1035,979,313,313,320,158,270,30,50,128,26,24,700,650,450,750,50,50,1
207,2,2,39.0,35.0,47.0,55.0,1342,1286,1007,951,335,335,525,258,435,90,90,168,26,25,700,650,450,750,50,50,1
214,2,2,40.0,35.0,47.0,47.0,1393,1258,1035,923,358,335,235,263,105,55,130,208,27,25,1000,650,450,750,50,150,1
221,2,2,39.0,36.0,47.0,47.0,1286,1258,951,923,335,335,336,164,170,20,166,144,26,26,1000,650,450,750,100,150,1
229,2,2,40.0,36.0,47.0,47.0,1320,1376,1007,1063,313,313,292,280,90,100,202,180,27,26,1000,650,450,750,100,150,1
236,2,2,41.0,37.0,47.0,47.0,1348,1370,1035,1035,313,335,302,440,60,220,242,220,28,27,1000,825,700,750,100,150,1
243,2,2,42.0,39.0,47.0,47.0,1454,1370,1119,1035,335,335,172,370,40,160,132,210,29,27,1000,825,700,850,100,150,1
250,2,2,42.0,42.0,47.0,47.0,1320,1264,1007,951,313,313,283,296,115,100,168,196,29,28,1000,1175,700,850,100,150,1
257,2,2,45.0,44.0,47.0,62.0,1426,1370,1091,1035,335,335,78,116,20,30,58,86,30,29,1175,1175,850,1100,100,150,1
264,2,2,46.0,46.0,47.0,62.0,1376,1594,1063,1259,313,335,99,196,5,70,94,126,31,31,1175,1175,950,1100,100,150,1
271,2,2,46.0,47.0,47.0,62.0,1404,1656,1091,1343,313,313,219,297,85,135,134,162,31,32,1175,1175,950,1100,100,150,1
279,2,2,47.0,50.0,47.0,62.0,1208,1578,895,1287,313,291,114,133,40,35,74,98,32,33,1175,1175,950,1100,100,150,1
286,2,2,49.0,52.0,70.0,62.0,1432,1824,1119,1511,313,313,195,263,85,125,110,138,33,35,1175,1325,950,1100,100,150,1
293,2,2,52.0,53.0,70.0,62.0,1684,1796,1371,1483,313,313,140,328,90,150,50,178,34,36,1325,1325,950,1100,100,150,1
300,2,2,56.0,54.0,70.0,62.0,1813,1986,1455,1651,358,335,80,269,40,55,40,214,36,37,1500,1325,950,1100,100,150,1
307,2,2,57.0,55.0,70.0,70.0,1897,1986,1539,1651,358,335,265,334,185,80,80,254,37,38,1500,1325,950,1100,100,150,1
314,2,2,59.0,56.0,70.0,70.0,1992,2020,1679,1707,313,313,447,316,335,130,112,186,39,39,1500,1325,950,1250,100,150,1
321,2,2,59.0,57.0,70.0,70.0,1992,2020,1679,1707,313,313,182,551,30,325,152,226,39,41,1500,1325,950,1250,100,150,1
329,2,2,62.0,58.0,70.0,70.0,2104,2104,1791,1791,313,313,162,311,45,45,117,266,41,41,1500,1325,1200,1250,100,150,1
336,2,2,65.0,61.0,70.0,70.0,2104,2104,1791,1791,313,313,192,386,85,130,107,256,42,42,1675,1500,1200,1250,100,150,1
343,2,2,68.0,64.0,78.0,70.0,2182,2216,1847,1791,335,425,117,336,20,70,97,266,43,43,1850,1675,1200,1400,100,150,1
350,2,2,69.0,65.0,78.0,70.0,2289,2194,1931,1679,358,515,237,537,100,215,137,322,44,44,1950,1675,1200,1550,100,150,1
357,2,2,71.0,70.0,78.0,70.0,2283,2311,1903,1819,380,492,256,323,75,45,181,278,46,45,1950,2025,1200,1550,100,150,1
364,2,2,72.0,70.0,78.0,78.0,2294,2345,1847,1875,447,470,318,604,85,270,233,334,47,46,1950,2025,1200,1550,100,150,1
371,2,2,77.0,75.0,78.0,78.0,2378,2317,1931,1847,447,470,335,279,150,85,185,194,48,47,2125,2375,1200,1550,100,150,1
379,2,2,77.0,76.0,78.0,86.0,2429,2401,1959,1931,470,470,515,534,270,280,245,254,48,47,2300,2375,1200,1550,200,150,1
386,2,2,76.0,74.0,78.0,86.0,2345,2423,1875,1931,470,492,605,464,300,250,305,214,49,48,2125,2075,1200,1550,375,450,1
393,2,2,78.0,75.0,93.0,86.0,2317,2311,1847,1819,470,492,471,345,110,75,361,270,50,50,2125,2075,1200,1550,375,450,1
400,2,2,81.0,77.0,93.0,101.0,2345,2160,1875,1735,470,425,237,394,20,80,217,314,51,51,2300,2075,1200,1550,375,450,1
407,2,2,84.0,79.0,101.0,101.0,2423,2356,1931,1931,492,425,278,246,80,80,198,166,53,52,2300,2075,1350,1550,375,450,1
414,2,2,85.0,79.0,101.0,109.0,2950,2569,2435,2099,515,470,333,271,175,45,158,226,54,53,2300,2075,1600,1550,375,450,1
421,2,2,87.0,84.0,101.0,109.0,2821,2759,2351,2267,470,492,555,311,345,125,210,186,56,55,2300,2225,1600,1550,375,450,1
429,2,2,87.0,85.0,101.0,109.0,2961,2894,2491,2379,470,515,510,136,240,40,270,96,58,56,2400,2225,1600,1650,375,450,1
436,2,2,91.0,88.0,101.0,109.0,2933,2927,2463,2435,470,492,480,342,250,190,230,152,59,58,2400,2325,1900,1900,375,450,1
443,2,2,91.0,96.0,101.0,109.0,3095,2983,2603,2491,492,492,505,133,415,25,90,108,59,58,2400,2625,1900,2550,375,450,1
450,2,2,103.0,98.0,109.0,109.0,3129,3006,2659,2491,470,515,266,382,120,210,146,172,59,58,2400,2625,1900,2550,375,450,1
457,2,2,103.0,102.0,109.0,117.0,3286,3039,2771,2435,515,604,557,353,355,105,202,248,59,59,3000,2825,1900,2550,375,450,1
464,2,2,106.0,102.0,117.0,117.0,3118,3112,2603,2463,515,649,297,633,35,305,262,328,59,60,3000,2825,1900,2850,375,450,1
471,2,2,106.0,110.0,125.0,125.0,3185,3140,2715,2491,470,649,469,193,155,85,314,108,59,60,3375,2925,1900,2850,375,450,1
479,2,2,108.0,110.0,125.0,133.0,3045,3106,2575,2435,470,671,485,564,115,380,370,184,62,60,3375,3850,2200,2850,375,450,1
486,2,2,112.0,119.0,125.0,149.0,3129,3162,2659,2491,470,671,460,500,330,240,130,260,62,60,3375,3850,2550,2850,375,450,1
493,2,2,120.0,122.0,141.0,149.0,3106,3084,2547,2435,559,649,427,206,225,20,202,186,62,60,3775,4250,2550,2850,375,450,1
500,2,2,120.0,124.0,141.0,157.0,3162,3146,2491,2519,671,627,657,402,375,290,282,112,62,62,4225,4250,2650,2850,375,450,1
507,2,2,124.0,129.0,141.0,157.0,3101,3118,2407,2491,694,627,367,522,305,330,62,192,62,62,4225,4450,2650,2850,375,450,1
514,2,2,128.0,132.0,141.0,157.0,2972,3084,2323,2435,649,649,334,672,300,400,34,272,62,63,4475,4900,2650,2850,375,450,1
521,2,2,127.0,139.0,141.0,157.0,2866,3190,2239,2519,627,671,605,262,545,210,60,52,62,65,4925,4925,2650,2850,375,625,1
529,2,2,139.0,142.0,149.0,157.0,3000,3218,2351,2547,649,671,350,233,210,105,140,128,62,65,4925,5125,2650,2850,375,675,1
536,2,2,139.0,142.0,164.0,157.0,3118,3168,2491,2519,627,649,731,600,515,400,216,200,65,66,5525,5575,2650,2850,375,675,1
543,2,2,143.0,142.0,164.0,157.0,3230,3118,2603,2491,627,627,811,316,515,290,296,26,65,66,5725,5400,2800,2850,375,850,1
550,2,2,143.0,143.0,156.0,165.0,3246,3174,2575,2547,671,627,1101,366,725,260,376,106,65,66,5725,5400,2800,2850,475,850,1
557,2,2,155.0,150.0,164.0,165.0,3493,3286,2799,2659,694,627,711,386,255,200,456,186,65,68,6325,5400,2950,2950,475,850,1
564,2,2,155.0,152.0,164.0,180.0,3504,3224,2855,2463,649,761,1033,376,505,90,528,286,65,69,6325,5625,2950,2950,475,1125,1
571,2,2,161.0,152.0,172.0,180.0,3364,3426,2715,2575,649,851,1034,767,430,385,604,382,63,70,6325,5725,2950,3100,575,1125,1
579,2,2,166.0,158.0,188.0,180.0,2798,3431,2239,2603,559,828,1048,559,380,385,668,174,62,70,7025,5550,2950,3100,625,1300,1
586,2,2,166.0,168.0,196.0,188.0,2905,3353,2435,2547,470,806,1414,450,690,180,724,270,62,70,7025,6250,2950,3300,625,1400,1
593,2,2,144.0,155.0,196.0,188.0,3381,3414,2911,2631,470,783,1384,576,600,360,784,216,62,70,5400,5525,2950,3300,1950,2875,1
600,2,2,129.0,135.0,196.0,180.0,3510,3358,2995,2575,515,783,1109,771,340,455,769,316,62,70,4750,4325,2950,3550,3400,4175,1
607,2,2,117.0,126.0,196.0,180.0,3431,3325,2939,2519,492,806,1300,616,475,200,825,416,62,70,3875,3775,2950,3550,4275,5425,1
614,2,2,105.0,112.0,196.0,180.0,3381,3370,2911,2519,470,851,1466,1026,585,510,881,516,62,70,3175,2875,2950,3550,5175,6325,1
621,2,2,107.0,121.0,196.0,180.0,3375,3510,2883,2659,492,851,1366,707,625,245,741,462,62,71,3075,3075,2950,3550,5275,6325,1
629,2,2,124.0,122.0,196.0,180.0,3403,3599,2911,2771,492,828,596,984,395,430,201,554,62,71,4525,3375,2950,3550,5275,6325,1
636,2,2,128.0,135.0,196.0,180.0,3437,3638,2967,2855,470,783,782,181,525,135,257,46,66,74,3725,3775,2950,3550,5275,6325,1
643,2,2,128.0,138.0,196.0,180.0,3515,3890,3023,3107,492,783,1127,311,810,215,317,96,66,74,4725,4375,2950,3550,5275,6325,1
650,2,2,136.0,138.0,196.0,180.0,3482,3694,2967,2911,515,783,927,541,550,345,377,196,70,74,5125,4825,2950,3550,5475,6525,1
657,2,2,139.0,140.0,204.0,180.0,3588,3885,2827,3079,761,806,661,916,430,620,231,296,70,75,5125,4925,2950,3800,5475,6525,1
664,2,2,147.0,146.0,204.0,180.0,3655,4064,2715,3191,940,873,538,881,295,635,243,246,70,75,5125,5450,2950,3800,5475,6525,1
671,2,2,147.0,143.0,204.0,180.0,3790,3986,2827,3135,963,851,904,478,545,340,359,138,73,75,5675,5550,2950,3950,5475,6725,1
679,2,2,159.0,150.0,204.0,180.0,3902,3941,2939,3135,963,806,795,355,320,275,475,80,73,76,6275,5750,2950,3950,5475,6825,1
686,2,2,162.0,160.0,204.0,180.0,3930,3806,2967,3023,963,783,776,196,285,20,491,176,73,76,6275,5650,2950,3950,5475,6925,1
693,2,2,169.0,160.0,212.0,180.0,3924,4142,2939,3359,985,783,532,296,75,170,457,126,73,76,6450,6250,2950,3950,5475,7025,1
700,2,2,166.0,160.0,212.0,180.0,3874,4137,2911,3331,963,806,1000,776,435,550,565,226,76,76,6600,6250,3250,4250,5675,7025,1
707,2,2,172.0,164.0,212.0,180.0,3935,4047,2995,3219,940,828,891,721,510,545,381,176,78,76,6600,6675,3500,4250,5675,7125,1
714,2,2,186.0,173.0,212.0,180.0,4025,4154,2995,3303,1030,851,558,322,45,200,513,122,78,76,6500,6675,3500,4250,5775,7325,1
721,2,2,186.0,173.0,212.0,188.0,4126,4047,3051,3219,1075,828,974,794,325,580,649,214,78,76,7300,7275,3500,4250,5775,7325,1
729,2,2,186.0,173.0,212.0,188.0,4148,3885,2939,3079,1209,806,1486,465,685,255,801,210,78,76,7300,7275,3750,4250,5775,7325,1
736,2,2,183.0,171.0,212.0,188.0,4378,3890,3079,3107,1299,783,1693,931,890,625,803,306,78,76,7300,7175,3750,3950,6075,7725,1
743,2,2,200.0,183.0,212.0,196.0,4378,3750,3079,2967,1299,783,1311,786,435,380,876,406,78,76,7600,7000,3750,3950,6075,7900,1
750,2,2,200.0,181.0,220.0,196.0,4333,3941,3079,3135,1254,806,1829,1171,805,740,1024,431,78,73,8400,8000,3750,3950,6075,8050,1
757,2,2,196.0,181.0,220.0,196.0,4361,3986,3107,3135,1254,851,1386,1651,435,1120,951,531,78,73,8200,8000,3750,3950,6275,8050,1
764,2,2,199.0,189.0,220.0,196.0,4277,3986,3023,3135,1254,851,1293,1217,340,590,953,627,78,73,8300,8300,3750,3950,6275,8150,1
771,2,2,199.0,195.0,220.0,196.0,4170,3801,2939,2995,1231,806,1786,800,685,460,1101,340,78,75,8600,9150,3750,4250,6275,8150,1
779,2,2,197.0,195.0,228.0,196.0,4266,3616,2967,2855,1299,761,2292,977,1035,545,1257,432,78,75,8500,9150,3750,4250,6375,8150,1
786,2,2,198.0,195.0,228.0,204.0,4215,3588,2939,2827,1276,761,2040,1432,785,900,1255,532,78,75,8400,9150,3750,4250,6475,8150,1
793,2,2,198.0,196.0,228.0,212.0,4187,3582,2911,2799,1276,783,1988,1762,685,1205,1303,557,78,75,8400,9150,4050,4250,6475,8150,1
800,2,2,198.0,197.0,228.0,212.0,4120,3689,2911,2883,1209,806,2172,1402,875,845,1297,557,78,75,8700,9150,4050,4550,6475,8150,1
807,2,2,199.0,197.0,228.0,220.0,4081,3375,2827,2547,1254,828,2364,1778,1065,1125,1299,653,78,75,8600,9150,4050,4700,6575,8150,1
814,2,2,183.0,190.0,236.0,220.0,4058,3364,2827,2491,1231,873,2847,1878,1400,1275,1447,603,78,76,8100,8675,4500,4700,7375,8725,1
821,2,2,196.0,200.0,236.0,243.0,4030,3375,2799,2547,1231,828,2679,635,1080,315,1599,320,78,76,8700,9125,4650,4700,7375,9425,1
829,2,2,199.0,200.0,251.0,243.0,4008,3498,2687,2715,1321,783,2705,1042,1050,630,1655,412,78,76,8700,9325,4750,4700,7375,9425,1
836,2,2,200.0,200.0,251.0,243.0,4075,3330,2799,2547,1276,783,3259,1442,1460,930,1799,512,82,76,8700,9325,4750,4700,7375,9425,1
843,2,2,198.0,198.0,251.0,243.0,3896,3762,2687,2911,1209,851,2708,1915,765,1295,1943,620,82,76,8900,9225,5050,4700,7475,9525,1
850,2,2,198.0,195.0,251.0,243.0,3868,4070,2659,2995,1209,1075,3181,2231,1090,1525,2091,706,83,75,8900,9500,5050,5000,7475,9775,1
857,2,2,170.0,193.0,251.0,243.0,3974,4170,2743,3051,1231,1119,3678,2713,1435,1875,2243,838,83,75,6825,9400,5050,5300,9550,9875,1
864,2,2,158.0,187.0,251.0,243.0,4014,4058,2827,2939,1187,1119,3772,2127,1685,1465,2087,662,83,75,6025,8125,5050,5300,10350,11150,1
871,2,2,172.0,184.0,251.0,243.0,4439,4142,3163,3023,1276,1119,3508,1774,1265,1380,2243,394,83,75,7125,8975,5350,5300,10450,11350,1
879,2,2,178.0,194.0,251.0,243.0,4428,4109,3107,3079,1321,1030,2830,1384,735,1120,2095,264,83,75,6725,8975,5800,5300,10450,11350,1
886,2,2,187.0,195.0,251.0,243.0,4540,3924,3331,2939,1209,985,2492,1278,515,890,1977,388,83,76,7075,9850,6050,5300,10550,11350,1
893,2,2,189.0,195.0,251.0,243.0,4383,3857,3219,2827,1164,1030,2626,1770,605,1250,2021,520,83,76,8200,9850,6050,5300,10650,11350,1
900,2,2,182.0,190.0,251.0,243.0,4456,3924,3247,2827,1209,1097,2873,2228,850,1580,2023,648,83,77,7400,9450,6050,5300,11450,11750,1
907,2,2,184.0,191.0,251.0,243.0,4221,4098,2967,3023,1254,1075,3074,2542,895,1920,2179,622,83,77,7350,9350,6050,5300,11800,11850,1
914,2,2,195.0,187.0,251.0,251.0,4305,4098,3051,3023,1254,1075,2571,3002,390,2260,2181,742,83,77,8350,9150,5900,5900,12175,12050,1
921,2,2,195.0,189.0,251.0,251.0,4053,3997,2855,3023,1198,974,2640,2072,325,1570,2315,502,83,77,8350,9150,5900,6000,12175,12050,1
929,2,2,195.0,187.0,251.0,251.0,3969,3790,2827,2939,1142,851,2379,2526,240,1920,2139,606,83,77,8350,9175,6050,6000,12175,12225,1
936,2,2,194.0,167.0,251.0,251.0,3963,3812,2911,2939,1052,873,2509,2984,350,2270,2159,714,83,79,8525,7725,6500,6000,12475,13675,1
943,2,2,186.0,159.0,251.0,251.0,3818,3857,2799,2995,1019,862,2940,3425,655,2605,2285,820,83,79,8300,7100,6500,6000,12875,14300,1
950,2,2,186.0,184.0,251.0,251.0,3896,4002,2967,3163,929,839,3041,1841,790,1525,2251,316,83,79,8600,8875,6500,6000,12875,14300,1
957,2,2,198.0,187.0,251.0,259.0,4025,3991,3107,3163,918,828,2472,1003,405,745,2067,258,83,79,9650,8875,6750,6000,12875,14300,1
964,2,2,200.0,189.0,251.0,259.0,4092,3890,3107,3107,985,783,2868,1256,685,910,2183,346,83,79,9650,8875,6750,6000,12875,14300,1
971,2,2,200.0,190.0,251.0,259.0,4142,3846,3135,3107,1007,739,3365,1519,1070,1085,2295,434,83,79,9750,8875,7250,6800,12875,14300,1
979,2,2,200.0,190.0,251.0,259.0,4126,3762,3163,3023,963,739,3854,1981,1455,1455,2399,526,83,82,9750,8875,7350,6800,12875,14300,1
986,2,2,200.0,188.0,251.0,259.0,4081,3902,3163,3163,918,739,4337,2447,1830,1825,2507,622,83,82,9750,9000,7350,6800,12875,14475,1
993,2,2,186.0,181.0,228.0,267.0,3958,3974,3107,3191,851,783,4706,2613,2095,2045,2611,568,83,82,8950,8600,7350,7550,14175,15175,1
1000,2,2,186.0,180.0,228.0,267.0,3224,3689,2575,2883,649,806,4652,2454,1965,2090,2687,364,83,82,9050,8400,7350,7800,14175,15375,1
1007,2,2,183.0,192.0,228.0,282.0,3476,3666,2715,2883,761,783,4392,2078,1980,1630,2412,448,83,82,8475,8900,7350,7800,14750,15575,1
1014,2,2,179.0,190.0,228.0,282.0,3179,3773,2463,2967,716,806,4342,2539,1850,1995,2492,544,83,82,8200,8825,7350,7800,15025,15750,1
1021,2,2,179.0,191.0,228.0,282.0,3028,3762,2155,3023,873,739,3810,2802,1610,2170,2200,632,83,82,8200,8825,7650,7800,15025,15750,1
1029,2,2,198.0,191.0,228.0,282.0,3370,3834,2407,2939,963,895,3592,3267,1280,2515,2312,752,82,82,9200,8925,7650,7800,14700,15950,1
1036,2,2,191.0,195.0,228.0,282.0,3392,3952,2407,2967,985,985,3405,3152,1265,2530,2140,622,82,83,8550,9050,7500,7800,15600,16125,1
1043,2,2,184.0,195.0,228.0,282.0,3168,3918,2183,2911,985,1007,3786,3617,1530,2875,2256,742,79,83,8500,9050,7500,7800,16400,16125,1
1050,2,2,175.0,195.0,228.0,282.0,3263,3745,2323,2715,940,1030,3777,3272,1405,2810,2372,462,79,83,7700,9050,7500,7800,17200,16125,1
1057,2,2,178.0,192.0,228.0,282.0,3347,3840,2295,2855,1052,985,3876,3734,1530,3160,2346,574,79,83,7700,8750,7500,7950,17200,16425,1
1064,2,2,176.0,178.0,228.0,282.0,3185,3734,2155,2771,1030,963,3037,3595,575,3205,2462,390,77,83,6050,7675,7800,7950,18950,17700,1
1071,2,2,166.0,175.0,243.0,282.0,3112,3806,2127,2799,985,1007,3409,4044,835,3530,2574,514,77,83,7050,7375,8100,7950,19450,18000,1
1079,2,2,166.0,199.0,243.0,282.0,3431,3706,2491,2743,940,963,3731,2695,1045,2465,2686,230,77,83,7350,7375,8100,7950,19450,18000,1
1086,2,2,164.0,199.0,243.0,282.0,3493,3706,2463,2743,1030,963,4052,3140,1305,2790,2747,350,77,83,7050,8275,8100,7950,19750,18000,1
1093,2,2,163.0,191.0,243.0,282.0,3756,3717,2659,2687,1097,1030,4794,2979,1915,2755,2879,224,76,83,7350,7575,8100,7950,19600,18700,1
1100,2,2,181.0,194.0,243.0,282.0,3991,3745,2827,2715,1164,1030,4365,3395,1350,3055,3015,340,76,83,8250,8535,8100,7950,19600,19000,1
1107,2,2,178.0,192.0,243.0,282.0,3963,3806,2799,2799,1164,1007,4822,3832,1675,3380,3147,452,76,83,8050,8450,8100,7950,19900,19100,1
1114,2,2,187.0,189.0,243.0,282.0,3862,3806,2743,2799,1119,1007,4006,4252,1360,3680,2646,572,75,83,8050,8165,8100,7950,19950,19400,1
1121,2,2,197.0,186.0,243.0,282.0,3823,3706,2771,2743,1052,963,3590,4073,1070,3635,2520,438,75,83,10175,7980,8100,8250,19950,19600,1
1129,2,2,199.0,196.0,243.0,282.0,3767,3694,2715,2687,1052,1007,3376,3601,770,3285,2606,316,75,83,10350,8555,8100,8250,19950,19700,1
1136,2,2,197.0,194.0,243.0,282.0,3700,3694,2603,2575,1097,1119,3207,4003,765,3555,2442,448,75,83,10250,8470,8100,8250,20050,19800,1
1143,2,2,200.0,200.0,243.0,282.0,3706,3571,2631,2407,1075,1164,3289,3624,1090,3290,2199,334,74,83,10150,9070,8100,8250,19825,20000,1
1150,2,2,200.0,200.0,243.0,282.0,3666,3605,2547,2463,1119,1142,3676,4026,1345,3560,2331,466,73,83,10900,9085,8100,8250,19875,20000,1
1157,2,2,200.0,200.0,243.0,282.0,3818,3498,2631,2379,1187,1119,3627,4433,1160,3835,2467,598,73,83,10900,9100,8100,8250,19875,20000,1
1164,2,2,200.0,190.0,243.0,282.0,3666,3577,2435,2435,1231,1142,4056,3648,1445,3410,2611,238,74,83,10900,8375,8100,8550,19875,21400,1
1171,2,2,200.0,185.0,243.0,282.0,3650,3370,2463,2351,1187,1019,4501,3926,1750,3645,2751,281,74,83,10900,7940,8100,8550,19875,21850,1
1179,2,2,200.0,185.0,243.0,282.0,3599,3364,2435,2379,1164,985,4584,3682,1860,3335,2724,347,74,83,10900,8140,8100,8550,19875,22325,1
1186,2,2,200.0,195.0,251.0,282.0,3694,3336,2463,2351,1231,985,4126,2797,1250,2530,2876,267,74,83,10900,9705,8100,8550,19875,22325,1
1193,2,2,190.0,191.0,251.0,282.0,3666,3084,2491,2099,1175,985,4564,2929,1550,2550,3014,379,74,83,10000,9585,8100,8550,20600,22875,1
1200,2,2,183.0,194.0,251.0,282.0,3577,3196,2491,2211,1086,985,3508,2889,1045,2465,2463,424,74,83,8400,9415,8100,8550,21850,23375,1
1207,2,2,199.0,194.0,251.0,282.0,3616,3146,2519,2183,1097,963,2527,2751,340,2215,2187,536,74,83,9625,9445,8100,8700,21850,23375,1
1214,2,2,199.0,194.0,251.0,282.0,3571,3258,2519,2295,1052,963,2951,2617,640,2215,2311,402,74,83,9900,9460,8100,8700,21850,23375,1
1221,2,2,199.0,194.0,251.0,282.0,3521,3151,2491,2211,1030,940,3379,2973,940,2455,2439,518,74,83,10000,10235,8700,9150,21850,23375,1
1229,2,2,199.0,188.0,251.0,282.0,3689,3224,2659,2239,1030,985,3827,3348,1260,2710,2567,638,74,83,10000,9800,9000,9300,21850,23825,1
1236,2,2,193.0,198.0,266.0,290.0,3543,3230,2491,2267,1052,963,4230,2664,1535,2210,2695,454,74,83,10675,10765,9000,9300,22450,23925,1
1243,2,2,179.0,194.0,266.0,290.0,3818,3196,2743,2211,1075,985,4699,2690,1880,2120,2819,570,74,83,9600,11210,9000,9300,23525,24140,1
1250,2,2,189.0,200.0,266.0,290.0,3750,3392,2631,2407,1119,985,3201,2336,800,2025,2401,311,74,83,10025,11505,9000,9000,25025,24440,1
1257,2,2,171.0,182.0,266.0,290.0,3711,3448,2659,2463,1052,985,3107,2682,740,2255,2367,427,74,83,8050,10560,8850,9000,27150,25900,1
1264,2,2,150.0,182.0,266.0,290.0,3739,3258,2687,2295,1052,963,3250,3013,905,2470,2345,543,74,83,6700,10455,8850,9000,29025,26050,1
1271,2,2,165.0,198.0,266.0,290.0,3515,3426,2463,2463,1052,963,2122,1379,195,1120,1927,259,74,83,6700,11945,8850,9150,29025,26050,1
1279,2,2,166.0,197.0,266.0,290.0,3213,3414,2183,2463,1030,951,2451,1483,400,1260,2051,223,74,83,6700,11875,8850,9300,29025,26150,1
1286,2,2,176.0,197.0,266.0,305.0,3280,3095,2183,2211,1097,884,2253,1833,145,1510,2108,323,77,83,6600,11890,8850,9300,29125,26150,1
1293,2,2,178.0,195.0,266.0,305.0,3224,3504,2127,2519,1097,985,2222,2267,140,1820,2082,447,78,83,7100,11730,8850,9300,29125,26325,1
1300,2,2,183.0,191.0,266.0,305.0,3454,3694,2379,2575,1075,1119,2631,2703,425,2120,2206,583,78,83,7650,11470,8450,9300,29825,26600,1
1307,2,2,182.0,191.0,266.0,305.0,3739,4047,2687,2883,1052,1164,3076,3149,750,2430,2326,719,79,83,7750,11455,8300,9750,30025,26630,1
1314,2,2,200.0,199.0,266.0,305.0,3582,4170,2575,3051,1007,1119,1691,2936,595,2285,1096,651,79,83,8175,11425,8200,9900,30125,26690,1
1321,2,2,200.0,198.0,266.0,305.0,3476,4221,2491,3079,985,1142,2095,3407,875,2620,1220,787,79,83,8375,12055,8200,9900,30125,26790,1
1329,2,2,199.0,198.0,243.0,305.0,3414,4361,2407,3219,1007,1142,2504,3922,1160,2995,1344,927,78,83,10175,12070,8200,9900,30675,26790,1
1336,2,2,179.0,186.0,235.0,305.0,2664,4086,1791,2967,873,1119,2781,4349,1345,3290,1436,1059,69,83,9125,10630,8200,9900,32275,28245,1
1343,2,2,165.0,190.0,235.0,305.0,2748,3986,1875,2799,873,1187,1976,3004,790,2255,1186,749,59,83,8125,8860,8200,9900,34575,30030,1
1350,2,2,168.0,196.0,235.0,305.0,2446,3907,1707,2743,739,1164,1396,2791,480,2160,916,631,57,83,8425,10680,8200,9900,34675,30030,1
1357,2,2,174.0,198.0,235.0,305.0,2395,3862,1679,2743,716,1119,945,2603,395,1990,550,613,57,83,8425,10695,8200,9900,34675,30030,1
1364,2,2,182.0,198.0,235.0,305.0,2446,3812,1707,2715,739,1097,442,2364,200,1990,242,374,57,83,8225,10710,8200,9900,34675,30030,1
1371,2,2,173.0,196.0,235.0,305.0,2311,3689,1595,2547,716,1142,715,2794,385,2280,330,514,57,83,8275,10550,8200,9900,35600,30205,1
1379,2,2,178.0,196.0,235.0,305.0,2384,3666,1623,2547,761,1119,710,3255,430,2605,280,650,57,83,8700,10650,8200,9900,35600,30305,1
1386,2,2,175.0,196.0,227.0,313.0,2653,3661,1623,2519,1030,1142,1038,3686,630,2900,408,786,57,83,9100,10650,8200,9900,35700,30305,1
1393,2,2,178.0,189.0,227.0,313.0,2636,3661,1595,2575,1041,1086,1047,4118,675,3210,372,908,57,83,9100,10000,7950,10150,35950,30955,1
1400,2,2,183.0,185.0,227.0,313.0,2434,3526,1595,2519,839,1007,628,4169,160,3245,468,924,54,83,9425,9250,7550,10150,36875,31805,1
1407,2,2,150.0,199.0,227.0,313.0,1998,3297,1259,2267,739,1030,846,3298,290,2600,556,698,27,83,9125,11500,7400,10150,38675,31805,1
1414,2,2,127.0,190.0,219.0,313.0,1197,3459,615,2183,582,1276,969,3679,345,2825,624,854,26,83,7425,10765,7300,10150,40625,32570,1
1419,2,2,122.0,188.0,219.0,313.0,1057,3442,475,2099,582,1343,1065,3665,385,2845,680,820,26,83,7725,10215,7300,10150,41050,33135,1
7,2,1,13.0,13.0,15.0,14.0,293,293,293,293,0,0,35,35,35,35,0,0,12,12,0,0,0,0,0,0,1
14,2,1,14.0,13.0,15.0,14.0,671,671,671,671,0,0,70,20,70,20,0,0,13,13,0,0,0,0,0,0,1
21,2,1,14.0,14.0,15.0,14.0,699,755,699,755,0,0,50,50,50,50,0,0,13,13,0,0,0,0,0,0,1
29,2,1,15.0,14.0,15.0,14.0,699,755,699,755,0,0,80,140,80,140,0,0,14,13,0,0,0,0,0,0,1
36,2,1,15.0,14.0,15.0,22.0,755,727,755,727,0,0,135,230,135,230,0,0,14,14,0,0,0,0,0,0,1
43,2,1,16.0,13.0,23.0,22.0,783,727,783,727,0,0,70,15,70,15,0,0,15,13,0,0,0,0,0,0,1
50,2,1,17.0,14.0,23.0,22.0,811,755,811,755,0,0,40,60,40,60,0,0,16,13,0,0,0,0,0,0,1
57,2,1,17.0,14.0,23.0,22.0,811,727,811,727,0,0,95,145,95,145,0,0,16,13,0,0,0,0,0,0,1
64,2,1,18.0,13.0,23.0,22.0,867,783,867,783,0,0,100,20,100,20,0,0,17,13,0,0,0,0,0,0,1
71,2,1,19.0,13.0,23.0,22.0,923,671,923,671,0,0,210,40,210,40,0,0,18,12,0,0,0,0,0,0,1
79,2,1,20.0,14.0,23.0,22.0,956,643,867,643,89,0,331,75,315,75,16,0,19,12,0,0,0,0,0,0,1
86,2,1,20.0,14.0,23.0,22.0,1006,671,895,671,111,0,53,65,25,65,28,0,19,13,0,0,150,0,0,0,1
93,2,1,20.0,14.0,23.0,22.0,950,715,839,671,111,44,165,148,125,140,40,8,20,14,0,0,150,0,0,0,1
100,2,1,20.0,14.0,23.0,30.0,1023,799,867,643,156,156,70,248,10,220,60,28,20,14,0,0,150,0,0,0,1
107,2,1,21.0,14.0,23.0,30.0,967,771,811,615,156,156,130,333,50,285,80,48,20,14,0,0,150,0,0,0,1
114,2,1,21.0,18.0,23.0,36.0,1051,799,895,643,156,156,115,193,15,125,100,68,20,14,0,0,150,250,0,0,1
121,2,1,22.0,17.0,23.0,36.0,1051,687,895,531,156,156,200,114,80,30,120,84,21,13,0,0,150,250,0,0,1
129,2,1,23.0,17.0,23.0,36.0,1174,637,951,503,223,134,283,120,135,20,148,100,22,12,0,0,150,250,0,0,1
136,2,1,25.0,18.0,31.0,36.0,1197,738,951,671,246,67,201,149,100,45,101,104,22,12,0,100,300,250,0,0,1
143,2,1,26.0,20.0,31.0,36.0,1214,760,923,671,291,89,152,141,115,25,37,116,23,13,0,100,300,250,0,0,1
150,2,1,26.0,21.0,31.0,36.0,1270,777,979,643,291,134,153,187,130,55,23,132,23,14,0,250,300,250,0,0,1
157,2,1,30.0,22.0,46.0,36.0,1208,827,895,671,313,156,9,227,0,75,9,152,24,15,125,300,300,250,0,0,1
164,2,1,31.0,23.0,46.0,36.0,1376,855,1063,699,313,156,134,278,85,110,49,168,25,16,125,300,300,450,0,0,1
171,2,1,32.0,24.0,46.0,36.0,1370,928,1035,727,335,201,204,341,115,145,89,196,26,17,125,300,300,450,0,0,1
179,2,1,33.0,25.0,46.0,36.0,1482,1006,1147,783,335,223,374,159,245,35,129,124,27,18,125,300,300,450,0,0,1
186,2,1,34.0,25.0,46.0,36.0,1516,945,1203,699,313,246,465,266,300,110,165,156,28,19,125,300,600,450,0,0,1
193,2,1,41.0,24.5,46.0,36.0,1538,1068,1203,755,335,313,70,411,40,215,30,196,30,20,300,275,600,450,0,25,1
200,2,1,42.0,24.5,46.0,36.0,1622,1090,1287,755,335,335,175,536,105,300,70,236,31,20,300,275,600,450,0,25,1
207,2,1,43.0,25.5,46.0,36.0,1600,1169,1287,811,313,358,151,626,45,350,106,276,32,20,300,275,600,450,0,25,1
214,2,1,44.0,27.5,54.0,36.0,1600,1096,1287,783,313,313,221,648,75,340,146,308,33,20,300,275,600,450,0,25,1
221,2,1,45.0,28.5,54.0,36.0,1902,1124,1567,811,335,313,356,743,170,395,186,348,34,21,725,275,600,450,0,25,1
229,2,1,49.0,29.5,54.0,36.0,1846,1096,1511,783,335,313,171,718,95,330,76,388,35,22,725,325,700,450,0,25,1
236,2,1,50.0,30.5,54.0,36.0,1936,1180,1623,867,313,313,312,823,200,395,112,428,36,23,725,325,700,700,0,25,1
243,2,1,51.0,30.5,62.0,44.0,1930,1258,1595,923,335,335,537,518,385,250,152,268,37,23,725,325,700,700,0,25,1
250,2,1,53.0,31.5,62.0,44.0,2098,1342,1763,1007,335,335,197,534,5,280,192,254,39,24,725,325,700,700,0,25,1
257,2,1,53.0,32.5,70.0,44.0,2132,1292,1819,979,313,313,438,535,210,295,228,240,39,25,1025,425,850,700,0,25,1
264,2,1,58.0,33.5,70.0,44.0,2182,1432,1847,1119,335,313,158,565,40,285,118,280,41,26,1025,525,850,700,0,25,1
271,2,1,58.0,34.5,78.0,44.0,2238,1460,1903,1147,335,313,73,695,15,375,58,320,41,27,1025,525,850,700,0,25,1
279,2,1,60.0,35.5,78.0,44.0,2222,1538,1931,1203,291,335,175,825,85,465,90,360,43,28,1025,525,850,700,0,25,1
286,2,1,60.0,35.5,78.0,52.0,2278,1516,1987,1203,291,313,351,931,225,535,126,396,43,28,1025,525,850,700,0,25,1
293,2,1,62.0,36.5,78.0,52.0,2356,1538,2043,1203,313,335,526,1081,360,645,166,436,45,29,1325,525,850,700,0,25,1
300,2,1,64.0,36.5,78.0,52.0,2468,1538,1931,1203,537,335,826,1186,580,710,246,476,47,29,1325,525,850,700,0,25,1
307,2,1,66.0,37.5,78.0,52.0,2524,1516,1875,1203,649,313,366,1337,40,825,326,512,49,30,1325,525,850,700,0,25,1
314,2,1,68.0,40.5,78.0,52.0,2597,1583,1903,1203,694,380,416,1285,110,825,306,460,51,31,1325,525,1250,1150,0,25,1
321,2,1,69.0,41.5,93.0,52.0,2653,1572,1959,1147,694,425,297,1422,65,910,232,512,51,32,1325,525,1250,1150,0,25,1
329,2,1,71.0,42.5,93.0,52.0,2776,1533,2127,1063,649,470,549,1562,245,990,304,572,53,33,1325,525,1250,1150,0,25,1
336,2,1,72.0,43.5,93.0,52.0,2726,1785,2099,1203,627,582,780,1657,400,1005,380,652,54,34,1325,725,1250,1150,0,25,1
343,2,1,74.0,44.5,93.0,52.0,2950,1908,2323,1259,627,649,990,1827,530,1095,460,732,57,35,1325,725,1250,1150,0,25,1
350,2,1,76.0,45.5,93.0,52.0,2972,1964,2323,1315,649,649,845,2008,305,1200,540,808,59,36,1325,725,1550,1150,0,25,1
357,2,1,80.0,48.5,93.0,60.0,3162,2020,2491,1371,671,649,665,2014,145,1230,520,784,60,37,1325,725,1850,1150,0,25,1
364,2,1,84.0,49.5,93.0,60.0,3190,2126,2519,1455,671,671,706,2214,210,1350,496,864,61,38,1675,725,1850,1150,0,25,1
371,2,1,84.0,49.5,101.0,60.0,3280,2188,2631,1539,649,649,1088,2465,520,1525,568,940,61,39,2025,725,2000,1150,0,25,1
379,2,1,88.0,49.5,109.0,60.0,3370,2166,2743,1539,627,627,879,2731,335,1715,544,1016,61,40,2375,925,2000,1150,0,25,1
386,2,1,88.0,49.5,109.0,60.0,3258,2266,2631,1595,627,671,679,3006,205,1910,474,1096,61,40,2375,925,2000,1150,0,25,1
393,2,1,91.0,49.5,109.0,60.0,3375,2272,2771,1623,604,649,785,3257,235,2085,550,1172,61,40,2375,925,2000,1150,0,25,1
400,2,1,100.0,49.5,109.0,60.0,3392,2194,2743,1567,649,627,485,3533,55,2285,430,1248,62,40,2375,925,2000,1150,0,25,1
407,2,1,102.0,49.5,109.0,60.0,3358,2272,2687,1623,671,649,430,3793,70,2465,360,1328,64,40,3075,925,2250,1150,0,25,1
414,2,1,105.0,49.5,109.0,60.0,3442,2238,2771,1567,671,671,846,4073,410,2665,436,1408,67,40,3075,925,2550,1150,0,25,1
421,2,1,109.0,49.5,109.0,60.0,3420,2294,2771,1623,649,671,897,4329,485,2845,412,1484,67,40,3075,925,2550,1150,0,25,1
429,2,1,117.0,49.5,124.0,60.0,3504,2222,2855,1595,649,627,623,4601,335,3045,288,1556,70,40,3425,925,2550,1150,0,25,1
436,2,1,117.0,49.5,124.0,60.0,3650,2216,3023,1567,627,649,1049,4866,685,3230,364,1636,70,40,4125,925,2550,1150,0,25,1
443,2,1,117.0,49.5,124.0,60.0,3728,2272,3079,1623,649,649,1504,5141,1060,3425,444,1716,70,40,4125,925,2550,1150,0,25,1
450,2,1,121.0,49.5,124.0,60.0,4036,2244,3387,1595,649,649,1649,5402,1225,3610,424,1792,70,40,4125,925,2550,1150,0,25,1
457,2,1,121.0,49.5,124.0,60.0,3840,2261,3191,1567,649,694,2070,5672,1570,3800,500,1872,70,40,4475,925,2550,1150,0,25,1
464,2,1,121.0,49.5,124.0,60.0,3554,2272,2883,1623,671,649,1835,5944,1355,4000,480,1944,70,40,4475,925,2850,1150,0,25,1
471,2,1,121.0,49.5,124.0,60.0,3566,2166,2939,1539,627,627,1513,6195,965,4175,548,2020,70,40,4475,925,2850,1150,0,25,1
479,2,1,124.0,49.5,124.0,60.0,3599,2244,2995,1595,604,649,835,6480,265,4380,570,2100,70,40,4650,925,2850,1150,0,25,1
486,2,1,124.0,49.5,124.0,60.0,3498,2160,2939,1511,559,649,1249,6730,615,4550,634,2180,70,40,4650,925,2850,1150,0,25,1
7,0,2,13.0,13.0,15.0,15.0,293,293,293,293,0,0,35,35,35,35,0,0,12,12,0,0,0,0,0,0,1
14,0,2,14.0,14.0,15.0,15.0,643,671,643,671,0,0,65,70,65,70,0,0,13,13,0,0,0,0,0,0,1
21,0,2,14.0,14.0,15.0,15.0,699,699,699,699,0,0,45,50,45,50,0,0,13,13,0,0,0,0,0,0,1
29,0,2,15.0,15.0,15.0,15.0,643,727,643,727,0,0,75,40,75,40,0,0,14,14,0,0,0,0,0,0,1
36,0,2,15.0,15.0,15.0,23.0,783,783,783,783,0,0,135,140,135,140,0,0,14,14,0,0,0,0,0,0,1
43,0,2,16.0,16.0,23.0,23.0,811,783,811,783,0,0,75,30,75,30,0,0,15,15,0,0,0,0,0,0,1
50,0,2,16.0,17.0,23.0,23.0,783,867,783,867,0,0,35,65,35,65,0,0,15,16,0,0,0,0,0,0,1
57,0,2,17.0,18.0,23.0,23.0,783,811,783,811,0,0,40,55,40,55,0,0,16,17,0,0,0,0,0,0,1
64,0,2,18.0,19.0,23.0,23.0,811,923,811,923,0,0,130,165,130,165,0,0,17,18,0,0,0,0,0,0,1
71,0,2,18.0,19.0,23.0,23.0,883,979,839,979,44,0,233,270,225,270,8,0,17,18,0,0,0,0,0,0,1
79,0,2,19.0,20.0,23.0,23.0,967,939,811,895,156,44,348,333,320,325,28,8,18,19,0,0,0,0,0,0,1
86,0,2,19.0,20.0,23.0,23.0,939,1001,783,867,156,134,458,304,410,280,48,24,18,19,0,0,0,150,0,0,1
93,0,2,20.0,21.0,23.0,23.0,911,1057,755,923,156,134,363,370,295,330,68,40,19,20,0,0,150,150,0,0,1
100,0,2,20.0,20.0,23.0,23.0,906,1006,727,895,179,111,468,142,380,90,88,52,19,20,0,0,150,150,0,0,1
107,0,2,20.0,21.0,23.0,23.0,934,1085,755,951,179,134,183,118,75,50,108,68,19,20,50,0,150,150,0,0,1
114,0,2,20.0,21.0,23.0,23.0,911,1057,755,923,156,134,44,114,20,30,24,84,19,20,50,0,150,150,0,0,1
121,0,2,21.0,22.0,23.0,31.0,911,1051,755,895,156,156,99,234,55,130,44,104,19,21,50,0,150,300,0,0,1
129,0,2,21.0,24.0,23.0,31.0,1023,995,867,839,156,156,134,184,120,85,14,99,19,21,50,0,150,300,0,0,1
136,0,2,22.0,25.0,23.0,31.0,1023,990,867,811,156,179,114,53,80,30,34,23,20,22,50,0,150,300,0,0,1
143,0,2,22.0,26.0,23.0,31.0,1135,1051,979,783,156,268,164,34,110,25,54,9,20,23,50,125,150,300,0,0,1
150,0,2,23.0,26.0,23.0,31.0,1158,1202,979,867,179,335,169,139,95,90,74,49,21,23,50,125,150,300,0,0,1
157,0,2,24.0,27.0,31.0,31.0,1158,1208,979,895,179,313,254,275,160,190,94,85,22,24,50,125,150,300,0,0,1
164,0,2,28.0,27.0,31.0,31.0,1135,1236,979,923,156,313,130,370,45,245,85,125,22,24,50,125,500,300,0,0,1
171,0,2,29.0,29.0,31.0,46.0,1219,1230,1063,895,156,335,270,425,165,260,105,165,23,25,50,125,600,300,0,0,1
179,0,2,29.0,31.0,31.0,46.0,1281,1292,1035,979,246,313,176,81,135,30,41,51,23,27,50,125,600,550,0,0,1
186,0,2,32.0,31.0,46.0,46.0,1264,1264,951,951,313,313,166,136,85,45,81,91,24,28,250,125,600,550,0,0,1
193,0,2,32.0,33.0,46.0,46.0,1342,1482,1007,1147,335,335,186,221,65,90,121,131,25,29,250,125,600,550,0,0,1
200,0,2,35.0,34.0,46.0,46.0,1538,1510,1203,1175,335,335,216,356,80,185,136,171,25,30,350,125,600,550,0,0,1
207,0,2,37.0,35.0,46.0,54.0,1538,1628,1203,1315,335,313,302,302,130,95,172,207,25,31,350,125,600,550,0,0,1
214,0,2,40.0,37.0,46.0,54.0,1482,1706,1147,1371,335,335,132,457,20,210,112,247,26,33,350,125,850,550,0,0,1
221,0,2,43.0,38.0,46.0,54.0,1566,1734,1231,1399,335,335,187,507,60,220,127,287,26,34,450,125,850,550,0,0,1
229,0,2,46.0,39.0,46.0,54.0,1656,1852,1343,1539,313,313,248,688,85,365,163,323,27,35,550,125,850,700,0,0,1
236,0,2,46.0,41.0,46.0,54.0,1684,1824,1371,1511,313,313,263,758,60,395,203,363,29,37,550,125,850,700,0,0,1
243,0,2,48.0,42.0,54.0,54.0,1706,1958,1371,1623,335,335,243,943,50,540,193,403,29,38,850,125,850,700,0,0,1
250,0,2,52.0,47.0,54.0,54.0,1846,2014,1511,1679,335,335,388,638,155,445,233,193,31,39,950,125,850,1150,0,0,1
257,0,2,52.0,48.0,62.0,54.0,1902,2076,1567,1763,335,313,364,444,95,215,269,229,31,40,950,625,850,1150,0,0,1
264,0,2,56.0,52.0,62.0,54.0,2266,2182,1931,1847,335,335,244,354,135,210,109,144,33,42,1050,875,1000,1150,0,0,1
271,0,2,58.0,53.0,62.0,62.0,2244,2188,1931,1875,313,313,125,490,105,310,20,180,32,43,1050,875,1000,1150,50,0,1
279,0,2,56.0,54.0,62.0,62.0,1292,2188,1091,1875,201,313,85,570,45,350,40,220,28,44,1050,875,1000,1150,350,0,1
286,0,2,52.0,59.0,70.0,62.0,122,1790,55,1455,67,335,48,370,0,210,48,160,25,45,1050,875,1000,1150,600,0,1
293,0,2,50.0,55.0,70.0,62.0,105,1090,83,755,22,335,58,445,10,245,48,200,24,43,1100,975,900,1150,800,400,1
300,0,2,44.0,58.0,70.0,62.0,503,1264,503,951,0,313,138,346,90,160,48,186,19,44,1375,975,1050,1150,1100,400,1
307,0,2,44.0,57.0,70.0,62.0,839,1846,839,1399,0,447,138,476,90,230,48,246,19,45,1575,975,1050,1150,1200,625,1
314,0,2,45.0,59.0,70.0,62.0,867,2306,867,1679,0,627,197,498,149,280,48,218,21,47,1575,975,1050,1150,1200,625,1
321,0,2,48.0,62.0,70.0,62.0,878,2395,811,1791,67,604,131,416,71,180,60,236,21,48,1575,1150,1050,1150,1200,625,1
329,0,2,49.0,63.0,70.0,77.0,1107,2513,839,1931,268,582,173,358,77,50,96,308,23,49,1575,1150,1050,1150,1200,625,1
336,0,2,52.0,64.0,70.0,77.0,1292,2614,979,1987,313,627,229,465,93,85,136,380,23,50,1675,1150,1050,1150,1200,625,1
343,0,2,52.0,70.0,70.0,93.0,1454,2574,1119,1903,335,671,399,555,223,170,176,385,23,51,1675,1150,1050,1150,1200,625,1
350,0,2,57.0,71.0,70.0,101.0,1533,2692,1175,2043,358,649,194,731,103,270,91,461,25,51,1775,1525,1050,1150,1200,625,1
357,0,2,55.0,71.0,70.0,109.0,1572,2468,1259,1819,313,649,291,921,168,380,123,541,25,53,1675,1025,1050,1150,1300,625,1
364,0,2,49.0,64.0,70.0,109.0,1740,2636,1427,1987,313,649,506,772,343,230,163,542,26,48,1300,1100,1050,1300,1725,1500,1
371,0,2,52.0,59.0,70.0,117.0,1852,1880,1539,1231,313,649,551,818,348,200,203,618,26,47,1200,800,1050,1300,1750,1850,1
379,0,2,53.0,61.0,70.0,117.0,1824,1477,1511,895,313,582,221,681,128,95,93,586,28,49,1425,925,1050,1300,1800,1850,1
386,0,2,51.0,64.0,70.0,117.0,2014,1337,1679,755,335,582,321,753,188,95,133,658,28,51,1325,925,1050,1400,2050,1850,1
393,0,2,52.0,66.0,70.0,117.0,1874,2283,1539,1679,335,604,342,659,223,125,119,534,30,53,1275,925,1050,1400,2100,1850,1
400,0,2,52.0,72.0,70.0,117.0,1986,2748,1651,2099,335,649,262,504,103,90,159,414,30,55,1275,925,1050,1400,2100,1850,1
407,0,2,58.0,73.0,70.0,117.0,1908,2972,1595,2323,313,649,263,651,93,165,170,486,32,57,1425,1225,1050,1400,2100,1850,1
414,0,2,58.0,75.0,70.0,117.0,1964,3000,1651,2351,313,649,433,613,223,55,210,558,34,58,1425,1225,1050,1400,2100,1850,1
421,0,2,64.0,76.0,70.0,117.0,2070,3062,1735,2435,335,627,78,684,28,50,50,634,34,60,1425,1225,1050,1400,2100,1850,1
429,0,2,65.0,78.0,78.0,117.0,1908,3090,1595,2463,313,627,274,804,188,190,86,614,36,61,1650,1225,1425,1750,2100,1850,1
436,0,2,69.0,80.0,78.0,117.0,1930,3224,1595,2575,335,649,194,589,93,95,101,494,36,62,1650,1375,1425,1750,2100,1850,1
443,0,2,73.0,84.0,78.0,125.0,2126,3274,1679,2603,447,671,84,779,48,205,36,574,37,62,1650,1375,1425,1750,2100,1850,1
450,0,2,75.0,87.0,86.0,133.0,2311,3364,1819,2715,492,649,185,831,118,335,67,496,37,62,2150,1575,1425,1900,2100,1850,1
457,0,2,77.0,95.0,94.0,133.0,2395,3414,1903,2743,492,671,186,481,163,355,23,126,39,65,2275,1775,1425,2050,2100,1850,1
464,0,2,79.0,96.0,94.0,133.0,2429,3420,1959,2771,470,649,187,782,108,580,79,202,39,65,2375,2375,1425,2500,2100,1850,1
471,0,2,83.0,103.0,102.0,133.0,2429,3398,1959,2771,470,627,242,903,153,625,89,278,41,67,2475,2475,1425,2500,2100,1850,1
479,0,2,87.0,104.0,102.0,141.0,2457,3476,1987,2827,470,649,237,1268,88,910,149,358,41,68,2575,2675,1425,2500,2100,1850,1
486,0,2,89.0,108.0,102.0,133.0,2530,3482,2015,2855,515,627,347,880,188,550,159,330,43,69,2575,3025,1425,2650,2100,1950,1
493,0,2,87.0,112.0,110.0,133.0,2938,3465,2379,2883,559,582,681,897,458,495,223,402,43,66,2725,3125,1425,2650,2200,2250,1
500,0,2,97.0,107.0,118.0,133.0,2860,3190,2323,2631,537,559,446,1220,263,750,183,470,45,60,2825,3425,1425,2650,2200,2550,1
507,0,2,91.0,108.0,118.0,149.0,2748,2524,2211,1987,537,537,639,1035,388,655,251,380,45,59,2525,3425,1425,2650,2500,2650,1
514,0,2,99.0,120.0,118.0,149.0,2602,2647,2043,2043,559,604,356,472,233,320,123,152,47,59,2525,3425,1425,2800,2500,2650,1
521,0,2,107.0,123.0,118.0,149.0,2748,3039,2099,2435,649,604,146,430,43,210,103,220,49,62,2975,3825,1425,2800,2500,2650,1
529,0,2,107.0,123.0,126.0,149.0,2804,3146,2155,2519,649,627,502,465,323,265,179,200,49,62,3075,4275,1425,2800,2500,2650,1
536,0,2,106.0,131.0,126.0,157.0,3022,3151,2351,2547,671,604,848,351,593,75,255,276,49,65,3025,4150,1425,2800,2550,2775,1
543,0,2,112.0,133.0,126.0,165.0,2944,3280,2295,2631,649,649,754,546,473,340,281,206,49,65,3475,4650,1425,2800,2550,2775,1
550,0,2,110.0,133.0,134.0,173.0,2591,3286,1987,2435,604,851,1046,934,693,620,353,314,47,65,3875,4850,1425,2800,2650,2775,1
557,0,2,107.0,129.0,134.0,173.0,1751,3454,1259,2491,492,963,662,1351,353,925,309,426,38,65,3975,4650,1425,2800,3100,2975,1
564,0,2,104.0,137.0,142.0,173.0,1298,3482,895,2519,403,963,825,1062,468,520,357,542,33,65,4100,5050,1425,2800,3475,3275,1
571,0,2,93.0,124.0,142.0,173.0,1639,3420,1259,2435,380,985,1029,1317,628,655,401,662,33,65,3425,4250,1425,2800,3875,4075,1
579,0,2,94.0,126.0,142.0,173.0,1718,3392,1315,2407,403,985,527,1263,128,685,399,578,33,65,3725,4250,1425,3050,3875,4075,1
586,0,2,96.0,137.0,142.0,173.0,1466,3364,1063,2379,403,985,605,589,158,145,447,444,33,67,3675,5125,1425,3050,4175,4300,1
593,0,2,92.0,134.0,142.0,173.0,1449,3084,1091,2099,358,985,780,936,293,380,487,556,33,64,3475,5325,1425,3050,4375,4450,1
600,0,2,98.0,132.0,142.0,173.0,1690,3112,1287,2127,403,985,593,1326,208,650,385,676,35,64,3525,5225,1425,3050,4375,4550,1
607,0,2,98.0,128.0,142.0,173.0,2003,3207,1623,2267,380,940,837,1713,408,925,429,788,35,64,3775,5025,1425,3050,4375,4750,1
614,0,2,90.0,144.0,142.0,173.0,1975,3286,1595,2323,380,963,1085,1303,608,395,477,908,35,64,3125,5825,1425,3050,5025,4750,1
621,0,2,89.0,134.0,142.0,173.0,1891,3297,1511,2267,380,1030,958,1298,483,270,475,1028,35,64,2975,5325,1425,3050,5375,5250,1
629,0,2,97.0,132.0,142.0,173.0,1863,3286,1483,2323,380,963,597,1686,328,550,269,1136,35,64,3175,5225,1425,3050,5375,5350,1
636,0,2,89.0,138.0,142.0,173.0,1214,3258,811,2295,403,963,355,1197,88,195,267,1002,32,64,2925,5900,1425,3050,5725,5550,1
643,0,2,74.0,138.0,142.0,173.0,1107,3308,727,2323,380,985,500,1242,193,220,307,1022,23,64,2325,6050,1425,3050,7125,5750,1
650,0,2,72.0,128.0,142.0,173.0,1331,3286,951,2323,380,963,653,1628,298,490,355,1138,23,64,2400,5550,1425,3050,7250,6250,1
657,0,2,74.0,126.0,157.0,173.0,1191,3230,811,2267,380,963,551,1259,148,355,403,904,23,64,2900,5450,1425,3050,7250,6350,1
664,0,2,73.0,126.0,157.0,173.0,1079,3224,699,2239,380,985,689,1640,238,620,451,1020,25,64,3100,5050,1425,3050,7300,6350,1
671,0,2,72.0,142.0,157.0,173.0,1354,3246,951,2239,403,1007,563,1215,118,75,445,1140,25,64,2800,5500,1425,3050,7600,6350,1
679,0,2,62.0,130.0,157.0,173.0,1382,3258,979,2295,403,963,707,1597,218,345,489,1252,25,64,2250,4725,1425,3050,8150,7525,1
7,2,0,13.0,13.0,15.0,15.0,335,293,335,293,0,0,40,35,40,35,0,0,12,12,0,0,0,0,0,0,1
14,2,0,14.0,14.0,15.0,15.0,671,671,671,671,0,0,70,70,70,70,0,0,13,13,0,0,0,0,0,0,1
21,2,0,14.0,14.0,15.0,15.0,699,699,699,699,0,0,50,50,50,50,0,0,13,13,0,0,0,0,0,0,1
29,2,0,15.0,15.0,15.0,15.0,727,671,727,671,0,0,90,85,90,85,0,0,14,14,0,0,0,0,0,0,1
36,2,0,15.0,15.0,15.0,15.0,811,755,811,755,0,0,150,135,150,135,0,0,14,14,0,0,0,0,0,0,1
43,2,0,16.0,16.0,23.0,23.0,867,755,867,755,0,0,45,70,45,70,0,0,15,15,0,0,0,0,0,0,1
50,2,0,17.0,16.0,23.0,23.0,839,783,839,783,0,0,65,40,65,40,0,0,16,15,0,0,0,0,0,0,1
57,2,0,18.0,17.0,23.0,23.0,839,727,839,727,0,0,120,35,120,35,0,0,17,16,0,0,0,0,0,0,1
64,2,0,19.0,18.0,23.0,23.0,923,895,923,895,0,0,180,140,180,140,0,0,18,17,0,0,0,0,0,0,1
71,2,0,19.0,18.0,23.0,23.0,945,911,923,867,22,44,244,238,240,230,4,8,18,17,0,0,0,0,0,0,1
79,2,0,20.0,19.0,23.0,23.0,1018,990,951,811,67,179,372,352,360,320,12,32,19,18,0,0,0,0,0,0,1
86,2,0,20.0,19.0,23.0,23.0,1040,911,951,755,89,156,339,458,315,410,24,48,19,18,0,0,150,0,0,0,1
93,2,0,20.0,20.0,23.0,23.0,1040,883,951,727,89,156,66,353,30,285,36,68,20,19,0,0,150,150,0,0,1
100,2,0,20.0,20.0,23.0,23.0,1113,911,979,755,134,156,97,468,45,380,52,88,20,19,0,0,150,150,0,0,1
107,2,0,21.0,20.0,23.0,23.0,1034,911,923,755,111,156,164,178,100,70,64,108,20,19,0,50,150,150,0,0,1
114,2,0,21.0,20.0,23.0,23.0,1029,939,895,783,134,156,209,288,125,160,84,128,20,19,0,50,150,150,0,0,1
121,2,0,22.0,21.0,31.0,23.0,995,934,839,755,156,179,284,93,180,45,104,48,21,19,0,50,300,150,0,0,1
129,2,0,24.0,22.0,31.0,23.0,1079,1023,923,867,156,156,89,79,40,65,49,14,21,20,0,50,300,150,0,0,1
136,2,0,25.0,22.0,31.0,23.0,1102,1023,923,867,179,156,168,114,95,80,73,34,22,20,0,50,300,150,0,0,1
143,2,0,27.0,23.0,31.0,23.0,1219,995,951,839,268,156,95,84,40,30,55,54,22,21,125,50,300,150,0,0,1
150,2,0,28.0,23.0,31.0,23.0,1242,1023,951,867,291,156,246,174,130,100,116,74,23,21,125,50,300,150,0,0,1
157,2,0,29.0,24.0,31.0,31.0,1320,1135,1007,979,313,156,337,254,185,160,152,94,24,22,125,50,400,150,0,0,1
164,2,0,29.0,26.0,31.0,31.0,1258,1214,923,1035,335,179,237,299,145,185,92,114,24,22,125,50,400,500,0,0,1
171,2,0,33.0,28.0,46.0,31.0,1286,1298,951,1119,335,179,167,84,85,50,82,34,25,23,250,50,400,500,0,0,1
179,2,0,33.0,29.0,46.0,46.0,1292,1331,979,1175,313,156,264,185,150,135,114,50,25,23,250,50,400,600,0,0,1
186,2,0,35.0,31.0,46.0,46.0,1398,1270,1063,1091,335,179,379,74,225,0,154,74,27,24,250,150,400,600,0,0,1
193,2,0,35.0,32.0,46.0,46.0,1460,1398,1147,1175,313,223,555,192,365,90,190,102,29,24,250,250,400,600,0,0,1
200,2,0,35.0,34.0,46.0,46.0,1600,1404,1287,1203,313,201,750,226,520,100,230,126,29,24,425,250,650,600,0,0,1
207,2,0,33.0,34.0,46.0,46.0,1650,1488,1315,1287,335,201,930,429,660,275,270,154,29,25,300,300,650,850,125,50,1
214,2,0,35.0,38.0,46.0,46.0,1678,1505,1343,1259,335,246,375,297,215,215,160,82,29,26,300,300,650,850,125,50,1
221,2,0,33.0,38.0,46.0,46.0,1600,1645,1287,1399,313,246,156,400,60,290,96,110,29,26,175,400,650,850,250,50,1
229,2,0,35.0,42.0,46.0,46.0,1678,1824,1343,1623,335,201,311,389,175,259,136,130,31,26,175,500,650,850,250,50,1
236,2,0,37.0,44.0,46.0,46.0,1678,1790,1343,1567,335,223,341,384,165,226,176,158,33,26,175,500,650,850,250,50,1
243,2,0,39.0,46.0,46.0,54.0,1690,1706,1399,1483,291,223,168,379,10,218,158,161,33,28,175,700,650,850,250,50,1
250,2,0,41.0,46.0,46.0,54.0,1774,1712,1483,1511,291,201,239,385,45,225,194,160,35,28,350,800,750,850,250,50,1
257,2,0,41.0,48.0,46.0,62.0,1796,1818,1483,1595,313,223,270,378,40,190,230,188,35,30,350,900,750,850,250,50,1
264,2,0,42.0,50.0,46.0,62.0,1964,1953,1651,1707,313,246,470,396,200,180,270,216,36,30,350,900,1000,925,300,50,1
271,2,0,45.0,54.0,54.0,62.0,1908,1992,1595,1791,313,201,270,216,85,180,185,36,36,32,350,900,1400,1000,300,50,1
279,2,0,49.0,58.0,54.0,62.0,1936,2070,1623,1847,313,223,280,193,105,125,175,68,38,34,700,1000,1400,1000,300,50,1
286,2,0,50.0,58.0,54.0,62.0,2143,2177,1763,1819,380,358,269,456,100,340,169,116,40,34,525,1000,1550,1000,475,50,1
293,2,0,52.0,60.0,62.0,62.0,2210,2255,1763,1875,447,380,281,239,60,200,221,39,40,36,800,1000,1550,1000,475,50,1
300,2,0,56.0,60.0,70.0,62.0,2238,2227,1791,1847,447,380,208,498,35,415,173,83,41,36,975,1100,1550,1000,475,50,1
307,2,0,58.0,67.0,70.0,70.0,2210,2222,1763,1819,447,403,189,477,10,350,179,127,41,38,1150,1100,1550,1150,475,50,1
314,2,0,60.0,69.0,70.0,70.0,2261,2418,1791,2015,470,403,299,360,110,185,189,175,41,40,1325,1400,1550,1150,475,50,1
321,2,0,60.0,65.0,70.0,78.0,2205,2513,1735,2155,470,358,559,570,310,355,249,215,41,40,1500,1200,1550,1150,475,275,1
329,2,0,59.0,69.0,78.0,78.0,2362,2457,1847,2099,515,358,739,348,430,260,309,88,41,42,1650,1200,1550,1150,575,375,1
336,2,0,66.0,69.0,78.0,86.0,2328,2423,1791,2043,537,380,389,376,245,240,144,136,41,42,2000,1475,1550,1150,575,375,1
343,2,0,68.0,74.0,86.0,86.0,2339,2395,1847,2015,492,380,381,105,235,75,146,30,41,44,2350,1575,1550,1150,575,375,1
350,2,0,68.0,75.0,86.0,86.0,2373,2423,1903,2043,470,380,662,388,460,310,202,78,41,43,2450,1700,1550,1150,575,425,1
357,2,0,72.0,78.0,86.0,86.0,2317,2166,1847,1763,470,403,582,258,420,155,162,103,41,45,2800,1650,1550,1150,575,475,1
364,2,0,72.0,78.0,94.0,86.0,2345,2227,1875,1847,470,380,872,424,650,277,222,147,41,45,2800,1650,1550,1150,575,475,1
371,2,0,70.0,79.0,94.0,86.0,2289,2294,1819,1847,470,447,1142,642,860,435,282,207,41,47,2625,1825,1550,1050,750,555,1
379,2,0,78.0,85.0,94.0,94.0,2334,2406,1819,1847,515,559,722,435,580,310,142,125,41,47,2800,2050,1550,1050,750,605,1
386,2,0,68.0,81.0,94.0,94.0,2278,2574,1763,2015,515,559,993,543,795,450,198,93,41,49,2450,1550,1550,1325,1625,1143,1
393,2,0,69.0,83.0,94.0,109.0,2311,2882,1819,2323,492,559,854,462,750,430,104,32,41,49,2450,1650,1550,1325,1625,1143,1
400,2,0,73.0,89.0,94.0,109.0,2238,2849,1791,2267,447,582,746,375,690,300,56,75,41,49,2450,1775,1550,1325,1625,1143,1
407,2,0,75.0,90.0,94.0,109.0,2294,2916,1847,2267,447,649,922,256,810,105,112,151,42,51,2450,1775,1550,1325,1625,1143,1
414,2,0,83.0,92.0,94.0,109.0,2160,3118,1735,2491,425,627,639,392,575,240,64,152,42,51,3000,2050,1550,1400,1625,1143,1
421,2,0,83.0,96.0,94.0,117.0,2160,3118,1623,2491,537,627,401,497,265,290,136,207,44,52,3000,2475,1450,1400,1625,1143,1
429,2,0,83.0,103.0,94.0,125.0,2345,3134,1651,2463,694,671,576,212,510,125,66,87,44,52,3375,2475,1450,1400,1625,1143,1
436,2,0,83.0,105.0,94.0,125.0,2244,3129,1595,2435,649,694,539,432,405,290,134,142,44,52,3375,2600,1450,1400,1625,1143,1
443,2,0,83.0,110.0,102.0,125.0,2278,3336,1651,2687,627,649,410,469,200,255,210,214,44,55,3375,2825,1450,1400,1625,1143,1
450,2,0,89.0,112.0,110.0,133.0,2278,3056,1651,2407,627,649,376,375,90,260,286,115,44,55,3375,2825,1450,1400,1625,1143,1
457,2,0,91.0,112.0,118.0,133.0,2250,3280,1623,2631,627,649,547,695,185,550,362,145,44,58,3775,3350,1450,1800,1625,1143,1
464,2,0,93.0,109.0,126.0,141.0,2250,3258,1623,2631,627,627,662,1071,220,850,442,221,44,58,3775,3175,1450,1800,1625,1418,1
471,2,0,89.0,113.0,126.0,141.0,2345,3308,1651,2659,694,649,947,1111,425,860,522,251,44,58,3425,3200,1750,1800,1975,1518,1
479,2,0,96.0,110.0,126.0,141.0,2350,2518,1679,1959,671,559,223,1279,125,968,98,311,46,54,3325,3150,2200,1800,2075,1768,1
486,2,0,92.0,110.0,126.0,141.0,2356,1835,1707,1455,649,380,495,877,325,776,170,101,46,49,4050,3000,2350,1800,2350,2268,1
493,2,0,91.0,100.0,126.0,141.0,2384,1012,1735,811,649,201,490,647,390,580,100,67,47,42,3700,2875,2650,1900,2700,3095,1
500,2,0,90.0,96.0,118.0,141.0,2418,44,1791,0,627,44,682,443,510,376,172,67,46,36,3700,2875,2650,1900,2850,3470,1
507,2,0,86.0,96.0,118.0,141.0,2339,531,1735,531,604,0,558,430,310,363,248,67,46,34,3500,3125,2650,1900,3050,3576,1
514,2,0,86.0,93.0,118.0,133.0,2244,883,1595,839,649,44,843,439,515,364,328,75,46,34,3800,3725,2650,1900,3050,3826,1
521,2,0,77.0,89.0,126.0,133.0,2132,1051,1483,895,649,156,384,556,180,461,204,95,35,34,3225,3550,2650,2000,4350,4051,1
529,2,0,74.0,84.0,126.0,133.0,1466,1023,839,867,627,156,341,276,65,211,276,65,32,31,3575,3050,2650,2000,4675,4754,1
536,2,0,74.0,85.0,134.0,133.0,1124,743,475,587,649,156,417,262,65,177,352,85,34,31,3325,3000,2750,2000,4925,4804,1
543,2,0,75.0,89.0,134.0,133.0,1135,1309,531,1063,604,246,559,183,135,87,424,96,36,33,3325,3000,2950,2000,4925,4804,1
550,2,0,83.0,90.0,134.0,133.0,1774,1813,1147,1455,627,358,194,383,90,247,104,136,36,33,3775,3400,2950,2000,4925,4804,1
557,2,0,83.0,92.0,134.0,133.0,1914,2098,1287,1763,627,335,420,414,240,342,180,72,37,33,3925,3500,2950,2000,4925,4804,1
564,2,0,83.0,85.0,134.0,133.0,2020,2406,1371,1959,649,447,661,279,405,222,256,57,37,33,3925,2850,2950,2000,4925,5604,1
571,2,0,83.0,89.0,134.0,133.0,1964,2496,1315,1847,649,649,487,363,155,222,332,141,37,33,3925,2850,2850,2000,4925,5604,1
579,2,0,87.0,91.0,134.0,133.0,1964,2754,1315,2127,649,627,369,269,90,252,279,17,37,33,4275,2850,2850,2000,4925,5604,1
586,2,0,87.0,96.0,134.0,133.0,1998,2720,1371,2071,627,649,315,284,60,187,255,97,37,36,4275,3525,2850,2000,4925,5604,1
593,2,0,87.0,104.0,134.0,133.0,1914,2742,1287,2071,627,671,551,149,220,22,331,127,37,39,4275,3525,2850,2000,4925,5604,1
600,2,0,91.0,104.0,134.0,133.0,1919,2468,1315,1819,604,649,292,431,135,232,157,199,37,39,4275,3525,2850,2000,4925,5604,1
607,2,0,93.0,105.0,142.0,141.0,1919,1757,1315,1287,604,470,433,293,200,75,233,218,37,37,4875,3775,2850,2000,4925,5876,1
614,2,0,96.0,105.0,142.0,141.0,1986,1510,1315,1175,671,335,373,356,210,98,163,258,37,35,4875,4225,2850,2000,4925,5976,1
621,2,0,94.0,104.0,142.0,141.0,2020,1292,1371,979,649,313,470,417,235,123,235,294,37,33,4675,4275,2850,2000,5125,6126,1
629,2,0,88.0,96.0,142.0,141.0,1998,1012,1371,699,627,313,697,547,390,213,307,334,39,33,4175,4175,2850,2000,5625,6552,1
636,2,0,86.0,98.0,142.0,141.0,2020,1118,1371,783,649,335,642,422,405,73,237,349,37,33,4175,4100,2850,2000,5725,6727,1
643,2,0,81.0,91.0,157.0,141.0,1953,1342,1371,1007,582,335,336,587,185,198,151,389,38,26,3800,4100,2850,2000,6925,7084,1
650,2,0,81.0,86.0,157.0,141.0,1908,1152,1371,839,537,313,569,392,350,17,219,375,38,20,3800,4000,2850,1900,6925,7804,1
657,2,0,79.0,86.0,157.0,141.0,2009,1079,1427,811,582,268,565,505,395,102,170,403,38,20,3300,4125,2850,1900,7425,7804,1
664,2,0,78.0,82.0,157.0,141.0,2143,866,1539,755,604,111,332,512,240,97,92,415,38,20,3050,3900,2850,1900,7925,8129,1
671,2,0,86.0,86.0,157.0,141.0,2171,1068,1567,979,604,89,279,449,115,47,164,402,38,20,3250,4125,2850,1900,8025,8129,1
679,2,0,89.0,88.0,157.0,141.0,2255,1141,1651,1007,604,134,242,350,110,7,132,343,41,20,3550,4125,2850,2000,8025,8129,1
686,2,0,93.0,91.0,157.0,141.0,2227,1589,1623,1455,604,134,154,416,75,57,79,359,43,22,3800,4125,2850,2000,8025,8129,1
693,2,0,92.0,92.0,157.0,141.0,2205,1639,1623,1483,582,156,356,516,205,137,151,379,46,22,3550,4175,2850,2000,8275,8179,1
700,2,0,95.0,92.0,157.0,141.0,2261,1650,1679,1427,582,223,483,704,260,297,223,407,47,24,3550,4175,2850,2000,8025,8179,1
707,2,0,97.0,102.0,157.0,141.0,2451,1762,1847,1539,604,223,430,352,235,17,195,335,47,24,3850,4325,2850,2000,8025,8179,1
714,2,0,103.0,102.0,157.0,141.0,2423,1796,1819,1595,604,201,307,566,140,207,167,359,50,24,4200,4550,2850,2000,8025,8179,1
721,2,0,106.0,104.0,157.0,141.0,2485,1869,1903,1623,582,246,310,433,225,92,85,341,52,24,4200,4550,2850,2000,8025,8179,1
729,2,0,106.0,113.0,165.0,141.0,2591,1807,1987,1539,604,268,367,395,310,22,57,373,52,24,4200,5125,2850,2000,8025,8179,1
736,2,0,106.0,113.0,165.0,141.0,2619,1869,2015,1623,604,246,269,443,140,42,129,401,52,24,4200,5125,2850,2000,8025,8179,1
743,2,0,106.0,118.0,165.0,141.0,2602,1762,2043,1539,559,223,577,456,380,27,197,429,52,27,4200,5225,2850,2000,8025,8179,1
750,2,0,110.0,119.0,165.0,141.0,2574,1919,2015,1651,559,268,265,688,150,227,115,461,52,29,4475,5575,2850,2000,8275,8179,1
757,2,0,111.0,117.0,165.0,141.0,2138,1930,1511,1595,627,335,261,923,120,422,141,501,52,30,4775,5425,2850,2100,8450,8379,1
764,2,0,114.0,115.0,165.0,141.0,2227,2222,1623,1931,604,291,259,1195,100,662,159,533,51,31,4775,5375,2850,2100,8500,8479,1
771,2,0,117.0,119.0,165.0,141.0,2451,2306,1847,2015,604,291,152,1126,75,607,77,519,52,31,4950,5275,2850,2100,8500,8579,1
779,2,0,113.0,128.0,165.0,141.0,2317,2356,1735,2043,582,313,319,731,170,422,149,309,54,31,4675,5275,3200,2100,8775,8579,1
786,2,0,113.0,128.0,173.0,141.0,2345,2238,1763,1903,582,335,597,771,380,422,217,349,54,31,4675,5150,3200,2100,8775,8804,1
793,2,0,120.0,135.0,173.0,141.0,2378,2339,1819,1847,559,492,244,670,205,307,39,363,54,34,4675,5400,3200,2100,8775,8804,1
800,2,0,127.0,140.0,181.0,141.0,2535,2384,1931,1847,604,537,160,585,45,162,115,423,53,34,5525,5600,3200,2100,8825,8804,1
807,2,0,129.0,138.0,196.0,149.0,2502,2283,1875,1791,627,492,356,825,165,346,191,479,53,34,5725,6050,3200,2100,8825,8904,1
814,2,0,130.0,134.0,196.0,149.0,2703,2121,2099,1651,604,470,435,1068,180,529,255,539,53,37,5625,6100,3200,2100,8825,9104,1
821,2,0,121.0,140.0,181.0,157.0,2653,2110,2071,1595,582,515,783,961,460,408,323,553,51,37,5525,6200,3200,2100,9925,9104,1
829,2,0,131.0,119.0,181.0,157.0,2395,2283,1791,1791,604,492,550,881,155,318,395,563,51,37,5525,4525,3200,2100,9925,10779,1
836,2,0,127.0,121.0,158.0,157.0,1981,2362,1399,1847,582,515,772,951,305,378,467,573,47,37,6025,4525,3200,2100,10625,10879,1
843,2,0,131.0,128.0,158.0,157.0,1617,2322,1035,1763,582,559,440,750,155,213,285,537,47,37,6525,4775,3200,2100,10625,10879,1
850,2,0,131.0,131.0,158.0,157.0,1807,2110,1203,1595,604,515,671,741,310,148,361,593,47,40,6525,5000,3200,2100,10625,10879,1
857,2,0,131.0,138.0,158.0,157.0,1751,1891,1147,1399,604,492,473,626,40,23,433,603,47,40,6525,5200,3200,2200,10625,10879,1
864,2,0,125.0,133.0,158.0,157.0,1667,2283,1063,1679,604,604,666,926,165,243,501,683,47,41,6000,5175,3200,2100,11150,11229,1
871,2,0,107.0,121.0,158.0,165.0,1751,2278,1147,1651,604,627,873,871,300,158,573,713,47,40,4800,4550,3200,2100,12250,12254,1
879,2,0,98.0,96.0,158.0,165.0,1667,2636,1063,1987,604,649,1066,871,425,128,641,743,47,40,4150,3225,3200,2100,12900,13779,1
886,2,0,76.0,80.0,158.0,165.0,1538,2765,979,2071,559,694,1254,1201,545,378,709,823,47,40,2475,2300,3200,2100,14575,14804,1
893,2,0,74.0,73.0,158.0,165.0,1667,2630,1063,1959,604,671,1456,1303,675,433,781,870,47,36,2325,2075,3200,2100,14725,15479,1
900,2,0,88.0,78.0,158.0,165.0,1690,2474,1063,1847,627,627,478,1090,75,198,403,892,47,36,3200,2175,3200,2100,14725,15479,1
907,2,0,92.0,82.0,158.0,165.0,1617,2418,1035,1791,582,627,262,1085,20,138,242,947,47,36,3500,2350,3200,2100,14725,15479,1
914,2,0,92.0,87.0,158.0,165.0,1533,2362,951,1735,582,627,439,1160,125,233,314,927,47,39,3500,2700,3200,2100,14725,15479,1
921,2,0,92.0,97.0,158.0,165.0,1566,2390,1063,1763,503,627,317,765,95,8,222,757,47,39,3600,2750,3200,2100,14725,15479,1
929,2,0,94.0,98.0,173.0,165.0,1516,2322,1091,1651,425,671,404,1020,130,183,274,837,47,39,3600,2925,3200,2100,14725,15479,1
936,2,0,95.0,102.0,173.0,165.0,1824,2429,1399,1735,425,694,321,891,145,53,176,838,47,40,3825,3075,3200,2100,14900,15629,1
943,2,0,93.0,93.0,173.0,165.0,1908,2378,1483,1707,425,671,563,1187,335,273,228,914,47,40,3650,2900,3200,2100,15075,16104,1
950,2,0,77.0,93.0,173.0,165.0,2160,2306,1735,1679,425,627,810,1009,530,98,280,911,47,40,2375,2800,3200,2100,16350,16204,1
957,2,0,79.0,99.0,173.0,165.0,2266,2250,1819,1623,447,627,432,1299,225,308,207,991,47,40,2375,3625,3200,2100,16350,16204,1
964,2,0,86.0,107.0,173.0,165.0,2070,2614,1623,1987,447,627,160,949,55,178,105,771,47,40,2625,3625,3200,2100,16350,16204,1
971,2,0,88.0,111.0,173.0,165.0,2076,2524,1651,1875,425,649,313,1059,160,258,153,801,47,40,3225,3725,3200,2100,16350,16204,1
979,2,0,92.0,113.0,173.0,165.0,2104,2541,1679,1847,425,694,360,1079,155,248,205,831,47,40,3425,4200,3100,2100,16350,16204,1
986,2,0,96.0,118.0,173.0,165.0,2087,2877,1707,2183,380,694,188,905,110,148,78,757,47,40,3975,4200,3100,2100,16350,16204,1
993,2,0,98.0,121.0,173.0,165.0,2082,2838,1679,2211,403,627,250,1063,170,238,80,825,47,40,4325,4500,3100,2100,16350,16204,1
1000,2,0,99.0,121.0,173.0,165.0,1908,2782,1483,2155,425,627,427,1388,295,483,132,905,47,43,4325,4500,3100,2100,16350,16204,1
1007,2,0,105.0,124.0,173.0,165.0,1874,3006,1427,2379,447,627,133,1183,95,198,38,985,47,43,4850,5400,3100,2300,16350,16204,1
1014,2,0,105.0,123.0,173.0,165.0,1908,3062,1483,2435,425,627,357,1533,275,468,82,1065,48,43,4850,5350,3100,2300,16350,16254,1
1021,2,0,105.0,129.0,173.0,165.0,2014,3134,1567,2463,447,671,603,1043,465,273,138,770,48,43,4850,5500,3100,2300,16350,16254,1
1029,2,0,115.0,132.0,173.0,165.0,1908,2731,1483,2015,425,716,90,638,50,63,40,575,48,43,5475,5500,3100,2550,16350,16254,1
1036,2,0,115.0,132.0,173.0,165.0,1824,2714,1399,2043,425,671,317,960,225,313,92,647,48,43,5575,5500,3100,2550,16350,16254,1
1043,2,0,114.0,131.0,173.0,165.0,1852,2558,1427,1931,425,627,219,1267,125,548,94,719,45,43,5750,5450,3100,2550,16500,16304,1
1050,2,0,111.0,137.0,188.0,165.0,1958,2390,1511,1763,447,627,456,397,310,148,146,249,45,43,5400,6425,3100,2550,16850,16304,1
1057,2,0,108.0,139.0,188.0,165.0,1740,2446,1315,1819,425,627,668,512,470,183,198,329,44,43,5300,6325,3100,2550,16950,16404,1
1064,2,0,119.0,139.0,188.0,165.0,1874,2328,1427,1679,447,649,50,462,0,153,50,309,44,43,5300,6325,3100,2550,16950,16404,1
1071,2,0,118.0,143.0,188.0,165.0,2210,2238,1763,1567,447,671,322,437,220,73,102,364,46,43,6000,6425,3250,2550,17000,16504,1
1079,2,0,119.0,142.0,188.0,180.0,2328,1953,1903,1315,425,638,469,643,315,213,154,430,46,40,5750,7250,3250,2775,17250,16604,1
1086,2,0,119.0,141.0,188.0,180.0,2334,1678,1931,1175,403,503,737,844,535,358,202,486,48,39,5750,7250,3250,2775,17250,16654,1
1093,2,0,114.0,135.0,188.0,180.0,2434,1589,1987,1119,447,470,1038,1040,780,498,258,542,48,37,5400,7325,3250,2875,17650,16979,1
1100,2,0,116.0,143.0,188.0,180.0,1734,1617,1287,1147,447,470,321,655,265,128,56,527,40,37,5400,7325,3250,2875,18050,16979,1
1107,2,0,120.0,142.0,188.0,180.0,844,1589,419,1119,425,470,219,740,115,153,104,587,40,37,6275,7300,3250,2875,18050,17279,1
1114,2,0,122.0,141.0,188.0,180.0,1331,1555,1007,1063,324,492,158,935,145,288,13,647,40,37,6275,7200,3250,2875,18050,17579,1
1121,2,0,122.0,146.0,188.0,180.0,1936,1578,1623,1063,313,515,393,840,340,158,53,682,44,37,6525,7450,3250,2875,18050,17579,1
1129,2,0,131.0,147.0,188.0,180.0,1919,1387,1707,895,212,492,75,782,0,73,75,709,44,37,6750,7575,3250,2875,18225,17579,1
1136,2,0,125.0,141.0,188.0,180.0,1779,1449,1623,979,156,470,275,913,180,148,95,765,44,37,6450,7275,3250,2875,18525,18004,1
1143,2,0,85.0,137.0,188.0,165.0,1807,1533,1651,1063,156,470,500,873,385,73,115,800,47,37,3100,6925,3250,2875,21875,18879,1
1150,2,0,77.0,132.0,188.0,165.0,1835,1242,1679,839,156,403,730,1021,595,173,135,848,47,37,2400,6700,3250,2875,22575,19254,1
1157,2,0,71.0,131.0,188.0,165.0,2059,782,1903,447,156,335,981,885,830,18,151,867,47,36,1875,6600,3250,2875,23100,19529,1
1164,2,0,74.0,131.0,188.0,165.0,2087,721,1931,363,156,358,931,940,910,33,21,907,47,36,1875,6825,3250,2875,23100,19529,1
1171,2,0,87.0,131.0,188.0,165.0,1779,917,1623,559,156,358,421,1053,380,107,41,946,46,36,2075,6825,3250,2875,23150,19529,1
1179,2,0,87.0,130.0,173.0,165.0,1085,1146,951,811,134,335,542,1195,485,215,57,980,46,36,2575,7000,3250,2875,23550,19579,1
1186,2,0,87.0,130.0,173.0,165.0,1359,1264,1203,951,156,313,722,1336,645,320,77,1016,46,36,2875,7000,3250,2875,23550,19579,1
1193,2,0,101.0,128.0,157.0,165.0,1471,1124,1315,811,156,313,207,1459,110,403,97,1056,46,36,3575,6725,3250,2875,23750,19854,1
1200,2,0,75.0,116.0,157.0,165.0,1611,1320,1455,1007,156,313,393,1627,280,531,113,1096,46,36,2050,5600,3000,2875,25325,20979,1
1207,2,0,74.0,126.0,149.0,165.0,1527,1544,1371,1231,156,313,473,1227,340,166,133,1061,45,36,2050,5600,2850,2875,25625,20979,1
1214,2,0,74.0,124.0,149.0,165.0,1533,1930,1399,1595,134,335,150,1292,5,216,145,1076,45,36,1325,5500,2850,2875,26350,21079,1
1221,2,0,76.0,127.0,149.0,165.0,1538,2737,1427,2379,111,358,82,1257,50,191,32,1066,45,36,1825,5700,2850,2875,26350,21079,1
1229,2,0,72.0,131.0,157.0,165.0,1488,2770,1399,2435,89,335,259,1573,215,471,44,1102,45,36,1875,5975,2850,2875,26550,21179,1
1234,2,0,47.0,130.0,157.0,165.0,1516,2440,1427,2127,89,313,411,1426,355,346,56,1080,45,36,175,5875,2850,2875,28250,21279,1
7,0,2,13.0,13.0,15.0,15.0,293,293,293,293,0,0,35,35,35,35,0,0,12,12,0,0,0,0,0,0,0
14,0,2,14.0,14.0,15.0,15.0,671,643,671,643,0,0,70,65,70,65,0,0,13,13,0,0,0,0,0,0,0
21,0,2,14.0,14.0,15.0,15.0,727,727,727,727,0,0,50,45,50,45,0,0,13,13,0,0,0,0,0,0,0
29,0,2,15.0,15.0,15.0,15.0,699,643,699,643,0,0,80,75,80,75,0,0,14,14,0,0,0,0,0,0,0
36,0,2,15.0,15.0,15.0,15.0,783,755,783,755,0,0,185,125,185,125,0,0,14,14,0,0,0,0,0,0,0
43,0,2,16.0,16.0,23.0,23.0,783,811,783,811,0,0,70,70,70,70,0,0,15,15,0,0,0,0,0,0,0
50,0,2,16.0,17.0,23.0,23.0,783,783,783,783,0,0,85,40,85,40,0,0,15,16,0,0,0,0,0,0,0
57,0,2,17.0,17.0,23.0,23.0,727,755,727,755,0,0,130,85,130,85,0,0,16,16,0,0,0,0,0,0,0
64,0,2,18.0,18.0,23.0,23.0,839,839,839,839,0,0,190,140,190,140,0,0,17,17,0,0,0,0,0,0,0
71,0,2,18.0,19.0,23.0,23.0,833,861,811,839,22,22,274,244,270,240,4,4,17,18,0,0,0,0,0,0,0
79,0,2,19.0,19.0,23.0,23.0,939,934,783,867,156,67,348,357,320,345,28,12,18,19,0,0,0,0,0,0,0
86,0,2,19.0,19.0,23.0,23.0,939,939,783,895,156,44,459,71,415,55,44,16,18,19,0,0,0,0,0,0,0
93,0,2,20.0,19.0,23.0,23.0,911,962,755,895,156,67,319,29,305,5,14,24,19,19,0,0,150,150,0,0,0
100,0,2,20.0,20.0,23.0,23.0,967,962,811,895,156,67,434,102,400,70,34,32,19,19,0,0,150,150,0,0,0
107,0,2,20.0,20.0,23.0,23.0,1023,995,867,951,156,44,159,76,105,40,54,36,19,19,0,0,150,150,0,0,0
114,0,2,20.0,21.0,23.0,23.0,1023,1068,867,979,156,89,174,123,100,75,74,48,19,20,0,0,150,150,0,0,0
121,0,2,21.0,22.0,23.0,23.0,962,1090,783,979,179,111,229,145,135,85,94,60,19,21,0,0,150,150,0,0,0
129,0,2,21.0,24.0,23.0,31.0,1074,1085,895,951,179,134,119,105,55,75,64,30,19,21,100,0,150,300,0,0,0
136,0,2,22.0,25.0,23.0,31.0,1191,1079,1035,923,156,156,195,80,115,80,80,0,20,22,100,0,150,300,0,0,0
143,0,2,22.0,26.0,31.0,31.0,1191,1174,1035,951,156,223,175,173,75,145,100,28,20,23,100,0,150,300,0,0,0
150,0,2,23.0,27.0,31.0,31.0,1163,1258,1007,923,156,335,260,323,140,255,120,68,21,24,100,175,150,300,0,0,0
157,0,2,23.0,27.0,31.0,46.0,1219,1264,1063,951,156,313,270,474,130,370,140,104,21,24,100,175,150,300,0,0,0
164,0,2,26.0,29.0,31.0,46.0,1270,1264,1091,951,179,313,265,429,105,285,160,144,22,25,100,175,250,300,0,0,0
171,0,2,26.0,31.0,31.0,46.0,1298,1230,1119,895,179,335,305,319,125,235,180,84,22,27,100,175,250,300,0,0,0
179,0,2,27.0,33.0,46.0,46.0,1275,1264,1119,951,156,313,351,230,155,210,196,20,23,27,100,175,525,300,0,0,0
186,0,2,27.0,35.0,46.0,46.0,1191,1454,1035,1119,156,335,106,250,15,190,91,60,24,29,200,175,675,300,0,0,0
193,0,2,28.0,35.0,46.0,46.0,1135,1510,979,1175,156,335,196,380,85,280,111,100,24,29,200,175,675,300,0,0,0
200,0,2,28.0,37.0,46.0,54.0,1107,1544,951,1231,156,313,221,411,90,275,131,136,24,31,200,175,750,300,0,0,0
207,0,2,31.0,41.0,46.0,54.0,1163,1544,1007,1231,156,313,161,376,60,250,101,126,25,33,200,325,750,300,0,0,0
214,0,2,33.0,41.0,46.0,54.0,1578,1650,1399,1315,179,335,256,481,135,315,121,166,25,33,200,325,850,550,0,0,0
221,0,2,35.0,44.0,46.0,54.0,1970,1734,1791,1399,179,335,376,491,235,435,141,56,26,35,200,325,850,550,0,0,0
229,0,2,38.0,44.0,46.0,54.0,1919,1712,1763,1399,156,313,52,197,20,105,32,92,27,35,425,325,925,650,0,0,0
236,0,2,43.0,45.0,46.0,54.0,1975,1902,1819,1567,156,335,52,427,25,295,27,132,28,37,425,600,925,650,0,0,0
243,0,2,44.0,45.0,46.0,54.0,2031,1936,1875,1623,156,313,97,63,50,45,47,18,29,37,425,600,925,650,0,0,0
250,0,2,45.0,47.0,46.0,54.0,2059,2003,1903,1735,156,268,117,205,100,155,17,50,30,37,550,700,925,650,0,0,0
257,0,2,51.0,47.0,54.0,62.0,2087,2048,1931,1735,156,313,22,391,10,305,12,86,32,37,775,700,925,650,0,0,0
264,0,2,54.0,49.0,62.0,62.0,2418,2048,2239,1735,179,313,187,402,180,280,7,122,33,39,775,700,925,650,0,0,0
271,0,2,55.0,52.0,70.0,62.0,2390,2048,2211,1735,179,313,222,427,195,315,27,112,34,40,775,875,925,650,0,0,0
279,0,2,56.0,56.0,70.0,62.0,2031,2216,1875,1903,156,313,338,302,295,250,43,52,35,41,1000,875,925,650,0,0,0
286,0,2,57.0,52.0,70.0,70.0,2283,2154,2127,1819,156,335,223,932,160,740,63,192,36,42,1125,875,925,650,0,0,0
293,0,2,63.0,52.0,78.0,70.0,2395,2121,2239,1763,156,358,188,656,155,420,33,236,38,42,1125,875,925,1250,0,0,0
300,0,2,63.0,58.0,78.0,70.0,2479,2126,2323,1679,156,447,248,107,195,15,53,92,38,42,1125,875,925,1250,0,0,0
307,0,2,65.0,59.0,78.0,85.0,2390,2065,2211,1595,179,470,163,303,140,155,23,148,39,42,1125,875,925,1250,0,0,0
314,0,2,71.0,63.0,78.0,85.0,2502,2154,2323,1707,179,447,143,230,100,130,43,100,41,42,1425,875,925,1250,0,0,0
321,0,2,73.0,65.0,78.0,85.0,2479,2205,2323,1735,156,470,324,395,265,235,59,160,41,43,1425,1325,925,1250,0,0,0
329,0,2,70.0,63.0,78.0,93.0,2630,2328,2407,1791,223,537,611,674,520,450,91,224,41,43,1325,1175,925,1350,200,150,0
336,0,2,72.0,63.0,86.0,93.0,2630,2418,2295,1903,335,515,455,789,395,555,60,234,43,43,1350,1500,925,1250,425,525,0
343,0,2,62.0,64.0,94.0,93.0,2630,2339,2295,1847,335,492,660,1025,560,735,100,290,43,43,650,1675,925,1600,1125,625,0
350,0,2,62.0,71.0,94.0,93.0,2558,2300,2155,1763,403,537,607,398,555,390,52,8,43,43,650,1675,925,1600,1125,625,0
357,0,2,70.0,73.0,94.0,93.0,2434,2334,1875,1707,559,627,140,214,70,130,70,84,45,44,1000,1675,925,1600,1125,625,0
364,0,2,70.0,75.0,109.0,93.0,2406,2345,1847,1763,559,582,285,247,155,195,130,52,45,46,1000,1675,925,1600,1125,625,0
371,0,2,72.0,78.0,109.0,93.0,2384,2345,1847,1763,537,582,269,393,175,265,94,128,47,49,1000,1675,925,1600,1125,625,0
379,0,2,76.0,80.0,109.0,93.0,2502,2496,1875,1847,627,649,454,544,280,340,174,204,49,51,1350,1675,925,1600,1125,625,0
386,0,2,80.0,88.0,109.0,93.0,2390,2608,1763,1959,627,649,299,165,95,85,204,80,49,53,1350,2175,925,1750,1125,625,0
393,0,2,82.0,90.0,109.0,93.0,2524,2765,1875,2183,649,582,534,449,250,305,284,144,51,55,1350,2675,1175,1750,1125,625,0
400,0,2,84.0,97.0,109.0,101.0,2524,2815,1875,2211,649,604,145,230,35,210,110,20,51,56,1575,2675,1175,1750,1125,625,0
407,0,2,86.0,100.0,109.0,109.0,2485,3062,1791,2435,694,627,275,501,160,405,115,96,53,58,1700,2775,1600,2000,1125,625,0
414,0,2,93.0,100.0,109.0,109.0,2692,3062,2043,2435,649,627,217,581,80,405,137,176,55,60,1700,2775,1600,2000,1125,625,0
421,0,2,95.0,100.0,109.0,109.0,3174,3022,2547,2351,627,671,218,586,105,430,113,156,55,60,1825,2775,1600,2000,1125,625,0
429,0,2,98.0,101.0,109.0,117.0,3734,3078,3107,2407,627,671,503,402,310,170,193,232,58,60,1925,2775,1675,2000,1125,625,0
436,0,2,98.0,104.0,109.0,125.0,4036,3084,3387,2435,649,649,878,338,605,30,273,308,58,61,2050,2775,1925,2000,1150,625,0
443,0,2,111.0,106.0,117.0,133.0,3980,3140,3331,2491,649,649,338,574,60,190,278,384,61,63,2175,2775,2025,2000,1150,625,0
450,0,2,113.0,107.0,125.0,141.0,4030,3140,3359,2491,671,649,239,744,160,280,79,464,63,64,2175,2775,2275,2000,1150,625,0
457,0,2,117.0,113.0,125.0,141.0,3997,3202,3303,2575,694,627,214,525,155,260,59,265,64,66,2175,3175,2275,2150,1150,725,0
464,0,2,117.0,119.0,125.0,141.0,3868,3280,3219,2631,649,649,346,425,215,180,131,245,64,67,2750,3175,2275,2150,1150,725,0
471,0,2,125.0,119.0,125.0,149.0,3902,3269,3275,2575,627,694,182,530,50,205,132,325,66,69,2750,3475,2275,2150,1150,725,0
479,0,2,125.0,123.0,125.0,157.0,3756,3151,3107,2435,649,716,587,509,375,200,212,309,66,69,2750,3675,2275,2150,1150,725,0
486,0,2,129.0,123.0,149.0,157.0,3493,3246,2799,2463,694,783,545,896,420,495,125,401,66,69,3150,3675,2275,2150,1150,725,0
493,0,2,138.0,125.0,149.0,165.0,3246,3101,2351,2295,895,806,226,1171,60,670,166,501,66,69,3625,3675,2275,2150,1150,725,0
500,0,2,144.0,132.0,157.0,165.0,3358,3106,2351,2323,1007,783,221,932,135,485,86,447,68,69,3625,4575,2275,2250,1150,725,0
507,0,2,147.0,135.0,157.0,180.0,3784,3218,2799,2435,985,783,358,997,210,550,148,447,69,69,3725,4575,2275,2350,1150,725,0
514,0,2,149.0,139.0,172.0,180.0,3767,3543,2827,2715,940,828,440,1072,180,625,260,447,71,69,4200,4925,2275,2350,1150,725,0
521,0,2,153.0,142.0,172.0,180.0,3823,3784,2883,2911,940,873,390,1287,60,740,330,547,74,72,4300,5025,2275,2350,1150,725,0
529,0,2,159.0,142.0,172.0,180.0,3952,3672,2967,2799,985,873,580,1727,155,1080,425,647,74,72,4700,5025,2275,2350,1150,725,0
536,0,2,163.0,142.0,172.0,180.0,4098,3790,3135,2827,963,963,586,1828,245,1265,341,563,74,75,4700,5025,2475,2350,1150,725,0
543,0,2,163.0,143.0,172.0,180.0,4120,3818,3135,2855,985,963,792,1953,485,1420,307,533,74,75,5100,5025,2475,2350,1150,725,0
550,0,2,172.0,152.0,172.0,188.0,4249,3907,3219,2967,1030,940,512,1174,160,725,352,449,74,75,5275,5025,2475,2650,1150,725,0
557,0,2,173.0,152.0,188.0,188.0,4148,4014,3163,3051,985,963,899,1159,435,790,464,369,74,79,5275,5025,2475,2650,1150,725,0
564,0,2,175.0,152.0,188.0,188.0,3795,4137,2855,3107,940,1030,951,1194,500,705,451,489,74,79,5825,5025,2475,2650,1150,725,0
571,0,2,184.0,154.0,188.0,188.0,3566,4064,2603,3079,963,985,511,1577,265,980,246,597,74,79,6250,5025,2775,3000,1150,725,0
579,0,2,187.0,156.0,212.0,188.0,3588,4215,2603,3275,985,940,341,1894,125,1235,216,659,76,79,6250,5200,2775,3000,1150,725,0
586,0,2,189.0,162.0,227.0,188.0,3599,4322,2659,3359,940,963,763,1519,435,1340,328,179,79,79,6350,5900,2775,3000,1200,725,0
593,0,2,188.0,162.0,227.0,188.0,3728,4165,2743,3135,985,1030,823,2011,375,1700,448,311,79,79,6300,5900,2850,3100,1250,725,0
600,0,2,198.0,162.0,227.0,188.0,3638,4288,2631,3079,1007,1209,524,1928,35,1665,489,263,82,79,7125,6400,2850,3300,1250,725,0
607,0,2,200.0,162.0,227.0,188.0,3504,3784,2519,2463,985,1321,820,1454,240,1185,580,269,82,79,7125,6400,2950,4400,1250,725,0
614,0,2,200.0,170.0,227.0,188.0,3711,3610,2771,2267,940,1343,1277,1486,585,1065,692,421,82,79,7125,6500,2950,4400,1250,725,0
621,0,2,200.0,176.0,227.0,196.0,4058,3767,3051,2491,1007,1276,796,1336,480,1225,316,111,82,79,7700,7400,2950,4400,1250,825,0
629,0,2,199.0,182.0,227.0,196.0,4299,3717,3247,2463,1052,1254,1314,1474,870,1215,444,259,82,79,7775,7700,2950,4400,1300,825,0
636,0,2,199.0,180.0,227.0,196.0,4456,3778,3359,2547,1097,1231,1851,1921,1275,1510,576,411,82,79,7775,7600,2950,4400,1300,925,0
643,0,2,198.0,160.0,227.0,196.0,4473,3750,3331,2519,1142,1231,1837,2393,1225,1830,612,563,82,79,6750,6400,2950,4400,2325,2125,0
650,0,2,189.0,130.0,227.0,196.0,4478,3700,3359,2491,1119,1209,2265,2435,1525,1720,740,715,82,79,6200,4025,2950,4700,2875,4700,0
657,0,2,173.0,84.0,227.0,196.0,4406,3924,3331,2603,1075,1321,2668,2891,1825,2020,843,871,82,79,5300,500,2950,5000,3775,8425,0
664,0,2,191.0,97.0,242.0,188.0,4495,3504,3443,2295,1052,1209,1811,1989,1165,1190,646,799,82,72,5950,1100,2950,4800,3775,9350,0
671,0,2,191.0,96.0,242.0,173.0,4294,2938,3219,1931,1075,1007,1613,2330,835,1415,778,915,82,71,5950,1100,2950,4700,3775,9900,0
679,0,2,191.0,96.0,242.0,173.0,4238,2810,3163,1847,1075,963,995,2651,610,1620,385,1031,82,71,5950,1100,2950,5000,3775,9900,0
686,0,2,200.0,102.0,242.0,173.0,4310,2698,3191,1735,1119,963,1496,926,975,350,521,576,82,71,6750,1100,2950,5000,3775,9975,0
693,0,2,200.0,102.0,242.0,173.0,4434,2647,3247,1707,1187,940,2027,1242,1370,550,657,692,82,71,6950,1850,2950,5000,3775,9975,0
700,0,2,200.0,112.0,242.0,173.0,4394,2692,3275,1707,1119,985,2541,502,1760,415,781,87,82,71,7200,2650,2950,5000,3775,9975,0
707,0,2,200.0,118.0,242.0,173.0,4277,2709,3247,1679,1030,1030,2471,832,1445,625,1026,207,82,71,7450,3400,2950,5000,3775,9975,0
714,0,2,200.0,117.0,242.0,165.0,4148,2664,3051,1679,1097,985,2972,890,1810,700,1162,190,82,71,8000,3300,2950,5000,3775,10425,0
721,0,2,200.0,122.0,242.0,157.0,4064,2647,2967,1707,1097,940,2243,797,945,495,1298,302,82,70,8000,3450,3250,5000,3775,10825,0
729,0,2,200.0,116.0,242.0,157.0,3952,2558,2855,1595,1097,963,2725,602,1295,380,1430,222,82,70,8000,2850,3250,5000,3775,11825,0
736,0,2,200.0,124.0,242.0,157.0,4075,2530,2911,1567,1164,963,3191,517,1625,175,1566,342,82,70,8000,2850,3250,5000,3775,11825,0
743,0,2,196.0,109.0,257.0,157.0,4002,2479,2883,1539,1119,940,3660,813,1970,355,1690,458,82,69,7750,2550,3250,5000,4025,12975,0
750,0,2,200.0,107.0,257.0,157.0,3958,2546,2883,1539,1075,1007,3584,523,2020,145,1564,378,82,69,7750,2350,3250,5000,4025,13175,0
757,0,2,200.0,116.0,257.0,157.0,4008,2591,2911,1539,1097,1052,3616,528,2120,155,1496,373,82,69,7750,3100,3700,5000,4025,13175,0
764,0,2,200.0,122.0,257.0,157.0,3952,2362,2855,1399,1097,963,3832,187,2300,160,1532,27,82,71,7750,3100,3700,5000,4025,13175,0
771,0,2,200.0,122.0,257.0,157.0,4014,2614,2827,1651,1187,963,4019,528,2485,385,1534,143,82,72,7750,3700,3775,5000,4025,13175,0
779,0,2,200.0,122.0,257.0,157.0,4126,2670,2827,1707,1299,963,4109,423,2415,160,1694,263,82,72,8300,3700,3850,5000,4025,13175,0
786,0,2,196.0,124.0,272.0,157.0,4126,2395,2827,1455,1299,940,4601,454,2755,200,1846,254,78,72,8300,3700,3850,5000,4225,13175,0
793,0,2,196.0,122.0,287.0,157.0,3946,2356,2715,1371,1231,985,4938,639,2955,265,1983,374,78,72,8300,3700,4150,5000,4225,13425,0
800,0,2,196.0,130.0,302.0,157.0,3784,2457,2463,1427,1321,1030,4953,439,2824,195,2129,244,78,72,8300,3950,4400,5000,4225,13675,0
807,0,2,196.0,130.0,302.0,157.0,3549,2328,2295,1343,1254,985,5334,702,3066,350,2268,352,78,72,8300,4450,4400,5000,4225,13675,0
814,0,2,192.0,130.0,302.0,165.0,3336,2395,2127,1455,1209,940,5355,994,2935,530,2420,464,74,72,8300,4450,4600,5000,4425,13675,0
821,0,2,198.0,138.0,302.0,165.0,2877,2418,1847,1455,1030,963,5038,889,2590,305,2448,584,69,72,8300,4850,4700,5000,4675,13675,0
829,0,2,198.0,134.0,317.0,157.0,2933,2194,1903,1231,1030,963,5097,1129,2675,425,2422,704,69,72,8300,4350,5000,5000,4675,14275,0
836,0,2,198.0,132.0,317.0,157.0,3504,2115,2519,1175,985,940,5543,1385,3005,565,2538,820,69,72,8350,4250,5000,5000,4675,14375,0
843,0,2,193.0,112.0,317.0,149.0,3773,2742,2743,1735,1030,1007,5979,1735,3325,795,2654,940,69,72,8350,3150,5000,5000,5275,15575,0
850,0,2,184.0,75.0,317.0,149.0,3588,2983,2603,1931,985,1052,6386,2065,3620,1005,2766,1060,69,67,7825,200,5000,5000,5800,19175,0
7,0,2,13.0,13.0,15.0,15.0,293,335,293,335,0,0,35,40,35,40,0,0,12,12,0,0,0,0,0,0,1
14,0,2,14.0,14.0,15.0,15.0,587,671,587,671,0,0,55,70,55,70,0,0,13,13,0,0,0,0,0,0,1
21,0,2,14.0,14.0,15.0,15.0,615,699,615,699,0,0,30,50,30,50,0,0,13,13,0,0,0,0,0,0,1
29,0,2,15.0,15.0,15.0,15.0,531,727,531,727,0,0,45,85,45,85,0,0,14,14,0,0,0,0,0,0,1
36,0,2,15.0,15.0,15.0,15.0,643,727,643,727,0,0,135,140,135,140,0,0,14,14,0,0,0,0,0,0,1
43,0,2,15.0,16.0,23.0,23.0,699,755,699,755,0,0,60,20,60,20,0,0,15,15,0,0,0,0,0,0,1
50,0,2,15.0,17.0,23.0,23.0,699,783,699,783,0,0,140,75,140,75,0,0,15,16,0,0,0,0,0,0,1
57,0,2,16.0,18.0,23.0,23.0,699,755,699,755,0,0,30,95,30,95,0,0,15,17,0,0,0,0,0,0,1
64,0,2,16.0,18.0,23.0,23.0,755,839,755,839,0,0,70,200,70,200,0,0,15,18,0,0,0,0,0,0,1
71,0,2,17.0,19.0,23.0,23.0,783,895,783,895,0,0,85,260,85,260,0,0,16,18,0,0,0,0,0,0,1
79,0,2,17.0,19.0,23.0,23.0,755,945,755,923,0,22,180,329,180,325,0,4,16,18,0,0,0,0,0,0,1
86,0,2,18.0,20.0,23.0,23.0,811,995,811,951,0,44,225,443,225,435,0,8,17,19,0,0,0,0,0,0,1
93,0,2,19.0,20.0,23.0,23.0,755,962,755,895,0,67,110,396,110,380,0,16,18,20,0,0,150,150,0,0,1
100,0,2,19.0,22.0,23.0,23.0,866,984,755,895,111,89,115,243,95,215,20,28,18,20,0,0,300,150,0,0,1
107,0,2,20.0,23.0,23.0,23.0,855,1034,699,923,156,111,120,315,80,275,40,40,18,20,0,0,300,150,0,0,1
114,0,2,21.0,23.0,23.0,23.0,855,1062,699,951,156,111,225,437,165,385,60,52,18,21,50,0,300,150,0,0,1
121,0,2,23.0,26.0,23.0,31.0,850,978,671,867,179,111,210,403,130,335,80,68,18,21,100,100,300,150,0,0,1
129,0,2,24.0,25.0,31.0,31.0,939,894,783,783,156,111,281,455,185,375,96,80,18,20,150,100,300,300,0,50,1
136,0,2,24.0,26.0,31.0,31.0,1107,838,951,727,156,111,156,152,140,60,16,92,19,21,150,100,300,300,0,50,1
143,0,2,24.0,27.0,31.0,31.0,1135,973,979,839,156,134,181,93,145,35,36,58,19,21,200,200,300,300,0,100,1
150,0,2,24.0,26.0,31.0,31.0,1107,950,951,839,156,111,256,150,200,80,56,70,18,21,250,100,300,300,50,200,1
157,0,2,24.0,25.0,31.0,31.0,1191,950,1035,839,156,111,296,272,220,190,76,82,18,20,150,100,300,300,150,250,1
164,0,2,26.0,28.0,31.0,31.0,1158,1029,979,895,179,134,276,173,180,125,96,48,19,21,200,275,300,300,150,250,1
171,0,2,24.0,26.0,31.0,31.0,1214,978,1035,867,179,111,411,235,295,175,116,60,19,21,100,175,300,300,250,350,1
179,0,2,24.0,26.0,31.0,31.0,1023,1006,867,895,156,111,342,132,210,110,132,22,19,21,100,175,550,300,350,400,1
186,0,2,23.0,27.0,31.0,31.0,1079,1006,923,895,156,111,487,259,335,225,152,34,19,22,100,175,550,300,400,400,1
193,0,2,26.0,27.0,31.0,31.0,967,978,811,867,156,111,572,330,425,280,147,50,20,22,150,350,550,300,400,400,1
200,0,2,27.0,30.0,39.0,31.0,1079,1001,923,867,156,134,262,236,95,220,167,16,21,23,150,350,550,300,400,400,1
207,0,2,27.0,29.0,39.0,46.0,1135,1169,979,923,156,246,412,408,225,310,187,98,21,23,150,350,550,300,400,400,1
214,0,2,27.0,31.0,39.0,46.0,1158,1197,979,951,179,246,307,250,200,220,107,30,22,25,250,350,550,300,400,400,1
221,0,2,30.0,32.0,39.0,46.0,1158,1326,979,1035,179,291,302,211,200,145,102,66,22,26,250,350,550,300,400,400,1
229,0,2,31.0,33.0,39.0,46.0,1135,1432,979,1119,156,313,398,342,280,240,118,102,23,27,250,350,550,300,400,400,1
236,0,2,31.0,33.0,39.0,46.0,1135,1432,979,1119,156,313,533,413,395,275,138,138,23,29,250,175,550,300,400,575,1
243,0,2,34.0,33.0,39.0,46.0,1107,1522,951,1231,156,291,522,249,393,175,129,74,24,29,350,175,550,300,400,575,1
250,0,2,34.0,34.0,39.0,46.0,1275,1572,1119,1259,156,313,537,449,388,335,149,114,24,30,350,175,800,550,400,625,1
257,0,2,37.0,34.0,39.0,46.0,1158,1320,979,1007,179,313,447,495,378,345,69,150,25,30,350,175,800,550,400,725,1
264,0,2,39.0,32.0,39.0,46.0,1102,1264,923,951,179,313,432,295,368,255,64,40,25,28,450,175,800,550,400,825,1
271,0,2,38.0,33.0,62.0,46.0,1303,1202,1147,867,156,335,598,390,518,310,80,80,26,29,350,175,800,700,500,875,1
279,0,2,37.0,34.0,62.0,46.0,1499,1236,1343,923,156,313,608,491,508,375,100,116,26,30,300,175,800,700,550,875,1
286,0,2,37.0,35.0,62.0,46.0,1415,1292,1259,979,156,313,183,172,113,53,70,119,27,31,600,175,800,950,550,875,1
293,0,2,37.0,37.0,62.0,46.0,1387,1622,1231,1287,156,335,281,222,266,138,15,84,27,32,600,175,800,950,550,875,1
300,0,2,38.0,41.0,62.0,46.0,1471,1740,1315,1427,156,313,401,203,366,133,35,70,27,34,600,350,800,950,550,875,1
307,0,2,38.0,44.0,62.0,46.0,1466,1768,1287,1455,179,313,486,143,431,83,55,60,28,35,600,525,875,950,550,950,1
314,0,2,39.0,45.0,62.0,46.0,1606,1874,1427,1539,179,335,416,173,341,73,75,100,28,36,600,625,1150,950,550,950,1
321,0,2,40.0,46.0,62.0,46.0,1499,1958,1343,1623,156,335,522,183,431,118,91,65,28,37,600,625,1150,950,550,950,1
329,0,2,43.0,46.0,62.0,46.0,1303,1964,1147,1651,156,313,152,269,141,168,11,101,28,38,650,625,1250,950,550,950,1
336,0,2,44.0,52.0,62.0,62.0,1247,2070,979,1735,268,335,307,164,256,123,51,41,29,38,650,625,1500,950,550,950,1
343,0,2,45.0,52.0,62.0,62.0,1376,1958,1063,1623,313,335,428,384,341,303,87,81,30,40,650,1075,1600,950,550,950,1
350,0,2,47.0,48.0,70.0,70.0,1488,1415,1175,1147,313,268,483,452,381,343,102,109,32,34,750,1075,1600,950,550,1250,1
357,0,2,51.0,48.0,70.0,70.0,1482,1286,1147,1063,335,223,228,510,111,373,117,137,32,34,550,1075,1600,950,750,1250,1
364,0,2,52.0,50.0,70.0,85.0,1656,1393,1343,1147,313,246,159,577,131,408,28,169,32,35,450,1075,1600,950,850,1300,1
371,0,2,48.0,50.0,70.0,85.0,2014,1813,1679,1567,335,246,109,455,41,408,68,47,34,36,375,975,1600,950,1161,1400,1
379,0,2,52.0,53.0,70.0,85.0,2266,1874,1931,1651,335,223,114,593,56,518,58,75,34,39,500,975,1600,950,1161,1400,1
386,0,2,56.0,54.0,70.0,85.0,2384,1902,2071,1567,313,335,170,496,76,373,94,123,36,40,500,975,1600,950,1161,1400,1
393,0,2,56.0,59.0,70.0,85.0,2720,1981,2407,1511,313,470,385,237,301,158,84,79,36,43,500,975,1700,950,1161,1400,1
400,0,2,58.0,62.0,78.0,85.0,2726,2003,2323,1511,403,492,577,237,441,198,136,39,38,44,1125,1125,1700,950,1161,1400,1
407,0,2,64.0,64.0,78.0,93.0,2759,2278,2267,1763,492,515,242,287,196,188,46,99,38,46,1125,1275,1700,950,1161,1400,1
414,0,2,66.0,66.0,78.0,93.0,2703,2395,2211,1791,492,604,273,358,221,183,52,175,40,48,1125,1275,1700,950,1161,1400,1
421,0,2,68.0,73.0,78.0,93.0,2619,2580,2127,1931,492,649,226,143,164,88,62,55,40,49,1225,1275,1700,1250,1161,1400,1
429,0,2,74.0,75.0,86.0,93.0,2317,2580,1847,1931,470,649,283,243,165,108,118,135,42,51,1475,1275,1700,1250,1161,1400,1
436,0,2,74.0,77.0,86.0,93.0,2334,2726,1819,2099,515,627,377,544,295,333,82,211,42,53,1475,1275,1700,1250,1161,1400,1
443,0,2,78.0,79.0,86.0,93.0,2670,2854,2043,2183,627,671,257,139,145,98,112,41,44,55,1575,1275,1700,1650,1161,1400,1
450,0,2,84.0,80.0,94.0,101.0,2720,3129,2071,2435,649,694,278,344,190,223,88,121,44,56,1825,1275,1800,1650,1161,1400,1
457,0,2,86.0,81.0,94.0,101.0,2798,3084,2127,2435,671,649,213,561,145,368,68,193,46,58,1825,1275,1800,1800,1161,1400,1
464,0,2,94.0,89.0,94.0,101.0,2832,3118,2183,2491,649,627,245,312,155,243,90,69,46,60,1925,1775,1800,1800,1161,1400,1
471,0,2,94.0,90.0,102.0,101.0,2720,3140,2071,2491,649,649,370,632,200,483,170,149,46,60,2175,1775,1800,1800,1161,1400,1
479,0,2,98.0,100.0,110.0,109.0,2614,3308,1987,2659,627,649,456,287,260,58,196,229,48,63,2475,1775,1800,1800,1161,1400,1
486,0,2,101.0,99.0,110.0,117.0,2552,3314,1903,2687,649,627,656,428,430,123,226,305,48,63,2825,2100,1700,1800,1211,1575,1
493,0,2,107.0,100.0,118.0,117.0,2664,3353,2015,2659,649,694,297,763,245,378,52,385,48,63,2825,2100,1700,1950,1211,1575,1
500,0,2,107.0,110.0,126.0,125.0,2574,3381,1903,2687,671,694,617,368,485,103,132,265,48,65,3075,2600,1700,1950,1211,1575,1
507,0,2,113.0,116.0,126.0,141.0,2558,3202,1931,2575,627,627,179,241,25,108,154,133,48,65,3275,3400,1700,1950,1211,1575,1
514,0,2,113.0,116.0,134.0,141.0,2580,3370,1931,2743,649,627,494,301,260,188,234,113,50,65,3375,3400,1700,2100,1211,1575,1
521,0,2,113.0,116.0,134.0,141.0,2614,3280,1987,2631,627,649,795,681,485,488,310,193,50,65,3775,3400,1700,2100,1211,1575,1
529,0,2,127.0,126.0,134.0,141.0,2524,3118,1875,2491,649,627,155,412,65,143,90,269,50,65,4025,3900,1700,2100,1211,1575,1
536,0,2,127.0,124.0,134.0,141.0,2552,2978,1903,2351,649,627,465,772,295,423,170,349,50,65,4025,3800,1700,2100,1211,1675,1
543,0,2,127.0,126.0,134.0,141.0,2518,3174,1847,2323,671,851,466,990,220,583,246,407,50,65,4125,3975,1700,2100,1211,1675,1
550,0,2,127.0,134.0,134.0,141.0,2462,3342,1791,2379,671,963,671,677,345,358,326,319,50,65,4450,3975,1700,2100,1336,1675,1
557,0,2,124.0,132.0,134.0,141.0,2524,3482,1875,2519,649,963,983,1093,585,658,398,435,50,65,4675,5075,1700,2250,1511,1775,1
564,0,2,124.0,134.0,134.0,141.0,2524,3560,1875,2575,649,985,823,1328,395,773,428,555,50,65,4375,4975,1700,2250,1811,1875,1
571,0,2,121.0,127.0,134.0,141.0,2418,3146,1791,2295,627,851,594,1664,190,1013,404,651,50,60,3875,5075,1700,2100,2411,2262,1
579,0,2,114.0,128.0,149.0,141.0,2328,2395,1679,1791,649,604,869,1191,385,668,484,523,52,60,3400,5225,1700,2100,2886,2812,1
586,0,2,110.0,129.0,149.0,141.0,2272,2513,1623,1931,649,582,594,885,80,498,514,387,52,59,3100,4775,1700,2100,3536,3312,1
593,0,2,114.0,127.0,149.0,133.0,2350,2412,1679,1987,671,425,465,1159,75,728,390,431,52,59,3300,4775,2000,2100,3536,3512,1
600,0,2,114.0,133.0,149.0,133.0,2384,2373,1735,2015,649,358,751,929,285,608,466,321,54,60,3300,5125,2000,1800,3536,3774,1
607,0,2,118.0,133.0,149.0,133.0,2244,2322,1595,1987,649,335,832,899,365,538,467,361,54,60,3650,5300,2000,1800,3536,3774,1
614,0,2,118.0,133.0,149.0,133.0,1964,2300,1315,1987,649,313,1072,980,525,583,547,397,54,60,3650,5300,2000,1800,3536,3774,1
621,0,2,118.0,131.0,149.0,133.0,1964,2395,1315,2127,649,268,488,1057,115,628,373,429,54,60,4050,5200,2075,1800,3536,3874,1
629,0,2,122.0,139.0,149.0,149.0,2300,2703,1651,2323,649,380,778,449,325,118,453,331,54,60,4300,5600,2075,1800,3536,3874,1
636,0,2,124.0,139.0,149.0,165.0,2294,2849,1623,2379,671,470,834,426,305,243,529,183,54,60,4300,5600,2075,1800,3536,3874,1
643,0,2,131.0,139.0,149.0,173.0,2322,2765,1651,2295,671,470,744,762,160,523,584,239,56,60,4300,5600,2175,1800,3536,3874,1
650,0,2,131.0,137.0,149.0,181.0,3336,2944,2687,2295,649,649,1186,725,530,398,656,327,56,60,4550,5500,2300,1950,3536,3974,1
657,0,2,140.0,145.0,157.0,173.0,3980,3151,3331,2435,649,716,961,423,275,208,686,215,59,60,4650,6200,2300,2100,3536,4074,1
664,0,2,140.0,147.0,157.0,173.0,4210,3095,3583,2379,627,716,1432,596,670,343,762,253,59,60,4775,6375,2550,2100,3536,4074,1
671,0,2,147.0,145.0,157.0,173.0,4400,3258,3751,2519,649,739,1012,1010,445,673,567,337,62,60,4875,6275,2550,2450,3536,4174,1
679,0,2,133.0,145.0,157.0,173.0,4456,3308,3807,2547,649,761,1492,898,845,473,647,425,62,60,4100,5400,2550,2450,4561,5049,1
686,0,2,128.0,133.0,157.0,173.0,4428,3319,3667,2603,761,716,964,1292,525,783,439,509,65,60,3300,5350,2550,2450,5361,6099,1
693,0,2,111.0,131.0,157.0,173.0,4389,3241,3583,2547,806,694,1470,1421,935,828,535,593,65,60,2450,5000,2550,2450,6411,6449,1
700,0,2,110.0,134.0,157.0,173.0,4422,2978,3639,2239,783,739,1983,1169,1360,488,623,681,65,59,2400,4500,2550,2450,6461,7099,1
707,0,2,122.0,126.0,157.0,173.0,4142,2653,3359,1959,783,694,844,1478,575,713,269,765,65,59,2275,4600,2550,2450,6586,7499,1
714,0,2,118.0,124.0,157.0,173.0,3319,2787,2603,2071,716,716,793,1811,615,958,178,853,65,59,2025,4500,2550,2450,6836,7599,1
721,0,2,120.0,126.0,157.0,188.0,3202,2950,2351,2211,851,739,1171,1928,885,983,286,945,65,59,2175,4650,2550,2450,6836,7699,1
729,0,2,134.0,139.0,157.0,188.0,3314,2927,2351,2211,963,716,882,1158,580,433,302,725,65,60,3400,4650,2550,2450,6836,7699,1
736,0,2,123.0,140.0,157.0,188.0,3554,3095,2547,2379,1007,716,1072,1521,750,708,322,813,65,63,2600,5700,2550,2450,7636,7699,1
743,0,2,125.0,139.0,157.0,188.0,3538,3151,2575,2435,963,716,1129,1495,870,598,259,897,65,65,2800,5600,2550,2450,7636,7799,1
750,0,2,131.0,139.0,157.0,188.0,3482,3168,2519,2407,963,761,1060,1892,760,903,300,989,65,65,3075,5600,2550,2450,7736,7799,1
757,0,2,131.0,139.0,157.0,188.0,3426,3235,2463,2519,963,716,1266,1716,850,843,416,873,65,66,3175,5600,2850,2450,7736,7799,1
764,0,2,131.0,135.0,172.0,204.0,3566,2905,2603,2099,963,806,1697,1916,1165,943,532,973,65,62,3175,5600,2850,2450,7736,7999,1
771,0,2,137.0,147.0,172.0,204.0,3734,3011,2771,2071,963,940,2127,1687,1475,598,652,1089,65,62,4250,6200,2850,2450,7736,7999,1
779,0,2,145.0,137.0,188.0,204.0,3650,3336,2687,2351,963,985,1144,2093,780,888,364,1205,63,62,4250,5700,3100,2450,7836,8499,1
786,0,2,142.0,135.0,188.0,204.0,3470,3465,2575,2435,895,1030,1538,1647,1070,668,468,979,63,62,4075,5600,3100,2450,8011,8599,1
793,0,2,148.0,133.0,188.0,204.0,3202,3504,2351,2407,851,1097,1223,1828,830,713,393,1115,63,62,4450,5350,3100,2750,8011,8849,1
800,0,2,154.0,145.0,188.0,204.0,3196,3364,2323,2267,873,1097,1002,1170,805,223,197,947,63,62,4550,6400,3200,2750,8111,8849,1
807,0,2,154.0,145.0,188.0,204.0,3146,3319,2295,2267,851,1052,1386,1579,1085,508,301,1071,63,62,4550,6400,3200,2750,8111,8849,1
814,0,2,162.0,145.0,188.0,204.0,3062,3420,2211,2323,851,1097,940,1546,785,443,155,1103,63,62,5025,6300,3425,2750,8111,8949,1
821,0,2,162.0,155.0,188.0,212.0,3028,3398,2155,2323,873,1075,1308,1061,1045,88,263,973,63,62,5625,6300,3425,2750,8111,8949,1
829,0,2,162.0,154.0,188.0,212.0,2877,3442,1959,2323,918,1119,1622,1313,1255,208,367,1105,63,62,5725,6375,3425,2750,8111,9049,1
836,0,2,164.0,154.0,188.0,212.0,2692,3274,1819,2155,873,1119,1317,1701,1100,468,217,1233,63,63,6100,7325,3625,2750,8111,9049,1
843,0,2,164.0,154.0,188.0,212.0,2558,3392,1707,2295,851,1097,1512,2113,1195,748,317,1365,63,63,6700,7325,3625,3050,8111,9049,1
850,0,2,170.0,168.0,188.0,212.0,2580,3342,1707,2267,873,1075,1235,1100,1110,653,125,447,63,63,6700,7525,3625,3050,8111,9049,1
857,0,2,172.0,160.0,188.0,212.0,2580,3314,1707,2239,873,1075,1134,1517,1105,938,29,579,62,63,6775,7925,3625,3150,8211,9449,1
864,0,2,172.0,160.0,188.0,212.0,2586,3358,1735,2239,851,1119,1453,1707,1320,1088,133,619,62,63,6775,8375,3625,3450,8211,9449,1
871,0,2,182.0,162.0,188.0,212.0,2574,3381,1679,2239,895,1142,1022,1514,860,763,162,751,62,63,6775,8375,3825,3450,8211,9449,1
879,0,2,178.0,160.0,188.0,212.0,2261,3218,1343,2099,918,1119,1290,1887,1020,1008,270,879,65,61,6425,8375,3825,3450,8561,9549,1
886,0,2,180.0,160.0,188.0,212.0,2278,3179,1427,2127,851,1052,1036,2257,745,1258,291,999,65,63,6825,8375,3825,3450,8611,9549,1
893,0,2,186.0,174.0,188.0,212.0,2642,3224,1791,2127,851,1097,1075,799,830,543,245,256,65,63,7800,10050,4050,3450,8611,9724,1
900,0,2,183.0,174.0,188.0,220.0,2658,3269,1875,2239,783,1030,1377,1193,1040,813,337,380,62,63,7800,10050,3950,3450,8836,9724,1
907,0,2,186.0,170.0,188.0,220.0,2765,3258,1959,2183,806,1075,821,1430,680,918,141,512,62,63,7800,9550,3850,3450,9029,10224,1
914,0,2,180.0,165.0,180.0,220.0,3000,3106,2015,2099,985,1007,801,1606,690,1028,111,578,62,58,7825,9300,3650,3450,9679,10724,1
921,0,2,173.0,168.0,180.0,220.0,2815,2474,1875,1623,940,851,1026,1257,815,583,211,674,60,58,7325,8375,3750,3450,10279,11824,1
929,0,2,172.0,172.0,196.0,220.0,2798,2418,1959,1567,839,851,1364,1347,1055,573,309,774,60,61,7275,8875,3750,3450,10329,11824,1
936,0,2,174.0,174.0,188.0,220.0,2826,2692,2043,1819,783,873,1300,1246,1095,468,205,778,60,61,7275,8625,3750,3450,10429,12074,1
943,0,2,170.0,170.0,196.0,220.0,2871,3062,2043,2211,828,851,1634,1621,1325,743,309,878,60,65,7075,8425,3750,3600,10629,12449,1
950,0,2,176.0,178.0,196.0,235.0,2972,3174,2099,2323,873,851,997,1205,930,823,67,382,60,66,7300,8600,3750,3600,11004,12449,1
957,0,2,176.0,171.0,196.0,235.0,2854,3213,1959,2407,895,806,811,1106,640,878,171,228,60,66,7300,7950,3750,3600,11004,13149,1
964,0,2,179.0,171.0,196.0,235.0,3174,3280,2323,2407,851,873,1222,1044,955,808,267,236,60,60,7950,9350,3675,3600,11079,13449,1
971,0,2,171.0,165.0,196.0,235.0,3638,3084,2743,2211,895,873,1620,1364,1245,1028,375,336,60,60,7625,9325,3450,3600,11879,13874,1
979,0,2,166.0,161.0,196.0,235.0,3622,3179,2771,2351,851,828,1710,1725,1335,1293,375,432,60,61,7425,8975,3550,3600,12279,14224,1
986,0,2,164.0,171.0,196.0,235.0,3006,3118,2267,2267,739,851,2023,1309,1560,973,463,336,58,62,7425,9675,3550,3600,12379,14224,1
993,0,2,156.0,157.0,196.0,235.0,2362,3235,1735,2407,627,828,2118,1690,1600,1258,518,432,60,64,6850,8275,3550,3600,13254,15624,1
1000,0,2,165.0,161.0,188.0,235.0,2462,3017,1791,2211,671,806,1293,1304,1070,1143,223,161,60,64,6850,8850,3650,3600,13479,15799,1
1007,0,2,166.0,170.0,188.0,235.0,2686,3106,2015,2099,671,1007,933,926,630,883,303,43,60,64,7150,9100,3650,3600,13479,15799,1
1014,0,2,170.0,177.0,188.0,235.0,2966,3207,2295,2043,671,1164,1100,817,725,763,375,54,60,69,7325,9350,3650,3600,13479,15799,1
1021,0,2,176.0,176.0,188.0,235.0,3112,3241,2463,2155,649,1086,431,1025,405,928,26,97,62,69,7550,9425,3750,3600,13479,15974,1
1029,0,2,176.0,178.0,188.0,235.0,2681,3028,1987,2099,694,929,744,819,630,618,114,201,62,74,7550,9425,3850,3600,13479,15974,1
1036,0,2,180.0,178.0,203.0,235.0,2608,3067,1735,2127,873,940,695,880,465,713,230,167,62,74,7875,9425,4050,3600,13479,15974,1
1043,0,2,186.0,182.0,203.0,235.0,2714,3179,1707,2239,1007,940,353,786,220,753,133,33,66,76,8600,9775,4050,3600,13479,15974,1
1050,0,2,188.0,184.0,203.0,235.0,2877,3347,1847,2407,1030,940,252,1002,145,903,107,99,66,76,8600,10025,4050,3600,13479,15974,1
1057,0,2,188.0,186.0,203.0,243.0,3034,3566,1959,2603,1075,963,620,1108,385,943,235,165,66,76,8600,10375,4050,3600,13479,15974,1
1064,0,2,188.0,192.0,203.0,243.0,3062,3784,1987,2799,1075,985,715,1045,460,918,255,127,66,76,8600,10900,4500,3600,13479,15974,1
1071,0,2,187.0,190.0,203.0,243.0,3185,3986,2155,3023,1030,963,496,1277,425,1163,71,114,66,76,8450,10875,4400,3600,14179,16249,1
1079,0,2,164.0,188.0,188.0,235.0,2546,3890,1651,2995,895,895,700,1476,544,1383,156,93,45,76,8650,10450,4225,3600,16567,17174,1
1086,0,2,160.0,188.0,188.0,227.0,1914,3644,1175,2771,739,873,469,1160,379,1088,90,72,40,76,8600,10450,4125,3600,17044,17524,1
1093,0,2,157.0,174.0,188.0,227.0,1779,3168,1063,2407,716,761,672,1522,494,1358,178,164,39,62,8500,10700,4125,3500,17194,18324,1
1100,0,2,152.0,170.0,180.0,204.0,1729,2843,1035,2127,694,716,576,1851,464,1603,112,248,34,60,8600,10450,4125,3500,17769,19174,1
1107,0,2,150.0,169.0,172.0,204.0,1527,2653,811,2071,716,582,746,2146,554,1838,192,308,32,60,8600,10350,3600,3500,18494,19274,1
1114,0,2,153.0,179.0,142.0,180.0,1387,2698,783,2071,604,627,904,1252,644,1218,260,34,32,56,9125,10350,3300,2900,19894,20374,1
1121,0,2,135.0,176.0,119.0,164.0,603,2434,335,1875,268,559,2115,1826,1289,1578,826,248,25,53,8825,11575,2325,2750,22169,20874,1
1129,0,2,133.0,174.0,111.0,172.0,0,2132,0,1483,0,649,2115,1617,1289,1393,826,224,23,51,8825,11575,2175,2100,22519,21624,1
1136,0,2,124.0,172.0,111.0,149.0,0,2188,0,1427,0,761,2115,1652,1289,1328,826,324,16,51,8725,11400,1650,2100,23719,22374,1
1143,0,2,122.0,172.0,96.0,149.0,0,2076,0,1427,0,649,2115,1897,1289,1493,826,404,14,51,8725,11400,1575,2100,24519,22374,1
1150,0,2,122.0,169.0,96.0,173.0,0,1919,0,1203,0,716,2069,2135,1243,1643,826,492,14,48,8725,11400,1575,2100,24519,22524,1
1157,0,2,122.0,167.0,96.0,165.0,0,1354,0,727,0,627,2000,2284,1207,1728,793,556,14,46,8725,11400,1575,2100,24519,22799,1
1164,0,2,120.0,167.0,96.0,142.0,0,1214,0,699,0,515,1994,2415,1204,1803,790,612,14,46,8625,11400,1325,2100,24869,23549,1
1171,0,2,118.0,167.0,72.0,134.0,0,1186,0,671,0,515,2494,1859,1454,1183,1040,676,14,46,8500,11400,900,2100,25794,23724,1
1179,0,2,115.0,166.0,64.0,134.0,0,1012,0,587,0,425,2475,1964,1435,1248,1040,716,13,45,8375,11400,900,1950,26073,23924,1
1186,0,2,113.0,162.0,56.0,141.0,0,362,0,139,0,223,2465,1992,1425,1248,1040,744,13,41,8250,11400,900,1950,26298,24299,1
1193,0,2,113.0,162.0,16.0,150.0,0,179,0,0,0,179,2465,1512,1425,898,1040,614,13,41,8250,11400,825,1950,27023,24774,1
1200,0,2,113.0,160.0,16.0,134.0,0,156,0,0,0,156,2433,1528,1402,898,1031,630,13,41,8250,11225,825,1950,27023,25149,1
1207,0,2,113.0,160.0,16.0,103.0,0,111,0,0,0,111,2427,1540,1399,898,1028,642,13,41,8250,11225,825,1950,27023,25749,1
1214,0,2,113.0,160.0,16.0,103.0,0,134,0,0,0,134,2427,1556,1399,898,1028,658,13,41,8250,11225,825,1700,27023,26149,1
1221,0,2,113.0,160.0,16.0,111.0,0,111,0,0,0,111,2027,1068,999,398,1028,670,13,41,8250,11225,725,1700,27123,26149,1
1229,0,2,97.0,158.0,16.0,119.0,0,134,0,0,0,134,2007,1084,989,398,1018,686,11,41,7100,11050,625,1700,28477,26324,1
1236,0,2,82.0,150.0,16.0,119.0,0,134,0,0,0,134,1979,1100,975,398,1004,702,9,41,6200,10350,550,1700,29586,27024,1
1243,0,2,55.0,150.0,16.0,134.0,0,134,0,0,0,134,1979,1116,975,398,1004,718,4,41,4650,10350,550,1700,31400,27024,1
1250,0,2,51.0,150.0,16.0,142.0,0,861,0,727,0,134,1979,1262,975,528,1004,734,2,41,4450,10350,550,1700,31762,27024,1
1257,0,2,36.0,138.0,16.0,142.0,0,1348,0,1259,0,89,1979,700,975,158,1004,542,2,41,2950,8525,550,1700,33272,28349,1
1264,0,2,17.0,138.0,16.0,142.0,0,1292,0,1203,0,89,1979,851,975,293,1004,558,2,41,1325,9225,550,2000,34995,28349,1
1271,0,2,14.0,138.0,16.0,142.0,0,1337,0,1203,0,134,1979,1012,975,438,1004,574,2,41,1150,9225,550,2000,35170,28349,1
7,2,1,13.0,13.0,15.0,14.0,335,293,335,293,0,0,40,35,40,35,0,0,12,12,0,0,0,0,0,0,0
14,2,1,14.0,13.0,15.0,14.0,671,643,671,643,0,0,70,15,70,15,0,0,13,13,0,0,0,0,0,0,0
21,2,1,14.0,14.0,15.0,14.0,643,727,643,727,0,0,40,50,40,50,0,0,13,13,0,0,0,0,0,0,0
29,2,1,15.0,14.0,15.0,14.0,671,755,671,755,0,0,80,145,80,145,0,0,14,13,0,0,0,0,0,0,0
36,2,1,15.0,16.0,15.0,22.0,699,783,699,783,0,0,125,145,125,145,0,0,14,14,0,0,0,0,0,0,0
43,2,1,16.0,16.0,23.0,22.0,755,755,755,755,0,0,65,225,65,225,0,0,15,14,0,0,0,0,0,0,0
50,2,1,17.0,15.0,23.0,22.0,783,811,783,811,0,0,45,30,45,30,0,0,16,15,0,0,0,0,0,0,0
57,2,1,18.0,17.0,23.0,22.0,783,839,783,839,0,0,90,30,90,30,0,0,17,15,0,0,0,0,0,0,0
64,2,1,19.0,18.0,23.0,22.0,895,839,895,839,0,0,155,80,155,80,0,0,18,16,0,0,0,0,0,0,0
71,2,1,19.0,17.0,23.0,22.0,973,867,951,867,22,0,269,170,265,170,4,0,18,17,0,0,0,0,0,0,0
79,2,1,20.0,17.0,23.0,22.0,928,923,839,923,89,0,326,30,310,30,16,0,19,16,0,0,0,0,0,0,0
86,2,1,20.0,18.0,23.0,22.0,1029,895,895,895,134,0,447,85,415,85,32,0,19,16,0,0,150,0,0,0,0
93,2,1,20.0,19.0,23.0,22.0,1001,923,867,923,134,0,168,150,120,150,48,0,20,17,0,0,150,0,0,0,0
100,2,1,21.0,19.0,23.0,22.0,1051,990,895,923,156,67,88,272,20,260,68,12,20,18,0,0,150,0,0,0,0
107,2,1,21.0,20.0,23.0,22.0,1130,978,951,867,179,111,143,324,55,300,88,24,20,19,0,0,150,0,0,0,0
114,2,1,22.0,19.0,23.0,22.0,1018,967,839,811,179,156,203,144,95,100,108,44,21,19,0,0,150,0,0,0,0
121,2,1,22.0,20.0,23.0,28.0,1051,962,895,783,156,179,179,214,55,150,124,64,21,19,0,0,150,250,0,0,0
129,2,1,23.0,23.0,23.0,28.0,1051,990,895,811,156,179,304,129,160,45,144,84,22,19,0,0,150,250,0,0,0
136,2,1,26.0,23.0,31.0,28.0,1135,1107,867,951,268,156,275,70,120,70,155,0,23,20,0,0,300,250,0,0,0
143,2,1,26.0,24.0,31.0,28.0,1152,911,839,867,313,44,111,10,70,10,41,0,23,20,0,50,300,250,0,0,0
150,2,1,27.0,26.0,31.0,28.0,1208,1091,895,1091,313,0,111,55,80,55,31,0,24,21,0,50,300,250,0,0,0
157,2,1,29.0,28.0,31.0,28.0,1258,1203,923,1203,335,0,136,105,90,105,46,0,24,21,125,50,300,250,0,0,0
164,2,1,31.0,31.0,46.0,36.0,1264,1203,951,1203,313,0,187,40,105,40,82,0,25,24,125,200,300,250,0,0,0
171,2,1,33.0,32.0,46.0,36.0,1342,1315,1007,1315,335,0,252,50,130,50,122,0,27,25,125,200,300,250,0,0,0
179,2,1,35.0,34.0,46.0,36.0,1482,1315,1147,1315,335,0,322,105,160,105,162,0,29,26,125,200,300,250,0,0,0
186,2,1,40.0,36.0,46.0,42.0,1600,1427,1287,1427,313,0,58,140,10,140,48,0,30,27,250,200,600,250,0,0,0
193,2,1,41.0,41.0,46.0,50.0,1628,1511,1315,1511,313,0,158,25,70,25,88,0,31,29,250,200,600,250,0,0,0
200,2,1,43.0,44.0,46.0,50.0,1706,1595,1371,1595,335,0,258,65,130,65,128,0,33,29,250,350,600,250,0,0,0
207,2,1,43.0,46.0,46.0,50.0,1762,1595,1427,1595,335,0,223,50,55,50,168,0,33,30,250,350,600,250,0,0,0
214,2,1,48.0,49.0,54.0,50.0,1740,1707,1427,1707,313,0,139,120,85,120,54,0,35,32,600,500,600,250,0,0,0
221,2,1,49.0,49.0,54.0,50.0,1846,1723,1511,1679,335,44,264,58,170,50,94,8,36,35,600,650,600,250,0,0,0
229,2,1,50.0,51.0,54.0,50.0,1824,1947,1511,1791,313,156,490,43,360,15,130,28,37,37,600,800,600,250,0,100,0
236,2,1,50.0,50.5,54.0,50.0,1936,2003,1623,1847,313,156,220,138,50,90,170,48,39,37,600,775,600,250,0,125,0
243,2,1,52.0,54.5,54.0,58.0,1992,2110,1679,1931,313,179,225,278,15,210,210,68,39,37,600,775,600,250,0,125,0
250,2,1,52.0,59.5,54.0,66.0,2098,2143,1763,1987,335,156,220,184,70,100,150,84,40,37,900,775,600,250,0,125,0
257,2,1,54.0,61.5,62.0,66.0,2126,2003,1791,1847,335,156,280,114,90,10,190,104,41,39,900,775,750,250,0,125,0
264,2,1,56.0,59.5,62.0,82.0,2182,2031,1847,1875,335,156,431,284,205,160,226,124,43,41,900,925,750,250,0,125,0
271,2,1,58.0,65.5,62.0,82.0,2250,1975,1735,1819,515,156,108,219,10,75,98,144,45,42,900,925,750,250,0,125,0
279,2,1,59.0,67.5,70.0,82.0,2250,2227,1623,2071,627,156,320,394,150,230,170,164,46,45,900,1225,750,375,0,125,0
286,2,1,64.0,67.5,70.0,82.0,2317,2362,1735,2183,582,179,153,434,115,350,38,84,47,50,900,1225,750,625,0,125,0
293,2,1,65.0,76.5,70.0,82.0,2418,2502,1791,2323,627,179,249,289,135,185,114,104,48,50,900,1225,750,625,0,125,0
300,2,1,66.0,76.5,70.0,82.0,2608,2591,1959,2435,649,156,464,165,270,45,194,120,49,55,1200,1225,1000,625,0,125,0
307,2,1,72.0,81.5,93.0,82.0,2602,2591,1931,2435,671,156,280,235,110,95,170,140,51,56,1200,1225,1000,625,0,125,0
314,2,1,73.0,81.5,101.0,90.0,2580,2703,1931,2547,649,156,527,365,285,205,242,160,51,59,1200,1225,1500,625,0,125,0
321,2,1,75.0,81.0,101.0,90.0,2608,2815,1959,2659,649,156,732,510,410,330,322,180,53,60,1200,1200,1500,625,0,150,0
329,2,1,76.0,86.5,101.0,98.0,2922,2927,2295,2771,627,156,938,555,540,355,398,200,56,64,1200,1175,1600,875,0,175,0
336,2,1,85.0,86.5,101.0,98.0,2950,2978,2323,2687,627,291,373,420,295,280,78,140,56,70,1575,1175,1600,875,0,175,0
343,2,1,90.0,85.5,101.0,98.0,2972,3134,2323,2687,649,447,283,495,225,445,58,50,57,69,1575,1175,1600,1125,0,175,0
350,2,1,91.0,85.5,109.0,98.0,3185,3510,2491,2771,694,739,323,626,185,480,138,146,58,69,1575,1175,1600,1125,0,175,0
357,2,1,93.0,85.5,109.0,98.0,3084,3280,2435,2295,649,985,220,677,110,565,110,112,60,69,1725,1175,1600,1125,0,175,0
364,2,1,95.0,84.0,109.0,98.0,3134,3112,2463,2127,671,985,275,1063,85,835,190,228,60,69,1725,1200,1600,1125,0,250,0
371,2,1,97.0,96.0,109.0,122.0,3084,3616,2323,2631,761,985,411,324,225,180,186,144,62,68,2250,1200,1600,1125,0,250,0
379,2,1,103.0,97.0,109.0,122.0,3246,3510,2463,2547,783,963,226,576,40,320,186,256,62,66,2250,1200,1600,1125,0,250,0
386,2,1,105.0,96.0,117.0,122.0,3246,3398,2463,2435,783,963,327,991,145,615,182,376,62,81,2400,1200,1600,1125,0,250,0
393,2,1,105.0,102.0,117.0,122.0,3442,3448,2547,2463,895,985,482,632,200,140,282,492,64,81,2400,1200,1600,1125,0,250,0
400,2,1,107.0,102.0,125.0,122.0,3476,3476,2603,2491,873,985,478,1042,300,430,178,612,64,81,2550,1200,2050,1250,0,250,0
407,2,1,109.0,107.5,125.0,138.0,3414,3706,2631,2743,783,963,632,914,370,190,262,724,64,86,2925,1175,2200,1250,0,275,0
414,2,1,119.0,103.5,133.0,144.0,3358,3929,2575,2922,783,1007,157,1349,45,505,112,844,64,82,2925,1175,2350,1250,0,275,0
421,2,1,119.0,103.5,133.0,144.0,3347,4165,2519,3023,828,1142,565,1841,345,853,220,988,64,82,4600,1175,2350,1250,0,275,0
429,2,1,119.0,103.5,133.0,144.0,3353,4652,2435,3398,918,1254,571,2380,310,1244,261,1136,64,82,4600,1525,2350,1250,0,275,0
436,2,1,124.0,103.5,133.0,144.0,3263,4809,2323,3510,940,1299,306,2938,25,1646,281,1292,64,82,5200,1525,2500,1750,0,275,0
443,2,1,125.0,121.0,141.0,144.0,3470,4798,2463,3499,1007,1299,702,859,305,415,397,444,64,82,5200,1500,2900,2200,0,300,0
450,2,1,129.0,131.0,141.0,144.0,3504,4731,2519,3432,985,1299,445,148,190,48,255,100,65,82,5650,1500,2900,2200,0,300,0
457,2,1,135.0,135.0,165.0,144.0,3487,4697,2547,3421,940,1276,357,221,140,165,217,56,65,82,5650,1500,3100,2200,0,300,0
464,2,1,135.0,143.0,165.0,160.0,3487,4647,2547,3348,940,1299,682,221,345,109,337,112,65,82,6175,1500,3100,2200,0,300,0
471,2,1,135.0,145.0,165.0,160.0,3510,4764,2547,3443,963,1321,1102,344,645,276,457,68,65,82,6175,3750,3100,2200,0,300,0
479,2,1,147.0,150.0,165.0,166.0,3510,4753,2547,3432,963,1321,477,555,200,331,277,224,65,87,6175,5000,3100,2200,0,300,0
486,2,1,143.0,160.0,173.0,166.0,3616,4787,2631,3488,985,1299,819,114,430,38,389,76,65,86,6875,5700,3100,2200,350,300,0
493,2,1,132.0,151.5,173.0,166.0,3554,4720,2547,3421,1007,1299,1215,1697,710,965,505,732,65,86,5725,5675,3100,2075,1500,750,0
500,2,1,138.0,152.0,173.0,166.0,3515,4350,2575,3208,940,1142,1109,2037,650,1177,459,860,65,86,6250,5550,3100,1825,1500,1125,0
507,2,1,146.0,149.5,181.0,152.0,3442,3992,2547,2917,895,1075,647,2306,330,1314,317,992,65,86,6950,5725,3100,1575,1675,2050,0
514,2,1,148.0,141.0,181.0,152.0,3582,3985,2687,2978,895,1007,763,2047,380,1310,383,737,65,84,6950,5300,3100,1575,1675,2625,0
521,2,1,148.0,137.5,181.0,152.0,3431,3986,2491,3023,940,963,1164,2529,665,1680,499,849,65,84,7125,5175,3100,1575,1675,2850,0
529,2,1,148.0,132.0,166.0,168.0,2972,3526,2211,2631,761,895,1084,1493,505,1240,579,253,65,71,7125,4700,3100,1575,2075,3975,0
536,2,1,150.0,124.5,166.0,168.0,2776,3006,2015,2200,761,806,726,1193,255,1152,471,41,65,64,6625,4325,3100,1575,2575,4700,0
542,2,1,150.0,121.0,166.0,168.0,2776,2788,2015,2049,761,739,726,1470,255,1353,471,117,65,63,6625,4150,3100,1575,2575,4925,0
7,2,1,13.0,13.0,15.0,14.0,293,293,293,293,0,0,35,35,35,35,0,0,12,12,0,0,0,0,0,0,1
14,2,1,14.0,13.0,15.0,14.0,615,671,615,671,0,0,60,20,60,20,0,0,13,13,0,0,0,0,0,0,1
21,2,1,14.0,14.0,15.0,14.0,699,727,699,727,0,0,45,55,45,55,0,0,13,13,0,0,0,0,0,0,1
29,2,1,15.0,14.0,15.0,14.0,643,755,643,755,0,0,70,145,70,145,0,0,14,13,0,0,0,0,0,0,1
36,2,1,15.0,16.0,15.0,22.0,755,727,755,727,0,0,175,140,175,140,0,0,14,14,0,0,0,0,0,0,1
43,2,1,16.0,16.0,23.0,22.0,699,811,699,811,0,0,50,235,50,235,0,0,15,14,0,0,0,0,0,0,1
50,2,1,17.0,15.0,23.0,22.0,727,811,727,811,0,0,15,35,15,35,0,0,16,15,0,0,0,0,0,0,1
57,2,1,18.0,17.0,23.0,22.0,755,867,755,867,0,0,65,35,65,35,0,0,17,15,0,0,0,0,0,0,1
64,2,1,18.0,18.0,23.0,22.0,839,895,839,895,0,0,115,90,115,90,0,0,17,16,0,0,0,0,0,0,1
71,2,1,19.0,17.0,23.0,22.0,951,811,951,811,0,0,230,160,230,160,0,0,18,17,0,0,0,0,0,0,1
79,2,1,20.0,17.0,23.0,22.0,995,895,951,895,44,0,303,25,295,25,8,0,19,16,0,0,0,0,0,0,1
86,2,1,20.0,18.0,23.0,22.0,990,867,923,867,67,0,416,85,400,85,16,0,19,16,0,0,0,0,0,0,1
93,2,1,20.0,19.0,23.0,22.0,1018,895,951,895,67,0,139,140,115,140,24,0,20,18,0,0,150,0,0,0,1
100,2,1,21.0,20.0,23.0,22.0,1062,934,951,867,111,67,70,217,30,205,40,12,20,18,0,0,150,0,0,0,1
107,2,1,21.0,20.0,23.0,22.0,1034,1029,923,895,111,134,107,338,55,310,52,28,20,19,0,0,150,0,0,0,1
114,2,1,22.0,20.0,23.0,22.0,1051,1107,895,951,156,156,87,378,15,330,72,48,21,20,0,0,150,0,0,0,1
121,2,1,22.0,24.0,23.0,28.0,1102,1051,923,895,179,156,217,194,125,130,92,64,21,20,0,0,150,250,0,0,1
129,2,1,23.0,26.0,23.0,36.0,1023,1135,867,979,156,156,278,229,170,145,108,84,22,20,0,0,150,250,0,0,1
136,2,1,25.0,28.0,31.0,36.0,1107,1029,839,895,268,134,293,250,170,150,123,100,22,20,0,0,300,250,0,0,1
143,2,1,26.0,29.0,31.0,36.0,1208,1051,895,1007,313,44,93,124,80,120,13,4,23,20,0,100,300,250,0,0,1
150,2,1,27.0,30.0,31.0,36.0,1208,1113,895,1091,313,22,193,209,140,205,53,4,24,22,0,100,300,250,0,0,1
157,2,1,29.0,29.0,31.0,36.0,1258,1147,923,1147,335,0,83,39,40,35,43,4,24,23,125,400,300,250,0,0,1
164,2,1,31.0,32.0,46.0,36.0,1286,1287,951,1287,335,0,44,14,15,10,29,4,25,23,125,400,300,250,0,0,1
171,2,1,32.0,32.0,46.0,36.0,1314,1259,979,1259,335,0,104,49,35,45,69,4,26,23,125,400,300,250,0,0,1
179,2,1,35.0,35.0,46.0,36.0,1404,1287,1091,1287,313,0,220,69,115,65,105,4,27,24,250,400,300,250,0,0,1
186,2,1,37.0,36.0,46.0,36.0,1404,1315,1091,1315,313,0,345,184,200,180,145,4,29,25,250,400,300,250,0,0,1
193,2,1,40.0,37.0,46.0,44.0,1544,1399,1231,1399,313,0,85,273,50,269,35,4,30,28,250,400,600,250,0,0,1
200,2,1,41.0,39.5,46.0,44.0,1538,1399,1203,1399,335,0,170,288,95,284,75,4,30,28,250,525,600,250,50,25,1
207,2,1,41.0,40.5,46.0,44.0,1566,1567,1231,1567,335,0,191,338,80,334,111,4,30,28,375,575,600,250,50,25,1
214,2,1,43.0,41.5,46.0,44.0,1734,1623,1399,1623,335,0,311,493,160,489,151,4,32,29,375,625,600,250,50,25,1
221,2,1,44.0,42.5,54.0,44.0,1740,1707,1427,1707,313,0,357,248,170,244,187,4,33,29,675,675,600,250,50,25,1
229,2,1,47.0,46.5,54.0,58.0,1930,1595,1595,1595,335,0,237,343,160,339,77,4,34,30,550,675,600,250,175,25,1
236,2,1,50.0,48.5,54.0,58.0,1902,1567,1567,1567,335,0,167,298,75,294,92,4,35,31,550,675,600,250,175,25,1
243,2,1,50.0,47.0,62.0,66.0,1908,1035,1595,1035,313,0,398,348,270,344,128,4,36,34,550,650,750,375,175,150,1
250,2,1,50.0,49.5,62.0,66.0,1936,867,1623,867,313,0,603,303,435,299,168,4,37,34,775,625,750,375,250,175,1
257,2,1,48.0,52.5,62.0,66.0,1986,1287,1651,1287,335,0,283,163,75,159,208,4,37,33,650,625,750,500,375,225,1
264,2,1,49.0,53.5,62.0,66.0,2014,1707,1679,1707,335,0,383,308,135,304,248,4,39,36,775,875,750,500,375,225,1
271,2,1,49.0,54.5,62.0,66.0,1936,1746,1623,1679,313,67,594,315,310,299,284,16,40,39,775,875,750,500,375,225,1
279,2,1,53.0,57.5,70.0,66.0,2182,1897,1847,1763,335,134,529,246,355,214,174,32,40,39,775,875,750,625,375,275,1
286,2,1,56.0,59.5,70.0,66.0,2238,2227,1903,2071,335,156,139,271,75,219,64,52,40,39,900,825,750,625,500,325,1
293,2,1,56.0,65.5,70.0,66.0,2138,2171,1735,2015,403,156,181,226,65,154,116,72,42,42,775,825,750,625,625,325,1
300,2,1,57.0,65.5,70.0,74.0,2149,2311,1679,2155,470,156,396,241,220,149,176,92,43,47,775,925,750,625,625,325,1
307,2,1,63.0,68.5,70.0,74.0,2149,2362,1567,2183,582,179,321,31,115,19,206,12,45,48,1025,925,750,625,625,325,1
314,2,1,63.0,68.5,70.0,90.0,2362,2474,1735,2295,627,179,461,236,175,204,286,32,46,46,1325,1075,750,825,625,325,1
321,2,1,63.0,72.5,70.0,90.0,2418,2311,1791,2155,627,156,713,247,355,199,358,48,47,51,1325,1025,850,825,625,375,1
329,2,1,65.0,75.5,93.0,90.0,2446,2507,1819,2351,627,156,510,422,80,354,430,68,47,52,1325,1025,850,950,625,375,1
336,2,1,66.0,78.5,93.0,90.0,2530,2731,1903,2575,627,156,757,277,255,189,502,88,47,57,1325,1025,1100,950,625,375,1
343,2,1,66.0,80.5,101.0,90.0,2513,2787,1931,2519,582,268,1036,347,470,319,566,28,50,57,1325,1025,1100,950,625,425,1
350,2,1,66.0,79.5,101.0,90.0,2653,2854,2071,2407,582,447,1367,628,725,544,642,84,50,59,1325,1025,1100,950,625,425,1
357,2,1,66.0,79.5,101.0,90.0,2737,2563,2155,2071,582,492,1689,418,975,274,714,144,50,57,1325,1025,1100,950,625,625,1
364,2,1,68.0,81.5,101.0,90.0,2759,2339,2155,1959,604,380,1530,493,840,309,690,184,50,56,1075,1125,1250,1200,875,725,1
371,2,1,68.0,85.5,101.0,90.0,2899,2709,2295,2351,604,358,1582,553,820,371,762,182,50,61,1075,1125,1400,1200,875,725,1
379,2,1,65.0,84.5,101.0,90.0,2754,3101,2127,2631,627,470,1885,803,1055,561,830,242,52,64,775,1125,1550,1200,1175,825,1
386,2,1,73.0,87.5,101.0,90.0,2804,2955,2155,2463,649,492,1306,1003,600,701,706,302,52,65,775,1125,1550,1200,1175,825,1
393,2,1,73.0,89.5,101.0,90.0,2793,3078,2211,2519,582,559,1650,1080,880,806,770,274,52,68,1850,1125,1550,1200,1175,825,1
400,2,1,78.0,89.5,109.0,90.0,2770,3286,2211,2435,559,851,1392,987,625,601,767,386,52,70,1850,1125,1550,1200,1175,825,1
407,2,1,88.0,89.5,109.0,90.0,2849,3510,2267,2547,582,963,653,1163,260,661,393,502,52,72,1850,1125,1550,1200,1175,825,1
414,2,1,89.0,89.0,109.0,90.0,2821,3616,2239,2631,582,985,941,1094,480,526,461,568,55,72,2625,1100,1950,1200,1175,850,1
421,2,1,90.0,98.5,117.0,130.0,2899,3734,2295,2771,604,963,1302,750,765,316,537,434,56,72,2875,1075,1950,1400,1175,875,1
429,2,1,103.0,110.5,117.0,170.0,3034,3790,2407,2827,627,963,389,616,130,216,259,400,56,72,3225,1175,1950,1400,1175,875,1
436,2,1,107.0,120.5,117.0,178.0,3084,3868,2435,2883,649,985,551,567,220,176,331,391,57,72,4000,1175,1950,1400,1175,875,1
443,2,1,105.0,130.5,117.0,184.0,2546,3538,1987,2575,559,963,716,123,325,91,391,32,54,72,4200,1775,1950,1400,1350,875,1
450,2,1,105.0,133.0,133.0,184.0,2149,3006,1679,2155,470,851,961,275,530,251,431,24,55,72,4200,2150,1950,1400,1350,900,1
457,2,1,115.0,132.0,133.0,184.0,2546,3162,2211,2379,335,783,415,347,190,231,225,116,55,72,4200,3050,2250,1400,1350,1250,1
464,2,1,107.0,127.0,133.0,160.0,2994,3090,2659,2351,335,739,745,306,480,106,265,200,55,71,4375,2450,2250,1400,2050,2400,1
471,2,1,104.0,124.5,133.0,152.0,2866,3123,2575,2407,291,716,896,490,595,306,301,184,55,71,3950,2225,2250,1400,2675,2800,1
479,2,1,100.0,131.0,133.0,152.0,2894,2994,2379,2323,515,671,1277,324,900,181,377,143,55,70,3675,2250,2250,1400,2950,2975,1
486,2,1,94.0,124.0,133.0,152.0,3039,2664,2435,2015,604,649,1114,629,665,406,449,223,55,70,2850,2500,2250,1400,4175,3325,1
493,2,1,82.0,114.5,133.0,152.0,2933,2692,2351,2043,582,649,776,940,505,641,271,299,55,66,2075,2625,2250,1400,5050,3800,1
500,2,1,66.0,121.0,133.0,152.0,2905,3218,2323,2547,582,671,1128,595,785,316,343,279,55,64,1075,2900,2250,1400,6050,4025,1
507,2,1,82.0,121.0,133.0,152.0,2894,3442,2267,2771,627,671,139,996,70,641,69,355,55,64,1075,2900,2250,1400,6050,4025,1
514,2,1,82.0,124.0,133.0,152.0,2787,3336,2183,2687,604,649,452,1232,315,801,137,431,56,75,2300,2900,2250,1400,6050,4025,1
521,2,1,86.0,125.0,133.0,152.0,2675,3336,2071,2687,604,649,409,862,300,351,109,511,57,73,2300,2900,2250,1400,6050,4025,1
529,2,1,84.0,133.0,133.0,152.0,2787,3588,2183,2827,604,761,736,813,555,381,181,432,57,75,2125,2900,2250,1400,6225,4025,1
536,2,1,92.0,142.0,133.0,152.0,2871,3868,2267,3107,604,761,513,830,460,406,53,424,57,75,2125,3000,2400,1400,6225,4025,1
543,2,1,93.0,149.0,133.0,152.0,2966,3896,2407,3135,559,761,571,967,450,451,121,516,57,75,2700,3350,2950,1400,6225,4025,1
550,2,1,93.0,152.0,133.0,152.0,2899,3913,2295,3107,604,806,922,1293,725,681,197,612,58,75,2700,3550,2950,1400,6125,4025,1
557,2,1,99.0,152.0,133.0,152.0,2899,3722,2295,2939,604,783,554,1416,535,716,19,700,58,75,2700,4350,2950,1400,6125,4025,1
564,2,1,100.0,152.0,133.0,152.0,2614,3868,1987,2995,627,873,375,1613,280,801,95,812,61,75,3075,4450,2950,1400,6125,4025,1
571,2,1,104.0,152.0,141.0,168.0,2849,3907,2043,2967,806,940,209,1865,160,941,49,924,61,75,3075,4500,2950,1400,6125,4025,1
579,2,1,106.0,158.0,141.0,192.0,3034,3773,2071,2855,963,918,415,1668,300,736,115,932,62,74,3800,4500,2950,1400,6125,4025,1
586,2,1,109.0,168.5,141.0,216.0,2933,3851,2015,2911,918,940,458,1089,385,791,73,298,62,74,3800,4475,2950,1400,6125,4050,1
593,2,1,109.0,168.5,149.0,230.0,3067,3644,2127,2771,940,873,825,1425,640,1031,185,394,62,72,3800,4825,2950,1400,6125,4150,1
600,2,1,110.0,173.0,149.0,236.0,3073,3504,2155,2743,918,761,902,988,605,706,297,282,62,69,3675,5850,2950,1400,6250,4225,1
607,2,1,116.0,178.0,149.0,236.0,3207,3678,2267,2827,940,851,440,1092,235,706,205,386,62,74,3550,5950,3200,1400,6375,4275,1
614,2,1,116.0,180.0,149.0,228.0,3078,3526,2183,2743,895,783,488,1250,325,826,163,424,65,77,4250,5750,3200,1650,6375,4475,1
621,2,1,123.0,186.0,149.0,228.0,3129,3633,2211,2827,918,806,260,1300,210,776,50,524,65,80,5075,5750,3200,1650,6375,4475,1
629,2,1,127.0,195.0,149.0,228.0,3207,3857,2267,3051,940,806,152,1307,90,691,62,616,65,82,5075,5850,3200,1650,6375,4475,1
636,2,1,127.0,198.0,141.0,228.0,3325,4058,2407,3275,918,783,545,1647,375,931,170,716,65,82,5425,6100,3500,1650,6475,4475,1
643,2,1,134.0,200.0,156.0,228.0,3179,4159,2239,3331,940,828,273,1606,245,986,28,620,65,82,5700,6250,3500,1650,6475,4475,1
650,2,1,144.0,196.5,156.0,228.0,3437,4165,2519,3135,918,1030,50,1993,10,1241,40,752,65,80,5875,6875,3500,1650,6475,4650,1
657,2,1,142.0,199.0,156.0,228.0,3465,4249,2547,2883,918,1366,353,1174,205,796,148,378,65,80,6375,6950,3350,1650,6800,4675,1
664,2,1,143.0,196.0,156.0,236.0,3633,4478,2715,3023,918,1455,570,1551,360,1001,210,550,65,80,6375,6650,3500,1650,6975,4975,1
671,2,1,127.0,183.0,156.0,244.0,3605,4568,2687,3135,918,1433,993,1458,675,736,318,722,65,80,5075,6000,3500,2100,8275,6750,1
679,2,1,119.0,184.5,156.0,244.0,3739,4641,2799,3163,940,1478,1440,1645,1010,751,430,894,66,80,4675,5875,3500,2100,8975,7175,1
686,2,1,117.0,183.0,156.0,244.0,3655,4646,2715,3191,940,1455,968,2092,880,1026,88,1066,66,80,4050,5700,3500,2100,9600,7350,1
693,2,1,121.0,199.0,156.0,244.0,3683,4495,2743,3107,940,1388,630,1021,580,591,50,430,66,80,3525,6700,3500,2100,10125,7350,1
700,2,1,112.0,198.0,156.0,244.0,3661,4562,2743,3107,918,1455,504,1566,350,956,154,610,70,82,3250,6650,3500,2100,10925,7400,1
707,2,1,120.0,198.0,156.0,244.0,3633,4506,2715,3051,918,1455,246,1803,180,1171,66,632,70,82,3250,6650,3500,2100,10925,7400,1
714,2,1,122.0,192.5,156.0,244.0,3745,4518,2827,3107,918,1411,524,1295,400,791,124,504,71,77,4725,6625,3500,2450,10925,7425,1
721,2,1,120.0,200.0,156.0,244.0,3778,4254,2883,2799,895,1455,966,801,730,296,236,505,71,77,4475,7900,3500,2450,11175,7850,1
729,2,1,128.0,200.0,156.0,244.0,3801,4305,2883,2827,918,1478,733,1323,585,646,148,677,71,77,5175,8500,3500,2450,11175,7850,1
736,2,1,132.0,200.0,156.0,244.0,3823,4271,2883,2883,940,1388,736,1442,630,801,106,641,71,77,5175,8850,3900,2700,11175,7925,1
743,2,1,132.0,198.0,156.0,244.0,3745,4193,2603,2715,1142,1478,524,1213,270,746,254,467,71,75,5175,9500,3900,2700,11175,7925,1
750,2,1,137.0,193.0,156.0,244.0,3801,3890,2547,2435,1254,1455,468,1674,270,1031,198,643,71,75,5675,9150,3900,3150,11225,8275,1
757,2,1,145.0,188.5,164.0,236.0,3700,4064,2491,2631,1209,1433,346,2187,250,1376,96,811,69,75,5975,8675,3600,3150,11325,8750,1
764,2,1,130.0,196.0,156.0,228.0,3386,4053,2267,2575,1119,1478,1248,1952,870,961,378,991,60,75,6325,7650,3300,3150,11550,9025,1
771,2,1,130.0,185.5,133.0,228.0,2110,4165,1259,2687,851,1478,226,2435,110,1276,116,1159,49,75,6025,6575,3300,3275,12900,9500,1
779,2,1,91.0,164.5,133.0,228.0,1527,4025,923,2547,604,1478,404,1866,220,531,184,1335,46,75,4025,4325,3300,3275,16275,11825,1
786,2,1,89.0,162.0,125.0,228.0,1611,3991,1007,2603,604,1388,416,2116,210,671,206,1445,46,75,3675,3900,3300,3675,16725,12250,1
793,2,1,91.0,170.0,125.0,228.0,1421,3924,839,2491,582,1433,408,2182,180,661,228,1521,46,75,4025,4950,3300,3675,16875,12250,1
800,2,1,94.0,173.5,125.0,228.0,1936,4025,1287,2547,649,1478,328,1810,120,490,208,1320,45,75,4025,5050,3300,3675,16925,12262,1
807,2,1,96.0,176.5,125.0,228.0,2502,4064,1651,2631,851,1433,266,1162,50,367,216,795,43,75,4375,5125,3300,3675,17025,12323,1
814,2,1,94.0,186.5,125.0,228.0,2339,4036,1399,2603,940,1433,552,1019,220,202,332,817,41,75,4725,6475,3300,3675,17125,12573,1
821,2,1,71.0,170.5,125.0,228.0,2210,4294,1315,2771,895,1523,802,1544,370,547,432,997,36,75,3175,6175,3300,3675,18925,13623,1
7,2,2,13.0,13.0,15.0,15.0,251,293,251,293,0,0,30,35,30,35,0,0,12,12,0,0,0,0,0,0,0
14,2,2,14.0,14.0,15.0,15.0,671,671,671,671,0,0,70,70,70,70,0,0,13,13,0,0,0,0,0,0,0
21,2,2,14.0,14.0,15.0,15.0,699,671,699,671,0,0,40,40,40,40,0,0,13,13,0,0,0,0,0,0,0
29,2,2,15.0,15.0,15.0,15.0,699,699,699,699,0,0,75,80,75,80,0,0,14,14,0,0,0,0,0,0,0
36,2,2,15.0,16.0,15.0,23.0,755,783,755,783,0,0,125,135,125,135,0,0,14,15,0,0,0,0,0,0,0
43,2,2,16.0,16.0,23.0,23.0,783,783,783,783,0,0,15,70,15,70,0,0,15,15,0,0,0,0,0,0,0
50,2,2,17.0,17.0,23.0,23.0,783,811,783,811,0,0,40,55,40,55,0,0,16,16,0,0,0,0,0,0,0
57,2,2,18.0,18.0,23.0,23.0,783,839,783,839,0,0,80,30,80,30,0,0,17,17,0,0,0,0,0,0,0
64,2,2,19.0,18.0,23.0,23.0,867,923,867,923,0,0,70,95,70,95,0,0,18,17,0,0,0,0,0,0,0
71,2,2,19.0,19.0,23.0,23.0,923,951,923,951,0,0,35,10,35,10,0,0,18,18,0,0,0,0,0,0,0
79,2,2,20.0,20.0,23.0,23.0,973,962,951,895,22,67,89,122,85,110,4,12,19,19,0,0,0,0,0,0,0
86,2,2,21.0,21.0,23.0,23.0,1006,1046,895,867,111,179,160,56,140,20,20,36,20,20,0,0,150,150,0,0,0
93,2,2,22.0,22.0,23.0,23.0,1051,1113,895,867,156,246,90,128,50,60,40,68,21,21,0,0,150,150,0,0,0
100,2,2,22.0,22.0,23.0,23.0,1107,1158,839,867,268,291,115,164,35,60,80,104,21,21,0,0,150,150,0,0,0
107,2,2,23.0,23.0,23.0,23.0,1152,1208,839,895,313,313,196,255,80,115,116,140,22,22,0,0,150,150,0,0,0
114,2,2,23.0,23.0,23.0,31.0,1225,1180,867,867,358,313,341,391,185,215,156,176,22,22,0,0,150,150,0,0,0
121,2,2,24.0,24.0,31.0,31.0,1286,1236,951,923,335,313,442,482,250,270,192,212,23,23,0,0,300,450,0,0,0
129,2,2,28.0,28.0,31.0,31.0,1236,1236,923,923,313,313,123,187,45,85,78,102,24,23,0,0,450,450,0,0,0
136,2,2,28.0,29.0,31.0,31.0,1236,1208,923,895,313,313,183,177,65,35,118,142,24,24,0,0,450,450,0,0,0
143,2,2,29.0,30.0,31.0,31.0,1236,1264,923,951,313,313,278,282,120,100,158,182,24,25,0,0,450,450,0,0,0
150,2,2,29.0,30.0,31.0,31.0,1208,1286,895,951,313,335,378,442,180,220,198,222,24,25,0,0,450,450,0,0,0
157,2,2,32.0,33.0,39.0,39.0,1230,1309,895,951,335,358,348,392,160,230,188,162,25,26,350,175,450,450,0,0,0
164,2,2,34.0,32.0,39.0,39.0,1253,1292,895,979,358,313,328,549,150,355,178,194,26,25,350,175,450,450,0,50,0
171,2,2,35.0,32.0,39.0,39.0,1180,1264,867,951,313,313,120,309,60,75,60,234,26,26,350,175,450,450,0,50,0
179,2,2,35.0,33.0,39.0,39.0,1236,1236,923,923,313,313,275,309,175,35,100,274,26,26,350,175,450,450,0,50,0
186,2,2,34.0,38.0,39.0,39.0,1292,1292,979,979,313,313,435,124,295,10,140,114,26,27,525,500,450,450,50,50,0
193,2,2,34.0,38.0,39.0,39.0,1264,1286,951,951,313,335,585,279,405,125,180,154,26,27,700,500,450,450,50,50,0
200,2,2,35.0,39.0,39.0,47.0,1320,1393,1007,1035,313,358,300,299,80,105,220,194,26,28,700,500,450,450,50,50,0
207,2,2,35.0,39.0,39.0,47.0,1393,1398,1035,1063,358,335,465,215,205,85,260,130,26,28,700,500,450,450,50,50,0
214,2,2,36.0,37.0,39.0,47.0,1398,1404,1063,1091,335,313,571,381,275,215,296,166,27,29,700,650,750,450,50,200,0
221,2,2,34.0,41.0,39.0,47.0,1404,1426,1091,1091,313,335,687,206,355,100,332,106,27,29,525,650,750,450,225,200,0
229,2,2,38.0,40.0,39.0,47.0,1376,1432,1063,1119,313,313,317,222,120,80,197,142,28,29,475,850,750,550,400,350,0
236,2,2,38.0,40.0,39.0,47.0,1326,1460,1035,1147,291,313,278,402,45,220,233,182,28,29,475,850,750,550,400,350,0
243,2,2,39.0,41.0,39.0,62.0,1376,1410,1063,1119,313,291,398,363,125,145,273,218,29,30,475,850,750,800,400,350,0
250,2,2,39.0,42.0,55.0,62.0,1292,1510,979,1175,313,335,248,148,35,40,213,108,29,30,775,850,750,800,400,350,0
257,2,2,43.0,43.0,55.0,62.0,1258,1365,923,1007,335,358,108,238,5,90,103,148,30,31,775,850,750,800,400,350,0
264,2,2,43.0,45.0,63.0,62.0,1230,1516,895,1203,335,313,148,70,5,40,143,30,30,33,775,850,750,900,400,350,0
271,2,2,45.0,46.0,78.0,62.0,1426,1796,1091,1483,335,313,234,140,55,70,179,70,31,35,775,850,750,900,400,350,0
279,2,2,46.0,44.0,78.0,62.0,1488,1555,1175,1287,313,268,310,242,95,140,215,102,32,32,775,850,750,900,400,550,0
286,2,2,44.0,45.0,78.0,62.0,1628,676,1315,587,313,89,320,70,165,10,155,60,33,31,950,1025,1000,1050,525,650,0
293,2,2,45.0,46.0,78.0,62.0,1740,710,1427,643,313,67,85,118,40,50,45,68,33,32,950,1025,1000,1050,525,650,0
300,2,2,46.0,48.0,78.0,62.0,1846,1096,1511,1007,335,89,241,200,160,120,81,80,34,34,950,1025,1100,1050,525,650,0
307,2,2,50.0,49.0,78.0,62.0,1953,1600,1595,1399,358,201,111,358,40,250,71,108,36,35,1125,1025,1100,1050,525,650,0
314,2,2,52.0,50.0,78.0,62.0,1880,1802,1567,1511,313,291,168,529,65,385,103,144,38,37,1125,1025,1100,1050,525,650,0
321,2,2,53.0,51.0,78.0,62.0,1964,1930,1651,1595,313,335,229,319,90,135,139,184,39,38,1125,1025,1100,1350,525,650,0
329,2,2,54.0,55.0,86.0,62.0,2020,1992,1707,1679,313,313,79,145,50,50,29,95,40,39,1125,1275,1100,1350,525,650,0
336,2,2,55.0,56.0,86.0,62.0,2098,1992,1763,1679,335,313,224,235,155,100,69,135,41,40,1125,1275,1350,1350,525,650,0
343,2,2,56.0,56.0,94.0,62.0,2093,2104,1735,1791,358,313,473,300,360,125,113,175,42,40,1125,1275,1350,1350,525,700,0
350,2,2,58.0,57.0,94.0,62.0,2261,2014,1791,1679,470,335,398,240,225,25,173,215,44,41,1125,1275,1350,1350,525,700,0
357,2,2,58.0,58.0,94.0,70.0,2261,2244,1791,1819,470,425,719,417,490,250,229,167,44,42,1125,1275,1350,1350,575,700,0
364,2,2,59.0,60.0,94.0,70.0,2266,2261,1819,1791,447,470,940,379,655,160,285,219,45,44,1125,1275,1650,1350,575,700,0
371,2,2,64.0,62.0,94.0,70.0,2317,2261,1847,1791,470,470,616,365,525,140,91,225,46,44,1125,1450,1650,1350,575,700,0
379,2,2,65.0,64.0,94.0,70.0,2418,2261,1903,1791,515,470,296,460,145,225,151,235,47,46,1625,1625,1650,1350,575,700,0
386,2,2,68.0,64.0,94.0,78.0,2345,2289,1875,1819,470,470,363,635,235,340,128,295,49,46,1625,1625,1650,1350,575,700,0
393,2,2,69.0,62.0,94.0,93.0,2345,1874,1875,1427,470,447,513,778,325,435,188,343,50,43,1625,1625,1650,1350,575,850,0
400,2,2,74.0,66.0,102.0,93.0,2451,1326,1959,923,492,403,258,416,110,175,148,241,51,43,1625,1450,1800,1600,575,1025,0
407,2,2,75.0,65.0,102.0,101.0,2457,1410,1987,1007,470,403,259,490,130,280,129,210,51,44,2075,1800,1950,2000,625,1200,0
414,2,2,76.0,65.0,102.0,101.0,2490,1303,2043,923,447,380,565,524,380,270,185,254,52,42,2075,1800,1950,2000,625,1300,0
421,2,2,81.0,65.0,102.0,101.0,2507,458,2015,279,492,179,511,226,370,60,141,166,53,42,2425,2000,1950,2000,625,1650,0
429,2,2,84.0,68.0,102.0,101.0,2485,799,2015,755,470,44,228,185,85,15,143,170,54,42,2700,2000,1950,2000,625,1650,0
436,2,2,86.0,64.0,102.0,101.0,2518,1006,2071,895,447,111,496,265,305,75,191,190,56,38,2700,2000,1950,2000,625,1850,0
443,2,2,85.0,65.0,102.0,101.0,2289,1191,1819,1035,470,156,556,425,305,215,251,210,57,41,2450,2000,1950,2000,875,1850,0
450,2,2,88.0,66.0,117.0,101.0,2177,1387,1707,1231,470,156,527,545,220,315,307,230,58,42,2450,2000,1950,2000,875,1850,0
457,2,2,88.0,69.0,117.0,101.0,2574,1706,2127,1371,447,335,678,208,415,180,263,28,59,40,2450,2250,2100,2000,875,1950,0
464,2,2,96.0,62.0,117.0,101.0,3151,1656,2659,1231,492,425,234,377,115,305,119,72,60,34,3150,2500,2100,2000,875,2300,0
471,2,2,93.0,63.0,125.0,101.0,3263,1146,2771,923,492,223,529,471,350,375,179,96,60,35,3100,2500,2100,2000,1175,2300,0
479,2,2,99.0,64.0,125.0,101.0,3269,1034,2799,811,470,223,360,519,275,395,85,124,60,35,3275,2500,2400,2000,1175,2300,0
486,2,2,99.0,70.0,133.0,101.0,3297,1202,2827,867,470,335,765,297,620,225,145,72,60,37,3275,2500,2700,2000,1175,2300,0
493,2,2,107.0,72.0,133.0,101.0,3319,1869,2827,1399,492,470,430,217,425,135,5,82,60,39,3800,2375,2700,2000,1175,2600,0
500,2,2,105.0,70.0,133.0,101.0,3179,1998,2687,1483,492,515,661,297,600,155,61,142,60,40,3725,2300,2800,2000,1425,2900,0
507,2,2,105.0,75.0,133.0,101.0,3134,2048,2687,1511,447,537,283,132,270,55,13,77,60,42,4100,2650,2800,2000,1425,2900,0
514,2,2,105.0,76.0,133.0,101.0,3011,2171,2519,1679,492,492,623,354,550,225,73,129,60,44,4100,2650,2800,2000,1425,2900,0
521,2,2,121.0,83.0,133.0,101.0,3039,2289,2547,1819,492,470,129,115,100,30,29,85,60,46,4600,2650,2800,2000,1425,2900,0
529,2,2,121.0,85.0,141.0,101.0,2938,2048,2491,1623,447,425,476,247,395,110,81,137,60,48,4950,2650,2950,2000,1425,2900,0
536,2,2,121.0,87.0,141.0,101.0,2815,1835,2323,1455,492,380,806,305,665,170,141,135,60,50,4950,2825,3250,2100,1425,2900,0
543,2,2,121.0,87.0,141.0,101.0,2793,1303,2323,923,470,380,1142,438,945,255,197,183,60,51,4950,2825,3400,1900,1425,3025,0
550,2,2,119.0,79.0,141.0,101.0,2765,1208,2295,783,470,425,1088,236,835,105,253,131,60,47,4575,2800,3400,1900,2200,3975,0
557,2,2,121.0,57.0,141.0,101.0,2821,1163,2351,783,470,380,474,376,365,205,109,171,60,37,3925,1750,3400,1900,2850,5525,0
564,2,2,119.0,55.0,141.0,101.0,2871,1292,2379,979,492,313,724,178,555,75,169,103,60,37,4350,1600,3400,1800,3125,6125,0
7,2,0,13.0,13.0,15.0,15.0,251,335,251,335,0,0,30,40,30,40,0,0,12,12,0,0,0,0,0,0,0
14,2,0,14.0,14.0,15.0,15.0,643,671,643,671,0,0,65,70,65,70,0,0,13,13,0,0,0,0,0,0,0
21,2,0,14.0,14.0,15.0,15.0,671,671,671,671,0,0,45,0,45,0,0,0,13,13,0,0,0,0,0,0,0
29,2,0,15.0,15.0,15.0,15.0,643,727,643,727,0,0,80,85,80,85,0,0,14,14,0,0,0,0,0,0,0
36,2,0,15.0,15.0,15.0,15.0,783,755,783,755,0,0,135,135,135,135,0,0,14,14,0,0,0,0,0,0,0
43,2,0,16.0,16.0,23.0,23.0,811,755,811,755,0,0,30,70,30,70,0,0,15,15,0,0,0,0,0,0,0
50,2,0,17.0,16.0,23.0,23.0,839,783,839,783,0,0,50,40,50,40,0,0,16,15,0,0,0,0,0,0,0
57,2,0,18.0,17.0,23.0,23.0,839,727,839,727,0,0,55,75,55,75,0,0,17,16,0,0,0,0,0,0,0
64,2,0,18.0,18.0,23.0,23.0,951,783,951,783,0,0,170,175,170,175,0,0,17,17,0,0,0,0,0,0,0
71,2,0,19.0,18.0,23.0,23.0,973,799,951,755,22,44,234,268,230,260,4,8,18,17,0,0,0,0,0,0,0
79,2,0,20.0,19.0,23.0,23.0,939,889,895,755,44,134,343,328,335,300,8,28,19,18,0,0,0,0,0,0,0
86,2,0,20.0,19.0,23.0,23.0,1012,967,923,811,89,156,65,448,45,400,20,48,19,18,0,0,150,150,0,0,0
93,2,0,20.0,20.0,23.0,23.0,973,911,839,755,134,156,36,303,0,285,36,18,20,19,0,0,150,150,0,0,0
100,2,0,21.0,20.0,23.0,23.0,1023,1074,867,895,156,179,111,428,55,390,56,38,20,19,0,0,150,150,0,0,0
107,2,0,21.0,20.0,23.0,23.0,1074,1046,895,867,179,179,111,143,35,85,76,58,20,19,0,0,150,150,0,0,0
114,2,0,22.0,20.0,23.0,23.0,1051,995,895,839,156,156,137,104,45,30,92,74,21,19,0,0,150,150,0,0,0
121,2,0,23.0,22.0,23.0,23.0,1079,967,923,811,156,156,217,164,105,70,112,94,22,19,0,100,150,150,0,0,0
129,2,0,23.0,22.0,23.0,23.0,1096,1107,895,951,201,156,130,244,40,130,90,114,22,19,0,100,300,150,0,0,0
136,2,0,26.0,23.0,31.0,31.0,1180,1079,867,923,313,156,170,139,90,105,80,34,23,20,0,100,300,150,0,0,0
143,2,0,26.0,25.0,31.0,31.0,1208,1079,895,923,313,156,75,69,55,15,20,54,23,21,0,150,300,150,0,0,0
150,2,0,27.0,25.0,31.0,31.0,1258,1130,923,951,335,179,180,84,120,10,60,74,24,21,0,150,300,150,0,0,0
157,2,0,30.0,26.0,46.0,31.0,1309,1079,951,923,358,156,105,220,30,130,75,90,24,22,175,200,300,150,0,0,0
164,2,0,32.0,26.0,46.0,31.0,1314,1135,979,979,335,156,161,215,50,155,111,60,26,22,175,200,300,150,0,0,0
171,2,0,33.0,27.0,46.0,31.0,1404,1247,1091,1091,313,156,87,335,40,255,47,80,27,23,175,200,300,250,0,0,0
179,2,0,35.0,28.0,46.0,46.0,1488,1426,1175,1203,313,223,122,102,35,90,87,12,29,24,175,200,300,500,0,0,0
186,2,0,36.0,30.0,46.0,46.0,1572,1264,1259,951,313,313,262,88,135,40,127,48,30,24,300,200,550,500,0,0,0
193,2,0,37.0,31.0,46.0,46.0,1656,1505,1343,1147,313,358,122,228,105,140,17,88,31,25,300,200,550,500,0,0,0
200,2,0,39.0,33.0,46.0,46.0,1762,1617,1427,1259,335,358,147,308,90,180,57,128,33,25,300,200,550,600,0,0,0
207,2,0,40.0,34.0,46.0,46.0,1740,1600,1427,1287,313,313,144,250,55,115,89,135,34,26,300,300,550,600,0,0,0
214,2,0,42.0,38.0,46.0,46.0,1880,1684,1567,1371,313,313,239,310,110,135,129,175,36,27,300,400,550,850,0,0,0
221,2,0,44.0,39.0,46.0,46.0,1992,1796,1679,1483,313,313,180,275,15,60,165,215,36,28,300,400,800,925,0,0,0
229,2,0,46.0,42.0,46.0,54.0,2104,1712,1791,1399,313,313,280,145,75,90,205,55,38,29,300,400,800,925,0,0,0
236,2,0,46.0,45.0,46.0,54.0,2076,1846,1763,1511,313,335,330,285,85,190,245,95,39,30,300,500,800,925,0,0,0
243,2,0,48.0,46.0,54.0,54.0,2126,1953,1791,1595,335,358,485,205,200,95,285,110,40,31,300,500,800,925,0,0,0
250,2,0,48.0,48.0,54.0,54.0,2238,2070,1903,1735,335,335,646,191,325,45,321,146,40,32,550,600,950,925,0,0,0
257,2,0,50.0,51.0,54.0,54.0,2143,1992,1763,1679,380,313,794,337,425,155,369,182,42,34,550,600,1100,1000,0,0,0
264,2,0,51.0,52.0,62.0,54.0,2334,2020,1707,1707,627,313,1024,477,575,255,449,222,44,35,550,600,1400,1000,0,0,0
271,2,0,57.0,54.0,62.0,62.0,2334,1908,1707,1595,627,313,550,322,400,60,150,262,44,36,1300,1000,1400,1150,0,0,0
279,2,0,57.0,56.0,70.0,62.0,2440,2026,1791,1623,649,403,441,363,365,145,76,218,45,37,1300,1000,1400,1150,0,0,0
286,2,0,58.0,57.0,70.0,62.0,2446,1891,1819,1399,627,492,623,645,550,325,73,320,45,38,1300,1000,1400,1150,0,0,0
293,2,0,60.0,57.0,78.0,62.0,2474,1331,1847,951,627,380,429,340,280,155,149,185,45,39,1300,1000,1400,1300,0,150,0
300,2,0,60.0,59.0,78.0,62.0,2446,1740,1819,1427,627,313,669,297,440,80,229,217,45,39,1300,950,1400,1425,0,200,0
307,2,0,63.0,60.0,78.0,62.0,2412,1880,1763,1567,649,313,804,327,570,70,234,257,47,39,1400,900,1400,1425,0,250,0
314,2,0,64.0,60.0,78.0,62.0,2384,1908,1735,1595,649,313,960,442,650,145,310,297,48,39,1400,950,1400,1525,0,200,0
321,2,0,74.0,60.0,78.0,54.0,2490,1964,1819,1651,671,313,306,272,295,135,11,137,49,41,900,1100,1700,1625,0,275,0
329,2,0,74.0,60.0,78.0,54.0,2552,1902,1903,1567,649,335,617,382,530,205,87,177,50,41,900,1325,1700,1625,0,275,0
336,2,0,73.0,64.0,86.0,78.0,2586,1673,1959,1315,627,358,878,332,715,140,163,192,51,41,1550,1325,1700,1625,250,275,0
343,2,0,74.0,65.0,86.0,78.0,2642,2294,2015,1959,627,335,1149,508,910,305,239,203,51,40,1550,1325,1700,1625,250,325,0
350,2,0,74.0,67.0,86.0,86.0,2614,2278,1987,1987,627,291,1064,660,895,425,169,235,53,40,1300,1425,1700,1625,500,325,0
357,2,0,74.0,69.0,86.0,86.0,2490,2222,1819,1931,671,291,814,736,765,465,49,271,53,40,1300,1550,1700,1625,500,325,0
364,2,0,83.0,79.0,101.0,86.0,2496,2216,1847,1903,649,313,246,281,125,220,121,61,55,42,1800,1675,1700,1625,500,325,0
371,2,0,84.0,81.0,101.0,86.0,2888,2278,2239,1875,649,403,307,154,210,95,97,59,56,42,1800,1775,1700,1625,500,325,0
379,2,0,91.0,83.0,101.0,94.0,3034,2205,2407,1735,627,470,373,313,300,209,73,104,58,44,1800,1775,1700,1625,500,325,0
386,2,0,92.0,87.0,101.0,94.0,3095,2255,2491,1763,604,492,270,314,125,213,145,101,60,44,2150,2025,1700,1625,500,325,0
393,2,0,91.0,89.0,101.0,94.0,3045,2653,2463,2183,582,470,396,547,175,391,221,156,60,46,2050,2525,1800,1525,600,350,0
400,2,0,95.0,90.0,101.0,110.0,3286,2759,2659,2267,627,492,238,317,45,151,193,166,61,46,2550,2525,1950,1525,600,350,0
407,2,0,102.0,95.0,109.0,110.0,3230,2759,2603,2267,627,492,218,328,45,156,173,172,61,46,2550,2775,1950,1725,600,350,0
414,2,0,104.0,101.0,109.0,110.0,3370,2983,2743,2491,627,492,373,393,120,211,253,182,63,48,2900,2875,2250,1725,600,350,0
421,2,0,108.0,103.0,109.0,110.0,3420,3185,2771,2715,649,470,688,649,355,411,333,238,63,48,2900,2875,2400,1725,650,350,0
429,2,0,107.0,107.0,117.0,110.0,3336,3263,2687,2771,649,492,765,784,360,536,405,248,64,50,3350,3225,2550,1725,700,350,0
436,2,0,97.0,96.0,117.0,110.0,3106,3230,2435,2715,671,515,1130,1134,645,826,485,308,63,50,2950,2850,2600,1725,1300,925,0
443,2,0,101.0,92.0,125.0,110.0,3146,2821,2519,2351,627,470,827,636,270,476,557,160,62,50,2850,2250,2600,1725,1950,1525,0
450,2,0,101.0,102.0,141.0,110.0,3258,2597,2631,2127,627,470,1137,396,500,276,637,120,62,50,2850,2500,2600,1725,1950,1525,0
457,2,0,114.0,104.0,141.0,110.0,3280,2591,2631,2099,649,492,973,146,260,116,713,30,65,52,2850,2600,2600,1725,1950,1525,0
464,2,0,121.0,106.0,141.0,110.0,3207,2625,2491,2155,716,470,970,362,265,276,705,86,67,52,3350,2600,2600,1725,1950,1525,0
471,2,0,120.0,110.0,141.0,110.0,3381,2507,2463,2015,918,492,1421,182,600,86,821,96,68,54,3700,3450,2600,1725,1950,1525,0
479,2,0,131.0,114.0,141.0,125.0,3532,2731,2547,2239,985,492,656,423,290,271,366,152,68,54,3700,3450,2600,1725,1950,1525,0
486,2,0,131.0,122.0,141.0,125.0,3476,2955,2491,2463,985,492,977,153,495,141,482,12,68,54,3800,3550,2600,1725,1950,1525,0
493,2,0,127.0,117.0,141.0,141.0,3650,3017,2687,2547,963,470,1019,394,425,326,594,68,68,56,4500,3450,2600,2025,2150,1875,0
500,2,0,129.0,116.0,149.0,149.0,3650,2989,2687,2407,963,582,1160,490,450,396,710,94,68,56,4400,3375,2600,2025,2350,2100,0
507,2,0,127.0,113.0,149.0,149.0,3700,2278,2715,1651,985,627,1615,353,785,266,830,87,68,57,4600,3275,2600,2025,2450,2350,0
514,2,0,111.0,83.0,149.0,149.0,3678,1130,2715,727,963,403,2057,483,1115,356,942,127,68,34,3500,2775,2600,2025,3550,4040,0
521,2,0,120.0,62.0,149.0,149.0,3790,1090,2827,755,963,335,1658,168,600,51,1058,117,68,24,3025,2250,2600,2025,4025,5615,0
7,1,2,13.0,13.0,14.0,15.0,335,335,335,335,0,0,40,40,40,40,0,0,12,12,0,0,0,0,0,0,0
14,1,2,13.0,14.0,14.0,15.0,699,671,699,671,0,0,25,70,25,70,0,0,13,13,0,0,0,0,0,0,0
21,1,2,14.0,14.0,14.0,15.0,699,643,699,643,0,0,50,40,50,40,0,0,13,13,0,0,0,0,0,0,0
29,1,2,14.0,15.0,14.0,15.0,811,643,811,643,0,0,155,80,155,80,0,0,13,14,0,0,0,0,0,0,0
36,1,2,16.0,15.0,22.0,15.0,839,755,839,755,0,0,155,130,155,130,0,0,14,14,0,0,0,0,0,0,0
43,1,2,16.0,16.0,22.0,23.0,839,783,839,783,0,0,235,15,235,15,0,0,14,15,0,0,0,0,0,0,0
50,1,2,15.0,17.0,22.0,23.0,783,839,783,839,0,0,30,50,30,50,0,0,15,16,0,0,0,0,0,0,0
57,1,2,17.0,18.0,22.0,23.0,867,783,867,783,0,0,35,90,35,90,0,0,15,17,0,0,0,0,0,0,0
64,1,2,18.0,18.0,22.0,23.0,923,895,923,895,0,0,90,150,90,150,0,0,16,17,0,0,0,0,0,0,0
71,1,2,17.0,19.0,22.0,23.0,895,923,895,923,0,0,170,115,170,115,0,0,17,18,0,0,0,0,0,0,0
79,1,2,17.0,20.0,22.0,23.0,867,923,867,923,0,0,25,65,25,65,0,0,16,19,0,0,0,0,0,0,0
86,1,2,17.0,19.0,22.0,23.0,643,967,643,923,0,44,90,138,90,130,0,8,16,19,0,0,0,0,0,0,0
93,1,2,20.0,20.0,22.0,23.0,447,990,447,923,0,67,59,281,59,265,0,16,18,19,0,0,0,150,0,0,0
100,1,2,20.0,20.0,22.0,31.0,391,1034,391,923,0,111,114,407,114,375,0,32,18,19,0,0,0,150,0,0,0
107,1,2,20.0,21.0,22.0,31.0,475,1062,475,951,0,111,179,192,179,148,0,44,20,20,0,0,0,150,0,0,0
114,1,2,21.0,21.0,22.0,23.0,671,1085,671,951,0,134,109,73,109,13,0,60,20,20,0,0,0,150,0,25,0
121,1,2,23.0,22.0,28.0,23.0,895,1057,895,923,0,134,74,169,74,93,0,76,20,21,0,0,250,150,0,25,0
129,1,2,23.0,23.0,28.0,23.0,1035,1135,1035,979,0,156,119,149,119,53,0,96,20,22,0,0,250,150,0,25,0
136,1,2,26.0,23.0,36.0,23.0,1119,1051,1119,895,0,156,54,225,54,113,0,112,20,22,0,0,250,150,0,25,0
143,1,2,29.0,24.0,36.0,31.0,1119,1158,1119,979,0,179,24,314,24,178,0,136,20,23,50,0,250,150,0,25,0
150,1,2,30.0,27.0,36.0,31.0,1231,1242,1231,951,0,291,134,239,134,138,0,101,21,24,50,0,250,300,0,25,0
157,1,2,32.0,27.0,36.0,31.0,1152,1236,1063,923,89,313,115,334,99,193,16,141,24,24,200,0,250,300,0,25,0
164,1,2,32.0,28.0,36.0,31.0,1326,1286,1147,951,179,335,280,189,244,158,36,31,25,25,200,0,250,300,0,25,0
171,1,2,30.0,29.0,36.0,31.0,1298,1281,1119,923,179,358,145,239,89,168,56,71,24,26,350,125,250,300,0,25,0
179,1,2,31.5,31.0,36.0,31.0,1331,1292,1175,979,156,313,151,111,79,58,72,53,24,26,325,125,250,300,25,25,0
186,1,2,34.5,33.0,44.0,46.0,1359,1264,1203,951,156,313,176,221,84,128,92,93,25,27,325,125,250,300,25,25,0
193,1,2,37.5,35.0,44.0,46.0,1365,1320,1231,1007,134,313,192,281,84,148,108,133,27,29,325,125,250,300,25,25,0
200,1,2,40.5,35.0,44.0,46.0,1477,1460,1343,1147,134,313,228,546,104,373,124,173,30,29,325,125,250,300,25,25,0
207,1,2,41.5,40.0,44.0,46.0,1510,1516,1399,1203,111,313,225,331,89,268,136,63,29,31,375,300,250,600,25,25,0
214,1,2,40.5,41.0,44.0,46.0,1617,1673,1483,1315,134,358,430,386,274,283,156,103,31,31,525,300,250,600,25,25,0
221,1,2,42.5,41.0,44.0,46.0,1662,1622,1483,1287,179,335,407,427,231,288,176,139,31,33,625,175,250,600,25,150,0
229,1,2,42.5,43.0,44.0,46.0,1723,1740,1567,1427,156,313,263,593,71,418,192,175,31,35,625,175,250,600,25,150,0
236,1,2,43.5,43.0,44.0,46.0,1695,1824,1539,1511,156,313,313,458,101,393,212,65,33,35,625,525,250,600,25,150,0
243,1,2,47.0,48.0,66.0,54.0,1835,1902,1679,1567,156,335,238,133,106,28,132,105,34,37,600,525,375,600,50,150,0
250,1,2,50.0,49.0,74.0,54.0,1891,2076,1735,1763,156,313,318,344,166,203,152,141,34,37,600,525,375,600,50,150,0
257,1,2,55.5,50.0,82.0,54.0,1942,1953,1763,1707,179,246,243,252,71,183,172,69,36,39,575,525,375,600,75,150,0
264,1,2,60.5,51.0,82.0,62.0,2054,1986,1875,1763,179,223,233,390,41,293,192,97,42,39,575,525,375,600,75,150,0
271,1,2,62.5,53.0,82.0,62.0,2115,2031,1959,1763,156,268,334,47,126,18,208,29,45,41,575,525,375,600,75,150,0
279,1,2,61.5,55.0,82.0,62.0,2255,2222,2099,1931,156,291,434,138,206,98,228,40,49,41,725,875,375,600,75,150,0
286,1,2,64.5,57.0,82.0,62.0,2423,2244,2267,1931,156,313,329,304,81,228,248,76,46,43,725,1000,375,600,75,150,0
293,1,2,65.5,58.0,82.0,62.0,2367,2272,2211,1959,156,313,329,415,161,303,168,112,46,44,725,1000,375,850,75,150,0
300,1,2,68.5,59.0,82.0,62.0,2563,2104,2407,1791,156,313,489,216,301,168,188,48,50,45,725,1000,375,850,75,150,0
307,1,2,68.5,60.0,82.0,62.0,2698,2110,2519,1931,179,179,519,263,311,203,208,60,54,46,875,1000,375,850,75,150,0
314,1,2,70.0,62.0,82.0,77.0,2832,1847,2407,1847,425,0,698,238,426,178,272,60,54,47,850,1000,375,1100,100,150,0
321,1,2,80.0,65.0,82.0,77.0,3056,2043,2407,2043,649,0,469,133,246,73,223,60,54,49,1000,1000,575,1400,100,150,0
329,1,2,80.0,65.0,106.0,77.0,3006,2395,2379,2351,627,44,815,291,516,223,299,68,54,49,1000,1100,575,1400,100,150,0
336,1,2,92.0,69.0,114.0,77.0,3106,2614,2435,2547,671,67,580,114,351,38,229,76,54,49,1000,1300,575,1400,100,150,0
343,1,2,99.5,69.0,114.0,85.0,3050,2754,2379,2687,671,67,545,332,336,248,209,84,54,49,1475,1550,575,1700,125,150,0
350,1,2,108.5,73.0,114.0,85.0,2950,2675,2323,2631,627,44,302,346,246,258,56,88,54,49,2225,1750,825,1700,125,150,0
357,1,2,110.5,77.0,114.0,85.0,3000,2731,2351,2687,649,44,212,474,76,378,136,96,54,49,2875,1950,825,1850,175,150,0
364,1,2,113.5,83.0,114.0,93.0,3140,2698,2491,2631,649,67,83,102,21,98,62,4,54,49,3075,2050,825,2000,175,150,0
371,1,2,113.5,89.0,114.0,93.0,3000,2586,2351,2519,649,67,443,110,301,98,142,12,54,49,3525,2050,825,2000,175,150,0
379,1,2,121.5,93.0,138.0,93.0,3118,2586,2491,2519,627,67,304,223,286,203,18,20,54,49,3575,2350,825,2150,175,150,0
386,1,2,127.0,93.0,146.0,101.0,3078,2558,2407,2491,671,67,279,76,256,48,23,28,54,49,3700,2125,825,2550,250,575,0
393,1,2,123.5,87.0,146.0,101.0,3078,2558,2407,2491,671,67,534,179,456,143,78,36,54,49,3675,2200,825,2550,500,1175,0
400,1,2,120.5,85.0,146.0,101.0,3000,2563,2351,2519,649,44,796,193,646,153,150,40,54,49,3675,1900,825,2650,750,1575,0
407,1,2,118.0,72.0,146.0,101.0,3000,2507,2351,2463,649,44,1001,196,771,148,230,48,54,48,3500,1150,825,2550,1125,2675,0
414,1,2,120.5,76.0,146.0,93.0,2972,2586,2323,2519,649,67,337,294,256,238,81,56,53,48,3575,1150,825,2550,1400,2475,0
421,1,2,122.5,82.0,146.0,93.0,2916,2558,2267,2491,649,67,542,317,456,253,86,64,53,48,3875,1650,825,2250,1400,2687,0
429,1,2,121.0,64.0,146.0,93.0,2938,2222,2267,2155,671,67,698,555,536,483,162,72,52,44,3850,1325,825,2250,1675,3762,0
7,2,2,13.0,13.0,15.0,15.0,251,293,251,293,0,0,30,35,30,35,0,0,12,12,0,0,0,0,0,0,1
14,2,2,14.0,14.0,15.0,15.0,643,671,643,671,0,0,65,70,65,70,0,0,13,13,0,0,0,0,0,0,1
21,2,2,14.0,14.0,15.0,15.0,671,699,671,699,0,0,45,50,45,50,0,0,13,13,0,0,0,0,0,0,1
29,2,2,15.0,15.0,15.0,15.0,699,727,699,727,0,0,85,95,85,95,0,0,14,14,0,0,0,0,0,0,1
36,2,2,15.0,15.0,23.0,15.0,783,811,783,811,0,0,140,140,140,140,0,0,14,14,0,0,0,0,0,0,1
43,2,2,16.0,16.0,23.0,23.0,811,783,811,783,0,0,30,30,30,30,0,0,15,15,0,0,0,0,0,0,1
50,2,2,17.0,17.0,23.0,23.0,867,811,867,811,0,0,10,60,10,60,0,0,16,16,0,0,0,0,0,0,1
57,2,2,18.0,18.0,23.0,23.0,839,867,839,867,0,0,35,35,35,35,0,0,17,17,0,0,0,0,0,0,1
64,2,2,19.0,19.0,23.0,23.0,895,923,895,923,0,0,95,100,95,100,0,0,18,18,0,0,0,0,0,0,1
71,2,2,19.0,19.0,23.0,23.0,951,979,951,979,0,0,55,5,55,5,0,0,18,18,0,0,0,0,0,0,1
79,2,2,20.0,20.0,23.0,23.0,945,945,923,923,22,22,69,74,65,70,4,4,19,19,0,0,0,0,0,0,1
86,2,2,21.0,21.0,23.0,23.0,1034,1006,923,895,111,111,45,45,25,25,20,20,20,20,0,0,150,150,0,0,1
93,2,2,22.0,22.0,23.0,23.0,973,1057,839,923,134,134,111,121,75,85,36,36,21,21,0,0,150,150,0,0,1
100,2,2,22.0,22.0,23.0,23.0,1012,1124,811,923,201,201,84,155,20,95,64,60,21,21,0,0,150,150,0,0,1
107,2,2,23.0,23.0,23.0,23.0,1174,1225,951,979,223,246,223,243,135,155,88,88,22,22,0,0,150,150,0,0,1
114,2,2,23.0,23.0,23.0,31.0,1163,1197,895,951,268,246,314,335,190,215,124,120,23,22,0,0,150,150,0,0,1
121,2,2,24.0,24.0,31.0,31.0,1208,1214,895,923,313,291,454,486,290,330,164,156,23,23,0,0,450,450,0,0,1
129,2,2,28.0,28.0,31.0,31.0,1225,1208,867,895,358,313,154,177,100,135,54,42,24,24,0,0,450,450,0,0,1
136,2,2,28.0,28.0,31.0,31.0,1258,1208,923,895,335,313,195,223,105,145,90,78,24,24,0,0,450,450,0,0,1
143,2,2,28.0,29.0,31.0,31.0,1236,1236,923,923,313,313,346,323,220,205,126,118,24,24,0,0,450,450,0,0,1
150,2,2,28.0,29.0,31.0,31.0,1264,1208,951,895,313,313,96,378,80,220,16,158,24,25,0,0,450,450,0,0,1
157,2,2,30.0,31.0,39.0,39.0,1242,1236,951,923,291,313,137,373,85,275,52,98,24,25,350,350,450,450,0,0,1
164,2,2,28.0,34.0,39.0,39.0,1292,1286,979,951,313,335,387,413,295,375,92,38,24,25,350,350,450,450,0,0,1
171,2,2,29.0,34.0,39.0,39.0,1314,1309,979,951,335,358,167,173,35,95,132,78,24,25,350,350,450,450,0,0,1
179,2,2,29.0,35.0,39.0,39.0,1309,1342,951,1007,358,335,212,174,40,60,172,114,24,26,350,350,450,450,0,0,1
186,2,2,30.0,37.0,39.0,39.0,1286,1292,951,979,335,313,308,80,100,30,208,50,25,27,350,650,450,450,0,0,1
193,2,2,33.0,38.0,39.0,39.0,1264,1404,951,1091,313,313,109,145,15,55,94,90,25,27,350,650,750,450,0,0,1
200,2,2,34.0,39.0,39.0,39.0,1320,1320,1007,1007,313,313,274,50,140,20,134,30,26,28,350,650,750,450,0,0,1
207,2,2,37.0,40.0,39.0,47.0,1292,1404,979,1091,313,313,219,161,145,95,74,66,27,29,350,800,850,550,0,0,1
214,2,2,35.0,41.0,39.0,47.0,1326,1404,1035,1091,291,313,85,226,25,120,60,106,27,30,350,800,850,550,0,0,1
221,2,2,39.0,41.0,39.0,47.0,1286,1432,951,1119,335,313,235,247,135,105,100,142,28,30,650,800,850,550,0,0,1
229,2,2,39.0,42.0,47.0,47.0,1202,1376,867,1063,335,313,125,358,85,180,40,178,28,31,650,800,850,550,0,0,1
236,2,2,40.0,42.0,47.0,47.0,1242,1404,951,1091,291,313,237,474,165,260,72,214,29,31,650,800,850,550,0,0,1
243,2,2,41.0,48.0,62.0,62.0,1292,1348,979,1035,313,313,142,194,30,40,112,154,29,32,650,1150,850,800,0,0,1
250,2,2,43.0,49.0,62.0,62.0,1382,1264,1091,951,291,313,218,244,70,50,148,194,31,33,950,1150,850,800,0,0,1
257,2,2,45.0,51.0,62.0,62.0,1488,1482,1175,1147,313,335,353,284,165,50,188,234,33,35,950,1150,850,950,0,0,1
264,2,2,45.0,53.0,62.0,62.0,1650,1813,1315,1455,335,358,503,509,275,235,228,274,33,37,950,1150,850,950,0,0,1
271,2,2,48.0,54.0,62.0,62.0,1813,1930,1455,1595,358,335,158,130,140,70,18,60,35,38,950,1150,1100,950,0,0,1
279,2,2,51.0,55.0,62.0,62.0,1874,1908,1539,1595,335,313,164,271,160,175,4,96,36,39,1100,1150,1250,950,0,0,1
286,2,2,51.0,57.0,62.0,62.0,1908,2132,1595,1819,313,313,375,446,335,310,40,136,37,41,1275,1150,1250,950,0,0,1
293,2,2,53.0,58.0,62.0,62.0,1964,2216,1651,1903,313,313,465,426,385,250,80,176,37,42,1275,1150,1250,950,0,0,1
300,2,2,57.0,59.0,70.0,62.0,1936,2272,1623,1959,313,313,270,451,200,335,70,116,39,43,1450,1150,1250,950,0,0,1
307,2,2,58.0,61.0,70.0,62.0,1936,2294,1623,1959,313,335,505,216,395,60,110,156,40,45,1450,1150,1250,950,0,0,1
314,2,2,60.0,61.0,70.0,70.0,2070,2266,1735,1931,335,335,250,432,100,240,150,192,42,45,1450,1150,1250,950,0,0,1
321,2,2,62.0,63.0,70.0,70.0,2177,2406,1819,2071,358,335,295,327,155,95,140,232,42,47,1450,1150,1250,950,0,0,1
329,2,2,66.0,64.0,70.0,78.0,2160,2384,1847,1959,313,425,212,503,90,215,122,288,44,48,1625,1150,1250,950,0,0,1
336,2,2,67.0,69.0,70.0,78.0,2188,2485,1875,2015,313,470,157,363,95,115,62,248,45,49,1625,1325,1250,950,0,0,1
343,2,2,68.0,72.0,78.0,86.0,2104,2485,1791,2015,313,470,367,513,265,280,102,233,46,51,1800,1500,1400,1200,0,0,1
350,2,2,72.0,72.0,78.0,86.0,2244,2502,1931,1987,313,515,297,763,255,470,42,293,47,51,1975,1500,1400,1200,0,0,1
357,2,2,76.0,74.0,78.0,86.0,2160,2283,1847,1791,313,492,142,779,110,430,32,349,48,53,2150,1500,1400,1200,0,0,1
364,2,2,78.0,79.0,78.0,86.0,2210,2283,1763,1791,447,492,263,605,175,300,88,305,50,54,2325,1950,1400,1200,0,0,1
371,2,2,78.0,84.0,78.0,86.0,2272,2541,1735,2071,537,470,543,501,395,240,148,261,50,55,2325,1950,1400,1500,0,0,1
379,2,2,78.0,90.0,94.0,101.0,2429,2513,1959,2043,470,470,831,446,635,225,196,221,52,57,2325,1950,1400,1500,0,0,1
386,2,2,87.0,95.0,109.0,101.0,2541,2681,2071,2211,470,470,411,341,305,160,106,181,52,57,2850,2300,1400,1600,0,0,1
393,2,2,87.0,95.0,109.0,101.0,2513,2675,2043,2183,470,492,561,316,395,225,166,91,52,58,2850,2650,1400,1750,0,25,1
400,2,2,84.0,86.0,109.0,101.0,2933,2250,2463,1735,470,515,841,526,615,375,226,151,55,59,2250,1800,1400,1750,600,875,1
407,2,2,87.0,89.0,109.0,101.0,3034,2446,2519,1931,515,515,546,427,410,320,136,107,56,61,1900,2375,1400,1650,950,1125,1
414,2,2,83.0,93.0,109.0,101.0,3168,2927,2631,2435,537,492,821,423,625,360,196,63,58,61,1925,2375,1400,1650,1450,1125,1
421,2,2,83.0,93.0,109.0,101.0,3039,3297,2547,2827,492,470,568,414,420,295,148,119,60,62,1750,2725,1400,1650,1625,1125,1
429,2,2,89.0,99.0,109.0,101.0,3129,3381,2659,2911,470,470,224,234,170,155,54,79,62,62,1575,2550,1400,1650,1800,1300,1
436,2,2,88.0,99.0,109.0,101.0,3017,3364,2547,2939,470,425,569,236,455,205,114,31,64,62,2100,2750,1400,1650,1800,1300,1
443,2,2,88.0,101.0,109.0,101.0,2989,3442,2519,2995,470,447,324,237,150,150,174,87,64,62,2100,2850,1400,1650,1800,1300,1
450,2,2,88.0,101.0,109.0,109.0,3157,3465,2687,2995,470,470,719,388,485,245,234,143,64,62,2100,2850,1400,1750,1800,1300,1
457,2,2,90.0,109.0,117.0,117.0,3314,3353,2687,2883,627,470,465,324,405,125,60,199,64,62,1925,3225,1400,1750,1975,1300,1
464,2,2,90.0,109.0,109.0,117.0,3386,3325,2603,2855,783,470,866,580,710,325,156,255,64,62,2275,3525,1400,1750,2000,1300,1
471,2,2,90.0,111.0,109.0,117.0,3190,3274,2407,2827,783,447,555,572,465,315,90,257,64,62,2275,3700,1400,2050,2000,1300,1
479,2,2,90.0,115.0,109.0,117.0,3358,3218,2575,2771,783,447,410,448,220,285,190,163,64,62,2275,3900,1250,2050,2150,1300,1
486,2,2,94.0,115.0,109.0,117.0,3286,3185,2547,2715,739,470,462,829,280,610,182,219,64,62,2625,4150,1250,2200,2150,1300,1
493,2,2,94.0,115.0,109.0,117.0,3381,3230,2575,2715,806,515,627,724,345,445,282,279,64,62,2625,4150,1700,2500,2150,1300,1
500,2,2,94.0,117.0,124.0,117.0,3297,2983,2491,2491,806,492,768,775,490,490,278,285,64,62,2625,4325,1850,2500,2150,1300,1
507,2,2,106.0,113.0,132.0,117.0,3504,2877,2631,2407,873,470,143,1146,65,805,78,341,64,62,3150,3975,1950,2650,2150,1650,1
514,2,2,106.0,125.0,132.0,133.0,3571,2877,2743,2407,828,470,450,651,280,400,170,251,64,62,3675,4325,2250,2650,2150,1650,1
521,2,2,106.0,131.0,132.0,133.0,3442,2899,2659,2407,783,492,762,716,500,405,262,311,64,62,3675,4800,2350,2800,2150,1650,1
529,2,2,112.0,133.0,132.0,133.0,3442,3179,2659,2687,783,492,572,1006,460,635,112,371,64,62,3675,5200,3250,2800,2150,1650,1
536,2,2,122.0,128.0,140.0,133.0,3487,3039,2659,2547,828,492,157,962,95,610,62,352,64,62,4100,4900,3250,2800,2325,1950,1
543,2,2,120.0,132.0,140.0,133.0,3605,2978,2799,2463,806,515,473,762,315,450,158,312,64,62,4650,4900,3500,2800,2500,1950,1
550,2,2,120.0,132.0,140.0,133.0,3655,3095,2827,2603,828,492,899,648,645,480,254,168,64,62,4750,5350,3600,3100,2500,1950,1
557,2,2,134.0,132.0,140.0,133.0,3734,3045,2883,2575,851,470,324,994,220,770,104,224,64,62,4750,5350,3600,3100,2500,1950,1
564,2,2,139.0,148.0,140.0,164.0,3493,3000,2687,2463,806,537,337,57,220,15,117,42,64,62,5950,5350,3600,3250,2500,1950,1
571,2,2,137.0,146.0,140.0,164.0,3381,3134,2575,2463,806,671,737,431,520,305,217,126,64,62,4850,6350,3700,3250,2600,2050,1
579,2,2,125.0,134.0,140.0,172.0,3414,3202,2631,2575,783,627,1048,823,735,625,313,198,64,62,5050,5750,3700,3350,3300,2650,1
586,2,2,137.0,150.0,148.0,180.0,3381,3308,2575,2659,806,649,558,408,295,130,263,278,64,62,5850,5750,3700,3500,3300,2650,1
593,2,2,136.0,150.0,148.0,180.0,3465,3392,2659,2743,806,649,828,519,465,165,363,354,64,62,5750,6550,3700,3500,3400,2650,1
600,2,2,142.0,150.0,148.0,180.0,3510,3308,2659,2659,851,649,849,919,390,485,459,434,64,62,5750,6550,3700,3500,3500,2650,1
607,2,2,145.0,162.0,148.0,180.0,3538,3476,2687,2827,851,649,575,115,220,55,355,60,64,62,6050,6050,3700,3500,3550,2650,1
614,2,2,145.0,162.0,148.0,180.0,3493,3330,2687,2659,806,671,887,530,440,390,447,140,64,62,6050,7200,3700,3500,3550,2650,1
621,2,2,157.0,158.0,164.0,180.0,3582,3476,2799,2827,783,649,828,941,285,725,543,216,68,62,6150,7375,3700,3800,3550,2925,1
629,2,2,155.0,142.0,149.0,180.0,2899,3336,2295,2687,604,649,927,1337,320,1045,607,292,68,62,6375,6500,3700,3800,4325,3800,1
636,2,2,140.0,134.0,149.0,180.0,3067,3498,2463,2827,604,671,1141,962,450,590,691,372,70,62,5225,5625,4000,3800,5300,5075,1
643,2,2,132.0,116.0,149.0,180.0,2955,3392,2351,2743,604,649,855,1173,100,725,755,448,70,62,4450,4400,4000,3800,6375,6900,1
650,2,2,116.0,100.0,149.0,180.0,3039,3426,2435,2799,604,627,1228,1569,405,1045,823,524,70,62,3500,3475,4000,3800,7825,7825,1
657,2,2,106.0,100.0,149.0,180.0,3157,3476,2575,2827,582,649,1091,604,200,400,891,204,70,62,2700,1950,4000,3800,8725,9350,1
664,2,2,107.0,98.0,149.0,180.0,2989,3526,2407,2855,582,671,1045,1009,315,725,730,284,70,62,2700,3175,4000,3800,8725,9525,1
671,2,2,107.0,102.0,149.0,180.0,2922,3314,2407,2687,515,627,1398,1191,600,835,798,356,70,62,2700,3175,4000,3800,8725,9525,1
679,2,2,120.0,102.0,149.0,180.0,3045,3028,2463,2379,582,649,895,1541,275,1105,620,436,70,62,3675,3375,4000,3800,8725,9525,1
686,2,2,128.0,120.0,149.0,180.0,2787,3330,2183,2659,604,671,531,506,35,240,496,266,70,62,3675,4475,4000,3800,8725,9525,1
693,2,2,128.0,120.0,149.0,180.0,2871,3364,2267,2715,604,649,571,702,165,460,406,242,70,62,4375,4475,4000,3800,8725,9525,1
700,2,2,131.0,124.0,149.0,180.0,3006,3482,2379,2855,627,627,832,928,350,610,482,318,70,62,4675,4475,4000,3800,8425,9525,1
707,2,2,131.0,136.0,149.0,180.0,2888,3526,2351,2855,537,671,665,443,135,295,530,148,70,62,4675,4675,4000,3800,8425,9525,1
714,2,2,131.0,136.0,141.0,188.0,2916,3616,2379,2967,537,649,1397,859,795,635,602,224,70,62,4675,5825,4000,3800,8150,9525,1
721,2,2,141.0,136.0,141.0,188.0,2972,3448,2435,2799,537,649,1106,355,440,255,666,100,70,62,4675,5325,4000,3800,8150,9525,1
729,2,2,137.0,140.0,141.0,188.0,2882,3476,2323,2827,559,649,1288,365,550,185,738,180,70,62,5125,5500,4000,3800,8500,9800,1
736,2,2,140.0,140.0,141.0,188.0,2922,3476,2407,2827,515,649,1353,776,705,520,648,256,70,62,5125,5900,4000,3800,8500,9800,1
743,2,2,140.0,140.0,141.0,188.0,2866,3426,2239,2799,627,627,1684,1192,960,860,724,332,70,62,5125,5900,4000,3800,8500,9800,1
750,2,2,140.0,160.0,141.0,188.0,2888,3504,2351,2855,537,649,1630,612,1000,200,630,412,70,62,5125,6500,4000,3950,8500,9800,1
757,2,2,140.0,160.0,141.0,188.0,2860,3470,2323,2799,537,671,1649,1022,1055,530,594,492,70,62,5425,6900,4300,4300,8500,9800,1
764,2,2,140.0,155.0,141.0,188.0,2810,3448,2295,2799,515,649,1902,1433,1240,865,662,568,70,62,5125,6525,4150,4300,8950,10175,1
771,2,2,126.0,129.0,157.0,188.0,2804,3392,2267,2743,537,649,1546,1249,820,605,726,644,70,62,3950,4425,4150,4300,10725,12675,1
779,2,2,102.0,113.0,157.0,188.0,2922,3498,2407,2827,515,671,1799,1679,1005,955,794,724,67,62,2650,3825,4150,4300,12225,13475,1
786,2,2,93.0,116.0,157.0,188.0,2457,3392,1875,2743,582,649,2058,1220,1200,620,858,600,64,62,2200,3425,4150,4300,12675,13875,1
793,2,2,94.0,110.0,149.0,203.0,2255,3426,1651,2799,604,627,1735,1636,805,960,930,676,59,62,1925,3750,4150,4300,13400,14250,1
800,2,2,86.0,106.0,149.0,203.0,2026,3442,1511,2771,515,671,1588,1001,710,545,878,456,57,65,2225,3850,4150,4300,14000,15200,1
807,2,2,83.0,102.0,149.0,203.0,1768,3448,1231,2799,537,649,1865,1077,965,645,900,432,57,65,2050,3050,4150,4300,14175,16000,1
814,2,2,93.0,100.0,149.0,203.0,1774,3566,1259,2939,515,627,770,1143,160,735,610,408,57,65,1525,3225,4150,4300,14700,16525,1
821,2,2,93.0,110.0,149.0,203.0,2048,3420,1511,2771,537,649,717,488,185,300,532,188,59,65,2750,3050,4000,4300,14850,16700,1
829,2,2,89.0,104.0,149.0,203.0,2059,3560,1567,2911,492,649,867,919,275,655,592,264,59,65,2225,3575,4000,4300,15375,17050,1
7,,,13.0,13.0,15.0,15.0,293,293,293,293,0,0,35,35,35,35,0,0,12,12,0,0,0,0,0,0,0
14,,,14.0,14.0,15.0,15.0,671,671,671,671,0,0,70,70,70,70,0,0,13,13,0,0,0,0,0,0,0
21,,,14.0,14.0,15.0,15.0,727,699,727,699,0,0,50,0,50,0,0,0,13,13,0,0,0,0,0,0,0
29,,,15.0,15.0,15.0,15.0,727,727,727,727,0,0,35,40,35,40,0,0,14,14,0,0,0,0,0,0,0
36,,,15.0,15.0,15.0,23.0,811,811,811,811,0,0,140,145,140,145,0,0,15,14,0,0,0,0,0,0,0
43,,,16.0,16.0,23.0,23.0,839,839,839,839,0,0,35,35,35,35,0,0,15,15,0,0,0,0,0,0,0
50,,,17.0,17.0,23.0,23.0,867,839,867,839,0,0,15,10,15,10,0,0,16,16,0,0,0,0,0,0,0
57,,,18.0,18.0,23.0,23.0,923,839,923,839,0,0,50,40,50,40,0,0,17,17,0,0,0,0,0,0,0
64,,,18.0,19.0,23.0,23.0,923,895,923,895,0,0,105,95,105,95,0,0,17,18,0,0,0,0,0,0,0
71,,,19.0,19.0,23.0,23.0,973,917,951,895,22,22,19,54,15,50,4,4,18,18,0,0,0,0,0,0,0
79,,,20.0,20.0,23.0,23.0,1012,922,923,811,89,111,96,115,80,95,16,20,19,19,0,0,0,0,0,0,0
86,,,21.0,20.0,23.0,23.0,1085,1040,951,839,134,201,77,98,45,50,32,48,20,19,0,0,150,150,0,0,0
93,,,21.0,21.0,23.0,23.0,1152,1023,951,755,201,268,165,160,105,80,60,80,20,20,0,0,150,150,0,0,0
100,,,22.0,22.0,23.0,23.0,1085,1141,839,783,246,358,138,150,50,30,88,120,21,21,0,0,150,150,0,0,0
107,,,23.0,23.0,23.0,23.0,1214,1096,923,783,291,313,244,222,120,70,124,152,22,22,0,0,150,150,0,0,0
114,,,23.0,23.0,31.0,23.0,1186,1180,895,867,291,313,386,317,230,125,156,192,22,23,0,0,300,150,0,0,0
121,,,28.0,26.0,31.0,31.0,1236,1180,923,867,313,313,211,282,165,100,46,182,23,23,0,0,450,450,0,0,0
129,,,28.0,28.0,31.0,31.0,1236,1236,923,923,313,313,171,152,135,30,36,122,23,23,0,0,450,450,0,0,0
136,,,29.0,28.0,31.0,31.0,1208,1208,895,895,313,313,261,197,185,35,76,162,24,24,0,0,450,450,0,0,0
143,,,30.0,28.0,31.0,31.0,1286,1253,951,895,335,358,271,342,155,140,116,202,25,24,0,0,450,450,0,0,0
150,,,32.0,28.0,39.0,31.0,1337,1337,979,979,358,358,96,502,90,260,6,242,25,24,150,0,450,450,0,0,0
157,,,35.0,30.0,39.0,39.0,1286,1236,951,923,335,313,92,154,50,80,42,74,26,24,325,350,450,450,0,0,0
164,,,35.0,31.0,39.0,39.0,1292,1236,979,923,313,313,323,134,245,70,78,64,26,23,325,350,450,450,0,50,0
171,,,36.0,31.0,39.0,39.0,1348,1264,1035,951,313,313,433,284,315,180,118,104,27,23,325,350,450,450,0,50,0
179,,,36.0,31.0,39.0,39.0,1348,1292,1035,979,313,313,198,434,40,290,158,144,27,23,475,350,450,450,0,50,0
186,,,37.0,31.0,39.0,39.0,1348,1258,1035,923,313,335,303,574,105,390,198,184,28,23,650,350,550,450,0,50,0
193,,,37.0,32.0,39.0,39.0,1376,1225,1063,867,313,358,319,269,85,45,234,224,28,23,650,700,550,450,0,50,0
200,,,38.0,32.0,39.0,39.0,1348,1236,1035,923,313,313,430,361,160,105,270,256,29,23,650,700,550,750,0,50,0
207,,,39.0,36.0,39.0,39.0,1348,1208,1035,895,313,313,591,211,285,65,306,146,30,24,650,700,550,750,0,50,0
214,,,40.0,37.0,47.0,39.0,1398,1208,1063,895,335,313,311,201,65,15,246,186,31,25,650,700,550,750,0,50,0
221,,,40.0,37.0,47.0,39.0,1432,1180,1119,867,313,313,382,301,100,75,282,226,31,25,650,700,550,750,0,50,0
229,,,41.0,38.0,47.0,39.0,1460,1264,1147,951,313,313,557,361,235,95,322,266,32,26,650,700,550,750,0,50,0
236,,,46.0,39.0,47.0,39.0,1510,1337,1175,979,335,358,387,426,125,120,262,306,33,27,650,700,550,750,0,50,0
243,,,47.0,39.0,47.0,39.0,1510,1309,1175,951,335,358,517,521,215,175,302,346,34,28,1000,1000,550,850,0,50,0
250,,,47.0,42.0,62.0,47.0,1292,1376,979,1063,313,313,243,438,5,160,238,278,34,28,1000,1000,950,850,0,50,0
257,,,49.0,42.0,62.0,47.0,1426,1264,1091,951,335,313,298,278,20,60,278,218,35,28,1000,1000,950,850,0,50,0
264,,,51.0,43.0,62.0,62.0,1762,1376,1427,1063,335,313,408,303,90,45,318,258,37,28,1000,1000,950,850,0,100,0
271,,,53.0,49.0,62.0,62.0,1936,1376,1623,1063,313,313,294,168,90,70,204,98,39,30,1000,1000,950,850,0,100,0
279,,,55.0,53.0,62.0,62.0,1936,1600,1623,1287,313,313,274,63,30,25,244,38,41,32,1000,1550,950,850,0,100,0
286,,,55.0,54.0,62.0,62.0,2126,1757,1791,1399,335,358,489,233,205,155,284,78,41,33,1000,1550,1100,850,0,100,0
293,,,57.0,56.0,62.0,62.0,2210,1818,1875,1483,335,335,689,224,365,110,324,114,43,35,1000,1550,1100,850,0,100,0
300,,,57.0,58.0,70.0,62.0,2188,1908,1875,1595,313,313,755,105,395,55,360,50,43,35,1000,1800,1100,850,0,100,0
307,,,59.0,60.0,70.0,62.0,2294,1964,1959,1651,335,313,500,245,100,155,400,90,45,37,1000,1800,1100,1100,0,100,0
314,,,60.0,60.0,70.0,62.0,2300,1992,1987,1679,313,313,591,335,155,205,436,130,46,37,1000,1800,1200,1100,0,100,0
321,,,61.0,62.0,70.0,70.0,2328,1981,2015,1623,313,358,821,328,345,250,476,78,47,39,1000,1800,1200,1100,0,100,0
329,,,62.0,64.0,70.0,70.0,2216,2194,1903,1679,313,515,1081,583,565,445,516,138,49,41,1000,2050,1350,1100,0,100,0
336,,,63.0,64.0,70.0,78.0,2334,2188,1931,1651,403,537,663,353,95,155,568,198,49,41,1000,2050,1350,1100,0,100,0
343,,,64.0,65.0,70.0,78.0,2496,2205,1959,1735,537,470,397,501,15,330,382,171,50,41,1000,2050,1350,1100,0,100,0
350,,,66.0,67.0,70.0,78.0,2474,2205,1959,1735,515,470,552,236,110,5,442,231,52,41,1000,2300,1350,1100,0,100,0
357,,,66.0,68.0,70.0,86.0,2552,2121,2015,1651,537,470,760,341,250,50,510,291,52,43,1000,2300,1350,1100,0,100,0
364,,,70.0,69.0,70.0,86.0,2580,2233,2043,1763,537,470,558,526,80,175,478,351,54,43,1350,2400,1350,1100,0,100,0
371,,,70.0,71.0,70.0,86.0,2630,2311,2071,1819,559,492,640,381,90,145,550,236,54,45,1350,2400,1350,1100,0,100,0
379,,,72.0,72.0,93.0,94.0,2614,2328,1987,1791,627,537,926,556,300,260,626,296,54,45,1350,2400,1350,1100,0,100,0
386,,,74.0,74.0,93.0,94.0,2367,2502,1763,1987,604,515,1094,647,400,295,694,352,56,47,1350,2400,1950,1250,0,100,0
393,,,81.0,75.0,93.0,94.0,2507,2429,1903,1959,604,470,657,684,45,380,612,304,56,48,1350,2500,2350,1250,0,100,0
400,,,84.0,77.0,93.0,94.0,2871,2451,2267,1959,604,492,964,983,280,615,684,368,59,50,1875,2500,2500,1400,0,100,0
407,,,87.0,80.0,93.0,109.0,3078,2513,2519,1931,559,582,697,789,95,345,602,444,62,52,1875,2500,2500,1550,0,100,0
414,,,91.0,81.0,93.0,109.0,3291,2541,2687,1959,604,582,733,896,130,480,603,416,65,53,1875,2500,2500,1800,0,100,0
421,,,91.0,83.0,93.0,109.0,3274,2754,2715,2127,559,627,781,682,210,190,571,492,65,55,1875,2500,2800,1800,0,100,0
429,,,92.0,85.0,93.0,109.0,3308,2994,2659,2323,649,671,1021,743,370,175,651,568,68,57,1875,2500,2800,1800,0,100,0
436,,,92.0,90.0,109.0,109.0,3414,3067,2743,2463,671,604,1431,727,700,195,731,532,69,60,1975,2500,2950,1800,0,100,0
443,,,92.0,91.0,109.0,109.0,3392,3241,2743,2659,649,582,1843,1019,1040,415,803,604,69,60,1975,2400,2950,1800,0,200,0
450,,,104.0,92.0,109.0,109.0,3342,3207,2603,2603,739,604,695,470,50,90,645,380,69,61,1975,2400,2950,2300,0,200,0
457,,,106.0,93.0,109.0,109.0,3403,3302,2575,2631,828,671,740,848,145,380,595,468,69,63,3025,2400,3100,2300,0,200,0
464,,,104.0,95.0,109.0,109.0,3510,3342,2659,2491,851,851,854,1266,155,690,699,576,67,64,3025,2525,3100,2300,25,450,0
471,,,104.0,107.0,109.0,117.0,3426,3622,2575,2659,851,963,1268,793,465,105,803,688,67,65,3025,3125,3100,2300,25,450,0
479,,,104.0,107.0,109.0,117.0,3487,3566,2547,2603,940,963,1485,731,570,35,915,696,67,65,3275,3125,3100,2300,25,450,0
486,,,114.0,107.0,125.0,117.0,3543,3666,2603,2771,940,895,1024,1171,255,375,769,796,67,65,4150,3125,3100,2950,25,450,0
493,,,114.0,111.0,141.0,117.0,3493,3672,2575,2799,918,873,1432,1110,555,210,877,900,67,65,4150,3500,3100,2950,25,450,0
500,,,114.0,123.0,149.0,125.0,3554,3498,2659,2603,895,895,1845,317,860,205,985,112,67,65,4150,3500,3100,2950,25,450,0
507,,,114.0,120.0,149.0,125.0,3437,3526,2519,2631,918,895,2260,754,1155,530,1105,224,67,65,4150,3200,3100,2950,25,750,0
514,,,126.0,124.0,149.0,125.0,3465,3476,2547,2603,918,873,1186,983,715,655,471,328,67,65,4650,4750,3100,2950,25,750,0
521,,,124.0,110.0,149.0,133.0,3549,3448,2519,2575,1030,873,1606,1393,1015,965,591,428,67,55,5475,4550,3100,3250,200,1450,0
529,,,118.0,99.0,164.0,133.0,3588,2574,2603,1903,985,671,2023,1571,1320,1075,703,496,67,54,4800,3900,3100,3250,875,2525,0
536,,,107.0,99.0,164.0,133.0,3392,2345,2407,1763,985,582,2270,1149,1455,585,815,564,67,54,3300,3250,3100,3250,2375,3975,0
543,,,100.0,88.0,164.0,133.0,3454,2350,2491,1791,963,559,2591,1338,1660,785,931,553,67,54,2625,2650,3100,3250,3050,4575,0
550,,,106.0,86.0,164.0,133.0,3347,2686,2407,2127,940,559,1487,1375,1190,750,297,625,70,54,3500,2150,3100,3250,3675,5275,0
557,,,102.0,88.0,164.0,133.0,3370,2961,2407,2379,963,582,1807,1227,1390,530,417,697,72,54,2975,1700,3100,3250,4200,5825,0
564,,,96.0,77.0,164.0,133.0,3538,2574,2575,2015,963,559,1843,1156,1310,495,533,661,72,53,2200,1600,3100,3250,4975,6925,0
571,,,91.0,63.0,164.0,148.0,3672,2485,2687,1903,985,582,1084,1258,635,525,449,733,74,53,1450,750,3100,3250,5725,7975,0
579,,,92.0,67.0,164.0,148.0,3650,2787,2687,2183,963,604,1367,866,810,365,557,501,76,53,1200,600,3100,3250,5975,8325,0
586,,,92.0,72.0,164.0,148.0,3806,2742,2911,2183,895,559,1831,930,1170,415,661,515,77,55,1200,400,3100,3250,5975,8325,0
593,,,100.0,79.0,164.0,148.0,3907,2714,2967,2155,940,559,1061,557,905,170,156,387,80,58,1700,1150,3100,3250,6225,8450,0
600,,,100.0,81.0,164.0,148.0,4075,2429,3135,1847,940,582,1542,339,1270,80,272,259,80,59,2200,1675,3100,3250,6225,8450,0
607,,,104.0,84.0,164.0,148.0,4075,2686,3135,2127,940,559,1352,518,1010,195,342,323,80,59,2125,1675,3100,3250,6475,8450,0
614,,,106.0,85.0,164.0,148.0,4277,2944,3247,2407,1030,537,1507,353,1245,120,262,233,82,60,2125,1675,3400,3250,6475,8450,0
621,,,106.0,87.0,164.0,148.0,4053,3017,3023,2435,1030,582,1813,631,1435,330,378,301,84,63,2125,1675,3850,3250,6475,8450,0
629,,,121.0,95.0,180.0,148.0,4036,3325,3051,2519,985,806,1482,689,1075,380,407,309,86,65,2825,2275,4150,3250,6475,8450,0
636,,,125.0,100.0,180.0,148.0,4014,3543,3051,2603,963,940,1253,480,730,455,523,25,86,66,2825,2275,4150,3250,6475,8450,0
643,,,134.0,110.0,180.0,148.0,4047,3543,3107,2603,940,940,1254,297,690,160,564,137,86,68,3525,2775,4150,3250,6475,8450,0
650,,,137.0,116.0,180.0,148.0,4120,3767,3023,2827,1097,940,1612,564,900,315,712,249,86,68,3525,3575,4150,3250,6475,8450,0
657,,,137.0,120.0,188.0,148.0,4187,3784,2911,2799,1276,985,2118,631,1250,370,868,261,86,68,3525,3575,4500,3250,6475,8450,0
664,,,149.0,120.0,188.0,148.0,4198,3907,2855,2967,1343,940,1415,849,1295,580,120,269,89,70,3625,3575,4500,3250,6475,8450,0
671,,,161.0,132.0,188.0,148.0,4221,3778,2967,2883,1254,895,715,547,455,170,260,377,89,70,4075,4175,4500,3350,6725,8450,0
679,,,165.0,134.0,188.0,148.0,4417,3857,3163,2939,1254,918,744,648,340,255,404,393,89,70,5425,4425,4500,3350,6725,8450,0
686,,,165.0,138.0,188.0,148.0,4148,3991,2939,3051,1209,940,992,734,440,525,552,209,89,70,5425,4425,4500,3350,6725,8450,0
693,,,175.0,146.0,204.0,148.0,4288,4047,3079,3107,1209,940,709,911,605,590,104,321,93,70,5425,5200,4500,3350,6725,8450,0
700,,,193.0,148.0,204.0,148.0,4316,4036,3107,2939,1209,1097,336,732,80,575,256,157,95,73,5425,5450,4500,3350,6725,8450,0
707,,,193.0,148.0,219.0,148.0,4462,3986,3163,2687,1299,1299,608,995,200,690,408,305,95,76,7225,5450,4500,3350,6725,8450,0
714,,,192.0,147.0,219.0,148.0,4428,4081,3107,2827,1321,1254,995,1474,435,1025,560,449,94,76,7225,5350,4500,3350,6775,8550,0
721,,,195.0,147.0,219.0,148.0,4417,4120,3163,2911,1254,1209,895,1472,195,875,700,597,91,77,7125,4775,4650,3350,7225,9125,0
729,,,179.0,137.0,219.0,164.0,4478,4193,3247,2939,1231,1254,1468,1478,620,725,848,753,91,77,6650,4350,4950,3250,8100,10525,0
736,,,182.0,92.0,219.0,156.0,4865,3952,3611,2855,1254,1097,295,1831,45,950,250,881,91,64,7450,2375,5100,3250,8800,13800,0
743,,,182.0,57.0,219.0,148.0,4865,2838,3611,1987,1254,851,295,2105,45,1140,250,965,91,47,7450,1200,5100,3250,8800,15925,0
7,0,1,13.0,13.0,15.0,14.0,293,293,293,293,0,0,35,35,35,35,0,0,12,12,0,0,0,0,0,0,0
14,0,1,14.0,13.0,15.0,14.0,671,671,671,671,0,0,70,20,70,20,0,0,13,13,0,0,0,0,0,0,0
21,0,1,14.0,14.0,15.0,14.0,727,755,727,755,0,0,45,55,45,55,0,0,13,13,0,0,0,0,0,0,0
29,0,1,15.0,14.0,15.0,14.0,727,755,727,755,0,0,80,145,80,145,0,0,14,13,0,0,0,0,0,0,0
36,0,1,15.0,16.0,15.0,22.0,811,783,811,783,0,0,135,140,135,140,0,0,14,14,0,0,0,0,0,0,0
43,0,1,16.0,16.0,23.0,22.0,783,839,783,839,0,0,65,240,65,240,0,0,15,15,0,0,0,0,0,0,0
50,0,1,16.0,15.0,23.0,22.0,839,867,839,867,0,0,40,35,40,35,0,0,15,15,0,0,0,0,0,0,0
57,0,1,17.0,17.0,23.0,22.0,755,839,755,839,0,0,75,35,75,35,0,0,16,15,0,0,0,0,0,0,0
64,0,1,18.0,18.0,23.0,22.0,811,867,811,867,0,0,125,95,125,95,0,0,17,16,0,0,0,0,0,0,0
71,0,1,18.0,17.0,23.0,22.0,839,923,839,923,0,0,220,180,220,180,0,0,17,17,0,0,0,0,0,0,0
79,0,1,19.0,17.0,23.0,22.0,894,923,783,923,111,0,330,40,310,40,20,0,18,16,0,0,0,0,0,0,0
86,0,1,19.0,18.0,23.0,22.0,934,923,755,923,179,0,445,100,405,100,40,0,18,16,0,0,0,0,0,0,0
93,0,1,20.0,19.0,23.0,22.0,1018,945,839,923,179,22,320,164,310,160,10,4,19,18,0,0,150,0,0,0,0
100,0,1,20.0,20.0,23.0,22.0,665,1034,531,923,134,111,377,235,355,215,22,20,19,18,0,0,150,0,0,0,0
107,0,1,20.0,20.0,23.0,22.0,805,1107,671,951,134,156,97,360,55,320,42,40,19,19,0,0,150,0,0,0,0
114,0,1,20.0,21.0,23.0,22.0,967,1135,811,979,156,156,117,445,55,385,62,60,19,20,0,0,150,0,0,0,0
121,0,1,21.0,25.0,23.0,28.0,939,1085,783,951,156,134,113,267,35,195,78,72,19,20,0,0,150,250,0,0,0
129,0,1,23.0,27.0,23.0,28.0,1051,1130,895,1063,156,67,208,305,110,225,98,80,20,21,100,0,150,250,0,0,0
136,0,1,23.0,27.0,23.0,28.0,1079,1107,923,1063,156,44,93,329,75,245,18,84,20,21,100,0,150,250,0,0,0
143,0,1,24.0,27.0,31.0,28.0,1051,1135,895,1091,156,44,98,127,60,35,38,92,21,20,150,100,150,250,0,0,0
150,0,1,24.0,29.0,31.0,36.0,1135,1186,979,1119,156,67,98,170,90,70,8,100,21,20,150,100,150,250,0,0,0
157,0,1,25.0,29.0,31.0,36.0,1158,1163,979,1119,179,44,183,299,155,195,28,104,22,22,150,400,150,250,0,0,0
164,0,1,26.0,32.0,31.0,36.0,1219,1214,1063,1147,156,67,339,252,295,140,44,112,23,23,150,400,150,250,0,0,0
171,0,1,26.0,34.0,31.0,36.0,1186,1219,1007,1175,179,44,428,206,360,90,68,116,23,23,150,400,150,250,0,0,0
179,0,1,27.0,36.0,46.0,36.0,1382,1331,1091,1287,291,44,463,69,355,45,108,24,24,24,150,400,400,250,0,0,0
186,0,1,27.0,38.0,46.0,44.0,1320,1382,1007,1315,313,67,289,92,270,60,19,32,24,26,150,400,500,250,0,0,0
193,0,1,32.0,42.0,46.0,44.0,1376,1415,1063,1371,313,44,209,66,150,30,59,36,25,28,150,400,500,250,0,0,0
200,0,1,32.0,42.0,46.0,44.0,1510,1578,1175,1511,335,67,259,164,160,120,99,44,25,29,150,550,500,250,0,0,0
207,0,1,34.0,44.0,46.0,44.0,1538,1611,1203,1567,335,44,344,253,205,205,139,48,26,32,150,550,575,250,0,0,0
214,0,1,39.0,49.0,46.0,50.0,1712,1695,1399,1651,313,44,150,161,75,105,75,56,27,34,350,550,575,250,0,0,0
221,0,1,40.0,51.0,46.0,58.0,1874,1774,1539,1707,335,67,305,224,190,160,115,64,28,34,350,700,825,250,0,0,0
229,0,1,45.0,53.0,54.0,58.0,1936,1919,1623,1875,313,44,111,358,35,290,76,68,30,37,350,700,825,250,0,0,0
236,0,1,47.0,58.0,54.0,58.0,2076,1942,1763,1875,313,67,151,231,35,155,116,76,30,37,550,700,825,250,0,0,0
243,0,1,51.0,58.0,54.0,58.0,2132,1970,1819,1903,313,67,246,464,90,380,156,84,32,41,600,700,825,250,0,0,0
250,0,1,53.0,60.0,54.0,66.0,1986,2205,1651,2071,335,134,386,484,190,380,196,104,33,44,600,850,825,250,0,0,0
257,0,1,54.0,65.0,62.0,66.0,2042,2339,1707,2183,335,156,206,389,70,265,136,124,34,43,925,1000,825,250,0,0,0
264,0,1,58.0,71.0,62.0,74.0,2042,2390,1707,2211,335,179,152,209,80,65,72,144,35,48,1075,1000,825,250,0,0,0
271,0,1,62.0,72.0,62.0,66.0,2182,2395,1847,2239,335,156,232,450,120,290,112,160,36,50,1075,1000,825,250,0,100,0
279,0,1,62.0,71.5,62.0,74.0,2104,2591,1791,2435,313,156,443,380,295,200,148,180,37,53,1075,975,825,375,0,125,0
286,0,1,64.0,70.5,70.0,74.0,2328,2675,2015,2519,313,156,573,510,385,310,188,200,37,50,1125,1175,825,375,0,125,0
293,0,1,70.0,79.5,70.0,90.0,2266,2698,1931,2519,335,179,558,260,330,40,228,220,39,50,1525,1175,825,375,0,125,0
300,0,1,70.0,79.5,70.0,98.0,2350,2731,2015,2575,335,156,338,301,70,65,268,236,39,52,1525,1325,1075,375,0,125,0
307,0,1,71.0,76.5,78.0,98.0,2300,2703,1987,2547,313,156,619,226,315,120,304,106,40,55,1525,1475,1075,625,0,125,0
314,0,1,71.0,81.5,78.0,106.0,2490,2754,2155,2575,335,179,224,95,80,65,144,30,41,55,1725,1475,1075,625,0,125,0
321,0,1,72.0,80.5,86.0,98.0,2574,2955,2239,2687,335,268,494,446,310,380,184,66,42,54,1725,1475,1075,625,0,225,0
329,0,1,72.0,85.0,86.0,98.0,2608,2994,2295,2659,313,335,785,361,565,255,220,106,43,59,1725,1350,1075,750,0,350,0
336,0,1,75.0,80.0,86.0,98.0,2552,3112,2239,2799,313,313,535,732,275,590,260,142,43,59,1725,1050,1075,750,0,650,0
343,0,1,74.0,84.5,86.0,98.0,2546,3140,2211,2827,335,313,785,617,485,435,300,182,45,59,1625,825,1075,750,100,1025,0
350,0,1,73.0,83.0,86.0,98.0,2630,3218,2295,2883,335,335,830,842,490,620,340,222,45,59,1525,600,1075,750,200,1250,0
357,0,1,75.0,80.0,86.0,98.0,2602,3330,2267,2995,335,335,626,942,300,680,326,262,46,59,1575,450,1300,750,200,1900,0
7,2,2,13.0,13.0,15.0,15.0,293,293,293,293,0,0,35,35,35,35,0,0,12,12,0,0,0,0,0,0,1
14,2,2,14.0,14.0,15.0,15.0,671,671,671,671,0,0,70,70,70,70,0,0,13,13,0,0,0,0,0,0,1
21,2,2,14.0,14.0,15.0,15.0,727,699,727,699,0,0,50,0,50,0,0,0,13,13,0,0,0,0,0,0,1
29,2,2,15.0,15.0,15.0,15.0,727,755,727,755,0,0,45,45,45,45,0,0,14,14,0,0,0,0,0,0,1
36,2,2,15.0,15.0,23.0,23.0,839,811,839,811,0,0,145,145,145,145,0,0,14,14,0,0,0,0,0,0,1
43,2,2,16.0,16.0,23.0,23.0,839,811,839,811,0,0,40,35,40,35,0,0,15,15,0,0,0,0,0,0,1
50,2,2,17.0,17.0,23.0,23.0,839,839,839,839,0,0,15,10,15,10,0,0,16,16,0,0,0,0,0,0,1
57,2,2,18.0,18.0,23.0,23.0,867,867,867,867,0,0,45,45,45,45,0,0,17,17,0,0,0,0,0,0,1
64,2,2,19.0,19.0,23.0,23.0,867,923,867,923,0,0,95,100,95,100,0,0,18,18,0,0,0,0,0,0,1
71,2,2,19.0,19.0,23.0,23.0,979,979,979,979,0,0,15,10,15,10,0,0,18,18,0,0,0,0,0,0,1
79,2,2,20.0,20.0,23.0,23.0,911,1023,867,979,44,44,73,83,65,75,8,8,19,19,0,0,0,0,0,0,1
86,2,2,21.0,21.0,23.0,23.0,1057,1062,923,951,134,111,209,55,185,35,24,20,20,20,0,0,0,150,0,0,1
93,2,2,22.0,22.0,23.0,23.0,1018,1029,839,895,179,134,119,121,75,85,44,36,21,21,0,0,150,150,0,0,1
100,2,2,22.0,22.0,23.0,23.0,1068,1062,867,839,201,223,97,104,25,40,72,64,21,21,0,0,150,150,0,0,1
107,2,2,23.0,23.0,23.0,23.0,1085,1102,839,811,246,291,184,235,80,135,104,100,22,22,0,0,150,150,0,0,1
114,2,2,24.0,24.0,31.0,31.0,1186,1118,895,783,291,335,271,320,135,180,136,140,23,23,0,0,150,300,0,0,1
121,2,2,24.0,28.0,31.0,31.0,1079,1230,811,895,268,335,393,111,225,35,168,76,23,23,0,0,300,450,0,0,1
129,2,2,29.0,29.0,31.0,31.0,1180,1174,867,839,313,335,198,131,90,115,108,16,24,24,0,0,450,450,0,0,1
136,2,2,29.0,29.0,31.0,31.0,1180,1180,867,867,313,313,189,172,45,120,144,52,24,24,0,0,450,450,0,0,1
143,2,2,30.0,29.0,31.0,31.0,1208,1180,895,867,313,313,339,317,155,225,184,92,25,25,0,0,450,450,0,0,1
150,2,2,30.0,29.0,31.0,31.0,1208,1236,895,923,313,313,240,467,120,335,120,132,25,25,0,0,450,450,0,0,1
157,2,2,34.0,33.0,39.0,39.0,1264,1202,951,867,313,335,145,177,35,155,110,22,26,25,250,325,450,450,0,0,1
164,2,2,34.0,33.0,39.0,39.0,1342,1286,1007,951,335,335,305,337,155,275,150,62,26,25,250,325,450,450,0,0,1
171,2,2,34.0,33.0,39.0,39.0,1337,1258,979,923,358,335,455,153,265,55,190,98,26,25,250,325,450,450,0,0,1
179,2,2,34.0,34.0,39.0,39.0,1314,1230,979,895,335,335,371,158,195,20,176,138,26,25,250,475,450,450,0,0,1
186,2,2,38.0,37.0,39.0,39.0,1320,1208,1007,895,313,313,422,104,210,30,212,74,26,26,500,650,450,450,0,0,1
193,2,2,38.0,37.0,39.0,39.0,1320,1236,1007,923,313,313,287,159,185,45,102,114,26,26,500,650,700,450,0,0,1
200,2,2,38.0,38.0,39.0,39.0,1320,1258,1007,923,313,335,442,214,300,60,142,154,26,27,500,650,700,450,0,0,1
207,2,2,38.0,39.0,47.0,39.0,1320,1236,1007,923,313,313,203,120,25,30,178,90,26,28,500,800,700,450,0,0,1
214,2,2,38.0,40.0,47.0,47.0,1286,1342,951,1007,335,335,353,240,135,110,218,130,26,29,625,800,700,550,0,0,1
221,2,2,40.0,40.0,47.0,47.0,1370,1365,1035,1007,335,358,398,395,165,225,233,170,26,29,750,800,700,550,0,0,1
229,2,2,43.0,41.0,47.0,47.0,1292,1426,979,1091,313,335,374,521,130,315,244,206,26,30,750,800,700,550,0,0,1
236,2,2,43.0,45.0,47.0,47.0,1314,1404,979,1091,335,313,429,332,145,190,284,142,26,30,1000,1150,700,550,0,0,1
243,2,2,43.0,46.0,47.0,62.0,1258,1432,923,1119,335,313,524,457,200,275,324,182,26,31,1000,1150,700,550,50,0,1
250,2,2,44.0,47.0,55.0,62.0,1320,1404,1007,1091,313,313,631,427,275,205,356,222,27,31,1000,1150,700,550,50,0,1
257,2,2,44.0,52.0,55.0,62.0,1264,1460,951,1147,313,313,741,102,345,15,396,87,27,31,1000,1150,700,800,50,0,1
264,2,2,49.0,54.0,55.0,62.0,1320,1454,1007,1119,313,335,401,177,215,50,186,127,28,33,1000,1500,1000,800,50,0,1
271,2,2,48.0,54.0,55.0,62.0,1270,1533,979,1175,291,358,252,252,130,85,122,167,29,33,875,1600,1000,800,175,0,1
279,2,2,48.0,57.0,55.0,62.0,1326,1566,1035,1231,291,335,368,306,210,178,158,128,29,35,1375,1600,1000,800,175,0,1
286,2,2,50.0,59.0,70.0,62.0,1432,1572,1119,1259,313,313,339,237,145,73,194,164,30,37,1375,1600,1000,800,175,0,1
293,2,2,51.0,61.0,70.0,62.0,1589,1578,1231,1287,358,291,369,248,135,98,234,150,31,37,875,1775,1000,800,175,0,1
300,2,2,50.0,61.0,70.0,62.0,1628,1516,1315,1203,313,313,311,388,145,198,166,190,32,39,1200,1875,1000,800,300,0,1
307,2,2,52.0,61.0,70.0,62.0,1768,1460,1455,1147,313,313,426,667,220,441,206,226,34,39,1200,1875,1000,800,300,0,1
314,2,2,58.0,62.0,70.0,62.0,1852,1398,1539,1063,313,335,231,637,135,371,96,266,36,39,1525,1875,1150,950,300,0,1
321,2,2,62.0,63.0,70.0,70.0,1880,1684,1567,1371,313,313,66,363,30,261,36,102,37,39,1525,1875,1400,950,300,0,1
329,2,2,64.0,64.0,70.0,70.0,1992,2054,1679,1763,313,291,151,474,75,336,76,138,38,40,1525,1875,1400,950,300,0,1
336,2,2,65.0,65.0,70.0,78.0,1981,2126,1623,1791,358,335,61,729,45,551,16,178,39,41,1525,1875,1400,950,300,0,1
343,2,2,65.0,67.0,70.0,78.0,2042,2266,1707,1931,335,335,202,400,150,186,52,214,40,43,1525,1875,1500,950,300,0,1
350,2,2,66.0,67.0,70.0,78.0,2076,2177,1763,1819,313,358,408,344,320,86,88,258,41,43,1525,1875,1500,950,300,0,1
357,2,2,68.0,67.0,78.0,86.0,2020,2210,1595,1763,425,447,448,210,375,46,73,164,42,45,1525,1875,1500,1200,300,0,1
364,2,2,69.0,69.0,78.0,86.0,2188,2311,1651,1819,537,492,276,240,135,16,141,224,43,45,1900,1875,1500,1200,300,0,1
371,2,2,69.0,69.0,78.0,94.0,2238,2261,1679,1791,559,470,234,516,25,236,209,280,44,45,1900,1875,1500,1200,300,0,1
379,2,2,70.0,69.0,78.0,94.0,2311,2373,1707,1903,604,470,325,546,40,206,285,340,44,47,1900,1875,1500,1200,300,0,1
386,2,2,70.0,75.0,78.0,94.0,2311,2339,1707,1847,604,492,607,351,250,51,357,300,44,47,2000,1875,1500,1200,300,0,1
393,2,2,72.0,77.0,78.0,94.0,2390,2362,1763,1847,627,515,553,461,120,151,433,310,45,47,2000,1875,1500,1350,300,0,1
400,2,2,72.0,80.0,78.0,86.0,2390,2283,1763,1791,627,492,834,408,325,96,509,312,45,49,2000,2225,1500,1500,300,25,1
407,2,2,76.0,80.0,78.0,86.0,2546,2261,1875,1791,671,470,539,579,200,211,339,368,45,49,2000,2225,1500,1500,300,25,1
414,2,2,76.0,85.0,86.0,101.0,2468,2378,1819,1931,649,447,845,455,430,81,415,374,45,50,2250,2400,2100,1750,300,25,1
421,2,2,76.0,89.0,86.0,117.0,2580,2541,1931,2071,649,470,1136,430,645,96,491,334,45,50,2700,2950,2250,1900,300,25,1
429,2,2,84.0,93.0,94.0,117.0,2468,2653,1819,2183,649,470,232,365,165,71,67,294,45,53,2700,3125,2400,1900,300,25,1
436,2,2,88.0,95.0,94.0,117.0,2524,2782,1875,2267,649,515,237,420,90,116,147,304,45,53,3350,3125,2400,1900,300,25,1
443,2,2,92.0,101.0,94.0,117.0,2474,2810,1847,2295,627,515,324,230,105,16,219,214,45,53,3800,3475,2400,2000,300,25,1
450,2,2,92.0,101.0,110.0,117.0,2524,2815,1875,2323,649,492,620,262,325,146,295,116,45,53,3900,3825,2400,2000,300,25,1
457,2,2,94.0,105.0,118.0,117.0,2546,2843,1875,2351,671,492,680,202,430,126,250,76,45,53,4000,3825,2400,2000,300,25,1
464,2,2,106.0,105.0,118.0,117.0,2502,2877,1875,2407,627,470,72,443,0,311,72,132,45,53,4450,4025,2400,2100,300,25,1
471,2,2,106.0,110.0,118.0,117.0,2468,2877,1819,2407,649,470,367,343,215,251,152,92,45,52,5100,4750,2400,2100,300,75,1
479,2,2,100.0,112.0,118.0,117.0,2440,2843,1791,2351,649,492,648,308,420,256,228,52,45,52,4800,4675,2400,2100,600,250,1
486,2,2,110.0,112.0,118.0,117.0,2384,2838,1735,2323,649,515,438,478,130,416,308,62,45,52,5100,4850,2400,2100,600,425,1
493,2,2,102.0,114.0,118.0,117.0,2362,2810,1735,2295,627,515,729,339,345,221,384,118,45,52,4750,5025,2400,2200,1150,425,1
500,2,2,98.0,112.0,118.0,117.0,2350,2731,1679,2239,671,492,599,460,135,286,464,174,45,50,4550,4875,2400,2200,1750,875,1
507,2,2,90.0,109.0,118.0,117.0,2406,2233,1735,1763,671,470,895,246,355,116,540,130,45,49,3650,4675,2400,2200,2650,1475,1
514,2,2,78.0,103.0,118.0,133.0,2362,2401,1735,1931,627,470,777,156,165,66,612,90,45,49,2525,3900,2400,2200,4175,2250,1
521,2,2,72.0,99.0,118.0,133.0,2356,2569,1707,2099,649,470,752,181,60,81,692,100,45,51,1675,3650,2400,2200,5025,2850,1
7,,,13.0,13.0,15.0,15.0,251,251,251,251,0,0,30,30,30,30,0,0,12,12,0,0,0,0,0,0,1
14,,,14.0,14.0,15.0,15.0,671,671,671,671,0,0,70,70,70,70,0,0,13,13,0,0,0,0,0,0,1
21,,,14.0,14.0,15.0,15.0,699,671,699,671,0,0,40,35,40,35,0,0,13,13,0,0,0,0,0,0,1
29,,,15.0,15.0,15.0,15.0,671,643,671,643,0,0,75,70,75,70,0,0,14,14,0,0,0,0,0,0,1
36,,,15.0,15.0,15.0,15.0,699,727,699,727,0,0,115,40,115,40,0,0,14,15,0,0,0,0,0,0,1
43,,,16.0,16.0,23.0,23.0,783,811,783,811,0,0,55,135,55,135,0,0,15,15,0,0,0,0,0,0,1
50,,,16.0,17.0,23.0,23.0,811,839,811,839,0,0,15,40,15,40,0,0,15,16,0,0,0,0,0,0,1
57,,,17.0,18.0,23.0,23.0,755,833,755,811,0,22,15,84,15,80,0,4,16,17,0,0,0,0,0,0,1
64,,,18.0,19.0,23.0,23.0,755,978,755,867,0,111,100,160,100,140,0,20,17,18,0,0,0,0,0,0,1
71,,,18.0,19.0,23.0,23.0,777,1001,755,867,22,134,194,276,190,240,4,36,17,18,0,0,0,0,0,0,1
79,,,19.0,19.0,23.0,23.0,861,995,727,839,134,156,304,391,280,335,24,56,18,19,0,0,0,0,0,0,1
86,,,19.0,19.0,23.0,23.0,962,1051,783,895,179,156,419,116,375,40,44,76,18,19,0,0,0,0,0,0,1
93,,,19.0,19.0,23.0,23.0,962,1018,783,839,179,179,279,236,265,140,14,96,19,19,0,0,150,0,0,0,1
100,,,19.0,19.0,23.0,23.0,939,973,783,839,156,134,390,193,360,85,30,108,19,19,0,0,150,150,0,0,1
107,,,19.0,21.0,23.0,23.0,939,950,783,839,156,111,95,209,45,85,50,124,19,19,0,0,150,150,0,0,1
114,,,19.0,22.0,23.0,23.0,939,1023,783,867,156,156,220,194,150,50,70,144,19,19,0,0,150,150,0,0,1
121,,,20.0,22.0,23.0,23.0,939,995,783,839,156,156,185,179,95,15,90,164,19,19,0,0,150,150,0,0,1
129,,,23.0,23.0,23.0,31.0,1079,995,923,839,156,156,170,299,60,115,110,184,20,20,0,100,250,150,0,0,1
136,,,23.0,25.0,23.0,31.0,1074,995,895,839,179,156,60,299,30,120,30,179,20,20,0,100,250,300,0,0,1
143,,,24.0,26.0,31.0,31.0,1074,1124,895,923,179,201,75,83,25,30,50,53,21,21,100,100,250,300,0,0,1
150,,,26.0,26.0,31.0,31.0,1107,1135,951,867,156,268,111,60,45,25,66,35,21,21,100,100,250,300,0,0,1
157,,,27.0,28.0,31.0,46.0,1107,1074,951,783,156,291,201,146,115,75,86,71,22,22,100,225,250,300,0,0,1
164,,,28.0,28.0,31.0,46.0,1191,1130,1035,839,156,291,211,237,105,130,106,107,22,22,150,225,250,300,0,0,1
171,,,30.0,30.0,31.0,46.0,1421,1191,1175,923,246,268,397,333,255,190,142,143,23,24,200,225,250,300,0,0,1
179,,,30.0,31.0,46.0,46.0,1460,1320,1147,1007,313,313,303,348,125,165,178,183,23,25,200,225,500,300,0,0,1
186,,,30.0,34.0,46.0,46.0,1342,1320,1007,1007,335,313,273,118,80,45,193,73,24,26,200,100,500,600,100,125,1
193,,,30.0,33.0,46.0,46.0,1236,1426,923,1091,313,335,369,153,140,40,229,113,24,27,150,0,500,600,150,225,1
200,,,30.0,34.0,46.0,54.0,1348,1404,1035,1091,313,313,284,219,115,70,169,149,24,28,150,0,575,600,150,225,1
207,,,34.0,35.0,46.0,54.0,1432,1538,1119,1203,313,335,124,64,40,25,84,39,25,29,250,0,675,600,150,225,1
214,,,37.0,41.0,46.0,54.0,1622,1594,1287,1259,335,335,174,99,50,20,124,79,25,31,250,350,675,600,150,225,1
221,,,37.0,42.0,46.0,54.0,1846,1628,1511,1203,335,425,284,245,120,110,164,135,25,32,250,350,675,600,150,225,1
229,,,41.0,43.0,46.0,54.0,1818,1751,1483,1259,335,492,230,110,30,65,200,45,27,33,350,350,675,600,150,225,1
236,,,46.0,48.0,46.0,54.0,1902,1830,1567,1315,335,515,25,130,10,25,15,105,27,34,625,700,925,600,150,225,1
243,,,46.0,49.0,54.0,54.0,1964,1835,1651,1343,313,492,221,211,170,50,51,161,29,35,675,700,825,600,175,225,1
250,,,50.0,50.0,54.0,54.0,1824,1785,1511,1315,313,470,151,427,60,210,91,217,29,37,725,700,825,600,175,225,1
257,,,51.0,55.0,54.0,62.0,1908,1975,1595,1483,313,492,261,27,130,0,131,27,30,37,725,1050,825,600,175,225,1
264,,,54.0,56.0,62.0,62.0,1874,1886,1539,1371,335,515,326,191,180,100,146,91,31,38,1025,1050,825,600,175,225,1
271,,,52.0,56.0,70.0,62.0,1874,2138,1539,1511,335,627,206,452,120,285,86,167,33,39,725,1050,825,600,750,225,1
279,,,54.0,58.0,62.0,62.0,1790,2132,1455,1483,335,649,114,617,48,370,66,247,33,40,725,1050,725,600,893,225,1
286,,,54.0,58.0,54.0,62.0,1622,2216,1287,1567,335,649,304,868,198,545,106,323,35,42,725,1050,725,600,1043,225,1
293,,,54.0,62.0,54.0,62.0,1600,2294,1287,1623,313,671,355,798,213,545,142,253,35,42,725,1400,725,850,1093,225,1
300,,,55.0,62.0,62.0,62.0,2020,2250,1707,1623,313,627,175,306,43,85,132,221,36,42,725,1400,725,850,1093,225,1
307,,,59.0,62.0,62.0,62.0,2154,2244,1819,1595,335,649,210,271,138,120,72,151,37,42,1200,1400,725,850,1093,225,1
314,,,62.0,62.0,62.0,62.0,2238,2278,1903,1651,335,627,145,343,133,120,12,223,38,42,1200,1400,725,850,1093,225,1
321,,,62.0,64.0,62.0,70.0,2266,2328,1931,1679,335,649,321,623,273,320,48,303,39,42,1200,1750,725,850,1093,225,1
329,,,62.0,64.0,62.0,78.0,2378,2272,2043,1623,335,649,381,438,293,55,88,383,40,42,1200,1750,725,850,1093,225,1
336,,,61.0,65.0,62.0,78.0,2300,2272,1987,1623,313,649,257,709,133,250,124,459,40,44,950,1750,825,950,1343,225,1
343,,,59.0,65.0,62.0,78.0,2300,2222,1987,1595,313,627,442,985,278,450,164,535,41,44,1175,1750,825,1200,1618,225,1
350,,,59.0,65.0,78.0,78.0,2132,2378,1819,1707,313,671,202,1265,173,650,29,615,42,45,775,1750,925,1500,2018,225,1
7,2,1,13.0,13.0,15.0,14.0,377,293,377,293,0,0,45,35,45,35,0,0,12,12,0,0,0,0,0,0,1
14,2,1,14.0,13.0,15.0,14.0,671,671,671,671,0,0,70,20,70,20,0,0,13,13,0,0,0,0,0,0,1
21,2,1,14.0,14.0,15.0,14.0,643,727,643,727,0,0,40,55,40,55,0,0,13,13,0,0,0,0,0,0,1
29,2,1,15.0,14.0,15.0,14.0,587,783,587,783,0,0,60,150,60,150,0,0,14,13,0,0,0,0,0,0,1
36,2,1,15.0,16.0,15.0,22.0,699,783,699,783,0,0,110,150,110,150,0,0,14,14,0,0,0,0,0,0,1
43,2,1,16.0,16.0,23.0,22.0,755,783,755,783,0,0,45,230,45,230,0,0,15,16,0,0,0,0,0,0,1
50,2,1,17.0,15.0,23.0,22.0,755,839,755,839,0,0,5,35,5,35,0,0,16,15,0,0,0,0,0,0,1
57,2,1,18.0,17.0,23.0,22.0,783,867,783,867,0,0,15,40,15,40,0,0,17,15,0,0,0,0,0,0,1
64,2,1,19.0,18.0,23.0,22.0,867,895,867,895,0,0,70,90,70,90,0,0,18,16,0,0,0,0,0,0,1
71,2,1,19.0,17.0,23.0,22.0,923,895,923,895,0,0,180,170,180,170,0,0,18,17,0,0,0,0,0,0,1
79,2,1,20.0,17.0,23.0,22.0,917,811,895,811,22,0,289,15,285,15,4,0,19,16,0,0,0,0,0,0,1
86,2,1,20.0,18.0,23.0,22.0,967,839,923,839,44,0,417,70,405,70,12,0,19,16,0,0,0,0,0,0,1
93,2,1,20.0,19.0,23.0,22.0,962,839,895,839,67,0,130,125,110,125,20,0,20,18,0,0,150,0,0,0,1
100,2,1,21.0,20.0,23.0,22.0,1040,962,951,895,89,67,57,197,25,185,32,12,20,18,0,0,150,0,0,0,1
107,2,1,21.0,20.0,23.0,22.0,1034,1001,923,867,111,134,113,313,65,285,48,28,20,19,0,0,150,0,0,0,1
114,2,1,22.0,20.0,23.0,22.0,1085,1051,951,895,134,156,84,348,20,300,64,48,21,20,0,0,150,0,0,0,1
121,2,1,22.0,25.0,23.0,28.0,1079,1130,923,951,156,179,215,123,135,55,80,68,21,20,0,0,150,250,0,0,1
129,2,1,23.0,26.0,23.0,36.0,1107,1102,951,923,156,179,245,213,145,125,100,88,22,20,0,0,150,250,0,0,1
136,2,1,25.0,28.0,31.0,36.0,1169,1141,923,1007,246,134,116,40,55,40,61,0,22,21,0,0,300,250,0,0,1
143,2,1,26.0,30.0,31.0,36.0,1236,1085,923,1063,313,22,262,65,165,65,97,0,23,21,0,50,300,250,0,0,1
150,2,1,27.0,30.0,31.0,36.0,1214,1091,923,1091,291,0,109,190,80,190,29,0,24,23,0,50,300,250,0,0,1
157,2,1,29.0,34.0,31.0,36.0,1264,1259,951,1259,313,0,79,95,35,95,44,0,24,24,125,350,300,250,0,0,1
164,2,1,31.0,34.0,46.0,36.0,1320,1287,1007,1287,313,0,190,240,110,240,80,0,25,25,125,400,300,250,0,0,1
171,2,1,31.0,34.0,46.0,36.0,1348,1371,1035,1371,313,0,155,65,85,65,70,0,25,25,125,400,300,250,0,0,1
179,2,1,33.0,34.0,46.0,36.0,1432,1399,1119,1399,313,0,320,130,210,130,110,0,27,25,250,400,300,250,0,0,1
186,2,1,37.0,36.0,46.0,36.0,1404,1455,1091,1455,313,0,325,160,200,160,125,0,29,25,250,450,300,250,0,0,1
193,2,1,37.0,36.0,46.0,36.0,1538,1399,1203,1399,335,0,455,235,290,235,165,0,29,25,250,600,600,250,0,0,1
200,2,1,42.0,41.0,46.0,44.0,1645,1427,1287,1427,358,0,155,150,100,150,55,0,31,25,250,600,600,250,0,0,1
207,2,1,43.0,44.0,46.0,52.0,1650,1483,1315,1483,335,0,156,130,65,130,91,0,32,25,250,600,600,250,0,0,1
214,2,1,45.0,47.0,46.0,52.0,1768,1483,1455,1483,313,0,277,160,150,160,127,0,34,30,375,600,600,250,0,0,1
221,2,1,48.0,51.0,54.0,52.0,1796,1567,1483,1567,313,0,197,95,180,95,17,0,34,34,675,750,600,250,0,0,1
229,2,1,50.0,51.0,62.0,52.0,1936,1852,1623,1763,313,89,377,331,320,315,57,16,36,34,675,750,600,250,0,0,1
236,2,1,50.0,52.0,62.0,52.0,1986,1947,1651,1791,335,156,162,411,65,375,97,36,37,36,675,750,600,250,0,0,1
243,2,1,52.0,52.0,62.0,58.0,2042,1947,1707,1791,335,156,252,631,115,575,137,56,38,37,675,900,600,250,0,0,1
250,2,1,53.0,57.5,62.0,66.0,2098,2003,1763,1847,335,156,413,411,240,335,173,76,39,36,975,875,600,250,0,25,1
257,2,1,52.0,59.0,70.0,66.0,2104,1975,1791,1819,313,156,454,446,245,350,209,96,40,35,850,950,600,250,125,150,1
264,2,1,52.0,56.0,70.0,66.0,2216,2026,1903,1847,313,179,689,521,440,405,249,116,42,37,725,950,600,250,250,200,1
271,2,1,52.0,67.0,70.0,66.0,2160,2026,1847,1847,313,179,339,385,150,249,189,136,42,43,725,950,600,375,250,200,1
279,2,1,56.0,67.0,70.0,66.0,2227,2171,1959,2015,268,156,291,551,120,399,171,152,44,43,725,950,600,375,250,200,1
286,2,1,58.0,67.0,70.0,66.0,2250,2311,1959,2155,291,156,306,521,95,349,211,172,46,50,900,1100,600,375,250,200,1
293,2,1,58.0,66.0,70.0,66.0,2378,2395,2043,2239,335,156,486,611,235,419,251,192,46,45,900,1100,600,375,250,400,1
300,2,1,60.0,73.0,70.0,74.0,2350,2395,1903,2239,447,156,562,566,255,354,307,212,48,45,900,1100,600,375,250,400,1
307,2,1,64.0,73.0,85.0,74.0,2535,2586,1931,2407,604,179,184,371,5,239,179,132,49,48,1075,1250,950,375,250,400,1
314,2,1,67.0,74.0,85.0,74.0,2580,2558,1931,2379,649,179,290,396,35,244,255,152,52,53,1075,1250,950,375,250,400,1
321,2,1,72.0,74.0,85.0,74.0,2558,2591,1931,2435,627,156,202,537,25,369,177,168,54,55,1075,1250,1250,375,250,400,1
329,2,1,74.0,77.0,85.0,82.0,2810,2675,2183,2519,627,156,403,507,150,319,253,188,56,56,1075,1250,1250,375,250,400,1
336,2,1,82.0,79.5,93.0,90.0,2978,2832,2351,2631,627,201,275,710,100,494,175,216,58,60,1425,1225,1400,500,250,425,1
343,2,1,84.0,84.5,101.0,106.0,3112,2955,2463,2575,649,380,305,617,150,449,155,168,60,63,1600,1225,1400,500,250,425,1
350,2,1,86.0,84.0,109.0,114.0,3224,3258,2575,2631,649,627,441,562,210,314,231,248,62,62,1900,1200,1400,500,250,450,1
357,2,1,87.0,87.0,109.0,114.0,3258,3526,2631,2855,627,671,332,529,225,259,107,270,63,62,1900,1250,1400,500,250,450,1
364,2,1,89.0,93.0,109.0,128.0,3319,3386,2715,2715,604,671,368,509,185,159,183,350,65,60,1900,1500,1400,750,250,450,1
371,2,1,95.0,98.0,109.0,128.0,3386,3454,2715,2827,671,627,252,676,135,254,117,422,66,60,1900,1650,1400,750,250,450,1
379,2,1,96.0,101.0,117.0,128.0,3381,3230,2575,2603,806,627,476,901,255,399,221,502,68,60,2425,2050,1400,750,250,450,1
386,2,1,97.0,100.5,117.0,128.0,3700,3398,2715,2771,985,627,866,1321,525,739,341,582,68,60,2425,2275,1400,750,250,475,1
393,2,1,97.0,107.5,117.0,128.0,3689,3358,2659,2687,1030,671,1081,1311,620,649,461,662,70,60,2425,2225,1750,750,250,525,1
400,2,1,101.0,113.5,117.0,128.0,3700,3420,2715,2771,985,649,989,1312,570,574,419,738,70,60,2825,2375,1750,950,375,525,1
407,2,1,101.0,116.5,117.0,128.0,3734,3386,2771,2715,963,671,995,1063,460,499,535,564,70,60,2825,2775,1750,1150,375,525,1
414,2,1,103.0,120.5,117.0,128.0,3706,3448,2743,2799,963,649,1171,804,520,389,651,415,70,60,2825,3075,2050,1150,375,525,1
421,2,1,104.0,120.0,117.0,142.0,3795,3342,2855,2715,940,627,1282,910,515,419,767,491,72,60,2825,3200,2200,1150,375,550,1
429,2,1,114.0,132.0,125.0,142.0,3689,3342,2771,2715,918,627,469,505,190,84,279,421,73,60,2825,3750,2200,1150,375,750,1
436,2,1,118.0,138.0,125.0,166.0,3806,3336,2799,2687,1007,649,254,555,155,54,99,501,73,60,3725,3700,2300,1150,375,800,1
443,2,1,110.0,125.5,125.0,166.0,3862,3386,2855,2715,1007,671,614,950,395,369,219,581,65,65,3725,3425,2200,1150,600,1300,1
450,2,1,104.0,137.0,125.0,174.0,3039,3370,2211,2699,828,671,718,644,415,166,303,478,58,69,4175,3100,2350,1150,1050,1325,1
457,2,1,107.0,147.0,133.0,174.0,2737,3420,2043,2749,694,671,653,558,270,125,383,433,61,69,4175,3100,2600,1150,1050,1325,1
464,2,1,114.0,154.0,133.0,174.0,2854,3292,2183,2665,671,627,388,549,225,194,163,355,64,69,4175,3100,2600,1150,1050,1325,1
471,2,1,117.0,160.0,141.0,174.0,3011,3544,2183,2917,828,627,405,686,230,326,175,360,67,69,4625,3900,3050,1150,1050,1325,1
479,2,1,119.0,169.5,172.0,174.0,3291,3729,2351,3102,940,627,212,659,125,294,87,365,68,69,4625,4375,3050,1150,1050,1350,1
486,2,1,127.0,172.0,172.0,174.0,3426,3745,2463,3074,963,671,332,395,125,100,207,295,70,73,4625,4700,3050,1150,1050,1625,1
493,2,1,124.0,172.5,172.0,174.0,3756,3806,2771,3135,985,671,713,518,390,143,323,375,69,73,4925,4475,3050,1150,1250,1950,1
500,2,1,132.0,172.0,172.0,174.0,3582,4142,2575,3471,1007,671,543,819,400,372,143,447,71,73,4925,4850,3050,1150,1250,1975,1
507,2,1,133.0,172.0,172.0,174.0,3605,4450,2575,3779,1030,671,478,355,365,328,113,27,72,73,5150,5200,3050,1150,1425,1975,1
514,2,1,134.0,174.0,172.0,190.0,3778,4182,2659,3555,1119,627,334,474,235,400,99,74,75,73,5350,5400,3050,1150,1425,1975,1
521,2,1,138.0,174.0,172.0,190.0,3778,4490,2547,3863,1231,627,486,1057,385,903,101,154,76,73,5350,6400,3050,1150,1425,2000,1
529,2,1,136.0,172.0,172.0,206.0,3851,4294,2575,3667,1276,627,853,566,600,332,253,234,79,73,4300,4800,2800,1150,2225,3450,1
536,2,1,105.0,165.0,172.0,206.0,3700,4467,2491,3796,1209,671,777,728,530,414,247,314,69,69,2250,3850,2950,1150,5275,4075,1
543,2,1,102.0,166.5,172.0,206.0,3246,3817,2127,3146,1119,671,449,696,270,310,179,386,69,65,2175,3675,3100,1150,6300,4450,1
550,2,1,97.0,170.5,172.0,206.0,3364,3442,2379,2771,985,671,766,906,475,440,291,466,62,65,2875,4725,2950,1150,6800,4450,1
557,2,1,96.0,168.0,164.0,206.0,2938,3398,2155,2771,783,627,469,1193,240,655,229,538,54,65,2875,4800,2950,1150,7350,4675,1
7,,,13.0,13.0,15.0,15.0,293,335,293,335,0,0,35,40,35,40,0,0,12,12,0,0,0,0,0,0,1
14,,,13.0,14.0,15.0,15.0,671,643,671,643,0,0,70,65,70,65,0,0,12,13,0,0,0,0,0,0,1
21,,,14.0,14.0,15.0,15.0,755,699,755,699,0,0,50,45,50,45,0,0,13,13,0,0,0,0,0,0,1
29,,,15.0,15.0,15.0,15.0,727,671,727,671,0,0,80,80,80,80,0,0,14,14,0,0,0,0,0,0,1
36,,,15.0,15.0,15.0,23.0,783,755,783,755,0,0,130,25,130,25,0,0,14,14,0,0,0,0,0,0,1
43,,,16.0,16.0,23.0,23.0,783,783,783,783,0,0,60,60,60,60,0,0,15,15,0,0,0,0,0,0,1
50,,,16.0,16.0,23.0,23.0,783,867,783,867,0,0,25,60,25,60,0,0,15,15,0,0,0,0,0,0,1
57,,,17.0,17.0,23.0,23.0,727,895,727,895,0,0,65,40,65,40,0,0,16,16,0,0,0,0,0,0,1
64,,,17.0,17.0,23.0,31.0,755,951,755,951,0,0,155,145,155,145,0,0,16,16,0,0,0,0,0,0,1
71,,,18.0,18.0,23.0,31.0,783,951,783,951,0,0,195,45,195,45,0,0,17,17,0,0,0,0,0,0,1
79,,,19.0,18.0,23.0,31.0,782,855,671,811,111,44,300,143,280,135,20,8,18,17,0,0,0,0,0,0,1
86,,,19.0,18.0,23.0,31.0,878,911,699,755,179,156,350,113,310,85,40,28,18,18,0,0,0,150,0,0,1
93,,,21.0,21.0,23.0,31.0,878,911,699,755,179,156,255,64,245,20,10,44,19,18,0,0,150,150,0,0,1
100,,,20.0,22.0,23.0,31.0,906,939,727,783,179,156,265,134,235,70,30,64,19,19,0,0,150,150,0,0,1
107,,,20.0,22.0,23.0,31.0,967,939,811,783,156,156,381,104,335,20,46,84,19,19,0,0,150,150,0,0,1
114,,,20.0,23.0,31.0,31.0,911,945,755,811,156,134,381,175,315,75,66,100,19,20,0,0,150,300,0,0,1
121,,,21.0,25.0,31.0,31.0,911,967,755,811,156,156,436,120,350,50,86,70,19,20,0,100,150,450,0,0,1
129,,,22.0,27.0,31.0,31.0,911,967,755,811,156,156,356,75,250,35,106,40,19,21,100,100,150,450,0,0,1
136,,,23.0,27.0,31.0,31.0,1023,1040,867,839,156,201,171,153,145,85,26,68,20,20,100,100,150,450,0,50,1
143,,,23.0,29.0,31.0,31.0,1102,1068,923,755,179,313,111,9,65,5,46,4,20,20,100,275,250,450,0,50,1
150,,,25.0,29.0,31.0,31.0,1023,1208,867,895,156,313,182,150,120,110,62,40,21,21,150,450,250,450,0,50,1
157,,,26.0,29.0,31.0,31.0,1079,1236,923,923,156,313,322,290,240,210,82,80,22,21,150,450,250,450,0,50,1
164,,,26.0,30.0,31.0,31.0,1107,1208,951,895,156,313,462,40,360,20,102,20,22,21,150,625,250,450,0,50,1
171,,,26.0,30.0,39.0,31.0,1163,1208,1007,895,156,313,162,175,40,115,122,60,22,22,200,625,250,450,50,50,1
179,,,28.0,30.0,39.0,31.0,1135,1202,979,867,156,335,202,315,85,215,117,100,22,22,200,625,650,450,50,50,1
186,,,27.0,30.0,39.0,31.0,1018,1258,839,923,179,335,324,461,187,325,137,136,21,22,250,625,650,450,100,50,1
193,,,29.0,28.0,39.0,31.0,1046,1202,867,867,179,335,309,591,152,415,157,176,20,22,250,525,650,450,150,150,1
200,,,27.0,29.0,39.0,31.0,939,1180,783,867,156,313,130,382,82,320,48,62,21,22,250,525,650,800,250,150,1
207,,,29.0,29.0,39.0,31.0,995,1152,839,839,156,313,155,527,87,425,68,102,21,22,300,525,650,800,250,150,1
214,,,29.0,29.0,39.0,31.0,1135,1180,979,867,156,313,175,167,112,25,63,142,21,23,300,525,725,800,250,150,1
221,,,31.0,30.0,39.0,31.0,1415,1230,1259,895,156,335,265,222,182,40,83,182,22,23,300,525,725,800,250,150,1
229,,,32.0,29.0,39.0,31.0,1331,1258,1175,923,156,335,158,327,155,105,3,222,22,24,350,350,800,800,250,325,1
236,,,33.0,33.0,39.0,39.0,1410,1258,1231,923,179,335,144,178,121,20,23,158,23,24,400,350,1050,800,250,400,1
243,,,35.0,34.0,39.0,39.0,1354,1342,1175,1007,179,335,289,293,246,95,43,198,24,25,450,700,1050,800,250,400,1
250,,,35.0,34.0,54.0,39.0,1387,1264,1231,951,156,313,340,389,281,155,59,234,24,25,450,700,1050,800,250,400,1
257,,,35.0,35.0,54.0,39.0,1387,1320,1231,1007,156,313,350,429,271,155,79,274,25,26,450,700,1050,800,250,400,1
264,,,39.0,35.0,54.0,39.0,1482,1320,1259,1007,223,313,232,584,221,270,11,314,25,26,500,700,1050,800,250,400,1
271,,,39.0,38.0,62.0,39.0,1706,1426,1371,1091,335,335,332,504,281,275,51,229,25,27,500,700,1050,1100,250,400,1
279,,,41.0,39.0,62.0,39.0,1566,1449,1231,1091,335,358,518,164,431,120,87,44,25,27,600,950,1050,1100,250,400,1
286,,,41.0,41.0,62.0,54.0,1566,1370,1231,1035,335,335,698,270,571,190,127,80,25,27,600,1200,1050,1100,250,400,1
293,,,41.0,41.0,62.0,54.0,1684,1365,1371,1007,313,358,454,229,291,105,163,124,25,27,800,1200,1050,1100,250,400,1
300,,,35.0,43.0,62.0,54.0,1684,1398,1371,951,313,447,649,404,446,220,203,184,25,29,600,1200,1050,1100,550,400,1
307,,,36.0,44.0,54.0,54.0,1600,1583,1287,1091,313,492,543,499,300,255,243,244,25,30,550,1200,1050,1100,707,400,1
314,,,33.0,45.0,54.0,62.0,1342,1611,1007,1119,335,492,578,680,295,380,283,300,23,31,500,1200,1050,1100,857,400,1
321,,,33.0,49.0,54.0,62.0,1208,1723,895,1231,313,492,609,405,290,295,319,110,23,32,500,1700,1050,1100,857,400,1
329,,,33.0,51.0,54.0,62.0,1342,1807,1007,1315,335,492,799,521,440,355,359,166,22,33,550,1700,1075,1350,909,400,1
336,,,29.0,51.0,54.0,62.0,962,1863,671,1371,291,492,606,746,215,520,391,226,16,33,550,1700,1075,1350,1209,400,1
7,1,0,13.0,13.0,14.0,15.0,293,377,293,377,0,0,35,45,35,45,0,0,12,12,0,0,0,0,0,0,0
14,1,0,13.0,14.0,14.0,15.0,671,643,671,643,0,0,20,65,20,65,0,0,13,13,0,0,0,0,0,0,0
21,1,0,14.0,14.0,14.0,15.0,755,699,755,699,0,0,55,50,55,50,0,0,13,13,0,0,0,0,0,0,0
29,1,0,14.0,15.0,14.0,15.0,811,727,811,727,0,0,145,40,145,40,0,0,13,14,0,0,0,0,0,0,0
36,1,0,16.0,15.0,22.0,15.0,811,811,811,811,0,0,150,140,150,140,0,0,14,14,0,0,0,0,0,0,0
43,1,0,16.0,16.0,22.0,23.0,867,867,867,867,0,0,245,80,245,80,0,0,16,15,0,0,0,0,0,0,0
50,1,0,15.0,16.0,22.0,23.0,839,839,839,839,0,0,35,45,35,45,0,0,15,15,0,0,0,0,0,0,0
57,1,0,17.0,17.0,22.0,23.0,867,727,867,727,0,0,40,75,40,75,0,0,15,16,0,0,0,0,0,0,0
64,1,0,18.0,18.0,22.0,23.0,867,783,867,783,0,0,95,175,95,175,0,0,16,17,0,0,0,0,0,0,0
71,1,0,17.0,18.0,22.0,23.0,895,822,895,755,0,67,180,272,180,260,0,12,17,17,0,0,0,0,0,0,0
79,1,0,17.0,19.0,22.0,23.0,951,911,951,755,0,156,40,332,40,300,0,32,16,18,0,0,0,0,0,0,0
86,1,0,18.0,19.0,22.0,23.0,923,939,923,783,0,156,100,457,100,405,0,52,16,18,0,0,0,0,0,0,0
93,1,0,19.0,20.0,22.0,23.0,951,967,951,811,0,156,170,322,170,300,0,22,18,19,0,0,0,150,0,0,0
100,1,0,20.0,20.0,22.0,23.0,1018,962,951,783,67,179,242,437,230,395,12,42,18,19,0,0,0,150,0,0,0
107,1,0,20.0,20.0,22.0,23.0,1034,990,923,811,111,179,363,152,335,90,28,62,19,19,0,0,0,150,0,0,0
114,1,0,21.0,20.0,22.0,23.0,1107,939,951,783,156,156,443,123,395,45,48,78,20,19,0,0,0,150,0,0,0
121,1,0,27.0,22.0,28.0,23.0,1057,939,923,783,134,156,179,183,115,85,64,98,20,19,0,100,250,150,0,0,0
129,1,0,27.0,23.0,28.0,23.0,1118,1079,1007,923,111,156,306,268,230,150,76,118,21,20,0,100,250,150,0,0,0
136,1,0,26.0,23.0,28.0,31.0,1158,1051,1091,895,67,156,149,103,65,65,84,38,20,20,0,100,250,150,0,0,0
143,1,0,27.0,24.0,28.0,31.0,1163,1275,1119,1119,44,156,138,128,50,120,88,8,20,21,100,150,250,150,0,0,0
150,1,0,28.0,24.0,28.0,31.0,1219,1326,1175,1147,44,179,231,268,135,240,96,28,20,21,100,150,250,150,0,0,0
157,1,0,30.0,25.0,36.0,31.0,1186,1354,1119,1175,67,179,59,418,55,370,4,48,22,22,400,150,250,150,0,0,0
164,1,0,31.0,26.0,36.0,31.0,1326,1275,1259,1119,67,156,182,109,170,45,12,64,22,23,400,150,250,150,0,0,0
171,1,0,32.0,26.0,36.0,31.0,1298,1275,1231,1119,67,156,170,204,150,120,20,84,24,23,400,150,250,150,0,0,0
179,1,0,34.0,27.0,36.0,46.0,1326,1387,1259,1231,67,156,178,224,150,120,28,104,26,24,400,150,250,250,0,0,0
186,1,0,36.0,27.0,44.0,46.0,1410,1219,1343,1063,67,156,261,24,225,0,36,24,26,24,400,150,250,500,0,0,0
193,1,0,41.0,29.0,44.0,46.0,1499,1247,1455,1091,44,156,135,89,95,45,40,44,28,25,400,150,250,500,0,0,0
200,1,0,44.0,31.0,44.0,46.0,1555,1242,1511,1063,44,179,168,139,120,75,48,64,28,25,400,150,250,500,0,0,0
207,1,0,44.0,35.0,50.0,46.0,1634,1331,1567,1175,67,156,221,120,165,40,56,80,31,26,400,200,250,500,0,0,0
214,1,0,50.0,35.0,50.0,46.0,1729,1488,1595,1287,134,201,181,138,105,55,76,83,34,26,550,200,250,500,0,0,0
221,1,0,50.0,39.0,50.0,46.0,1807,1740,1651,1427,156,313,291,153,195,30,96,123,34,28,550,300,250,750,0,0,0
229,1,0,50.0,42.0,50.0,46.0,1947,1802,1791,1511,156,291,446,269,330,110,116,159,36,29,700,400,250,825,0,0,0
236,1,0,57.0,43.0,58.0,46.0,1975,2104,1819,1791,156,313,206,329,70,230,136,99,36,30,700,400,250,825,0,0,0
243,1,0,57.0,47.0,66.0,61.0,2059,2238,1903,1903,156,335,471,134,315,95,156,39,36,31,700,500,250,825,0,0,0
250,1,0,63.0,52.0,74.0,61.0,2026,2098,1847,1763,179,335,421,104,245,25,176,79,40,32,1000,600,250,825,0,0,0
257,1,0,67.0,53.0,74.0,61.0,2138,2160,1959,1847,179,313,266,135,70,45,196,90,46,33,1150,600,250,825,0,0,0
264,1,0,70.0,54.0,74.0,61.0,2311,2126,2155,1791,156,335,312,195,100,65,212,130,46,34,1150,600,250,825,0,0,0
271,1,0,72.0,60.0,82.0,61.0,2479,2126,2323,1791,156,335,502,70,270,0,232,70,46,35,1150,800,250,900,0,0,0
279,1,0,76.0,61.0,82.0,61.0,2591,2244,2435,1931,156,313,607,316,355,210,252,106,49,36,1150,800,250,900,0,0,0
286,1,0,81.0,62.0,90.0,69.0,2619,2636,2463,2323,156,313,372,541,100,395,272,146,53,38,1250,1050,250,900,0,0,0
293,1,0,80.0,68.0,90.0,69.0,2619,2770,2463,2435,156,335,597,351,305,315,292,36,52,40,1550,1250,250,900,0,0,0
300,1,0,83.0,69.0,90.0,69.0,2810,2798,2631,2463,179,335,407,166,95,90,312,76,54,42,1550,1250,250,900,0,0,0
307,1,0,84.0,70.0,98.0,77.0,2759,2832,2603,2519,156,313,233,227,55,115,178,112,53,43,1550,1250,250,900,0,0,0
314,1,0,88.0,71.0,98.0,77.0,2983,2714,2827,2379,156,335,398,212,200,60,198,152,59,45,1550,1150,250,900,0,100,0
321,1,0,84.0,72.0,98.0,77.0,3067,2664,2911,2351,156,313,658,483,440,295,218,188,55,46,1650,1150,625,900,0,100,0
329,1,0,89.0,73.0,98.0,85.0,3067,2608,2911,2295,156,313,543,508,305,280,238,228,58,48,1650,1150,625,900,0,100,0
336,1,0,94.0,73.0,98.0,85.0,3039,2580,2883,2267,156,313,448,158,190,140,258,18,56,48,1650,1400,625,1150,0,100,0
343,1,0,92.0,76.0,98.0,85.0,3202,2552,3023,2127,179,425,573,244,395,170,178,74,60,50,1650,1400,625,1250,0,100,0
350,1,0,91.5,77.0,98.0,101.0,3106,2530,2771,1903,335,627,841,440,615,340,226,100,60,51,1775,1400,825,1550,25,100,0
357,1,0,95.5,82.0,98.0,101.0,3196,2384,2435,1735,761,649,831,430,605,250,226,180,64,52,1775,1450,1075,1550,25,100,0
364,1,0,101.5,84.0,104.0,101.0,3330,2630,2435,1959,895,671,683,610,345,350,338,260,66,54,1775,1450,1575,1550,25,100,0
371,1,0,103.5,88.0,104.0,101.0,3398,2770,2435,2099,963,671,98,306,90,170,8,136,66,55,1975,1550,1575,1550,100,100,0
379,1,0,103.5,93.0,104.0,101.0,3504,2860,2519,2211,985,649,538,297,410,85,128,212,76,57,2075,1650,1575,1550,100,100,0
386,1,0,103.5,92.0,104.0,117.0,3599,2972,2659,2323,940,649,285,123,245,35,40,88,74,59,2175,1200,1700,2050,150,600,0
393,1,0,103.5,96.0,104.0,117.0,3750,3084,2743,2435,1007,649,275,268,115,100,160,168,74,61,2175,1300,1700,2150,150,600,0
400,1,0,103.5,101.0,112.0,117.0,3717,3146,2687,2519,1030,627,733,159,503,115,230,44,76,62,2175,1400,1700,2150,150,600,0
407,1,0,110.5,103.0,128.0,117.0,3767,3224,2827,2575,940,649,427,144,243,20,184,124,74,64,2175,1550,1700,2150,150,600,0
414,1,0,115.5,109.0,128.0,117.0,3991,3319,3051,2603,940,716,522,262,218,75,304,187,74,66,1875,1650,1700,2150,450,600,0
421,1,0,115.5,114.0,128.0,117.0,4148,3246,3163,2463,985,783,1017,295,593,70,424,225,83,67,2175,1650,1700,2150,450,600,0
429,1,0,121.5,118.0,128.0,125.0,4327,3442,3387,2659,940,783,674,440,263,215,411,225,83,67,2175,2100,1700,2150,450,600,0
436,1,0,123.5,121.0,128.0,125.0,4400,3493,3415,2687,985,806,1059,676,528,355,531,321,83,67,2575,2350,1700,2150,450,600,0
443,1,0,123.5,125.0,152.0,125.0,4669,3442,3639,2659,1030,783,1519,422,868,30,651,392,83,68,2825,2600,1700,2150,550,600,0
450,1,0,128.5,130.0,152.0,133.0,4680,3409,3695,2603,985,806,1806,587,1043,120,763,467,83,68,3125,2800,1700,2150,550,600,0
457,1,0,128.5,132.0,152.0,133.0,4747,3342,3807,2491,940,851,2278,692,1453,125,825,567,83,70,3125,3000,2150,2150,550,600,0
464,1,0,126.0,131.0,160.0,133.0,4708,3403,3723,2575,985,828,2828,888,1883,250,945,638,83,70,3150,2900,2150,2450,775,850,0
471,1,0,149.0,136.0,166.0,149.0,4652,3437,3667,2631,985,806,1213,690,1048,85,165,605,83,70,3400,3200,2150,2450,775,850,0
479,1,0,149.0,140.0,166.0,157.0,4523,3431,3359,2603,1164,828,1755,545,1438,40,317,505,83,70,3400,3200,2150,2450,775,850,0
486,1,0,156.0,142.0,166.0,157.0,4630,3353,3331,2547,1299,806,1970,341,1493,90,477,251,90,70,3400,3450,2150,2450,775,850,0
493,1,0,155.0,144.0,166.0,157.0,4590,3414,3247,2631,1343,783,2200,497,1563,175,637,322,90,70,4650,3500,2150,2450,1125,1000,0
500,1,0,158.0,144.0,166.0,173.0,4378,3465,3079,2659,1299,806,1073,432,863,210,210,222,89,70,5000,3550,2150,2450,1125,1000,0
507,1,0,161.0,152.0,166.0,173.0,4131,3482,2855,2631,1276,851,1439,432,1073,110,366,322,89,70,5000,4000,2150,2650,1125,1000,0
514,1,0,154.0,147.0,166.0,173.0,4316,3319,2995,2491,1321,828,1960,624,1438,235,522,389,89,70,5650,3800,2150,2650,1550,1300,0
521,1,0,165.0,151.0,166.0,188.0,4266,3381,2967,2575,1299,806,1531,625,953,165,578,460,89,70,6000,3850,2150,2950,1550,1300,0
529,1,0,164.0,153.0,166.0,188.0,4467,3101,3191,2295,1276,806,1388,686,1008,130,380,556,88,70,6000,3900,2150,2950,1550,1400,0
536,1,0,165.0,152.0,166.0,188.0,4624,2961,3303,2155,1321,806,1768,646,1228,15,540,631,86,70,6050,4250,2150,2950,1650,1700,0
543,1,0,161.0,149.0,182.0,188.0,4350,2994,3051,2211,1299,783,2090,862,1398,135,692,727,86,70,6500,4250,2150,2950,2000,2000,0
550,1,0,170.0,152.0,182.0,188.0,4355,3151,3079,2323,1276,828,1857,987,1163,185,694,802,89,70,6500,4250,2150,2950,2000,2100,0
557,1,0,182.0,154.0,182.0,188.0,4568,3291,3247,2463,1321,828,1208,963,958,215,250,748,89,70,6500,4450,2150,3150,2000,2100,0
564,1,0,182.0,157.0,198.0,188.0,4876,2983,3555,2155,1321,828,1593,1159,1183,340,410,819,89,70,6700,4600,2400,3150,2250,2100,0
571,1,0,181.0,162.0,196.0,188.0,4893,3179,3639,2351,1254,828,2191,1210,1633,295,558,915,89,72,6450,4800,2400,3150,2500,2100,0
579,1,0,181.5,163.0,196.0,188.0,4966,3521,3667,2715,1299,806,2216,1286,1498,325,718,961,89,72,7175,4500,2400,3150,3025,2300,0
586,1,0,171.5,135.0,196.0,188.0,5150,3381,3807,2687,1343,694,1236,1076,1158,85,78,991,89,68,4825,3350,2400,3300,4475,4000,0
593,1,0,159.0,125.0,196.0,180.0,5072,3056,3751,2407,1321,649,1638,1126,1408,55,230,1071,89,65,4000,2950,2400,3350,5550,4900,0
600,1,0,164.0,127.0,196.0,172.0,4999,2826,3723,2155,1276,671,1565,1221,1333,95,232,1126,89,65,4000,3050,2400,3350,5550,5200,0
607,1,0,163.5,136.0,196.0,172.0,4994,2804,3695,2155,1299,649,1846,1382,1458,255,388,1127,87,65,3825,3400,2400,3350,5775,5200,0
614,1,0,170.5,138.0,196.0,172.0,4714,3078,3415,2407,1299,671,1057,1202,863,120,194,1082,89,65,5575,3500,2400,3350,5775,5200,0
621,1,0,169.5,145.0,196.0,172.0,4663,3224,3387,2575,1276,649,1518,1158,1218,25,300,1133,92,67,5825,3750,2400,3350,5775,5200,0
629,1,0,184.5,146.0,196.0,172.0,4646,3084,3303,2435,1343,649,1008,1333,848,145,160,1188,92,69,6525,3900,2400,3500,5775,5400,0
636,1,0,181.0,155.0,196.0,172.0,4714,3426,3303,2799,1411,627,1586,1254,1258,40,328,1214,92,71,6500,4000,2400,3725,6250,5400,0
643,1,0,188.0,158.0,196.0,172.0,4921,3498,3443,2827,1478,671,1632,1609,1128,315,504,1294,92,72,6100,4150,2400,3725,6650,5450,0
650,1,0,185.5,164.0,196.0,172.0,5190,3750,3555,3079,1635,671,2133,1379,1433,105,700,1274,92,74,7025,4200,2400,3725,6775,5600,0
657,1,0,175.0,143.0,196.0,172.0,5206,3980,3527,3331,1679,649,2764,1311,1868,65,896,1246,92,74,6800,3000,2400,3725,7175,6600,0
664,1,0,192.0,141.0,204.0,172.0,5050,3997,3415,3303,1635,694,2461,1089,1373,205,1088,884,92,74,6700,3050,2400,3725,7275,6600,0
671,1,0,191.0,146.0,204.0,180.0,5111,4103,3499,3275,1612,828,1314,1049,938,165,376,884,91,74,6700,3200,2750,3725,7275,6800,0
679,1,0,200.0,151.0,204.0,180.0,5100,4081,3443,3163,1657,918,564,965,438,40,126,925,91,74,6700,3425,2750,3725,7275,6900,0
686,1,0,200.0,154.0,204.0,180.0,5106,4126,3471,3163,1635,963,1166,1012,848,25,318,987,91,74,7600,3475,2750,3725,7275,7000,0
693,1,0,200.0,161.0,210.0,188.0,4781,3930,3191,2967,1590,963,1728,1324,1218,225,510,1099,91,74,8950,3825,2750,3725,7275,7000,0
700,1,0,200.0,166.0,210.0,188.0,4691,3913,3079,2995,1612,918,1234,1542,1053,385,181,1157,91,74,8950,4250,2750,3725,7275,7000,0
707,1,0,200.0,169.0,210.0,188.0,4786,3851,3107,2911,1679,940,1464,1354,1258,110,206,1244,91,74,8950,4500,2750,3725,7275,7000,0
714,1,0,195.0,168.0,210.0,188.0,4579,3879,2967,2939,1612,940,1997,1551,1603,245,394,1306,91,74,9550,4400,3150,3725,7725,7400,0
721,1,0,190.5,168.0,210.0,188.0,4887,3801,3275,2883,1612,918,2589,1638,2003,245,586,1393,91,74,9275,4350,3150,3725,8000,7750,0
729,1,0,197.5,170.0,202.0,188.0,4904,3666,3247,2771,1657,895,2714,1621,1928,170,786,1451,91,74,8975,4300,3150,3725,8300,7850,0
736,1,0,199.5,152.0,202.0,188.0,5083,2832,3471,2071,1612,761,2777,1535,1803,50,974,1485,91,67,8425,3800,3150,3725,8850,8775,0
743,1,0,183.0,138.0,202.0,133.0,5089,2770,3499,2099,1590,671,2793,1570,1923,55,870,1515,91,66,7300,3300,3150,3725,10275,10475,0
750,1,0,186.5,126.0,202.0,125.0,5128,2630,3471,1959,1657,671,2609,1661,1543,70,1066,1591,91,64,6575,2725,3150,3725,11050,11300,0
757,1,0,180.0,116.0,202.0,109.0,5212,2283,3555,1791,1657,492,3235,1704,1973,65,1262,1639,91,52,6500,2775,3150,3625,11250,12575,0
7,0,2,13.0,13.0,15.0,15.0,335,293,335,293,0,0,40,35,40,35,0,0,12,12,0,0,0,0,0,0,0
14,0,2,14.0,14.0,15.0,15.0,671,699,671,699,0,0,70,75,70,75,0,0,13,13,0,0,0,0,0,0,0
21,0,2,14.0,14.0,15.0,15.0,671,699,671,699,0,0,45,50,45,50,0,0,13,13,0,0,0,0,0,0,0
29,0,2,15.0,15.0,15.0,15.0,699,727,699,727,0,0,85,90,85,90,0,0,14,14,0,0,0,0,0,0,0
36,0,2,15.0,16.0,15.0,23.0,727,811,727,811,0,0,130,145,130,145,0,0,14,15,0,0,0,0,0,0,0
43,0,2,16.0,16.0,23.0,23.0,783,839,783,839,0,0,75,35,75,35,0,0,15,15,0,0,0,0,0,0,0
50,0,2,16.0,17.0,23.0,23.0,783,867,783,867,0,0,45,60,45,60,0,0,15,16,0,0,0,0,0,0,0
57,0,2,17.0,18.0,23.0,23.0,755,867,755,867,0,0,85,115,85,115,0,0,16,17,0,0,0,0,0,0,0
64,0,2,18.0,19.0,23.0,23.0,867,951,867,951,0,0,195,175,195,175,0,0,17,18,0,0,0,0,0,0,0
71,0,2,18.0,19.0,23.0,23.0,883,1001,839,979,44,22,243,239,235,235,8,4,17,18,0,0,0,0,0,0,0
79,0,2,19.0,20.0,23.0,23.0,967,1023,811,979,156,44,348,363,320,355,28,8,18,19,0,0,0,0,0,0,0
86,0,2,19.0,20.0,23.0,23.0,939,1012,783,923,156,89,458,325,410,305,48,20,18,19,0,0,0,150,0,0,0
93,0,2,20.0,20.0,23.0,23.0,990,1006,811,895,179,111,378,42,310,10,68,32,19,20,0,0,150,150,0,0,0
100,0,2,20.0,21.0,23.0,23.0,1018,1023,839,867,179,156,488,122,400,70,88,52,19,20,0,0,150,150,0,0,0
107,0,2,20.0,21.0,23.0,23.0,1023,1051,867,895,156,156,204,92,100,20,104,72,19,20,50,0,150,150,0,0,0
114,0,2,21.0,21.0,23.0,23.0,928,1046,839,867,89,179,67,147,5,55,62,92,19,20,50,0,150,150,0,50,0
121,0,2,21.0,24.0,23.0,31.0,967,1102,923,923,44,179,176,102,110,15,66,87,19,21,50,0,150,300,0,50,0
129,0,2,22.0,24.0,23.0,31.0,1135,1079,1091,923,44,156,269,133,195,80,74,53,20,21,50,0,150,300,0,50,0
136,0,2,22.0,25.0,31.0,31.0,1258,1046,1147,867,111,179,440,162,350,85,90,77,20,22,50,0,150,300,0,50,0
143,0,2,23.0,26.0,31.0,31.0,1337,1186,1203,895,134,291,141,72,35,55,106,17,21,23,50,0,150,300,0,50,0
150,0,2,25.0,27.0,31.0,31.0,1253,1258,1119,923,134,335,137,117,15,60,122,57,21,24,50,0,250,300,0,50,0
157,0,2,26.0,30.0,31.0,31.0,1303,1236,1147,923,156,313,287,93,145,50,142,43,22,25,50,125,250,300,0,50,0
164,0,2,27.0,31.0,31.0,46.0,1303,1314,1147,979,156,335,247,208,85,125,162,83,23,26,50,125,250,300,0,50,0
171,0,2,29.0,32.0,31.0,46.0,1359,1398,1203,1063,156,335,302,273,120,150,182,123,23,26,150,125,250,300,0,50,0
179,0,2,29.0,34.0,46.0,46.0,1415,1544,1259,1231,156,313,467,419,265,260,202,159,24,28,150,125,250,550,0,50,0
186,0,2,30.0,35.0,46.0,46.0,1382,1550,1203,1259,179,291,252,145,30,100,222,45,24,30,250,300,250,550,0,50,0
193,0,2,32.0,37.0,46.0,46.0,1298,1690,1119,1399,179,291,312,246,70,165,242,81,24,31,250,300,250,550,0,50,0
200,0,2,33.0,38.0,46.0,46.0,1527,1768,1371,1455,156,313,423,156,165,135,258,21,25,32,250,300,250,550,0,50,0
207,0,2,33.0,39.0,46.0,54.0,1443,1807,1287,1539,156,268,338,168,85,115,253,53,25,33,250,300,400,550,0,50,0
214,0,2,37.0,40.0,61.0,54.0,1527,1746,1371,1455,156,291,313,178,40,85,273,93,26,34,350,300,400,550,0,50,0
221,0,2,38.0,41.0,61.0,54.0,1499,1908,1343,1595,156,313,353,203,60,70,293,133,27,35,350,300,400,550,0,50,0
229,0,2,39.0,42.0,61.0,54.0,1723,1930,1567,1595,156,335,238,384,50,215,188,169,28,36,350,300,750,550,0,50,0
236,0,2,43.0,45.0,61.0,54.0,1886,2154,1707,1819,179,335,258,364,50,205,208,159,29,37,450,475,750,550,0,50,0
243,0,2,44.0,47.0,61.0,54.0,1947,2132,1791,1819,156,313,199,460,75,265,124,195,30,39,450,475,750,550,0,50,0
250,0,2,48.0,50.0,61.0,54.0,2087,2154,1931,1707,156,447,99,114,55,5,44,109,32,40,450,475,825,800,0,50,0
257,0,2,53.0,53.0,61.0,62.0,2087,2328,1931,1679,156,649,79,89,40,25,39,64,33,41,600,475,825,1250,0,50,0
264,0,2,55.0,56.0,61.0,62.0,2395,2294,2239,1623,156,671,114,60,55,45,59,15,35,42,600,725,825,1400,0,50,0
271,0,2,58.0,56.0,61.0,62.0,2479,2362,2323,1735,156,627,189,132,135,45,54,87,36,43,650,975,825,1400,0,50,0
279,0,2,61.0,59.0,61.0,62.0,2530,2423,2351,1819,179,604,279,208,205,95,74,113,38,44,875,1225,825,1400,0,50,0
286,0,2,62.0,60.0,69.0,62.0,2670,2384,2491,1735,179,649,334,443,240,250,94,193,40,44,825,1400,825,1400,50,50,0
293,0,2,69.0,61.0,69.0,70.0,2664,2412,2463,1763,201,649,123,688,55,415,68,273,40,45,1050,1400,825,1400,50,50,0
300,0,2,69.0,62.0,69.0,70.0,2894,2328,2491,1679,403,649,249,809,125,460,124,349,43,46,1050,1400,825,1500,50,50,0
307,0,2,68.0,63.0,85.0,70.0,2955,2485,2463,1791,492,694,509,1069,325,640,184,429,40,47,1000,1400,825,1500,250,50,0
314,0,2,64.0,70.0,85.0,70.0,2121,2490,1651,1819,470,671,656,555,420,425,236,130,36,48,1350,1400,825,1500,450,50,0
321,0,2,69.0,67.0,85.0,78.0,1897,2558,1427,1931,470,627,316,417,170,215,146,202,39,49,1250,1150,1025,1500,550,550,0
329,0,2,71.0,67.0,85.0,78.0,2143,2586,1651,1959,492,627,286,323,130,195,156,128,40,50,1250,1600,1025,1500,550,550,0
336,0,2,72.0,69.0,85.0,78.0,2115,2502,1623,1875,492,627,341,508,125,300,216,208,40,51,1250,1600,1025,1500,550,550,0
343,0,2,79.0,70.0,85.0,86.0,2222,2468,1707,1819,515,649,167,719,45,510,122,209,43,51,1600,1600,1025,1500,550,550,0
350,0,2,81.0,77.0,93.0,86.0,2222,2440,1707,1791,515,649,342,265,160,205,182,60,44,53,1600,1850,1025,1500,550,550,0
357,0,2,82.0,78.0,93.0,86.0,2205,2496,1735,1847,470,649,379,406,145,270,234,136,46,53,1700,1800,1025,1500,550,550,0
364,0,2,84.0,80.0,93.0,78.0,2177,2580,1707,1931,470,649,544,1041,250,825,294,216,47,55,1950,2250,1275,1500,550,500,0
371,0,2,88.0,79.0,93.0,78.0,2283,2535,1791,1931,492,604,239,1158,85,870,154,288,47,55,1950,2250,1275,1500,550,500,0
379,0,2,79.0,70.0,101.0,78.0,2289,2507,1819,1903,470,604,505,1245,295,885,210,360,47,52,1575,1425,1275,1800,1025,1425,0
386,0,2,75.0,49.0,101.0,78.0,1919,2227,1539,1623,380,604,364,1237,160,930,204,307,45,44,1350,600,1275,1700,1350,3175,0
7,1,0,13.0,13.0,14.0,15.0,293,293,293,293,0,0,35,35,35,35,0,0,12,12,0,0,0,0,0,0,0
14,1,0,13.0,14.0,14.0,15.0,671,671,671,671,0,0,20,70,20,70,0,0,13,13,0,0,0,0,0,0,0
21,1,0,14.0,14.0,14.0,15.0,727,699,727,699,0,0,55,50,55,50,0,0,13,13,0,0,0,0,0,0,0
29,1,0,14.0,15.0,14.0,15.0,755,699,755,699,0,0,150,85,150,85,0,0,13,14,0,0,0,0,0,0,0
36,1,0,16.0,15.0,22.0,15.0,755,699,755,699,0,0,145,125,145,125,0,0,14,14,0,0,0,0,0,0,0
43,1,0,16.0,16.0,22.0,23.0,783,755,783,755,0,0,235,65,235,65,0,0,14,15,0,0,0,0,0,0,0
50,1,0,15.0,16.0,22.0,23.0,783,755,783,755,0,0,30,35,30,35,0,0,15,15,0,0,0,0,0,0,0
57,1,0,17.0,17.0,22.0,23.0,783,755,783,755,0,0,35,125,35,125,0,0,15,16,0,0,0,0,0,0,0
64,1,0,18.0,18.0,22.0,23.0,839,783,839,783,0,0,90,180,90,180,0,0,16,17,0,0,0,0,0,0,0
71,1,0,17.0,18.0,22.0,23.0,867,861,867,839,0,22,170,284,170,280,0,4,17,17,0,0,0,0,0,0,0
79,1,0,17.0,19.0,22.0,23.0,923,889,923,755,0,134,40,339,40,315,0,24,16,18,0,0,0,0,0,0,0
86,1,0,18.0,19.0,22.0,23.0,923,967,923,811,0,156,95,459,95,415,0,44,16,18,0,0,0,0,0,0,0
93,1,0,19.0,20.0,22.0,23.0,951,1018,951,839,0,179,160,329,160,315,0,14,18,19,0,0,0,150,0,0,0
100,1,0,20.0,20.0,22.0,23.0,1018,995,951,839,67,156,237,435,225,405,12,30,19,19,0,0,0,150,0,0,0
107,1,0,20.0,20.0,22.0,23.0,1090,1023,979,867,111,156,358,165,330,115,28,50,19,19,0,0,0,150,0,0,0
114,1,0,21.0,20.0,22.0,23.0,1107,967,951,811,156,156,443,170,395,100,48,70,20,19,0,0,0,150,0,0,0
121,1,0,27.0,21.0,28.0,23.0,1107,911,951,755,156,156,168,175,100,85,68,90,20,19,0,0,250,150,0,0,0
129,1,0,27.0,23.0,28.0,23.0,1068,1051,979,895,89,156,296,260,220,150,76,110,21,20,0,100,250,150,0,0,0
136,1,0,27.0,23.0,28.0,31.0,1107,1102,1063,923,44,179,430,155,350,125,80,30,21,20,0,100,250,150,0,0,0
143,1,0,27.0,24.0,28.0,31.0,1242,1130,1175,951,67,179,133,240,45,190,88,50,20,21,100,150,250,150,0,0,0
150,1,0,28.0,24.0,28.0,31.0,1214,1163,1147,1007,67,156,221,241,125,225,96,16,20,21,100,150,250,150,0,0,0
157,1,0,31.0,25.0,36.0,31.0,1186,1275,1119,1119,67,156,204,411,100,375,104,36,22,22,400,150,250,150,0,0,0
164,1,0,33.0,26.0,36.0,31.0,1146,1359,1035,1203,111,156,205,121,85,65,120,56,22,23,400,150,250,150,0,0,0
171,1,0,33.0,26.0,36.0,31.0,1202,1303,1091,1147,111,156,57,266,25,190,32,76,25,23,400,150,250,150,0,0,0
179,1,0,36.0,27.0,36.0,46.0,1314,1438,1203,1259,111,179,78,236,30,140,48,96,25,24,400,150,250,400,0,0,0
186,1,0,36.0,27.0,36.0,46.0,1421,1326,1287,1147,134,179,254,131,190,115,64,16,26,24,400,150,250,500,0,0,0
193,1,0,41.0,32.0,44.0,46.0,1477,1387,1343,1231,134,156,190,52,110,20,80,32,28,25,400,150,250,500,0,0,0
200,1,0,43.0,33.0,44.0,46.0,1561,1471,1427,1315,134,156,231,107,135,55,96,52,28,25,550,150,250,500,0,0,0
207,1,0,43.0,34.0,44.0,46.0,1566,1583,1455,1427,111,156,118,87,110,40,8,47,33,26,550,150,250,500,0,0,0
214,1,0,44.0,36.0,50.0,46.0,1662,1723,1595,1567,67,156,171,297,155,230,16,67,33,28,550,350,250,500,0,0,0
221,1,0,47.0,42.0,50.0,46.0,1802,2003,1735,1847,67,156,194,62,170,50,24,12,34,28,550,350,250,825,0,0,0
229,1,0,51.0,45.0,58.0,46.0,1807,1986,1763,1763,44,223,103,180,75,140,28,40,34,30,550,350,250,825,0,0,0
236,1,0,54.0,45.0,66.0,61.0,1858,2238,1791,1903,67,335,186,425,150,345,36,80,38,31,700,350,250,825,0,0,0
243,1,0,59.0,51.0,74.0,61.0,2026,2194,1959,1903,67,291,134,217,90,105,44,112,39,32,700,600,250,825,0,0,0
250,1,0,62.0,52.0,74.0,61.0,2194,2188,2127,1875,67,313,147,102,95,50,52,52,42,33,750,600,250,825,0,0,0
257,1,0,64.0,54.0,74.0,61.0,2272,2076,2183,1763,89,313,159,177,95,135,64,42,44,34,900,825,250,825,0,0,0
264,1,0,68.0,59.0,74.0,61.0,2591,2076,2435,1763,156,313,209,187,125,105,84,82,43,35,950,1025,250,825,100,0,0
271,1,0,70.0,62.0,74.0,69.0,2451,1992,2295,1679,156,313,194,123,90,63,104,60,45,36,1050,1075,250,825,100,0,0
279,1,0,70.0,65.0,82.0,69.0,2479,2261,2323,1903,156,358,234,253,110,153,124,100,46,37,1200,1075,250,825,100,0,0
286,1,0,72.0,69.0,82.0,69.0,2591,2552,2435,2239,156,313,459,360,315,228,144,132,47,39,1250,1325,250,825,100,0,0
293,1,0,79.0,69.0,90.0,69.0,2608,2524,2407,2211,201,313,308,125,140,53,168,72,48,40,1450,1325,250,825,100,0,0
300,1,0,80.0,72.0,98.0,77.0,2720,2636,2407,2323,313,313,468,155,260,93,208,62,51,40,1450,1525,500,825,100,0,0
307,1,0,79.0,75.0,106.0,77.0,2804,2664,2491,2351,313,313,504,235,260,158,244,77,56,43,1450,1725,500,825,100,0,0
314,1,0,81.0,75.0,114.0,77.0,2860,2406,2547,2071,313,335,209,504,175,383,34,121,56,43,1450,1725,500,1075,100,0,0
321,1,0,84.0,78.0,106.0,93.0,3078,2546,2743,1987,335,559,319,576,245,433,74,143,58,46,1450,1500,500,1150,200,225,0
329,1,0,90.0,80.0,106.0,93.0,3146,2826,2743,2155,403,671,186,316,110,193,76,123,61,46,1450,1500,500,1150,200,225,0
336,1,0,87.0,81.0,114.0,93.0,2574,2726,2127,2099,447,627,455,598,335,403,120,195,59,48,1450,1500,500,1400,350,225,0
343,1,0,85.5,77.0,114.0,93.0,1908,2832,1595,2183,313,649,471,953,315,678,156,275,59,49,1425,1550,500,1400,625,425,0
350,1,0,81.0,78.0,114.0,93.0,1936,2686,1623,2015,313,671,461,1128,265,798,196,330,56,49,1150,1450,500,1400,1100,525,0
357,1,0,81.0,78.0,114.0,93.0,1180,2720,867,2071,313,649,136,1039,0,758,136,281,55,49,1000,1150,500,1400,1350,825,0
364,1,0,81.0,83.0,106.0,93.0,1740,2726,1427,2099,313,627,226,920,50,763,176,157,56,51,1200,1150,500,1400,1600,825,0
371,1,0,84.0,80.0,106.0,93.0,1986,3134,1651,2463,335,671,246,1245,30,1008,216,237,59,51,1200,950,700,1400,1650,1125,0
379,1,0,86.0,83.0,106.0,93.0,1818,3106,1483,2435,335,671,372,815,120,648,252,167,63,52,1200,950,700,1700,1650,1325,0
386,1,0,86.0,86.0,112.0,93.0,2300,2804,1987,2155,313,649,513,267,225,153,288,114,64,52,1200,1000,700,1700,1650,1325,0
393,1,0,88.0,90.0,112.0,93.0,2832,2776,2519,2127,313,649,763,407,435,313,328,94,66,55,1200,1400,700,1700,1650,1325,0
400,1,0,93.0,93.0,112.0,93.0,3224,3112,2799,2463,425,649,768,223,380,128,388,95,66,55,1250,1600,700,1700,1650,1325,0
407,1,0,96.0,99.0,112.0,101.0,3213,3196,2743,2547,470,649,838,363,390,238,448,125,69,57,1350,1600,700,1950,1650,1325,0
414,1,0,99.0,102.0,120.0,117.0,3386,3302,2715,2631,671,671,350,289,10,188,340,101,65,59,1350,1925,950,2150,1650,1325,0
421,1,0,103.0,104.0,120.0,133.0,3431,3218,2603,2547,828,671,461,584,75,403,386,181,70,60,1400,2125,950,2150,1650,1325,0
429,1,0,104.0,100.0,120.0,133.0,3633,3230,2827,2603,806,627,762,896,280,643,482,253,70,61,1750,2350,950,2150,1750,1525,0
436,1,0,93.0,102.0,120.0,133.0,3375,3616,2547,2967,828,649,938,1171,460,888,478,283,66,60,1750,2450,1450,2450,2250,1575,0
443,1,0,102.0,100.0,120.0,141.0,2776,3661,2015,2967,761,694,611,690,45,648,566,42,64,60,1800,1950,1450,2450,2450,2075,0
450,1,0,104.0,102.0,112.0,141.0,3235,3728,2519,2967,716,761,785,621,135,483,650,138,63,63,1800,1950,1450,2450,2550,2075,0
457,1,0,106.0,104.0,112.0,141.0,3498,3722,2715,2939,783,783,1095,667,345,533,750,134,78,63,1800,2050,1450,2450,2550,2175,0
464,1,0,106.0,112.0,112.0,149.0,3549,3739,2743,2911,806,828,581,622,210,538,371,84,79,64,1800,2200,1700,2450,2550,2175,0
471,1,0,104.5,114.0,112.0,149.0,3207,3874,2379,3023,828,851,566,802,95,643,471,159,76,66,1575,1950,1825,2450,3025,2475,0
479,1,0,101.5,116.0,112.0,149.0,3386,4137,2603,3331,783,806,634,754,75,503,559,251,66,67,1575,1800,1825,2650,3525,2675,0
486,1,0,105.5,119.0,112.0,149.0,3252,3868,2715,2995,537,873,821,247,210,138,611,109,74,67,1575,2100,1825,2650,3525,2875,0
493,1,0,107.5,127.0,112.0,149.0,3784,4098,3247,3135,537,963,1203,213,520,113,683,100,77,69,1775,2700,1825,2650,3525,2875,0
500,1,0,111.5,129.0,112.0,149.0,3930,4092,3303,3107,627,985,853,508,290,388,563,120,78,69,1925,2700,1825,2650,3525,2875,0
507,1,0,110.5,132.0,112.0,157.0,4098,4126,3359,3163,739,963,859,829,375,593,484,236,77,69,2025,3100,1825,2875,3525,2875,0
514,1,0,112.0,135.0,120.0,157.0,4193,4114,3387,3107,806,1007,875,1170,445,818,430,352,76,69,2000,3400,1825,2875,3650,2875,0
521,1,0,122.0,142.0,128.0,157.0,4215,3958,3387,2995,828,963,601,1222,150,808,451,414,79,69,2650,3450,1825,2875,3650,2925,0
529,1,0,119.5,145.0,136.0,148.0,4327,2866,3499,2015,828,851,782,958,335,548,447,410,78,70,2275,3975,1825,3175,3650,3225,0
536,1,0,129.5,149.0,152.0,156.0,4221,2815,3415,1987,806,828,638,547,245,283,393,264,79,71,2475,4225,1825,3325,3650,3225,0
543,1,0,127.5,153.0,160.0,156.0,4445,3011,3527,2183,918,828,624,324,365,118,259,206,80,72,2825,4275,2075,3325,3675,3575,0
550,1,0,133.5,157.0,160.0,164.0,4518,3252,3555,2491,963,761,355,126,80,103,275,23,81,72,2975,4275,2075,3400,3675,3575,0
557,1,0,137.0,159.0,160.0,172.0,4490,3403,3527,2575,963,828,831,296,540,198,291,98,82,72,3400,4350,2075,3550,3750,3800,0
564,1,0,138.0,163.0,168.0,172.0,4484,3644,3499,2659,985,985,621,516,410,298,211,218,82,72,3400,4650,2075,3550,3750,3800,0
571,1,0,148.5,169.0,168.0,172.0,4456,3655,3471,2715,985,940,337,199,110,48,227,151,84,72,3425,4700,2075,3550,3825,3900,0
579,1,0,150.5,173.0,168.0,180.0,4406,3650,3443,2687,963,963,1059,329,720,133,339,196,84,72,4325,5250,2075,3550,3825,3900,0
586,1,0,152.0,177.0,168.0,180.0,4562,3582,3555,2575,1007,1007,999,434,615,143,384,291,83,72,4300,5450,2075,3550,3850,4000,0
593,1,0,163.5,177.0,168.0,196.0,4512,3678,3527,2715,985,963,410,861,35,458,375,403,82,74,4975,5800,2075,3550,3875,4000,0
600,1,0,161.0,177.0,168.0,196.0,4607,3711,3667,2771,940,940,1323,1307,742,788,581,519,83,74,5275,6250,2075,3550,3649,4000,0
607,1,0,161.5,174.0,184.0,196.0,4518,4310,3555,3303,963,1007,958,1827,357,1188,601,639,83,74,5150,6275,2075,3550,3974,4150,0
614,1,0,153.5,172.0,192.0,196.0,4098,4501,3135,3471,963,1030,1415,2347,702,1588,713,759,81,74,5250,6175,2425,3550,4374,4250,0
621,1,0,147.0,166.0,192.0,196.0,3342,4411,2491,3471,851,940,1061,2096,652,1283,409,813,62,74,5475,5775,2425,3550,5449,4650,0
629,1,0,154.0,179.0,200.0,196.0,3134,4294,2351,3331,783,963,477,1571,272,863,205,708,62,74,5075,5575,2425,3550,5849,4750,0
636,1,0,150.0,167.0,186.0,196.0,2658,4182,1875,3219,783,963,809,1997,512,1173,297,824,68,74,4675,4825,2425,3550,6724,5400,0
643,1,0,152.5,173.0,186.0,196.0,2317,4131,1623,3191,694,940,642,1698,257,808,385,890,68,76,4650,4975,2425,3550,6749,5450,0
650,1,0,141.5,163.0,186.0,196.0,2703,4025,1875,2883,828,1142,976,2187,487,1153,489,1034,68,77,5700,4775,2425,3750,7299,6100,0
657,1,0,143.5,166.0,186.0,196.0,3202,4137,2239,2883,963,1254,908,986,457,458,451,528,67,77,5750,4525,2425,3750,7299,6625,0
664,1,0,150.5,163.0,186.0,196.0,3431,4070,2491,2883,940,1187,461,897,352,483,109,414,67,79,5850,4275,2425,3750,7374,7275,0
671,1,0,156.5,168.0,186.0,196.0,3375,4103,2435,2827,940,1276,339,892,272,468,67,424,67,80,5950,4275,2300,3750,7499,7275,0
679,1,0,162.0,169.0,186.0,196.0,3134,4148,2239,2827,895,1321,48,477,27,318,21,159,69,80,6075,4475,2300,3975,7549,7275,0
686,1,0,163.0,175.0,186.0,196.0,3134,4288,2239,2967,895,1321,320,603,187,438,133,165,68,81,7025,5025,2300,3975,7549,7275,0
693,1,0,164.0,175.0,178.0,211.0,3151,4299,2211,3023,940,1276,265,1101,162,788,103,313,68,82,7325,5850,2300,3975,7749,7275,0
700,1,0,163.0,174.0,178.0,211.0,3056,4422,2071,3079,985,1343,306,1626,87,1153,219,473,70,82,7175,6250,2300,3975,7899,7325,0
707,1,0,165.0,172.0,178.0,211.0,2989,4372,1959,3051,1030,1321,501,1367,162,738,339,629,70,82,7125,6250,2300,3975,7999,7425,0
714,1,0,167.0,182.0,186.0,211.0,3185,3857,2155,2603,1030,1254,417,560,262,283,155,277,69,82,7125,6700,2300,3975,7999,7525,0
721,1,0,170.0,183.0,186.0,226.0,2966,3711,1959,2435,1007,1276,198,576,77,268,121,308,69,82,7275,6650,2650,3975,7999,7575,0
729,1,0,170.0,183.0,192.0,226.0,2854,3818,1847,2519,1007,1299,227,757,132,418,95,339,72,82,7575,6650,2650,3975,7999,7575,0
736,1,0,175.0,183.0,200.0,226.0,3263,3902,2211,2603,1052,1299,334,672,107,423,227,249,72,82,7675,6800,2650,3975,8049,7575,0
743,1,0,176.0,187.0,200.0,226.0,3392,4019,2295,2743,1097,1276,495,1439,207,913,288,526,72,82,7825,7625,2650,4075,8124,7575,0
750,1,0,182.5,185.0,200.0,226.0,3767,3969,2603,2603,1164,1366,100,1739,72,1053,28,686,72,82,8050,7925,2650,4175,8149,7825,0
757,1,0,174.5,182.0,192.0,226.0,3812,3935,2603,2659,1209,1276,351,1598,187,1068,164,530,72,82,7250,7475,2800,4175,8949,8175,0
764,1,0,172.5,182.0,192.0,226.0,3739,4070,2575,2771,1164,1299,549,1188,257,698,292,490,72,81,7050,6575,2800,4000,9399,9300,0
771,1,0,169.5,167.0,192.0,226.0,3890,4047,2771,2771,1119,1276,606,1495,182,853,424,642,72,81,6900,5700,2800,3700,10199,11150,0
779,1,0,167.0,153.0,184.0,226.0,3756,4053,2659,2799,1097,1254,822,2031,262,1233,560,798,72,79,6175,5100,2800,3550,10774,12200,0
786,1,0,175.0,152.0,190.0,226.0,3812,4170,2715,2939,1097,1231,517,1595,92,678,425,917,72,76,6825,4975,2800,3475,10774,12825,0
793,1,0,175.0,151.0,190.0,226.0,3554,3650,2435,2463,1119,1187,638,1897,227,848,411,1049,72,75,7075,5275,2800,3225,10774,13225,0
800,1,0,177.0,143.0,190.0,226.0,3683,3414,2519,2295,1164,1119,638,1883,187,823,451,1060,73,75,7075,4900,2950,3225,11024,14300,0
807,1,0,171.0,145.0,190.0,241.0,3711,3403,2547,2351,1164,1052,775,1623,267,743,508,880,73,73,6725,4825,2950,3000,11699,14900,0
814,1,0,175.0,137.0,190.0,241.0,3801,3202,2659,2127,1142,1075,1022,1804,382,838,640,966,73,69,7075,4350,2950,2750,11699,15825,0
821,1,0,187.0,114.0,190.0,226.0,3605,2462,2463,1455,1142,1007,538,1506,62,578,476,928,73,44,7625,4450,3100,2750,11699,17625,0
829,1,0,188.5,114.0,190.0,186.0,3616,1208,2519,559,1097,649,640,1129,107,333,533,796,73,41,7600,4550,2950,2750,11974,18225,0
836,1,0,182.5,106.0,190.0,178.0,3672,1174,2575,615,1097,559,875,1128,202,268,673,860,73,35,7200,4875,2950,3175,12474,19200,0
841,1,0,182.5,103.0,190.0,162.0,3672,1236,2575,699,1097,537,875,1262,202,291,673,971,73,30,7200,4775,2950,3075,12474,19824,0
7,1,1,13.0,13.0,14.0,14.0,293,335,293,335,0,0,35,40,35,40,0,0,12,12,0,0,0,0,0,0,0
14,1,1,13.0,13.0,14.0,14.0,671,671,671,671,0,0,20,20,20,20,0,0,13,13,0,0,0,0,0,0,0
21,1,1,14.0,14.0,14.0,14.0,699,727,699,727,0,0,55,55,55,55,0,0,13,13,0,0,0,0,0,0,0
29,1,1,14.0,14.0,14.0,14.0,783,699,783,699,0,0,150,145,150,145,0,0,13,13,0,0,0,0,0,0,0
36,1,1,16.0,16.0,22.0,22.0,783,783,783,783,0,0,150,150,150,150,0,0,14,14,0,0,0,0,0,0,0
43,1,1,16.0,15.0,22.0,22.0,811,783,811,783,0,0,240,40,240,40,0,0,14,15,0,0,0,0,0,0,0
50,1,1,15.0,17.0,22.0,22.0,783,811,783,811,0,0,30,40,30,40,0,0,15,15,0,0,0,0,0,0,0
57,1,1,17.0,17.0,22.0,22.0,839,811,839,811,0,0,45,140,45,140,0,0,15,16,0,0,0,0,0,0,0
64,1,1,18.0,17.0,22.0,22.0,895,951,895,951,0,0,100,260,100,260,0,0,16,17,0,0,0,0,0,0,0
71,1,1,17.0,17.0,22.0,22.0,951,951,951,951,0,0,180,15,180,15,0,0,17,16,0,0,0,0,0,0,0
79,1,1,17.0,16.0,22.0,22.0,895,951,895,951,0,0,35,105,35,105,0,0,16,15,0,0,0,0,0,0,0
86,1,1,18.0,16.0,22.0,22.0,979,895,979,895,0,0,105,210,105,210,0,0,16,16,0,0,0,0,0,0,0
93,1,1,19.0,21.0,22.0,22.0,951,979,951,979,0,0,160,20,160,20,0,0,18,16,0,0,0,250,0,0,0
100,1,1,20.0,21.0,22.0,22.0,1018,917,951,895,67,22,237,24,225,20,12,4,18,16,0,0,0,250,0,0,0
107,1,1,20.0,21.0,22.0,22.0,1057,917,923,783,134,134,362,129,330,105,32,24,19,16,0,150,0,250,0,0,0
114,1,1,20.0,22.0,22.0,22.0,995,967,839,811,156,156,478,204,430,160,48,44,20,16,0,150,0,250,0,0,0
121,1,1,27.0,23.0,28.0,30.0,1079,911,923,755,156,156,173,104,105,40,68,64,20,17,0,150,250,250,0,0,0
129,1,1,27.0,25.0,28.0,30.0,1051,962,895,783,156,179,293,219,205,135,88,84,20,17,0,300,250,250,0,0,0
136,1,1,28.0,26.0,28.0,30.0,1079,883,923,727,156,156,83,280,75,180,8,100,20,18,0,300,250,250,0,0,0
143,1,1,28.0,28.0,28.0,36.0,1051,1001,895,867,156,134,213,106,185,90,28,16,20,19,150,300,250,250,0,0,0
150,1,1,27.0,27.5,28.0,36.0,1102,1057,923,923,179,134,348,237,300,205,48,32,20,19,150,275,250,250,50,25,0
157,1,1,30.0,29.5,36.0,36.0,1130,1034,951,923,179,111,128,264,110,220,18,44,19,21,450,275,250,250,50,25,0
164,1,1,30.0,33.0,36.0,36.0,1051,1113,895,979,156,134,249,200,215,140,34,60,19,23,450,400,250,250,50,50,0
171,1,1,31.0,32.0,36.0,36.0,1079,1258,923,1147,156,111,234,112,180,90,54,22,19,24,650,400,250,250,50,50,0
179,1,1,33.0,34.0,36.0,36.0,1135,1292,979,1203,156,89,264,155,190,125,74,30,19,26,650,400,250,250,50,50,0
186,1,1,35.0,34.0,44.0,44.0,1051,1382,895,1315,156,67,289,328,195,290,94,38,19,26,700,400,250,250,50,50,0
193,1,1,40.0,35.0,44.0,44.0,1135,1443,979,1399,156,44,184,97,70,55,114,42,19,27,750,400,250,250,50,50,0
200,1,1,41.0,36.0,44.0,44.0,1130,1527,951,1483,179,44,254,135,120,85,134,50,19,27,800,400,450,250,50,50,0
207,1,1,43.0,38.0,44.0,44.0,1079,1522,923,1455,156,67,230,88,105,30,125,58,19,28,900,400,450,250,50,50,0
214,1,1,44.0,40.0,44.0,44.0,1107,1600,951,1511,156,89,70,185,0,115,70,70,19,29,1200,400,450,450,50,50,0
221,1,1,44.0,43.0,44.0,52.0,1079,1594,923,1483,156,111,100,72,60,65,40,7,19,32,1350,400,450,450,75,50,0
229,1,1,44.0,44.0,52.0,52.0,1079,1141,923,1007,156,134,185,88,125,65,60,23,19,31,1450,500,450,450,225,100,0
236,1,1,39.0,41.5,52.0,52.0,1051,1135,895,979,156,156,115,183,35,165,80,18,19,31,1100,475,450,575,725,275,0
243,1,1,39.0,39.5,52.0,52.0,1046,1247,867,1091,179,156,145,91,45,59,100,32,19,31,800,200,450,575,800,812,0
250,1,1,38.0,35.5,52.0,52.0,1074,827,895,671,179,156,125,61,55,9,70,52,19,28,800,50,450,575,875,1112,0
257,1,1,38.5,28.5,52.0,52.0,1079,111,923,0,156,111,106,69,20,9,86,60,19,21,875,250,450,575,1000,1462,0
264,1,1,36.5,10.5,52.0,58.0,1051,67,895,0,156,67,86,77,5,9,81,68,19,9,725,50,450,575,1175,2337,0
7,1,2,12.0,13.0,14.0,15.0,377,293,377,293,0,0,95,35,95,35,0,0,12,12,0,0,0,0,0,0,0
14,1,2,12.0,14.0,14.0,15.0,699,671,699,671,0,0,175,70,175,70,0,0,12,13,0,0,0,0,0,0,0
21,1,2,11.0,14.0,14.0,15.0,671,699,671,699,0,0,45,0,45,0,0,0,11,13,0,0,0,0,0,0,0
29,1,2,13.0,15.0,14.0,15.0,615,643,615,643,0,0,20,30,20,30,0,0,11,14,0,0,0,0,0,0,0
36,1,2,14.0,15.0,14.0,15.0,615,699,615,699,0,0,40,125,40,125,0,0,12,14,0,0,0,0,0,0,0
43,1,2,14.0,16.0,14.0,23.0,671,699,671,699,0,0,20,15,20,15,0,0,13,15,0,0,0,0,0,0,0
50,1,2,14.0,17.0,14.0,23.0,699,811,699,811,0,0,100,35,100,35,0,0,14,16,0,0,0,0,0,0,0
57,1,2,14.0,18.0,14.0,23.0,783,783,783,783,0,0,200,30,200,30,0,0,14,17,0,0,0,0,0,0,0
64,1,2,16.0,19.0,22.0,23.0,755,755,755,755,0,0,180,120,180,120,0,0,14,18,0,0,250,0,0,0,0
71,1,2,17.0,19.0,22.0,23.0,755,839,755,839,0,0,215,75,215,75,0,0,14,18,0,0,250,0,0,0,0
79,1,2,18.0,20.0,22.0,23.0,699,895,699,895,0,0,255,135,255,135,0,0,14,19,0,0,250,0,0,0,0
86,1,2,18.0,19.0,22.0,23.0,671,995,671,951,0,44,35,203,35,195,0,8,14,19,150,0,250,0,0,0,0
93,1,2,20.0,21.0,22.0,23.0,727,967,727,923,0,44,50,192,50,180,0,12,13,19,150,0,250,150,0,0,0
100,1,2,19.0,21.0,22.0,23.0,699,995,699,951,0,44,240,55,240,35,0,20,13,19,200,0,250,150,0,0,0
107,1,2,18.0,21.0,22.0,31.0,755,822,755,755,0,67,30,143,30,115,0,28,12,19,250,0,250,150,0,0,0
114,1,2,19.0,24.0,22.0,31.0,643,710,643,643,0,67,55,76,55,40,0,36,12,19,250,100,250,300,0,0,0
121,1,2,19.0,24.0,22.0,31.0,671,542,671,475,0,67,145,189,145,145,0,44,12,19,300,100,250,300,0,0,0
129,1,2,20.0,25.0,22.0,31.0,671,508,671,419,0,89,185,191,185,135,0,56,12,20,350,100,400,300,0,0,0
136,1,2,18.5,27.0,22.0,31.0,671,586,671,475,0,111,165,63,165,45,0,18,12,19,275,200,400,450,75,25,0
143,1,2,20.0,25.0,22.0,31.0,671,777,671,643,0,134,105,114,105,80,0,34,12,18,300,100,400,450,100,175,0
150,1,2,19.5,23.0,22.0,31.0,699,777,699,643,0,134,190,100,190,50,0,50,12,18,275,0,400,450,125,275,0
157,1,2,21.5,21.0,30.0,31.0,699,782,699,671,0,111,25,92,25,30,0,62,12,18,275,0,400,300,125,425,0
164,1,2,21.0,23.0,30.0,23.0,755,782,755,671,0,111,115,193,115,115,0,78,12,18,250,125,400,300,150,525,0
171,1,2,20.5,24.0,30.0,31.0,727,810,727,699,0,111,195,235,195,145,0,90,12,19,325,125,250,300,175,525,0
179,1,2,24.5,24.0,36.0,31.0,727,586,727,475,0,111,185,186,185,80,0,106,12,19,475,125,250,400,175,525,0
186,1,2,23.5,21.0,36.0,31.0,783,306,783,195,0,111,275,218,275,100,0,118,12,17,425,125,250,300,225,775,0
193,1,2,27.5,22.0,36.0,23.0,755,514,755,447,0,67,55,251,55,125,0,126,12,17,475,250,250,300,275,875,0
200,1,2,28.5,22.0,36.0,23.0,783,962,783,895,0,67,45,269,45,135,0,134,12,17,425,250,250,300,325,875,0
207,1,2,28.5,20.0,36.0,15.0,727,962,727,895,0,67,25,272,25,130,0,142,16,18,425,125,250,400,325,1100,0
214,1,2,29.5,20.0,36.0,15.0,811,939,811,895,0,44,20,211,20,65,0,146,17,18,525,125,250,400,375,1025,0
221,1,2,30.0,19.0,36.0,15.0,979,822,979,755,0,67,20,299,20,145,0,154,16,17,500,125,250,400,400,1075,0
229,1,2,31.5,22.0,44.0,31.0,951,626,951,559,0,67,20,247,20,110,0,137,18,17,625,125,250,400,425,1075,0
236,1,2,31.0,23.0,44.0,31.0,1007,794,1007,727,0,67,150,375,150,230,0,145,20,18,600,125,250,400,450,1000,0
243,1,2,32.5,22.0,44.0,31.0,1119,710,1119,643,0,67,185,218,185,90,0,128,22,17,575,125,250,400,475,1050,0
250,1,2,33.0,24.0,44.0,31.0,1085,631,1063,587,22,44,264,297,260,165,4,132,24,18,550,250,250,400,500,1050,0
257,1,2,34.0,25.0,44.0,31.0,1253,827,1119,783,134,44,319,350,295,210,24,140,24,18,500,250,250,400,550,1050,0
264,1,2,37.5,25.0,44.0,39.0,1275,962,1119,895,156,67,289,463,245,315,44,148,25,19,475,250,250,400,575,1050,0
271,1,2,37.0,25.0,44.0,39.0,1387,1057,1231,923,156,134,464,188,400,20,64,168,27,19,450,250,250,400,600,1050,0
279,1,2,39.0,26.0,44.0,39.0,1494,995,1315,839,179,156,139,249,55,65,84,184,27,19,450,375,250,400,600,1050,0
286,1,2,41.0,26.0,44.0,39.0,1438,1023,1259,867,179,156,169,79,65,25,104,54,26,19,650,375,250,400,600,1050,0
293,1,2,44.0,26.0,52.0,39.0,1370,1051,1259,895,111,156,172,104,60,30,112,74,29,19,650,375,250,400,600,1050,0
300,1,2,45.0,27.0,52.0,39.0,1421,1023,1287,867,134,156,153,99,25,5,128,94,30,20,700,375,250,400,600,1050,0
307,1,2,44.0,28.0,52.0,39.0,1555,1051,1399,895,156,156,238,229,90,115,148,114,33,21,700,375,250,400,600,1050,0
314,1,2,46.0,29.0,52.0,39.0,1695,1130,1539,951,156,179,358,109,190,25,168,84,33,22,700,375,250,400,600,1050,0
321,1,2,49.0,29.0,60.0,39.0,1751,1152,1595,951,156,201,348,198,160,90,188,108,34,22,700,375,250,400,600,1050,0
329,1,2,50.0,30.0,60.0,47.0,1914,1225,1735,979,179,246,173,341,65,205,108,136,38,23,700,375,250,700,600,1050,0
336,1,2,51.0,34.0,60.0,47.0,1947,1264,1791,951,156,313,229,191,105,165,124,26,37,24,700,375,250,700,600,1050,0
343,1,2,53.0,35.0,68.0,62.0,1947,1342,1791,1007,156,335,304,201,160,135,144,66,38,24,700,375,450,700,600,1050,0
350,1,2,55.0,36.0,68.0,62.0,2065,1292,1819,979,246,313,360,247,180,145,180,102,40,25,700,375,450,700,600,1050,0
357,1,2,63.0,37.0,74.0,62.0,2160,1348,1847,1035,313,313,116,312,0,170,116,142,40,26,700,375,575,700,600,1050,0
364,1,2,64.0,43.0,74.0,62.0,2244,1510,1931,1175,313,335,61,97,30,65,31,32,41,28,700,675,575,700,600,1050,0
371,1,2,68.0,44.0,90.0,62.0,2210,1622,1875,1287,335,335,46,237,0,165,46,72,40,29,700,675,575,700,600,1050,0
379,1,2,70.0,45.0,90.0,62.0,2266,1600,1931,1287,335,313,161,323,75,215,86,108,40,30,1250,675,575,700,600,1050,0
386,1,2,71.0,47.0,90.0,62.0,2233,1678,1875,1343,358,335,281,368,155,220,126,148,43,32,1450,675,825,700,600,1050,0
393,1,2,73.0,47.0,90.0,62.0,2233,1706,1763,1371,470,335,391,478,205,290,186,188,44,32,1450,675,825,700,600,1050,0
400,1,2,75.0,53.0,90.0,62.0,2429,1684,1847,1371,582,313,543,269,310,195,233,74,44,34,1450,1075,825,700,600,1050,0
407,1,2,85.0,54.0,98.0,62.0,2524,1846,1875,1511,649,335,264,404,80,290,184,114,44,35,1450,1075,825,700,600,1050,0
414,1,2,81.0,55.0,98.0,62.0,2104,1818,1455,1483,649,335,344,569,80,415,264,154,43,36,1500,1075,825,800,700,1050,0
421,1,2,83.0,57.0,98.0,62.0,1880,1964,1231,1651,649,313,395,260,105,70,290,190,44,38,1900,1075,825,900,800,1050,0
429,1,2,84.0,57.0,98.0,62.0,2216,1936,1567,1623,649,313,515,405,145,175,370,230,44,38,1950,1475,825,900,900,1050,0
436,1,2,88.0,62.0,106.0,62.0,2328,2070,1679,1735,649,335,191,150,120,30,71,120,46,40,1950,1475,950,900,900,1050,0
443,1,2,89.0,63.0,98.0,70.0,2322,2126,1651,1791,671,335,326,310,275,150,51,160,46,41,2150,1475,950,900,900,1050,0
450,1,2,96.0,63.0,98.0,70.0,2524,1964,1875,1651,649,313,147,341,95,145,52,196,46,42,2750,1475,950,900,900,1050,0
457,1,2,97.0,64.0,106.0,70.0,2552,2182,1903,1847,649,335,338,411,285,175,53,236,46,42,2850,1475,950,900,900,1050,0
464,1,2,103.0,66.0,114.0,70.0,2518,2132,1847,1819,671,313,298,102,165,30,133,72,52,42,2950,1650,950,900,900,1050,0
471,1,2,104.5,70.0,114.0,70.0,2580,2188,1931,1875,649,313,219,343,160,235,59,108,56,43,2825,2050,950,1000,1025,1250,0
479,1,2,104.0,70.0,114.0,70.0,2664,2216,2015,1903,649,313,380,418,245,270,135,148,56,43,2700,2050,950,1100,1125,1250,0
486,1,2,109.0,70.0,122.0,62.0,2804,2126,2155,1791,649,335,280,403,65,215,215,188,58,43,2900,2050,950,1000,1125,1450,0
493,1,2,106.0,70.0,122.0,77.0,3112,2126,2463,1791,649,335,676,678,385,450,291,228,58,43,2700,2050,950,1150,1325,1450,0
500,1,2,108.0,70.0,122.0,77.0,3196,2076,2547,1763,649,313,651,559,280,295,371,264,61,43,2850,2050,950,1000,1325,1600,0
507,1,2,113.0,61.0,122.0,85.0,3280,2182,2631,1847,649,335,537,1169,90,715,447,454,61,43,2850,1525,950,750,1325,2575,0
514,1,2,113.0,56.0,130.0,85.0,3224,2020,2575,1707,649,313,778,1360,255,870,523,490,61,43,2850,1000,950,650,1475,3200,0
521,1,2,111.0,56.0,130.0,85.0,3364,2076,2715,1763,649,313,733,1550,130,1020,603,530,66,43,2700,1000,950,650,1775,3250,0
529,1,2,111.0,50.0,138.0,85.0,3392,2104,2743,1791,649,313,789,1775,110,1205,679,570,66,41,2550,700,950,650,1925,3900,0
536,1,2,113.0,44.0,138.0,85.0,3470,1690,2799,1399,671,291,1049,1397,290,795,759,602,66,35,2700,700,950,700,1925,4350,0
7,0,2,13.0,13.0,15.0,15.0,251,335,251,335,0,0,30,40,30,40,0,0,12,12,0,0,0,0,0,0,0
14,0,2,14.0,14.0,15.0,15.0,671,671,671,671,0,0,70,70,70,70,0,0,13,13,0,0,0,0,0,0,0
21,0,2,14.0,14.0,15.0,15.0,699,671,699,671,0,0,40,45,40,45,0,0,13,13,0,0,0,0,0,0,0
29,0,2,15.0,15.0,15.0,15.0,699,755,699,755,0,0,75,50,75,50,0,0,14,14,0,0,0,0,0,0,0
36,0,2,15.0,15.0,15.0,15.0,727,811,727,811,0,0,125,150,125,150,0,0,14,15,0,0,0,0,0,0,0
43,0,2,16.0,16.0,23.0,23.0,727,839,727,839,0,0,200,90,200,90,0,0,15,15,0,0,0,0,0,0,0
50,0,2,16.0,17.0,23.0,23.0,755,895,755,895,0,0,20,25,20,25,0,0,15,16,0,0,0,0,0,0,0
57,0,2,17.0,18.0,23.0,23.0,671,839,671,839,0,0,35,130,35,130,0,0,16,17,0,0,0,0,0,0,0
64,0,2,17.0,18.0,23.0,23.0,727,951,727,951,0,0,70,190,70,190,0,0,16,17,0,0,0,0,0,0,0
71,0,2,18.0,19.0,23.0,23.0,671,995,671,951,0,44,105,303,105,295,0,8,17,18,0,0,0,0,0,0,0
79,0,2,19.0,20.0,23.0,23.0,698,1062,587,951,111,111,195,385,175,365,20,20,18,19,0,0,0,0,0,0,0
86,0,2,19.0,20.0,23.0,23.0,777,1107,531,951,246,156,291,365,235,325,56,40,18,19,0,0,0,150,0,0,0
93,0,2,20.0,20.0,23.0,23.0,900,1057,587,923,313,134,151,81,105,25,46,56,19,20,0,0,150,150,0,0,0
100,0,2,20.0,20.0,23.0,23.0,900,1023,587,867,313,156,166,106,80,30,86,76,19,20,0,0,150,150,0,0,0
107,0,2,20.0,21.0,23.0,23.0,950,1023,615,867,335,156,276,102,150,10,126,92,19,20,0,0,150,150,0,0,0
114,0,2,20.0,22.0,23.0,23.0,917,1023,559,867,358,156,131,132,65,20,66,112,19,21,0,0,150,150,0,0,0
121,0,2,21.0,25.0,31.0,31.0,911,1107,643,951,268,156,195,132,105,25,90,107,19,22,0,0,150,300,0,0,0
129,0,2,21.0,26.0,31.0,31.0,1107,1107,839,951,268,156,182,122,110,45,72,77,19,23,100,0,150,300,0,0,0
136,0,2,22.0,26.0,31.0,31.0,1253,1146,1007,923,246,223,320,89,220,30,100,59,20,23,100,0,150,300,0,0,0
143,0,2,23.0,27.0,31.0,31.0,1309,1225,1063,867,246,358,428,184,300,85,128,99,21,24,100,0,150,300,0,0,0
150,0,2,23.0,29.0,31.0,31.0,1337,1286,1091,951,246,335,575,285,415,150,160,135,21,24,100,125,150,300,0,0,0
157,0,2,25.0,30.0,31.0,31.0,1314,1264,1091,951,223,313,229,276,70,105,159,171,22,25,100,125,400,300,0,0,0
164,0,2,28.0,32.0,31.0,46.0,1342,1236,1119,923,223,313,241,326,50,115,191,211,22,26,100,125,500,300,0,0,0
171,0,2,29.0,32.0,31.0,46.0,1421,1292,1175,979,246,313,257,181,38,30,219,151,23,26,100,300,500,300,0,0,0
179,0,2,29.0,34.0,31.0,46.0,1253,1326,1007,1035,246,291,409,282,158,95,251,187,23,28,200,300,500,300,0,0,0
186,0,2,31.0,36.0,31.0,46.0,1225,1404,979,1091,246,313,217,287,63,110,154,177,24,29,300,300,500,300,0,0,0
193,0,2,34.0,38.0,39.0,46.0,1135,1510,867,1175,268,335,204,367,18,150,186,217,24,30,300,300,500,300,0,0,0
200,0,2,33.0,38.0,39.0,46.0,1303,1617,1035,1259,268,358,366,557,148,300,218,257,24,31,200,300,500,300,100,0,0
207,0,2,34.0,42.0,39.0,46.0,1516,1622,1203,1287,313,335,416,203,183,10,233,193,25,32,300,300,500,450,100,0,0
214,0,2,35.0,46.0,39.0,46.0,1404,1684,1091,1371,313,313,446,319,173,90,273,229,25,34,400,475,500,700,100,0,0
221,0,2,39.0,46.0,39.0,46.0,1404,1796,1091,1483,313,313,266,224,53,105,213,119,26,34,400,475,750,700,100,0,0
229,0,2,41.0,48.0,54.0,54.0,1449,1824,1091,1511,358,313,391,114,138,55,253,59,27,36,450,475,750,700,100,0,0
236,0,2,44.0,48.0,54.0,54.0,1421,1880,1063,1567,358,313,236,344,68,245,168,99,27,36,500,650,825,700,100,0,0
243,0,2,45.0,50.0,54.0,54.0,1404,1986,1091,1651,313,335,358,489,158,350,200,139,28,38,500,825,825,700,100,0,0
250,0,2,45.0,54.0,54.0,54.0,1404,2042,1091,1707,313,335,363,285,148,210,215,75,28,38,750,1000,925,700,100,0,0
257,0,2,47.0,54.0,54.0,54.0,1796,2098,1483,1763,313,335,438,535,183,420,255,115,29,40,750,1175,925,700,100,0,0
264,0,2,48.0,54.0,54.0,54.0,1796,2182,1483,1847,313,335,498,286,203,135,295,151,30,40,1025,1175,925,700,100,0,0
271,0,2,52.0,56.0,54.0,62.0,1874,2216,1539,1903,335,313,38,452,28,265,10,187,30,40,1075,1175,1000,950,100,0,0
279,0,2,52.0,59.0,54.0,62.0,1841,2104,1483,1791,358,313,148,412,98,260,50,152,31,42,1075,1175,1000,950,100,0,0
286,0,2,54.0,61.0,54.0,70.0,1852,2082,1539,1791,313,291,165,243,83,105,82,138,31,42,1075,1350,1000,950,100,0,0
293,0,2,54.0,63.0,54.0,70.0,1824,2210,1511,1875,313,335,175,318,53,140,122,178,32,44,1175,1450,1000,950,100,0,0
300,0,2,61.0,63.0,62.0,70.0,1684,2272,1371,1959,313,313,235,274,73,60,162,214,33,44,1175,1450,1000,950,100,0,0
307,0,2,61.0,64.0,70.0,78.0,1656,2334,1343,2043,313,291,350,351,148,105,202,246,33,46,1175,1450,1150,950,100,0,0
314,0,2,63.0,64.0,70.0,86.0,1964,2373,1651,2015,313,358,415,284,173,90,242,194,35,46,1475,1450,1150,950,100,0,0
321,0,2,65.0,67.0,70.0,86.0,1953,2490,1595,2043,358,447,600,365,318,190,282,175,35,47,1575,1450,1150,1100,100,0,0
329,0,2,69.0,67.0,78.0,86.0,2457,2434,2099,1987,358,447,285,466,88,335,197,131,37,48,1575,1450,1150,1100,100,0,0
336,0,2,70.0,70.0,78.0,109.0,2356,2294,2043,1847,313,447,217,642,63,455,154,187,38,49,1950,1450,1150,1100,100,0,0
343,0,2,71.0,70.0,78.0,109.0,2496,2216,2183,1791,313,425,367,315,173,80,194,235,39,50,1950,1550,1300,1250,100,0,0
350,0,2,74.0,73.0,78.0,109.0,2608,2378,2295,1931,313,447,522,407,288,120,234,287,40,52,2075,1550,1300,1550,100,0,0
357,0,2,79.0,82.0,86.0,109.0,2709,2770,2351,2323,358,447,285,175,128,90,157,85,41,53,2075,1550,1425,1550,100,0,0
364,0,2,80.0,84.0,86.0,109.0,2821,2877,2351,2407,470,470,425,401,308,260,117,141,42,55,2075,2125,1425,1550,100,0,0
371,0,2,84.0,84.0,86.0,109.0,2754,2905,2127,2435,627,470,210,466,88,415,122,51,43,56,2300,2225,1425,1550,100,0,0
379,0,2,90.0,87.0,94.0,109.0,2849,2989,2155,2519,694,470,230,587,153,480,77,107,45,56,2425,2225,1425,1550,100,0,0
386,0,2,92.0,87.0,94.0,109.0,2720,2994,2071,2547,649,447,342,738,293,575,49,163,46,56,2425,2225,1425,1550,100,0,0
393,0,2,92.0,78.0,94.0,109.0,2804,2994,2155,2547,649,447,303,1089,253,870,50,219,47,50,2300,2225,1425,1850,400,450,0
400,0,2,92.0,81.0,102.0,109.0,2860,2569,2211,2099,649,470,713,1235,633,960,80,275,47,50,2425,2225,1425,2150,400,450,0
407,0,2,97.0,84.0,102.0,125.0,2838,2602,2211,2043,627,559,89,1392,58,1045,31,347,47,53,2425,2225,1525,2150,400,450,0
414,0,2,102.0,102.0,102.0,125.0,2770,2821,2099,2127,671,694,419,693,308,270,111,423,47,53,2950,2225,1525,2150,400,450,0
421,0,2,102.0,105.0,102.0,125.0,2742,2804,2071,2155,671,649,544,570,353,75,191,495,47,56,2950,3125,1525,2450,400,450,0
429,0,2,103.0,108.0,110.0,125.0,2692,2866,2043,2239,649,627,156,606,93,185,63,421,47,56,3200,3125,1525,2450,400,450,0
436,0,2,105.0,106.0,110.0,125.0,2580,2894,1931,2267,649,627,196,766,103,265,93,501,47,59,3200,3025,1525,2450,450,550,0
443,0,2,109.0,102.0,126.0,125.0,2580,2972,1931,2323,649,649,412,1136,243,555,169,581,48,59,3525,2825,1525,2450,575,750,0
450,0,2,112.0,99.0,126.0,125.0,2636,2636,1987,1987,649,649,337,1136,163,625,174,511,49,57,3375,2925,1525,2800,775,1050,0
457,0,2,111.0,111.0,126.0,125.0,2586,2798,1959,2127,627,671,263,517,138,180,125,337,50,57,3175,3900,1525,2900,975,1050,0
464,0,2,110.0,109.0,126.0,125.0,2602,3134,1931,2463,671,671,343,893,238,480,105,413,50,57,3175,3800,1525,3100,1075,1150,0
471,0,2,118.0,113.0,126.0,125.0,2630,3140,1959,2491,671,649,313,964,153,475,160,489,50,57,3625,3800,1525,3100,1075,1250,0
479,0,2,119.0,113.0,126.0,125.0,2664,3090,2015,2463,649,627,225,1350,93,785,132,565,51,57,3725,4300,1525,3100,1175,1250,0
486,0,2,122.0,123.0,141.0,125.0,2770,3146,2099,2519,671,627,260,625,123,130,137,495,52,57,3850,4800,1825,3100,1175,1250,0
493,0,2,124.0,122.0,141.0,125.0,2552,3140,1903,2491,649,649,311,1000,148,425,163,575,53,57,3950,4450,1825,3100,1350,1600,0
500,0,2,128.0,124.0,141.0,125.0,2502,3084,1875,2435,627,649,343,1076,108,475,235,601,54,57,4200,4450,1825,3100,1400,1600,0
507,0,2,133.0,123.0,141.0,149.0,2664,3146,2015,2519,649,627,458,1348,175,750,283,598,55,57,4325,4525,1900,3100,1400,1700,0
514,0,2,135.0,135.0,141.0,149.0,2714,3006,2043,2379,671,627,452,725,96,305,356,420,57,57,4550,5500,2000,3100,1400,1700,0
521,0,2,137.0,140.0,141.0,157.0,2524,3062,1875,2435,649,627,404,696,33,300,371,396,57,57,4750,5800,2100,3100,1400,1700,0
529,0,2,138.0,140.0,141.0,157.0,2832,2636,2183,1987,649,649,576,841,151,365,425,476,58,57,5000,6000,2100,3100,1400,1700,0
536,0,2,139.0,143.0,141.0,157.0,2916,2686,2267,2015,649,671,657,671,156,265,501,406,59,57,5000,6100,2100,3100,1400,1700,0
543,0,2,141.0,143.0,141.0,157.0,3000,2720,2351,2071,649,649,627,1202,96,720,531,482,60,57,5050,6100,2100,3100,1400,1700,0
550,0,2,149.0,137.0,149.0,157.0,3090,2882,2351,2211,739,671,428,1533,76,975,352,558,62,51,5050,6100,2300,3100,1400,2000,0
557,0,2,141.0,133.0,149.0,157.0,3370,2742,2519,2071,851,671,573,1568,171,930,402,638,62,51,4450,5900,2300,3100,1950,2500,0
564,0,2,140.0,133.0,149.0,157.0,3291,2614,2463,1987,828,627,789,1780,266,1070,523,710,64,51,4350,6100,2400,3100,2050,2600,0
571,0,2,144.0,135.0,149.0,157.0,3213,2625,2407,1819,806,806,361,1662,46,990,315,672,65,51,4450,5925,2500,3100,2150,2775,0
579,0,2,139.0,135.0,149.0,157.0,3241,2714,2435,1819,806,895,396,1979,56,1195,340,784,67,53,3875,5825,2600,3100,2850,2875,0
586,0,2,139.0,149.0,149.0,157.0,3297,2754,2491,1791,806,963,697,755,261,305,436,450,67,54,4275,7125,2600,3100,2850,3150,0
593,0,2,144.0,149.0,157.0,157.0,3448,2866,2575,1903,873,963,469,1088,46,530,423,558,67,56,4600,7125,2600,3100,2850,3150,0
600,0,2,140.0,144.0,157.0,157.0,3577,2843,2659,1903,918,940,902,1416,371,750,531,666,67,56,4500,6825,2600,3100,3425,3450,0
607,0,2,140.0,152.0,157.0,157.0,3566,2849,2603,1931,963,918,439,1259,21,485,418,774,67,56,4500,7000,2600,3100,3800,3575,0
614,0,2,141.0,152.0,165.0,157.0,3487,2877,2547,1959,940,918,1076,1111,496,225,580,886,67,56,4625,7500,2600,3100,3850,3775,0
621,0,2,148.0,146.0,165.0,157.0,3325,2798,2407,1903,918,895,544,1443,31,445,513,998,67,56,4725,7125,2600,3100,3950,4150,0
629,0,2,152.0,144.0,165.0,157.0,3487,2905,2547,1987,940,918,746,1805,246,695,500,1110,67,56,5000,7025,2500,3100,4050,4250,0
636,0,2,156.0,157.0,165.0,181.0,3543,3006,2603,2043,940,963,552,1011,86,35,466,976,68,56,5275,6925,2500,3100,4175,4350,0
643,0,2,158.0,157.0,165.0,181.0,3549,3034,2631,2071,918,963,910,1364,336,280,574,1084,68,56,5575,7525,2500,3100,4175,4350,0
650,0,2,157.0,149.0,165.0,181.0,3482,2899,2519,1959,963,940,561,1693,96,505,465,1188,68,56,5475,6825,2500,3100,4375,5050,0
657,0,2,161.0,152.0,165.0,181.0,3431,2910,2491,2015,940,895,734,1446,186,150,548,1296,68,56,5575,6825,2500,3100,4375,5050,0
664,0,2,159.0,138.0,165.0,181.0,3381,2882,2463,1987,918,895,852,1793,221,385,631,1408,69,56,5850,6350,2400,3100,4875,5825,0
671,0,2,163.0,141.0,173.0,181.0,3375,2821,2435,1903,940,918,628,1369,56,145,572,1224,69,59,6375,6250,2625,3100,4875,5925,0
679,0,2,167.0,141.0,173.0,181.0,3319,2793,2379,1875,940,918,650,1367,66,235,584,1132,70,60,6500,6250,2750,3100,4875,5925,0
686,0,2,167.0,141.0,173.0,181.0,2961,2798,2043,1791,918,1007,837,1584,166,340,671,1244,70,60,6325,6250,2750,3350,5275,5925,0
693,0,2,171.0,140.0,173.0,181.0,2955,2787,2015,1847,940,940,669,1623,61,425,608,1198,72,60,6375,5900,2750,3350,5325,6275,0
700,0,2,168.0,141.0,188.0,181.0,3000,2910,2015,2015,985,895,570,1687,146,535,424,1152,72,60,6875,6100,3000,3350,5375,6375,0
707,0,2,173.0,147.0,188.0,189.0,2910,2966,1903,2071,1007,895,636,1553,121,285,515,1268,72,58,6975,6500,3000,3500,5375,6575,0
714,0,2,171.0,153.0,188.0,189.0,2888,2994,1903,2099,985,895,658,1375,56,145,602,1230,72,58,6500,6500,3225,3850,5900,6575,0
721,0,2,170.0,149.0,188.0,189.0,2899,2989,1959,2071,940,918,771,1742,186,400,585,1342,72,58,6500,7425,3125,3850,6050,6775,0
729,0,2,155.0,135.0,188.0,204.0,2446,3056,1595,2071,851,985,575,2088,61,630,514,1458,72,58,5225,6575,3125,3850,7383,7625,0
736,0,2,160.0,150.0,188.0,204.0,2821,3084,2015,2099,806,985,505,1546,41,130,464,1416,72,58,5750,7175,3125,3850,7383,7625,0
743,0,2,160.0,150.0,188.0,204.0,3627,2653,2799,1735,828,918,634,1835,91,315,543,1520,71,58,5750,7175,2900,3850,7658,7625,0
750,0,2,150.0,150.0,188.0,204.0,3762,2518,2911,1623,851,895,699,1993,181,365,518,1628,70,58,4975,6875,2900,3850,8633,7925,0
757,0,2,148.0,166.0,188.0,204.0,2933,2714,2239,1819,694,895,661,530,171,140,490,390,68,58,5425,6775,2900,3850,8783,8025,0
764,0,2,141.0,152.0,188.0,204.0,2664,2938,2015,2043,649,895,811,886,266,380,545,506,68,61,4925,8175,2900,3850,9333,8725,0
771,0,2,150.0,152.0,188.0,204.0,3224,3073,2575,2155,649,918,582,1258,136,640,446,618,68,61,5375,8175,2900,3850,9333,8725,0
779,0,2,156.0,152.0,188.0,204.0,3448,3224,2799,2239,649,985,757,1640,256,910,501,730,68,61,5625,6575,2900,3850,9333,8725,0
786,0,2,158.0,152.0,188.0,204.0,3482,3118,2855,2155,627,963,703,2013,151,1175,552,838,69,61,5850,6575,2900,3850,9383,8725,0
793,0,2,162.0,170.0,188.0,204.0,3414,3157,2743,2239,671,918,603,512,21,170,582,342,69,61,6025,8375,2900,3850,9383,8725,0
800,0,2,164.0,166.0,188.0,204.0,3498,3218,2827,2323,671,895,1073,909,411,455,662,454,69,61,6100,9750,3000,3850,9483,8925,0
807,0,2,153.0,158.0,188.0,204.0,3414,3162,2743,2267,671,895,934,1291,446,725,488,566,69,61,5275,9225,3150,3850,10458,9450,0
814,0,2,146.0,123.0,188.0,204.0,3532,3269,2771,2351,761,918,515,1702,231,1020,284,682,69,61,4850,5775,3300,3850,11358,12900,0
821,0,2,154.0,139.0,188.0,204.0,3616,3370,2855,2407,761,963,693,889,321,245,372,644,69,61,5500,6175,3300,3850,11358,13400,0
829,0,2,160.0,142.0,188.0,204.0,3498,3364,2715,2379,783,985,279,582,11,180,268,402,69,61,5600,6175,3300,3850,11358,13400,0
836,0,2,157.0,138.0,188.0,204.0,3577,3381,2659,2463,918,918,375,966,41,460,334,506,69,61,5425,5725,3200,3850,11633,13850,0
843,0,2,160.0,138.0,180.0,204.0,3526,3302,2631,2407,895,895,405,1354,96,740,309,614,67,61,5875,5725,3200,3850,12058,13850,0
850,0,2,166.0,138.0,180.0,204.0,3437,3269,2631,2351,806,918,450,645,66,415,384,230,66,61,6350,5950,3200,3850,12108,14225,0
857,0,2,171.0,150.0,180.0,204.0,3409,3386,2491,2491,918,895,527,202,43,110,484,92,69,61,6950,5950,3200,3850,12108,14225,0
864,0,2,175.0,148.0,180.0,204.0,3297,3353,2379,2435,918,918,435,589,93,385,342,204,69,61,7175,6825,3200,3850,12108,14225,0
871,0,2,174.0,146.0,180.0,204.0,3347,3476,2407,2491,940,985,327,995,128,675,199,320,69,61,7225,6725,3300,3850,12158,14325,0
879,0,2,164.0,138.0,180.0,204.0,3358,3510,2463,2547,895,963,250,1409,118,985,132,424,69,61,7075,6325,3300,3850,12833,15325,0
886,0,2,168.0,106.0,180.0,204.0,3291,3465,2351,2547,940,918,351,1203,153,975,198,228,69,61,7400,3525,3300,3850,13033,18125,0
893,0,2,170.0,119.0,180.0,204.0,3566,3414,2603,2519,963,895,347,720,233,380,114,340,69,61,7350,4025,3300,3850,13083,18525,0
900,0,2,172.0,105.0,180.0,204.0,3918,3386,3023,2491,895,895,327,1132,188,680,139,452,69,61,7225,3325,3300,3850,13433,19225,0
907,0,2,163.0,88.0,195.0,196.0,3958,3353,2995,2435,963,918,203,1543,98,975,105,568,69,57,6550,2225,3300,3850,14233,20625,0
914,0,2,164.0,100.0,195.0,196.0,3263,2989,2323,2127,940,862,436,971,123,305,313,666,71,56,6550,1825,3300,3850,14408,21375,0
921,0,2,168.0,99.0,195.0,196.0,2815,2927,1931,2099,884,828,387,737,43,275,344,462,71,55,6825,2725,3300,3850,14758,21725,0
929,0,2,167.0,97.0,195.0,196.0,2944,2933,2183,2127,761,806,512,1080,78,530,434,550,71,55,6875,2550,3300,3850,15283,21900,0
936,0,2,160.0,93.0,195.0,196.0,3078,2922,2463,2183,615,739,575,1435,223,805,352,630,71,55,6250,2350,3400,3850,16133,22100,0
943,0,2,162.0,101.0,195.0,196.0,3157,2950,2575,2211,582,739,676,531,323,155,353,376,71,55,6300,2150,3400,3850,16483,22600,0
950,0,2,164.0,104.0,195.0,196.0,3851,3006,3247,2267,604,739,858,733,458,265,400,468,71,55,6725,3675,3400,3850,16483,22600,0
957,0,2,168.0,107.0,195.0,196.0,3594,2810,2967,2071,627,739,494,760,143,350,351,410,71,59,6675,3675,3400,3850,16583,22600,0
964,0,2,166.0,104.0,195.0,196.0,3566,2933,2939,2127,627,806,892,1121,473,615,419,506,71,59,6750,3375,3400,3850,16833,22900,0
971,0,2,164.0,112.0,195.0,196.0,3398,2983,2771,2155,627,828,713,768,393,170,320,598,71,59,6525,4000,3550,3850,17283,23275,0
979,0,2,154.0,95.0,195.0,196.0,3834,2916,3163,2155,671,761,378,1097,78,415,300,682,71,59,5675,2850,3550,3850,18308,24425,0
986,0,2,139.0,91.0,195.0,196.0,3773,2888,3079,2183,694,705,481,1264,143,500,338,764,71,59,4500,2800,3550,3850,19608,24975,0
993,0,2,139.0,97.0,195.0,196.0,3879,2966,3163,2351,716,615,379,1015,78,475,301,540,71,59,3975,2800,3550,3850,20408,24975,0
1000,0,2,144.0,97.0,195.0,196.0,3739,2849,3023,2267,716,582,428,1047,93,585,335,462,71,59,4225,2800,3550,3850,20508,24975,0
1007,0,2,151.0,97.0,195.0,196.0,3470,2793,2687,2211,783,582,450,1079,98,695,352,384,71,59,4375,2800,3550,3850,20508,24975,0
1014,0,2,157.0,107.0,195.0,196.0,3605,2860,2687,2211,918,649,492,560,178,350,314,210,71,59,4725,3675,3550,3850,20608,24975,0
1021,0,2,164.0,114.0,195.0,196.0,3661,2810,2743,2183,918,627,394,458,43,180,351,278,71,59,5100,4175,3550,3850,20608,25075,0
1029,0,2,165.0,119.0,195.0,196.0,3778,2905,2883,2323,895,582,591,322,153,180,438,142,73,59,5350,4475,3550,3850,20708,25075,0
1036,0,2,172.0,119.0,195.0,196.0,3739,2821,2799,2239,940,582,746,158,213,140,533,18,73,59,6000,4650,3700,3850,20708,25075,0
1043,0,2,178.0,119.0,195.0,204.0,3700,2877,2715,2295,985,582,1022,510,423,420,599,90,73,59,6400,4650,4000,3850,20708,25075,0
1050,0,2,180.0,115.0,195.0,212.0,3364,2765,2379,2183,985,582,1114,851,553,685,561,166,73,59,6325,4750,4000,3850,20833,25175,0
1057,0,2,182.0,110.0,195.0,212.0,3683,2927,2743,2323,940,604,1433,903,793,815,640,88,73,59,6900,4425,4000,3850,20933,25800,0
1064,0,2,178.0,124.0,195.0,212.0,3605,2882,2687,2211,918,671,1161,444,713,280,448,164,73,59,6275,5050,4150,3850,21883,25975,0
1071,0,2,180.0,105.0,195.0,212.0,3605,2759,2687,2155,918,604,642,768,453,540,189,228,73,59,5875,3725,4150,3850,22133,26900,0
1079,0,2,176.0,99.0,195.0,212.0,3627,2877,2687,2295,940,582,243,1016,113,720,130,296,73,59,5350,3425,4150,4150,22908,27300,0
1086,0,2,175.0,97.0,195.0,212.0,3627,2871,2687,2267,940,604,120,357,103,135,17,222,73,59,5375,1650,4150,3900,23058,29325,0
1092,0,2,175.0,74.0,195.0,212.0,3627,2810,2687,2183,940,627,120,354,103,210,17,144,73,59,5375,900,4150,3700,23058,31275,0
7,0,2,13.0,13.0,15.0,15.0,293,251,293,251,0,0,35,30,35,30,0,0,12,12,0,0,0,0,0,0,0
14,0,2,14.0,14.0,15.0,15.0,643,671,643,671,0,0,65,70,65,70,0,0,13,13,0,0,0,0,0,0,0
21,0,2,14.0,14.0,15.0,15.0,699,727,699,727,0,0,50,45,50,45,0,0,13,13,0,0,0,0,0,0,0
29,0,2,15.0,15.0,15.0,15.0,643,783,643,783,0,0,75,90,75,90,0,0,14,14,0,0,0,0,0,0,0
36,0,2,15.0,15.0,15.0,15.0,699,811,699,811,0,0,125,140,125,140,0,0,14,14,0,0,0,0,0,0,0
43,0,2,16.0,16.0,23.0,23.0,783,811,783,811,0,0,70,25,70,25,0,0,15,15,0,0,0,0,0,0,0
50,0,2,16.0,17.0,23.0,23.0,811,811,811,811,0,0,40,45,40,45,0,0,15,16,0,0,0,0,0,0,0
57,0,2,17.0,18.0,23.0,23.0,727,755,727,755,0,0,80,40,80,40,0,0,16,17,0,0,0,0,0,0,0
64,0,2,18.0,19.0,23.0,23.0,755,895,755,895,0,0,165,132,165,132,0,0,17,18,0,0,0,0,0,0,0
71,0,2,18.0,19.0,23.0,23.0,771,895,727,895,44,0,258,192,250,192,8,0,17,18,0,0,0,0,0,0,0
79,0,2,18.0,20.0,23.0,23.0,810,922,699,811,111,111,355,307,335,287,20,20,18,19,0,0,0,0,0,0,0
86,0,2,19.0,21.0,23.0,23.0,715,995,559,839,156,156,390,223,350,187,40,36,18,20,0,0,0,150,0,0,0
93,0,2,20.0,21.0,23.0,23.0,850,995,671,839,179,156,390,338,380,282,10,56,18,21,0,0,150,150,0,0,0
100,0,2,20.0,21.0,23.0,23.0,911,1051,755,895,156,156,346,473,320,397,26,76,19,21,0,0,150,150,0,0,0
107,0,2,20.0,21.0,23.0,23.0,911,1107,755,951,156,156,466,203,420,107,46,96,19,21,0,0,150,150,0,0,0
114,0,2,20.0,22.0,23.0,23.0,911,1107,755,951,156,156,81,183,15,67,66,116,19,21,0,0,150,150,0,0,0
121,0,2,20.0,22.0,23.0,23.0,911,1130,755,951,156,179,146,193,60,57,86,136,19,21,0,0,150,300,0,0,0
129,0,2,22.0,25.0,23.0,31.0,883,1074,727,895,156,179,151,138,45,32,106,106,19,22,100,0,150,300,0,0,0
136,0,2,22.0,25.0,23.0,31.0,934,1191,755,1035,179,156,266,134,140,62,126,72,19,22,100,0,150,300,0,0,0
143,0,2,22.0,26.0,31.0,31.0,990,1124,811,923,179,201,186,207,140,107,46,100,20,23,150,0,150,300,0,0,0
150,0,2,23.0,27.0,31.0,31.0,1191,1186,1035,895,156,291,27,358,15,222,12,136,20,24,150,175,150,300,0,0,0
157,0,2,23.0,28.0,31.0,31.0,1191,1208,1035,895,156,313,157,78,125,52,32,26,20,23,150,175,150,300,0,0,0
164,0,2,24.0,29.0,31.0,31.0,1219,1264,1063,951,156,313,182,179,130,117,52,62,21,24,150,175,150,300,0,0,0
171,0,2,24.0,29.0,31.0,31.0,1247,1208,1091,895,156,313,327,269,255,167,72,102,21,24,150,175,150,300,0,0,0
179,0,2,25.0,31.0,31.0,46.0,1275,1146,1119,811,156,335,417,209,325,67,92,142,22,25,150,175,250,300,0,0,0
186,0,2,27.0,32.0,46.0,46.0,1124,1253,923,895,201,358,361,264,245,82,116,182,23,26,150,350,600,300,0,0,0
193,0,2,30.0,33.0,46.0,54.0,1275,1314,1007,979,268,335,123,420,100,202,23,218,23,27,150,350,600,550,0,0,0
200,0,2,31.0,34.0,46.0,54.0,1398,1404,1063,1091,335,313,238,241,175,137,63,104,24,28,150,350,600,550,0,0,0
207,0,2,31.0,35.0,46.0,54.0,1314,1516,979,1203,335,313,248,136,145,92,103,44,24,29,250,350,600,550,0,0,0
214,0,2,33.0,37.0,46.0,54.0,1510,1516,1175,1203,335,313,388,116,245,32,143,84,25,31,350,350,600,550,0,0,0
221,0,2,36.0,38.0,46.0,54.0,1628,1572,1315,1259,313,313,439,271,285,147,154,124,26,32,350,350,600,550,0,0,0
229,0,2,39.0,39.0,46.0,54.0,1902,1650,1567,1315,335,335,414,226,320,62,94,164,27,33,350,350,850,550,0,0,0
236,0,2,43.0,40.0,46.0,54.0,1846,1841,1511,1483,335,358,489,396,355,192,134,204,29,34,350,350,850,550,0,0,0
243,0,2,43.0,43.0,46.0,54.0,1964,1846,1651,1511,313,335,390,282,245,92,145,190,29,35,450,350,850,550,0,0,0
250,0,2,46.0,44.0,46.0,54.0,1936,1964,1623,1651,313,313,505,363,320,137,185,226,31,37,550,525,850,800,0,0,0
257,0,2,46.0,46.0,46.0,54.0,2042,1964,1707,1651,335,313,700,348,475,82,225,266,32,37,750,525,850,800,0,0,0
264,0,2,49.0,47.0,54.0,54.0,2154,2048,1819,1735,335,313,795,463,555,157,240,306,33,38,750,525,925,950,0,0,0
271,0,2,52.0,51.0,62.0,62.0,1992,2126,1679,1791,313,335,156,373,80,127,76,246,33,39,800,700,925,1100,0,0,0
279,0,2,55.0,53.0,62.0,62.0,1958,2093,1623,1735,335,358,201,433,85,197,116,236,35,39,850,875,925,1100,0,0,0
286,0,2,60.0,53.0,62.0,62.0,1790,2182,1455,1847,335,335,91,604,60,332,31,272,37,39,850,1300,1000,1250,0,0,0
293,0,2,60.0,58.0,62.0,62.0,1908,2160,1595,1735,313,425,322,475,255,272,67,203,37,39,900,1300,1000,1250,0,0,0
300,0,2,61.0,59.0,62.0,62.0,2266,1958,1931,1511,335,447,592,337,485,182,107,155,39,38,850,1475,1000,1250,100,143,0
307,0,2,63.0,61.0,70.0,70.0,2546,1622,2211,1287,335,335,192,437,45,242,147,195,39,38,850,1825,1000,1250,100,143,0
314,0,2,65.0,61.0,70.0,70.0,2412,1975,2099,1595,313,380,413,624,230,377,183,247,41,38,1150,1925,1000,1250,100,143,0
321,0,2,65.0,62.0,70.0,70.0,2490,2194,2155,1679,335,515,383,784,210,477,173,307,43,40,1325,1925,1000,1250,200,143,0
329,0,2,61.0,60.0,70.0,70.0,2266,2166,1931,1651,335,515,653,1025,440,662,213,363,43,41,1225,1750,1000,1250,400,318,0
336,0,2,65.0,68.0,70.0,70.0,1981,2255,1623,1763,358,492,527,456,395,237,132,219,45,41,1175,1575,1000,1250,450,493,0
343,0,2,67.0,68.0,101.0,78.0,2199,2233,1707,1763,492,470,656,427,460,252,196,175,45,41,1175,2275,1000,1250,450,493,0
350,0,2,66.0,69.0,101.0,78.0,2552,2261,1903,1791,649,470,711,682,560,447,151,235,47,43,975,2275,1000,1250,650,493,0
357,0,2,66.0,70.0,101.0,78.0,2798,2261,2127,1791,671,470,907,567,680,422,227,145,47,43,975,2275,1300,1250,650,493,0
364,0,2,67.0,71.0,101.0,78.0,2468,2283,1819,1791,649,492,1128,382,825,177,303,205,48,44,1075,2275,1300,1250,650,493,0
371,0,2,65.0,64.0,101.0,78.0,2110,2390,1483,1875,627,515,1351,657,976,392,375,265,47,46,1025,1575,1300,1250,1025,1193,0
379,0,2,66.0,72.0,101.0,86.0,2194,2339,1567,1847,627,492,1162,239,736,122,426,117,47,47,1075,2100,1300,1250,1025,1193,0
386,0,2,68.0,72.0,101.0,86.0,2373,2373,1791,1903,582,470,1100,415,706,242,394,173,47,47,1075,2275,1300,1250,1025,1193,0
393,0,2,77.0,76.0,101.0,86.0,2731,2261,2127,1791,604,470,465,315,216,182,249,133,49,47,1175,2275,1300,1250,1025,1193,0
400,0,2,78.0,78.0,101.0,86.0,3336,2289,2687,1819,649,470,728,435,425,242,303,193,49,47,1225,2275,1300,1250,1025,1193,0
407,0,2,82.0,79.0,101.0,94.0,3084,2423,2435,1931,649,492,693,695,379,442,314,253,51,48,1275,2275,1550,1250,1025,1193,0
414,0,2,86.0,84.0,101.0,94.0,3448,2362,2799,1847,649,515,313,255,119,42,194,213,52,50,1500,2275,1550,1250,1025,1193,0
421,0,2,89.0,84.0,101.0,94.0,3778,2334,3107,1819,671,515,574,431,304,162,270,269,53,51,1900,2525,1650,1250,1025,1193,0
429,0,2,93.0,84.0,101.0,94.0,3840,2395,3191,1903,649,492,725,477,554,152,171,325,54,51,2075,2900,1650,1250,1025,1193,0
436,0,2,96.0,84.0,101.0,109.0,3426,2429,2799,1959,627,470,956,743,734,362,222,381,54,51,2250,2900,1650,1550,1025,1193,0
443,0,2,98.0,88.0,101.0,109.0,3392,2457,2743,1987,649,470,896,543,594,352,302,191,55,51,2250,3400,1950,1550,1025,1193,0
450,0,2,98.0,86.0,101.0,117.0,3538,2569,2911,2099,627,470,1307,858,929,607,378,251,51,51,2675,3150,1950,1650,1225,1443,0
457,0,2,100.0,87.0,101.0,117.0,2306,2759,1791,2267,515,492,1533,753,1099,442,434,311,53,51,2800,2900,1950,1650,1225,1693,0
464,0,2,101.0,90.0,101.0,117.0,2093,2866,1623,2351,470,515,1584,1083,1194,712,390,371,52,54,2850,2900,2050,2100,1275,1693,0
471,0,2,101.0,97.0,101.0,117.0,2423,2894,1819,2379,604,515,1309,824,839,397,470,427,54,55,2725,3100,2050,2100,1638,1693,0
479,0,2,101.0,98.0,101.0,117.0,2328,2843,1679,2351,649,492,980,815,434,332,546,483,54,57,2725,3200,2050,2250,1638,1693,0
486,0,2,106.0,110.0,109.0,117.0,2334,2737,1707,2267,627,470,886,541,264,2,622,539,56,58,2725,3200,2050,2250,1763,1693,0
493,0,2,109.0,111.0,109.0,125.0,2440,2877,1791,2407,649,470,886,601,484,102,402,499,59,59,2725,3700,2050,2400,1763,1693,0
500,0,2,118.0,112.0,133.0,125.0,2882,2916,2211,2379,671,537,856,706,474,335,382,371,59,61,2875,3700,2350,2400,1763,1693,0
507,0,2,118.0,114.0,133.0,125.0,2972,3028,2323,2267,649,761,887,826,429,355,458,471,60,63,2925,3700,2350,2400,1763,1693,0
514,0,2,121.0,124.0,133.0,125.0,3134,3319,2463,2491,671,828,443,637,159,70,284,567,61,64,2825,4100,2350,2550,1963,1693,0
521,0,2,124.0,124.0,149.0,125.0,3218,3325,2547,2519,671,806,803,623,314,60,489,563,61,65,3025,4200,2350,2550,1963,1693,0
529,0,2,123.0,124.0,173.0,125.0,3392,3297,2631,2491,761,806,704,934,269,275,435,659,62,65,3000,4200,2350,2550,2088,1693,0
536,0,2,135.0,122.0,173.0,133.0,3650,3325,2687,2519,963,806,730,1334,204,575,526,759,63,65,3525,4025,2350,2700,2088,1868,0
543,0,2,137.0,138.0,173.0,141.0,3902,3297,2939,2491,963,806,1135,920,489,65,646,855,63,65,3500,4025,2600,3050,2288,1868,0
550,0,2,137.0,138.0,173.0,157.0,4070,3347,3107,2519,963,828,1326,1180,664,225,662,955,65,65,3500,4725,2600,3050,2288,1868,0
557,0,2,145.0,138.0,173.0,157.0,4092,3067,3107,2239,985,828,791,1126,59,75,732,1051,66,67,3875,4725,2600,3050,2288,1868,0
564,0,2,149.0,138.0,173.0,157.0,3924,2871,2939,2043,985,828,782,1077,259,130,523,947,66,67,4450,4725,2600,3050,2288,1868,0
571,0,2,149.0,150.0,173.0,157.0,3918,2849,2911,2043,1007,806,828,218,239,75,589,143,66,67,4450,5325,2700,3050,2288,1868,0
579,0,2,156.0,142.0,173.0,149.0,3734,3045,2771,2239,963,806,1300,594,599,355,701,239,66,63,4875,5175,2700,3200,2288,2518,0
586,0,2,153.0,119.0,173.0,149.0,3454,2933,2491,2127,963,806,1716,1230,899,895,817,335,66,58,4850,4725,2700,3200,2438,3368,0
593,0,2,136.0,103.0,173.0,149.0,3482,3017,2519,2211,963,806,2136,1215,1199,780,937,435,66,58,4400,3925,2700,3200,3338,4168,0
600,0,2,142.0,103.0,173.0,149.0,3454,2933,2491,2127,963,806,1787,1461,809,930,978,531,66,58,4325,3925,2900,3200,3538,4168,0
607,0,2,143.0,122.0,173.0,149.0,3482,3011,2519,2183,963,828,1873,686,779,55,1094,631,66,58,4325,3925,2900,3200,3538,4168,0
614,0,2,145.0,125.0,173.0,149.0,3750,2989,2743,2183,1007,806,1683,733,719,160,964,573,67,61,4625,4725,2900,3200,3538,4168,0
621,0,2,157.0,127.0,173.0,157.0,3756,3101,2771,2295,985,806,1055,849,379,180,676,669,67,63,4875,4725,2900,3200,3538,4168,0
629,0,2,157.0,138.0,188.0,157.0,3627,3017,2687,2211,940,806,1507,259,719,90,788,169,67,66,4875,4925,2900,3200,3538,4168,0
636,0,2,163.0,138.0,188.0,157.0,3678,3129,2715,2323,963,806,537,330,29,215,508,115,67,66,5175,5525,2900,3200,3538,4168,0
643,0,2,159.0,137.0,188.0,157.0,3728,3213,2743,2407,985,806,959,700,349,485,610,215,67,69,5175,5425,2800,3200,3838,4268,0
650,0,2,158.0,129.0,188.0,157.0,3930,3123,2967,2295,963,828,1454,1076,730,765,724,311,67,70,5475,5025,2800,3200,4088,4668,0
657,0,2,161.0,135.0,188.0,157.0,4092,3235,3107,2407,985,828,1930,1042,1090,635,840,407,67,70,5675,5325,2800,3350,4188,4768,0
664,0,2,161.0,133.0,188.0,157.0,4114,3269,3107,2463,1007,806,2411,1423,1455,920,956,503,67,70,5675,4825,3250,3350,4188,4868,0
671,0,2,167.0,133.0,188.0,157.0,3734,3101,2771,2295,963,806,2383,1009,1340,510,1043,499,67,70,5925,4050,3250,3350,4188,6093,0
679,0,2,171.0,130.0,188.0,172.0,3370,3297,2407,2491,963,806,1919,959,935,360,984,599,67,70,6475,4200,3250,3350,4188,6343,0
686,0,2,174.0,130.0,188.0,172.0,3202,3325,2239,2519,963,806,1239,1360,285,665,954,695,67,70,6475,4200,3250,3350,4188,6343,0
693,0,2,173.0,138.0,188.0,172.0,2950,3381,1987,2575,963,806,765,1361,120,570,645,791,67,70,6375,4600,3250,3350,4588,6343,0
700,0,2,163.0,136.0,188.0,172.0,3056,3599,2071,2771,985,828,615,1426,275,535,340,891,67,70,5575,4875,3250,3350,5488,6843,0
707,0,2,126.0,108.0,188.0,172.0,3190,3655,2183,2827,1007,828,991,1842,535,855,456,987,67,70,3725,2375,3250,3350,8038,8943,0
714,0,2,110.0,110.0,188.0,172.0,3190,3711,2183,2883,1007,828,1237,1608,690,675,547,933,67,70,2775,2300,3775,3350,9062,9468,0
721,0,2,122.0,110.0,188.0,172.0,3202,3577,2239,2771,963,806,1149,1579,515,550,634,1029,67,70,3125,2475,3875,3350,9112,9743,0
729,0,2,132.0,111.0,188.0,172.0,3174,3381,2211,2575,963,806,690,1445,15,320,675,1125,67,72,3375,2475,3875,3650,9112,9743,0
736,0,2,133.0,128.0,188.0,172.0,3112,3437,2127,2631,985,806,755,365,85,265,670,100,67,74,3375,2475,3875,3800,9112,9743,0
743,0,2,141.0,128.0,188.0,172.0,3426,3459,2463,2631,963,828,1191,766,405,570,786,196,68,75,3850,2675,3875,3800,9112,9743,0
750,0,2,145.0,129.0,188.0,172.0,4008,3358,3023,2463,985,895,1202,859,325,630,877,229,68,77,4825,4125,3875,3800,9112,9743,0
757,0,2,153.0,129.0,188.0,172.0,4086,3398,3079,2435,1007,963,1235,675,264,330,971,345,68,77,5175,4125,3875,3800,9112,9743,0
764,0,2,157.0,135.0,188.0,172.0,4036,3728,3051,2631,985,1097,1649,716,575,235,1074,481,68,77,5325,4125,3875,4100,9112,9880,0
771,0,2,146.0,129.0,188.0,196.0,4042,3728,3079,2519,963,1209,2116,754,930,125,1186,629,68,77,4675,3825,3875,4100,9746,10580,0
779,0,2,143.0,115.0,188.0,204.0,4126,3762,3163,2575,963,1187,2586,1059,1280,290,1306,769,68,77,5025,3275,3875,4100,10096,11530,0
786,0,2,140.0,111.0,188.0,204.0,4098,3868,3135,2659,963,1209,2787,1013,1390,100,1397,913,68,77,4650,2075,3875,4350,10696,12730,0
793,0,2,150.0,115.0,188.0,204.0,3980,3812,2995,2603,985,1209,1647,958,505,205,1142,753,68,77,4675,2575,3875,4350,10871,12730,0
800,0,2,154.0,114.0,188.0,204.0,3862,3728,2855,2519,1007,1209,2108,997,850,300,1258,697,68,76,4825,2975,3875,4350,10871,12780,0
807,0,2,146.0,106.0,188.0,219.0,3330,3140,2323,2043,1007,1097,2484,1340,1110,515,1374,825,68,74,4475,2425,3875,4200,11396,13730,0
814,0,2,141.0,104.0,188.0,219.0,3146,3017,2183,1987,963,1030,2851,1228,1365,275,1486,953,68,74,4400,2325,3875,4200,11926,14330,0
821,0,2,136.0,106.0,188.0,219.0,3090,3599,2127,2659,963,940,2847,857,1270,400,1577,457,68,74,4025,2825,3875,4300,12576,14630,0
829,0,2,135.0,99.0,188.0,219.0,3252,4008,2267,3135,985,873,3247,1131,1550,570,1697,561,68,74,4450,1525,3875,4300,12751,15330,0
836,0,2,146.0,108.0,188.0,219.0,3118,4092,2155,3219,963,873,2348,1130,635,465,1713,665,68,74,4450,2325,3875,4300,12751,15430,0
843,0,2,155.0,114.0,188.0,219.0,3174,4226,2211,3331,963,895,1684,828,105,405,1579,423,68,74,4825,2825,3875,4300,12751,15430,0
850,0,2,158.0,116.0,188.0,219.0,2966,4142,1959,3247,1007,895,2014,1122,315,745,1699,377,68,74,4975,3025,3875,4300,12751,15430,0
857,0,2,168.0,124.0,188.0,211.0,2860,3521,1875,2603,985,918,2351,815,540,330,1811,485,69,74,5875,3025,3875,4200,12751,15930,0
864,0,2,158.0,108.0,188.0,211.0,2726,3269,1763,2351,963,918,2677,1201,750,600,1927,601,69,74,5100,2625,3875,4200,13604,16730,0
871,0,2,168.0,112.0,188.0,196.0,2866,3190,1903,2295,963,895,2243,1285,225,580,2018,705,69,74,5550,2425,3875,4200,13604,17330,0
879,0,2,172.0,116.0,188.0,196.0,3174,3185,2211,2267,963,918,2254,657,320,290,1934,367,69,74,5850,2725,3875,4200,13604,17330,0
886,0,2,174.0,122.0,188.0,196.0,3230,3218,2267,2323,963,895,2604,1041,550,570,2054,471,69,74,6050,3725,3875,4200,13604,17330,0
893,0,2,186.0,126.0,188.0,196.0,2916,3526,1931,2631,985,895,2325,665,180,390,2145,275,69,74,6675,3725,3875,4200,13604,17330,0
900,0,2,186.0,126.0,188.0,188.0,3162,3431,2155,2603,1007,828,2711,1066,450,695,2261,371,69,74,6675,3725,3875,4100,13604,17530,0
907,0,2,188.0,118.0,188.0,165.0,3224,2502,2239,1931,985,571,3067,1315,690,890,2377,425,69,72,7225,3725,3875,3950,13604,18730,0
914,0,2,152.0,97.0,188.0,157.0,2787,2199,1903,1819,884,380,3400,1283,925,810,2475,473,65,61,5700,2425,3875,3950,15804,20680,0
921,0,2,144.0,98.0,188.0,157.0,2793,2171,1987,1791,806,380,3745,941,1170,420,2575,521,65,58,5275,2575,3875,3950,16229,21580,0
929,0,2,134.0,88.0,188.0,157.0,2905,2334,2099,1931,806,403,3851,1224,1255,655,2596,569,65,58,4500,2575,3875,3950,17154,22080,0
936,0,2,136.0,86.0,188.0,157.0,2765,2423,1959,2043,806,380,2786,1118,390,805,2396,313,65,58,4500,2275,3875,3950,16854,22380,0
943,0,2,131.0,102.0,188.0,157.0,2815,2479,1987,2099,828,380,2757,607,340,250,2417,357,65,58,3950,3075,3875,3950,17404,22380,0
950,0,2,119.0,90.0,188.0,157.0,2838,2446,1987,2043,851,403,3097,295,580,90,2517,205,65,58,3350,2275,3875,3950,18004,23630,0
957,0,2,123.0,96.0,188.0,157.0,2849,2479,2043,2099,806,380,2519,289,185,40,2334,249,65,58,3475,2375,3875,3950,18104,23630,0
964,0,2,129.0,98.0,188.0,172.0,2877,2423,2071,2043,806,380,3060,382,530,235,2530,147,65,58,4075,2875,3875,3950,18104,23630,0
971,0,2,128.0,102.0,188.0,164.0,2843,2418,2015,2071,828,347,2775,469,270,280,2505,189,65,58,3925,3075,3875,3950,18254,23730,0
979,0,2,116.0,96.0,188.0,164.0,2877,2362,2071,2127,806,235,3116,748,515,535,2601,213,65,58,3100,2775,3875,3950,19329,24030,0
986,0,2,121.0,106.0,188.0,164.0,2905,2149,2099,1903,806,246,2712,486,215,245,2497,241,65,58,3350,3275,3875,3950,19329,24030,0
993,0,2,126.0,108.0,188.0,164.0,2894,2037,2043,1791,851,246,2152,389,5,270,2147,119,65,58,3700,3275,3875,3950,19329,24030,0
1000,0,2,132.0,112.0,188.0,164.0,2882,2345,2099,2099,783,246,2485,322,250,275,2235,47,65,58,4225,3825,3875,3950,19329,24030,0
1007,0,2,132.0,116.0,218.0,164.0,2658,2776,1987,2463,671,313,2585,461,270,370,2315,91,65,58,4150,4325,3875,3950,19329,24030,0
1014,0,2,132.0,124.0,218.0,164.0,2630,2787,1959,2295,671,492,2335,231,190,205,2145,26,65,58,4200,4825,3875,3950,19329,24030,0
1021,0,2,133.0,124.0,218.0,164.0,2216,2692,1567,2155,649,537,2545,559,195,465,2350,94,65,58,4925,5075,3875,3950,19504,24030,0
1029,0,2,133.0,122.0,218.0,164.0,2154,2826,1483,2267,671,559,2799,902,365,740,2434,162,65,58,5300,4975,3875,3950,19629,24130,0
1036,0,2,132.0,138.0,218.0,164.0,2098,2826,1427,2267,671,559,3030,436,520,210,2510,226,64,58,5575,5475,3875,3950,19679,24130,0
1043,0,2,139.0,142.0,218.0,164.0,2003,2793,1287,2211,716,582,2632,399,71,205,2561,194,61,58,5575,5775,3875,3950,19829,24130,0
1050,0,2,139.0,144.0,218.0,164.0,1880,2670,1231,2043,649,627,2852,535,220,315,2632,220,60,58,6075,6300,3975,3950,19979,24130,0
1057,0,2,139.0,150.0,218.0,164.0,1796,2602,1147,1931,649,671,3040,150,329,50,2711,100,60,58,6800,6050,3975,3950,19979,24380,0
1064,0,2,139.0,152.0,218.0,164.0,1662,2731,1035,2015,627,716,2921,272,267,230,2654,42,60,58,6850,6750,3975,3950,19979,24380,0
1071,0,2,147.0,158.0,218.0,164.0,2160,2558,1511,1707,649,851,2615,270,15,120,2600,150,60,58,6850,6950,3975,3950,19979,24380,0
1079,0,2,147.0,158.0,218.0,164.0,2418,2552,1791,1679,627,873,2887,594,218,340,2669,254,60,58,6850,7250,3975,3950,19979,24380,0
1086,0,2,128.0,130.0,218.0,164.0,2462,2630,1791,1735,671,895,3182,908,433,550,2749,358,49,58,5900,5575,3875,3950,21651,26055,0
1093,0,2,139.0,130.0,218.0,164.0,2322,2574,1651,1679,671,895,2863,1197,38,735,2825,462,49,58,6400,5575,3875,3950,21651,26055,0
1100,0,2,128.0,130.0,210.0,164.0,2104,2535,1455,1707,649,828,2949,1513,48,955,2901,558,38,58,6400,5575,4125,3950,22301,26055,0
1107,0,2,129.0,140.0,210.0,164.0,1662,2496,1035,1623,627,873,3100,721,123,55,2977,666,36,58,6475,4975,4125,3950,22663,26655,0
1114,0,2,132.0,140.0,210.0,164.0,1460,2658,811,1763,649,895,3070,1034,13,260,3057,774,37,58,6725,6075,4125,3950,22663,26655,0
1121,0,2,134.0,140.0,210.0,164.0,1494,2552,867,1679,627,873,3131,1338,23,460,3108,878,39,58,6725,6075,4125,3950,22663,26655,0
1129,0,2,130.0,138.0,210.0,164.0,1746,2502,1119,1707,627,795,3138,1642,29,670,3109,972,33,58,6925,5875,4125,3950,23014,26855,0
1136,0,2,127.0,122.0,195.0,141.0,1594,2087,923,1483,671,604,3318,1862,129,830,3189,1032,30,42,6925,5875,4125,3850,23717,28255,0
1143,0,2,126.0,127.0,195.0,141.0,1600,1298,951,895,649,403,3514,1206,249,130,3265,1076,31,37,7000,5875,4125,3850,23767,28880,0
1150,0,2,111.0,77.0,195.0,141.0,1578,1275,951,895,627,380,3710,1360,369,240,3341,1120,31,37,5875,3375,4125,3850,24892,31880,0
7,0,2,13.0,13.0,15.0,15.0,293,293,293,293,0,0,35,35,35,35,0,0,12,12,0,0,0,0,0,0,1
14,0,2,14.0,14.0,15.0,15.0,671,671,671,671,0,0,70,70,70,70,0,0,13,13,0,0,0,0,0,0,1
21,0,2,14.0,14.0,15.0,15.0,671,727,671,727,0,0,45,50,45,50,0,0,13,13,0,0,0,0,0,0,1
29,0,2,15.0,15.0,15.0,15.0,755,727,755,727,0,0,95,85,95,85,0,0,14,14,0,0,0,0,0,0,1
36,0,2,15.0,16.0,15.0,23.0,755,839,755,839,0,0,130,145,130,145,0,0,14,15,0,0,0,0,0,0,1
43,0,2,16.0,16.0,23.0,23.0,839,811,839,811,0,0,80,35,80,35,0,0,15,15,0,0,0,0,0,0,1
50,0,2,16.0,17.0,23.0,23.0,839,811,839,811,0,0,50,55,50,55,0,0,15,16,0,0,0,0,0,0,1
57,0,2,17.0,18.0,23.0,23.0,755,811,755,811,0,0,135,115,135,115,0,0,16,17,0,0,0,0,0,0,1
64,0,2,17.0,18.0,23.0,23.0,783,923,783,923,0,0,230,75,230,75,0,0,17,17,0,0,0,0,0,0,1
71,0,2,18.0,19.0,23.0,23.0,799,945,755,923,44,22,278,189,270,185,8,4,17,18,0,0,0,0,0,0,1
79,0,2,19.0,20.0,23.0,23.0,861,967,727,923,134,44,324,353,300,345,24,8,18,19,0,0,0,0,0,0,1
86,0,2,19.0,20.0,23.0,23.0,889,1023,755,979,134,44,434,76,390,60,44,16,18,19,0,0,0,150,0,0,1
93,0,2,20.0,20.0,23.0,23.0,883,1046,727,979,156,67,339,199,275,175,64,24,19,20,0,0,150,150,0,0,1
100,0,2,20.0,21.0,23.0,23.0,911,1068,755,979,156,89,444,121,360,85,84,36,19,20,0,0,150,150,0,0,1
107,0,2,20.0,21.0,23.0,23.0,1018,1012,839,923,179,89,154,83,50,35,104,48,19,20,50,0,150,150,0,0,1
114,0,2,20.0,22.0,23.0,23.0,934,1062,755,951,179,111,274,99,150,35,124,64,19,21,50,0,150,150,0,0,1
121,0,2,21.0,23.0,23.0,23.0,995,1079,839,923,156,156,90,219,50,135,40,84,19,22,50,0,150,150,0,0,1
129,0,2,21.0,23.0,23.0,31.0,1079,1079,923,923,156,156,125,304,115,200,10,104,19,22,50,0,150,150,0,0,1
136,0,2,22.0,26.0,23.0,31.0,1191,1102,1035,923,156,179,105,259,75,160,30,99,20,23,50,0,150,300,0,0,1
143,0,2,22.0,26.0,23.0,31.0,1247,1191,1091,923,156,268,245,235,195,150,50,85,20,23,50,0,150,300,0,50,1
150,0,2,23.0,27.0,23.0,31.0,1219,1236,1063,923,156,313,150,206,80,185,70,21,21,24,50,0,150,300,0,50,1
157,0,2,23.0,29.0,31.0,46.0,1270,1236,1091,923,179,313,245,181,155,145,90,36,21,24,50,125,150,300,0,50,1
164,0,2,26.0,31.0,31.0,46.0,1191,1286,1035,951,156,335,26,146,20,120,6,26,22,25,50,125,500,300,0,50,1
171,0,2,28.0,32.0,31.0,46.0,1219,1398,1063,1063,156,335,61,266,35,200,26,66,23,26,50,125,500,300,0,50,1
179,0,2,29.0,34.0,31.0,46.0,1348,1404,1147,1091,201,313,174,212,120,135,54,77,23,28,50,125,600,300,0,50,1
186,0,2,29.0,36.0,46.0,46.0,1460,1510,1147,1175,313,335,144,342,50,225,94,117,23,28,200,250,600,300,0,50,1
193,0,2,33.0,40.0,46.0,46.0,1510,1600,1175,1287,335,313,159,288,25,235,134,53,24,30,250,250,600,600,0,50,1
200,0,2,34.0,41.0,46.0,46.0,1617,1684,1259,1371,358,313,254,338,80,245,174,93,24,32,250,250,850,600,0,50,1
207,0,2,34.0,41.0,46.0,46.0,1538,1768,1203,1455,335,313,375,548,165,415,210,133,24,32,250,250,850,600,0,50,1
214,0,2,40.0,41.0,46.0,46.0,1516,1874,1203,1539,313,335,216,219,70,150,146,69,25,33,450,375,850,600,0,50,1
221,0,2,43.0,43.0,46.0,54.0,1488,1846,1175,1511,313,335,211,84,25,75,186,9,27,33,450,625,850,600,0,50,1
229,0,2,44.0,45.0,46.0,54.0,1572,1796,1259,1483,313,313,291,185,65,140,226,45,27,33,450,625,850,600,0,50,1
236,0,2,46.0,47.0,46.0,54.0,1768,1908,1455,1595,313,313,369,330,103,245,266,85,29,35,550,625,850,600,0,50,1
243,0,2,50.0,47.0,54.0,54.0,2098,1874,1763,1539,335,335,449,445,143,320,306,125,29,35,850,625,850,600,0,50,1
250,0,2,52.0,50.0,54.0,54.0,2121,1902,1763,1567,358,335,529,220,183,155,346,65,31,37,850,875,850,700,0,50,1
257,0,2,52.0,51.0,54.0,62.0,1958,1902,1623,1567,335,335,580,306,248,205,332,101,31,37,950,875,850,950,0,50,1
264,0,2,56.0,53.0,62.0,62.0,2020,1958,1707,1623,313,335,561,391,193,325,368,66,33,38,1050,875,850,1250,0,50,1
271,0,2,56.0,54.0,62.0,62.0,1936,1992,1623,1679,313,313,581,132,173,30,408,102,33,39,1050,1125,1000,1250,0,50,1
279,0,2,62.0,57.0,62.0,70.0,2188,1964,1875,1539,313,425,276,132,153,70,123,62,35,40,1050,1125,1000,1250,0,50,1
286,0,2,60.0,57.0,70.0,70.0,2188,2031,1875,1427,313,604,441,208,278,120,163,88,36,39,850,1400,1000,1250,300,150,1
293,0,2,56.0,57.0,70.0,70.0,2233,1466,1875,951,358,515,351,249,148,105,203,144,36,38,550,1400,1000,1250,607,250,1
300,0,2,58.0,57.0,70.0,70.0,1986,1488,1651,1063,335,425,497,136,233,90,264,46,38,38,550,1400,1000,1250,607,250,1
307,0,2,59.0,59.0,70.0,70.0,2104,2037,1791,1455,313,582,543,241,243,190,300,51,39,40,550,1650,1000,1250,607,250,1
314,0,2,62.0,62.0,70.0,70.0,2104,2289,1791,1595,313,694,698,96,358,65,340,31,40,40,650,1650,1000,1250,607,250,1
321,0,2,63.0,63.0,70.0,70.0,2496,2194,2183,1567,313,627,953,249,573,150,380,99,41,41,950,1650,1000,1250,607,250,1
329,0,2,62.0,64.0,70.0,70.0,2496,2244,2183,1595,313,649,1248,264,828,185,420,79,41,43,1300,1750,1125,1250,657,250,1
336,0,2,68.0,65.0,70.0,78.0,2546,2283,2211,1679,335,604,813,291,628,140,185,151,42,43,1300,1750,1250,1250,657,250,1
343,0,2,69.0,67.0,70.0,93.0,2401,2339,2043,1735,358,604,828,572,603,345,225,227,42,45,1300,2000,1550,1250,657,250,1
350,0,2,70.0,75.0,70.0,93.0,2434,2446,2099,1819,335,627,209,167,98,60,111,107,43,46,1400,2000,1550,1550,657,250,1
357,0,2,70.0,75.0,70.0,93.0,2468,2429,2155,1735,313,694,445,452,298,265,147,187,44,48,1400,2000,1550,1550,657,250,1
364,0,2,70.0,81.0,70.0,101.0,2569,2490,2211,1819,358,671,363,453,268,190,95,263,45,49,1675,2300,1625,1650,657,250,1
371,0,2,77.0,84.0,78.0,101.0,2569,2608,1987,1959,582,649,538,370,388,135,150,235,45,49,1675,2300,1625,1900,657,250,1
379,0,2,77.0,85.0,78.0,101.0,2608,2698,1959,2071,649,627,388,381,283,70,105,311,45,52,1675,2300,1625,1900,657,250,1
386,0,2,83.0,87.0,94.0,101.0,2496,2675,1847,2071,649,604,330,622,253,235,77,387,46,52,1775,2300,1625,1900,657,250,1
393,0,2,90.0,93.0,94.0,101.0,2490,2782,1819,2155,671,627,165,427,108,110,57,317,47,53,2025,2800,1625,1900,657,250,1
400,0,2,93.0,97.0,94.0,101.0,2558,2882,1931,2211,627,671,182,398,78,105,104,293,48,55,2025,3325,1825,1900,657,250,1
407,0,2,92.0,99.0,94.0,101.0,2698,2961,2071,2267,627,694,402,653,218,280,184,373,49,55,1875,3325,1825,2050,907,250,1
414,0,2,90.0,97.0,102.0,101.0,3000,2776,2351,2127,649,649,772,920,508,475,264,445,50,54,2025,3325,1825,2200,1007,400,1
421,0,2,87.0,89.0,110.0,101.0,2854,2009,2183,1539,671,470,707,1143,513,650,194,493,51,52,2100,2875,1825,2200,1532,950,1
429,0,2,91.0,94.0,125.0,101.0,2854,2054,2183,1763,671,291,693,750,473,225,220,525,51,51,2150,2875,1825,2200,1532,1050,1
436,0,2,95.0,100.0,125.0,101.0,2938,2513,2267,2267,671,246,544,413,398,60,146,353,51,51,2150,3250,1825,2200,1532,1050,1
443,0,2,98.0,101.0,125.0,101.0,2916,2698,2267,2407,649,291,580,493,358,100,222,393,53,52,2275,3550,1825,2200,1532,1050,1
450,0,2,98.0,101.0,125.0,101.0,2838,2793,2211,2323,627,470,671,334,373,85,298,249,54,53,2100,3550,1825,2200,1832,1050,1
457,0,2,101.0,101.0,125.0,101.0,2782,2670,2155,2155,627,515,611,443,283,130,328,313,55,53,2375,3550,1825,2200,1832,1050,1
464,0,2,109.0,104.0,125.0,117.0,3078,2737,2407,2155,671,582,306,341,123,110,183,231,56,53,2950,3550,1825,2200,1832,1050,1
471,0,2,113.0,105.0,133.0,117.0,2938,2709,2267,2127,671,582,291,613,78,310,213,303,57,56,2950,3550,1825,2200,1832,1050,1
479,0,2,114.0,113.0,133.0,117.0,2972,2843,2323,2239,649,604,233,319,48,140,185,179,58,56,3075,4050,1825,2500,1832,1050,1
486,0,2,116.0,115.0,133.0,117.0,3213,3006,2519,2379,694,627,107,635,38,380,69,255,58,58,3300,4050,1975,2650,1832,1050,1
493,0,2,121.0,116.0,133.0,117.0,3314,3090,2575,2351,739,739,150,703,43,360,107,343,59,60,3575,4150,2125,2650,1832,1050,1
500,0,2,121.0,116.0,141.0,117.0,3308,3090,2547,2351,761,739,417,772,218,345,199,427,59,60,4025,4150,2125,2650,1832,1050,1
507,0,2,127.0,117.0,141.0,117.0,3532,3095,2771,2379,761,716,313,891,168,380,145,511,62,60,4150,4150,2275,2650,1832,1050,1
514,0,2,128.0,125.0,141.0,133.0,3694,3174,2911,2435,783,739,545,978,308,375,237,603,62,60,4275,4150,2275,2800,1832,1050,1
521,0,2,123.0,127.0,141.0,149.0,3638,3140,2855,2379,783,761,957,1045,628,350,329,695,65,61,3900,4250,2275,3050,2082,1250,1
529,0,2,109.0,113.0,149.0,149.0,3778,3157,2995,2351,783,806,1415,1326,998,535,417,791,65,63,2950,4150,2525,3050,3032,2250,1
536,0,2,86.0,99.0,157.0,149.0,3717,3230,2911,2491,806,739,1726,1705,1238,830,488,875,66,63,1550,3125,2525,3050,4882,3275,1
543,0,2,92.0,109.0,157.0,149.0,3784,3252,3023,2491,761,761,1449,1122,1073,455,376,667,66,63,1425,3400,2525,3050,5007,3525,1
550,0,2,90.0,110.0,157.0,149.0,3700,3224,2939,2463,761,761,1180,1009,1058,250,122,759,66,63,1200,3400,2525,3050,5232,3525,1
557,0,2,94.0,117.0,157.0,149.0,3599,3252,2771,2491,828,761,559,1096,458,245,101,851,66,66,1325,3700,2525,3050,5232,3525,1
564,0,2,97.0,116.0,157.0,149.0,3325,3196,2407,2435,918,761,517,1188,333,445,184,743,66,66,1575,3700,2525,3050,5232,3525,1
571,0,2,106.0,116.0,157.0,149.0,3129,3230,2211,2379,918,851,137,967,49,420,88,547,68,66,2025,3700,2525,3050,5232,3525,1
579,0,2,114.0,122.0,157.0,149.0,3532,3213,2547,2295,985,918,87,805,34,350,53,455,70,66,2150,4350,2725,3050,5232,3525,1
586,0,2,116.0,125.0,157.0,149.0,3902,3213,2939,2295,963,918,428,1042,264,475,164,567,72,66,2275,4350,2725,3050,5232,3525,1
593,0,2,122.0,125.0,157.0,149.0,4019,3286,3079,2323,940,963,344,1244,214,565,130,679,73,66,2525,4350,2825,3050,5232,3525,1
600,0,2,124.0,131.0,157.0,149.0,4014,3291,3051,2351,963,940,334,737,209,400,125,337,75,69,2650,4350,3175,3400,5232,3525,1
607,0,2,131.0,139.0,157.0,157.0,4305,3386,3275,2491,1030,895,494,655,324,360,170,295,77,69,3025,4650,3175,3400,5182,3525,1
614,0,2,133.0,139.0,157.0,157.0,4478,3353,3471,2435,1007,918,365,752,104,345,261,407,77,69,3725,5800,3175,3400,5182,3525,1
621,0,2,135.0,139.0,157.0,180.0,4462,3207,3499,2267,963,940,748,638,404,115,344,523,77,69,3725,5800,3250,3400,5182,3525,1
629,0,2,143.0,148.0,165.0,180.0,4148,3157,3163,2239,985,918,265,271,134,90,131,181,77,69,3975,5800,3250,3400,5182,3525,1
636,0,2,145.0,150.0,180.0,180.0,4131,3235,3191,2295,940,940,630,453,396,310,234,143,77,72,4375,6600,3350,3400,5182,3525,1
643,0,2,145.0,154.0,180.0,180.0,4019,3314,3079,2351,940,963,1117,515,764,260,353,255,78,72,4500,6000,3350,3700,5182,3525,1
650,0,2,148.0,156.0,180.0,180.0,4238,3437,3275,2519,963,918,193,429,124,120,69,309,80,72,4500,6900,3350,4100,5182,3525,1
657,0,2,163.0,156.0,180.0,180.0,4126,3717,3163,2799,963,918,155,901,74,480,81,421,80,72,5225,7075,3550,4500,5182,3525,1
664,0,2,165.0,166.0,180.0,180.0,4103,3935,3163,2995,940,940,539,873,354,340,185,533,80,72,5225,7475,3550,4500,5182,3525,1
671,0,2,165.0,166.0,180.0,180.0,3689,3857,2771,2939,918,918,521,1220,374,575,147,645,80,72,5225,7575,3550,4500,5182,3525,1
679,0,2,165.0,170.0,180.0,180.0,3162,3913,2267,2995,895,918,804,1503,549,750,255,753,80,72,5825,7775,3550,4500,5182,3525,1
686,0,2,159.0,176.0,180.0,180.0,3353,4019,2435,3079,918,940,1536,1445,1052,580,484,865,74,72,6550,7825,3550,4650,6031,3675,1
693,0,2,153.0,168.0,180.0,188.0,3269,3991,2351,3051,918,940,1413,702,1067,125,346,577,70,72,6700,7425,3700,4650,6356,4075,1
700,0,2,151.0,168.0,180.0,188.0,3146,3840,2183,2967,963,873,1675,1157,1217,480,458,677,68,72,6700,7425,4000,4800,6456,4075,1
707,0,2,162.0,172.0,180.0,188.0,3146,3918,2183,3023,963,895,802,444,732,305,70,139,68,72,6700,7425,4000,4800,6556,4075,1
714,0,2,163.0,176.0,180.0,188.0,2849,3974,1931,3079,918,895,677,593,507,350,170,243,68,72,6700,8025,4000,4800,6556,4175,1
721,0,2,166.0,176.0,180.0,188.0,2854,3907,1959,2967,895,940,489,1060,357,705,132,355,69,72,6850,7875,4000,4800,6556,4175,1
729,0,2,166.0,179.0,180.0,196.0,2770,3694,1875,2575,895,1119,271,680,77,185,194,495,69,72,6850,8325,4000,4800,6556,4175,1
736,0,2,168.0,185.0,180.0,196.0,2765,3638,1847,2407,918,1231,532,594,222,105,310,489,72,72,7950,8325,4200,4800,6581,4175,1
743,0,2,174.0,185.0,180.0,196.0,2765,3728,1847,2519,918,1209,399,733,102,100,297,633,74,75,7950,8850,4300,4800,6581,4175,1
750,0,2,180.0,185.0,180.0,196.0,3112,3627,2127,2463,985,1164,381,853,122,180,259,673,75,75,7950,8850,4450,4800,6581,4175,1
757,0,2,180.0,183.0,180.0,196.0,3291,3510,2351,2323,940,1187,510,1292,147,475,363,817,77,75,7950,8600,4450,5000,6581,4425,1
764,0,2,180.0,195.0,180.0,196.0,3336,3840,2351,2631,985,1209,505,1141,197,180,308,961,78,75,7950,8900,4450,5450,6581,4425,1
771,0,2,180.0,181.0,180.0,204.0,3493,3666,2351,2547,1142,1119,934,1465,482,380,452,1085,78,75,8075,8350,4450,5450,6581,5275,1
779,0,2,140.0,148.0,180.0,219.0,3672,3711,2463,2547,1209,1164,1390,1744,782,565,608,1179,78,74,4625,6150,4550,5450,10006,7525,1
786,0,2,113.0,140.0,180.0,227.0,3666,3879,2435,2715,1231,1164,1355,1609,620,290,735,1319,82,74,1600,4675,4550,5450,13359,9175,1
793,0,2,112.0,140.0,180.0,227.0,3526,4042,2295,2855,1231,1187,1257,1859,503,400,754,1459,82,74,1475,5175,4550,5750,13484,9275,1
800,0,2,114.0,144.0,195.0,227.0,3543,4210,2267,3023,1276,1187,1565,1668,655,265,910,1403,82,74,1575,4975,4550,5750,13484,9475,1
807,0,2,131.0,154.0,195.0,227.0,3879,4210,2603,3023,1276,1187,1006,1664,385,125,621,1539,82,74,2000,5775,4550,5750,13484,9475,1
814,0,2,131.0,154.0,195.0,227.0,3717,4238,2463,3051,1254,1187,1372,2178,599,495,773,1683,82,74,2000,6175,4550,5750,13484,9475,1
821,0,2,140.0,160.0,195.0,227.0,3532,4159,2323,2995,1209,1164,766,2174,224,555,542,1619,82,74,2300,6425,4550,5750,13484,9475,1
829,0,2,142.0,164.0,195.0,227.0,3890,4182,2659,2995,1231,1187,847,2179,149,570,698,1609,82,74,2400,6425,4550,5750,13484,9475,1
836,0,2,144.0,184.0,195.0,227.0,3812,4159,2603,2995,1209,1164,1030,564,305,165,725,399,82,76,3000,6625,4550,5750,13484,9475,1
843,0,2,151.0,184.0,195.0,227.0,3896,4221,2575,3079,1321,1142,727,1085,100,550,627,535,82,78,3200,6625,4550,5750,13484,9475,1
850,0,2,152.0,186.0,195.0,227.0,3868,4182,2547,2995,1321,1187,969,1473,290,790,679,683,82,78,4625,8425,4550,5750,13484,9475,1
857,0,2,152.0,192.0,195.0,227.0,3857,4400,2603,3191,1254,1209,1392,1693,577,870,815,823,82,78,4625,8825,4550,5750,13484,9475,1
864,0,2,158.0,194.0,195.0,227.0,3834,4266,2603,3079,1231,1187,1309,2013,592,1050,717,963,82,78,5050,9225,4775,5750,13484,9575,1
871,0,2,163.0,180.0,195.0,227.0,3672,4406,2463,3219,1209,1187,747,2124,282,1025,465,1099,82,78,5475,8325,4775,5750,13609,11075,1
879,0,2,131.0,180.0,195.0,227.0,3806,4378,2575,3191,1231,1187,1213,2039,592,800,621,1239,82,78,3125,7650,4675,5750,16059,11750,1
886,0,2,114.0,170.0,180.0,227.0,3034,4361,1959,3219,1075,1142,798,2365,90,990,708,1375,72,78,1625,7550,4350,5750,19228,12450,1
7,1,1,13.0,13.0,14.0,14.0,335,293,335,293,0,0,40,35,40,35,0,0,12,12,0,0,0,0,0,0,1
14,1,1,13.0,13.0,14.0,14.0,671,643,671,643,0,0,20,15,20,15,0,0,13,13,0,0,0,0,0,0,1
21,1,1,14.0,14.0,14.0,14.0,727,699,727,699,0,0,55,50,55,50,0,0,13,13,0,0,0,0,0,0,1
29,1,1,14.0,14.0,14.0,14.0,755,727,755,727,0,0,155,140,155,140,0,0,13,13,0,0,0,0,0,0,1
36,1,1,16.0,16.0,22.0,22.0,811,811,811,811,0,0,155,145,155,145,0,0,14,14,0,0,0,0,0,0,1
43,1,1,16.0,16.0,22.0,22.0,839,839,839,839,0,0,250,235,250,235,0,0,14,14,0,0,0,0,0,0,1
50,1,1,15.0,15.0,22.0,22.0,811,839,811,839,0,0,40,30,40,30,0,0,15,15,0,0,0,0,0,0,1
57,1,1,18.0,17.0,22.0,22.0,811,867,811,867,0,0,0,35,0,35,0,0,15,15,0,0,0,0,0,0,1
64,1,1,18.0,18.0,22.0,22.0,923,923,923,923,0,0,105,90,105,90,0,0,16,15,0,0,0,0,0,0,1
71,1,1,17.0,17.0,22.0,22.0,923,951,923,951,0,0,185,170,185,170,0,0,17,17,0,0,0,0,0,0,1
79,1,1,17.0,17.0,22.0,22.0,923,979,923,979,0,0,45,30,45,30,0,0,16,16,0,0,0,0,0,0,1
86,1,1,18.0,18.0,22.0,22.0,923,979,923,979,0,0,110,90,110,90,0,0,16,16,0,0,0,0,0,0,1
93,1,1,19.0,19.0,22.0,22.0,895,979,895,979,0,0,160,155,160,155,0,0,18,18,0,0,0,0,0,0,1
100,1,1,20.0,19.0,22.0,22.0,1034,1012,923,923,111,89,245,261,225,245,20,16,18,18,0,0,0,0,0,0,1
107,1,1,20.0,20.0,22.0,22.0,1079,1079,923,923,156,156,365,351,325,315,40,36,19,19,0,0,0,0,0,0,1
114,1,1,20.0,21.0,22.0,22.0,1135,995,979,839,156,156,401,416,345,360,56,56,20,20,0,0,0,0,0,0,1
121,1,1,26.0,25.0,28.0,28.0,1135,1107,979,951,156,156,126,256,50,180,76,76,20,20,0,0,250,250,0,0,1
129,1,1,26.0,26.0,36.0,28.0,1191,1102,1035,923,156,179,266,236,170,140,96,96,20,21,0,0,250,250,0,0,1
136,1,1,28.0,28.0,36.0,28.0,1169,1163,1035,1007,134,156,102,82,90,70,12,12,21,21,0,0,250,250,0,0,1
143,1,1,29.0,30.0,36.0,36.0,1118,1146,1007,1035,111,111,184,119,160,95,24,24,21,21,50,50,250,250,0,0,1
150,1,1,29.0,30.0,36.0,36.0,1202,1202,1091,1091,111,111,321,270,285,230,36,40,23,23,50,50,250,250,0,0,1
157,1,1,29.0,28.5,36.0,36.0,1208,1281,1119,1147,89,134,123,126,75,70,48,56,23,24,350,325,250,250,0,25,1
164,1,1,32.0,30.5,36.0,36.0,1370,1337,1259,1203,111,134,94,132,30,60,64,72,23,24,350,325,250,250,0,25,1
171,1,1,31.0,32.5,36.0,36.0,1342,1426,1231,1315,111,111,101,204,75,120,26,84,23,24,350,325,250,250,0,25,1
179,1,1,32.0,32.5,36.0,36.0,1398,1393,1287,1259,111,134,108,65,70,15,38,50,24,24,350,325,250,250,0,25,1
186,1,1,35.0,32.5,36.0,36.0,1342,1421,1231,1287,111,134,125,226,75,160,50,66,25,25,350,325,250,250,0,25,1
193,1,1,36.0,35.5,36.0,36.0,1404,1387,1315,1231,89,156,237,246,175,160,62,86,25,25,350,325,250,250,0,25,1
200,1,1,38.0,41.5,44.0,44.0,1454,1471,1343,1315,111,156,303,126,225,20,78,106,28,28,500,525,250,250,0,25,1
207,1,1,42.0,41.5,44.0,44.0,1566,1499,1455,1343,111,156,165,171,75,45,90,126,27,27,550,525,250,250,0,25,1
214,1,1,43.0,42.0,44.0,44.0,1594,1578,1483,1399,111,179,207,306,105,160,102,146,32,29,650,600,450,250,0,50,1
221,1,1,43.5,43.0,44.0,44.0,1650,1662,1539,1483,111,179,354,311,240,170,114,141,32,30,625,700,450,450,25,50,1
229,1,1,43.5,49.0,58.0,50.0,1712,1667,1623,1511,89,156,456,202,330,45,126,157,34,31,625,700,450,450,25,50,1
236,1,1,48.5,49.0,58.0,58.0,1846,1723,1735,1567,111,156,442,207,300,130,142,77,34,32,625,750,575,575,25,50,1
243,1,1,53.5,53.0,58.0,58.0,1874,1835,1763,1679,111,156,304,237,200,140,104,97,34,38,625,750,575,575,25,50,1
250,1,1,53.0,54.0,66.0,58.0,1958,1835,1847,1679,111,156,167,352,163,260,4,92,34,38,850,750,575,575,74,50,1
257,1,1,55.5,58.0,66.0,58.0,1902,2059,1791,1903,111,156,114,272,98,160,16,112,32,37,1075,750,575,575,99,50,1
264,1,1,57.5,56.5,66.0,58.0,1818,2082,1707,1903,111,179,135,362,103,230,32,132,35,36,975,1025,575,575,199,75,1
271,1,1,59.0,58.0,66.0,58.0,1919,2031,1763,1875,156,156,160,203,133,180,27,23,39,36,900,1100,575,575,274,75,1
279,1,1,59.0,58.0,66.0,58.0,1835,2087,1679,1931,156,156,270,253,223,210,47,43,41,36,900,1100,575,575,274,75,1
286,1,1,58.5,58.0,66.0,58.0,2166,2059,1875,1903,291,156,560,298,473,235,87,63,44,36,925,1250,575,575,299,75,1
293,1,1,64.5,58.0,74.0,58.0,2496,2003,2183,1847,313,156,456,528,333,445,123,83,44,36,925,1400,775,575,299,75,1
300,1,1,64.5,57.0,74.0,82.0,2552,2003,2239,1847,313,156,661,773,498,670,163,103,44,36,925,1350,775,575,299,125,1
307,1,1,72.5,64.0,82.0,90.0,2552,2026,2239,1735,313,291,571,483,468,340,103,143,44,35,1225,1350,775,775,299,125,1
314,1,1,80.0,67.5,82.0,90.0,2518,2014,2183,1679,335,335,466,338,423,155,43,183,44,43,1150,1125,775,775,299,350,1
321,1,1,82.0,70.0,90.0,90.0,2552,1908,2239,1595,313,313,573,209,548,15,25,194,44,43,1050,1000,775,775,399,400,1
329,1,1,81.5,68.0,90.0,98.0,2552,2154,2239,1819,313,335,768,489,728,255,40,234,44,43,1675,1200,775,1025,574,550,1
336,1,1,89.5,77.0,90.0,106.0,2580,2182,2267,1847,313,335,423,287,393,119,30,168,44,43,1825,1225,775,1025,624,587,1
343,1,1,90.0,82.0,90.0,106.0,2552,2266,2239,1819,313,447,578,272,508,119,70,153,44,43,1850,1375,775,1025,699,637,1
350,1,1,87.5,86.0,90.0,106.0,2552,2367,2239,1875,313,492,534,167,503,29,31,138,44,43,1825,1275,775,1025,824,737,1
357,1,1,88.0,84.5,106.0,106.0,2546,2390,2211,1875,335,515,617,267,527,119,90,148,44,43,1975,1600,775,1025,1036,1012,1
364,1,1,93.0,90.5,106.0,114.0,2574,2367,2239,1875,335,492,572,98,492,44,80,54,44,43,2075,1800,775,1025,1061,1012,1
371,1,1,91.5,94.5,122.0,114.0,2524,2367,2211,1875,313,492,783,84,667,49,116,35,44,43,2050,2100,775,1025,1261,1112,1
379,1,1,86.0,90.5,122.0,114.0,2552,2423,2239,1931,313,492,679,79,627,59,52,20,44,43,1875,1900,775,1025,1736,1637,1
386,1,1,81.0,83.5,122.0,114.0,2552,2457,2239,1987,313,470,819,80,727,79,92,1,44,43,1725,1450,775,1025,2086,2312,1
393,1,1,80.5,87.0,122.0,114.0,2468,2429,2155,1959,313,470,779,60,647,24,132,36,44,43,1550,1575,775,1025,2411,2412,1
400,1,1,70.5,89.0,122.0,114.0,2412,2530,2099,2015,313,515,989,165,817,94,172,71,41,43,1300,1675,775,1025,2811,2512,1
407,1,1,79.5,92.0,122.0,114.0,2261,2474,1903,1959,358,515,784,230,647,99,137,131,41,42,1600,2075,775,1025,2811,2512,1
414,1,1,87.5,94.0,122.0,114.0,2244,2423,1931,1931,313,492,656,392,587,209,69,183,44,42,1650,2375,775,1025,2811,2512,1
421,1,1,95.5,96.0,122.0,114.0,2300,2339,1987,1847,313,492,541,127,532,84,9,43,44,41,1650,2625,775,1025,2811,2512,1
429,1,1,99.0,100.0,122.0,114.0,2378,2345,1819,1875,559,470,625,208,582,109,43,99,44,43,2125,2675,775,1025,2836,2512,1
436,1,1,102.0,102.0,122.0,114.0,2401,2317,1595,1847,806,470,671,278,532,169,139,109,43,49,2325,2675,1025,1025,2836,2512,1
443,1,1,101.0,104.5,122.0,114.0,2373,2289,1567,1819,806,470,472,348,437,179,35,169,46,51,2725,2750,1025,1025,2836,2537,1
450,1,1,107.0,103.5,122.0,114.0,2373,2339,1567,1735,806,604,439,644,312,399,127,245,46,51,2925,2750,1025,1025,2836,2537,1
457,1,1,109.0,102.5,122.0,114.0,2502,2574,1651,1903,851,671,492,759,257,434,235,325,46,50,2875,2750,1025,1025,2886,2537,1
464,1,1,114.0,105.5,130.0,114.0,2664,2720,1679,2071,985,649,368,636,117,239,251,397,54,50,2875,2900,1025,1025,2886,2537,1
471,1,1,120.0,103.0,138.0,122.0,2810,2804,1847,2155,963,649,300,981,12,504,288,477,55,53,2875,2775,1025,1025,2886,2662,1
479,1,1,118.5,102.0,138.0,154.0,2927,2776,1987,2127,940,649,551,1272,172,719,379,553,60,53,2700,2675,1025,1025,3061,2762,1
486,1,1,124.0,112.0,138.0,154.0,3196,2894,2211,2043,985,851,356,1133,7,464,349,669,60,53,2375,2675,1025,1025,3386,2762,1
493,1,1,128.5,116.5,146.0,154.0,3230,2894,2267,1931,963,963,432,1174,42,389,390,785,60,54,2600,2600,1025,1475,3461,2837,1
500,1,1,125.5,123.0,146.0,154.0,3370,3000,2407,2015,963,985,844,429,342,74,502,355,60,58,2550,3025,1025,1475,3611,2912,1
507,1,1,126.0,127.0,146.0,154.0,3442,3011,2435,2071,1007,940,1144,401,522,134,622,267,60,59,3075,3025,1025,1475,3686,2912,1
514,1,1,127.0,133.0,146.0,154.0,3448,3090,2463,2127,985,963,1210,156,472,69,738,87,60,59,3375,3075,1475,1475,3686,2912,1
521,1,1,141.0,135.0,146.0,154.0,3375,3106,2435,2099,940,1007,792,327,117,224,675,103,62,59,3375,3675,1475,1475,3686,2912,1
529,1,1,140.0,135.5,146.0,154.0,3442,3022,2435,2015,1007,1007,1427,192,632,69,795,123,62,58,3375,4250,1475,1475,3686,2937,1
536,1,1,141.0,139.5,154.0,154.0,3448,3095,2463,2155,985,940,1303,165,392,134,911,31,62,58,3375,4650,1475,1475,3686,2937,1
543,1,1,146.0,141.5,146.0,154.0,3398,3084,2435,2099,963,985,780,240,57,189,723,51,61,58,4075,5050,1475,1475,3686,2937,1
550,1,1,145.0,143.5,162.0,154.0,3342,3196,2379,2211,963,985,1195,245,352,174,843,71,61,58,4075,5050,1475,1475,3686,2937,1
557,1,1,151.0,143.5,170.0,162.0,3246,3118,2239,2155,1007,963,811,417,152,234,659,183,61,58,4075,5450,1475,1475,3761,2937,1
564,1,1,152.0,147.5,154.0,170.0,3342,3146,2379,2183,963,963,888,302,217,199,671,103,60,58,4075,5850,1600,1475,3961,2937,1
571,1,1,154.0,155.5,138.0,194.0,3179,3218,2239,2211,940,1007,704,193,17,74,687,119,60,58,4825,5850,1725,1475,4161,2937,1
579,1,1,154.0,158.5,130.0,202.0,3364,3218,2379,2211,985,1007,1109,423,302,184,807,239,60,58,4825,6050,1725,1475,4261,2937,1
586,1,1,154.0,163.5,138.0,202.0,3358,3179,2351,2239,1007,940,1119,546,192,199,927,347,60,64,5575,6450,1850,1475,4261,2937,1
593,1,1,154.0,166.5,154.0,202.0,3342,3196,2379,2211,963,985,1287,726,252,259,1035,467,60,64,5825,6800,1850,1475,4261,2937,1
600,1,1,154.0,169.5,154.0,208.0,3336,3118,2351,2155,985,963,1202,547,147,214,1055,333,60,64,6075,7050,1850,1475,4261,2937,1
607,1,1,165.0,175.5,186.0,208.0,3252,3286,2267,2323,985,963,588,248,67,99,521,149,59,66,6075,7050,1850,1475,4261,2937,1
614,1,1,169.0,181.5,202.0,208.0,3370,3549,2407,2519,963,1030,1010,163,427,94,583,69,59,66,6875,7050,1850,1475,4036,2937,1
621,1,1,175.0,183.5,194.0,208.0,3314,3554,2351,2547,963,1007,411,374,112,289,299,85,59,70,6725,7050,1850,1475,4286,2937,1
629,1,1,177.0,185.5,194.0,208.0,3364,3566,2379,2603,985,963,261,591,92,394,169,197,59,70,7025,7850,1850,1475,4286,2937,1
636,1,1,179.0,191.5,194.0,208.0,3319,3498,2379,2267,940,1231,408,401,227,344,181,57,59,72,7125,7850,1850,1475,4286,2937,1
643,1,1,181.0,191.5,194.0,216.0,3314,3728,2351,2407,963,1321,308,846,207,629,101,217,59,72,7025,8250,1850,1475,4386,2937,1
650,1,1,181.0,195.5,194.0,216.0,2860,3812,1987,2491,873,1321,380,698,287,629,93,69,57,72,8025,8350,1850,1475,4561,3037,1
657,1,1,180.0,194.0,194.0,216.0,2210,3902,1651,2603,559,1299,614,754,457,729,157,25,56,71,8275,8525,1725,1475,4686,3312,1
664,1,1,180.0,184.0,194.0,216.0,2373,4008,1903,2687,470,1321,965,1221,702,1044,263,177,56,71,8275,7925,1275,1475,5386,4112,1
671,1,1,182.0,195.0,194.0,216.0,2423,3924,1931,2603,492,1321,640,496,517,259,123,237,54,71,8775,7625,1275,1475,5436,4412,1
679,1,1,182.0,194.5,194.0,216.0,2227,3773,1735,2519,492,1254,725,109,542,24,183,85,54,68,8925,7900,1275,1475,5536,4737,1
686,1,1,180.0,196.0,194.0,208.0,2222,3818,1707,2519,515,1299,710,189,467,144,243,45,58,68,8925,9125,1275,1475,5536,4862,1
693,1,1,184.0,186.0,194.0,208.0,2838,3868,2099,2547,739,1321,675,654,432,449,243,205,58,71,8675,8125,1275,1475,6036,5862,1
700,1,1,172.0,180.0,194.0,208.0,3129,3868,2323,2547,806,1321,1036,721,697,564,339,157,58,71,7175,7125,1275,1850,7536,6862,1
707,1,1,168.0,184.0,194.0,208.0,3017,3846,2211,2547,806,1299,1407,483,972,374,435,109,58,71,7075,7725,1400,1850,8036,6862,1
714,1,1,166.0,194.0,194.0,208.0,2994,3700,2211,2379,783,1321,1773,439,1242,174,531,265,58,71,6975,7925,1400,1850,8136,6862,1
721,1,1,168.0,193.0,194.0,208.0,3112,3941,2239,2687,873,1254,1846,902,1207,489,639,413,58,70,6975,8325,1400,1850,8136,6862,1
729,1,1,158.0,198.5,194.0,208.0,3090,3907,2127,2631,963,1276,2212,782,1457,509,755,273,60,70,6175,9200,1400,1850,8936,6887,1
736,1,1,154.0,197.5,210.0,208.0,3252,3952,2267,2631,985,1321,2444,1052,1577,719,867,333,60,70,5725,9050,1400,1850,9386,7037,1
743,1,1,158.0,190.5,202.0,208.0,3090,4042,2127,2743,963,1299,561,1329,482,944,79,385,58,70,5075,8600,1850,1850,10236,7487,1
750,1,1,154.0,190.5,202.0,208.0,3011,3986,2183,2687,828,1299,657,1590,582,1149,75,441,56,70,4725,9000,1850,1850,10761,7687,1
757,1,1,144.0,186.5,208.0,208.0,2574,4092,1791,2771,783,1321,693,2067,622,1474,71,593,50,70,3975,8600,1850,1850,11811,8087,1
7,2,2,13.0,13.0,15.0,15.0,377,293,377,293,0,0,45,35,45,35,0,0,12,12,0,0,0,0,0,0,0
14,2,2,14.0,14.0,15.0,15.0,671,671,671,671,0,0,70,70,70,70,0,0,13,13,0,0,0,0,0,0,0
21,2,2,14.0,14.0,15.0,15.0,699,727,699,727,0,0,0,0,0,0,0,0,13,13,0,0,0,0,0,0,0
29,2,2,15.0,15.0,15.0,15.0,755,727,755,727,0,0,95,35,95,35,0,0,14,14,0,0,0,0,0,0,0
36,2,2,15.0,15.0,23.0,23.0,839,839,839,839,0,0,150,140,150,140,0,0,14,14,0,0,0,0,0,0,0
43,2,2,16.0,16.0,23.0,23.0,867,811,867,811,0,0,40,30,40,30,0,0,15,15,0,0,0,0,0,0,0
50,2,2,17.0,17.0,23.0,23.0,811,839,811,839,0,0,55,5,55,5,0,0,16,16,0,0,0,0,0,0,0
57,2,2,18.0,18.0,23.0,23.0,923,867,923,867,0,0,45,40,45,40,0,0,17,17,0,0,0,0,0,0,0
64,2,2,19.0,19.0,23.0,23.0,923,951,923,951,0,0,100,100,100,100,0,0,18,18,0,0,0,0,0,0,0
71,2,2,19.0,20.0,23.0,23.0,923,951,923,951,0,0,45,5,45,5,0,0,18,19,0,0,0,0,0,0,0
79,2,2,20.0,20.0,23.0,23.0,1023,967,979,923,44,44,73,73,65,65,8,8,19,19,0,0,0,0,0,0,0
86,2,2,21.0,21.0,23.0,23.0,950,1034,839,923,111,111,25,40,5,20,20,20,20,20,0,0,150,150,0,0,0
93,2,2,22.0,22.0,23.0,23.0,967,1079,811,923,156,156,90,124,50,80,40,44,21,21,0,0,150,150,0,0,0
100,2,2,22.0,22.0,23.0,23.0,1006,1034,783,811,223,223,68,92,0,20,68,72,21,21,0,0,150,150,0,0,0
107,2,2,23.0,23.0,23.0,23.0,1062,1057,839,811,223,246,202,165,110,65,92,100,22,22,0,0,150,150,0,0,0
114,2,2,23.0,23.0,23.0,23.0,1186,1163,895,895,291,268,298,317,170,185,128,132,23,23,0,0,150,150,0,0,0
121,2,2,24.0,24.0,31.0,31.0,1130,1158,839,867,291,291,424,447,260,275,164,172,23,23,0,0,450,300,0,0,0
129,2,2,29.0,29.0,31.0,31.0,1180,1202,867,867,313,335,179,92,75,30,104,62,24,24,0,0,450,450,0,0,0
136,2,2,29.0,29.0,31.0,31.0,1258,1225,923,867,335,358,224,142,80,40,144,102,24,24,0,0,450,450,0,0,0
143,2,2,28.0,30.0,31.0,31.0,1253,1258,895,923,358,335,419,233,235,95,184,138,24,25,0,0,450,450,0,0,0
150,2,2,28.0,30.0,31.0,31.0,1258,1236,923,923,335,313,460,129,240,55,220,74,24,25,0,0,450,450,0,0,0
157,2,2,32.0,35.0,39.0,39.0,1236,1264,923,951,313,313,346,129,140,65,206,64,24,26,250,350,450,450,0,0,0
164,2,2,32.0,35.0,39.0,39.0,1180,1292,867,979,313,313,566,289,320,185,246,104,24,26,250,350,450,450,0,0,0
171,2,2,32.0,35.0,39.0,39.0,1236,1292,923,979,313,313,311,444,25,300,286,144,24,27,250,350,450,450,0,0,0
179,2,2,32.0,35.0,39.0,39.0,1208,1342,895,1007,313,335,456,204,130,20,326,184,24,27,250,350,450,450,0,0,0
186,2,2,36.0,38.0,39.0,39.0,1258,1342,923,1007,335,335,356,160,40,40,316,120,24,27,500,675,450,450,0,0,0
193,2,2,36.0,38.0,39.0,39.0,1230,1348,895,1035,335,313,497,226,145,70,352,156,24,28,500,675,450,450,0,0,0
200,2,2,37.0,39.0,39.0,39.0,1208,1320,895,1007,313,313,338,286,50,90,288,196,24,28,500,675,450,450,0,0,0
207,2,2,37.0,39.0,39.0,39.0,1180,1376,867,1063,313,313,384,401,60,165,324,236,24,29,500,675,450,450,0,0,0
214,2,2,37.0,40.0,39.0,47.0,1236,1348,923,1035,313,313,539,211,175,35,364,176,25,29,750,825,450,450,0,0,0
221,2,2,40.0,40.0,47.0,47.0,1208,1426,895,1091,313,335,515,381,140,165,375,216,25,29,750,825,450,450,0,0,0
229,2,2,43.0,41.0,47.0,47.0,1208,1393,895,1035,313,358,480,441,90,185,390,256,26,30,1000,825,450,450,0,0,0
236,2,2,43.0,44.0,47.0,47.0,1286,1376,951,1063,335,313,645,433,215,195,430,238,26,31,1000,825,450,550,0,0,0
243,2,2,46.0,47.0,62.0,47.0,1264,1376,951,1063,313,313,496,368,30,140,466,228,27,32,1000,1175,700,550,0,0,0
250,2,2,47.0,47.0,62.0,62.0,1348,1348,1035,1035,313,313,611,238,105,120,506,118,27,32,1000,1175,700,800,0,0,0
257,2,2,53.0,49.0,62.0,62.0,1510,1404,1175,1091,335,313,401,363,55,205,346,158,29,33,1300,1175,700,800,0,0,0
264,2,2,53.0,47.0,62.0,62.0,1533,872,1175,671,358,201,526,401,140,223,386,178,29,33,1300,1175,700,800,0,25,0
271,2,2,55.0,48.0,62.0,62.0,1600,211,1287,167,313,44,663,256,245,128,418,128,31,32,1550,1175,700,800,0,75,0
279,2,2,56.0,51.0,62.0,62.0,1628,743,1315,699,313,44,403,139,120,53,283,86,31,32,1550,1350,700,800,0,75,0
286,2,2,58.0,52.0,62.0,62.0,1690,1331,1399,1063,291,268,464,204,145,78,319,126,33,32,1550,1525,700,800,0,75,0
293,2,2,59.0,54.0,62.0,62.0,1762,1174,1427,839,335,335,664,289,305,123,359,166,35,34,1550,1525,700,800,0,75,0
300,2,2,60.0,55.0,62.0,62.0,1908,1208,1595,895,313,313,420,390,125,188,295,202,35,36,1650,1525,700,800,0,75,0
307,2,2,67.0,60.0,70.0,62.0,1824,1566,1511,1231,313,335,485,185,250,43,235,142,36,37,1650,1700,700,800,0,75,0
314,2,2,68.0,61.0,70.0,62.0,1964,1880,1651,1567,313,313,225,216,100,38,125,178,37,37,1800,1875,950,800,0,75,0
321,2,2,70.0,62.0,70.0,62.0,1930,2020,1595,1707,335,313,356,456,195,238,161,218,39,38,1800,1875,950,800,0,75,0
329,2,2,71.0,63.0,78.0,70.0,2014,1482,1679,1147,335,335,561,261,360,103,201,158,40,36,1800,1875,950,800,0,225,0
336,2,2,74.0,62.0,78.0,70.0,2070,995,1735,727,335,268,437,319,300,133,137,186,41,35,2050,2225,950,800,125,325,0
343,2,2,73.0,62.0,78.0,70.0,2110,1180,1819,979,291,201,294,298,125,88,169,210,42,34,1925,2225,950,800,250,375,0
350,2,2,74.0,63.0,78.0,70.0,2082,1695,1791,1427,291,268,374,514,165,268,209,246,43,35,1925,2225,950,800,250,375,0
357,2,2,78.0,65.0,78.0,70.0,2076,1914,1763,1623,313,291,285,406,140,228,145,178,44,37,2100,2225,950,800,250,375,0
364,2,2,78.0,66.0,78.0,70.0,2188,2054,1875,1763,313,291,570,291,385,73,185,218,45,38,2650,2225,950,800,250,375,0
371,2,2,78.0,66.0,78.0,70.0,2345,2048,1987,1735,358,313,440,361,215,103,225,258,45,38,2650,2225,950,800,250,375,0
379,2,2,82.0,68.0,86.0,70.0,2311,2210,1931,1875,380,335,224,371,55,73,169,298,45,40,2650,2225,950,800,250,375,0
386,2,2,85.0,69.0,86.0,78.0,2373,2182,1903,1847,470,335,205,307,55,73,150,234,45,41,3000,2225,950,800,250,375,0
393,2,2,85.0,70.0,86.0,78.0,2429,2076,1959,1763,470,313,401,444,195,178,206,266,45,42,3000,2225,1250,800,250,375,0
400,2,2,89.0,70.0,94.0,78.0,2485,2143,2015,1763,470,380,337,546,175,228,162,318,47,43,3000,2225,1250,1050,250,375,0
407,2,2,93.0,71.0,102.0,86.0,2423,2244,1931,1819,492,425,287,463,165,168,122,295,47,44,3800,2225,1400,1050,250,375,0
414,2,2,93.0,75.0,102.0,86.0,2462,2294,2015,1847,447,447,279,593,205,338,74,255,47,44,3800,2225,1400,1200,250,75,0
421,2,2,95.0,75.0,102.0,78.0,2345,2350,1875,1903,470,447,455,321,325,118,130,203,47,44,3800,2675,1400,1200,250,175,0
429,2,2,95.0,76.0,110.0,86.0,2395,2378,1903,1931,492,447,540,323,350,68,190,255,47,44,3800,2675,1400,1200,250,175,0
436,2,2,97.0,77.0,110.0,94.0,2317,2406,1847,1959,470,447,531,569,385,258,146,311,49,44,3800,2675,1400,1200,250,175,0
443,2,2,106.0,81.0,125.0,110.0,2367,2423,1875,1931,492,492,131,495,75,228,56,267,51,45,4325,2850,1400,1200,250,175,0
450,2,2,108.0,81.0,133.0,110.0,2591,2423,2099,1931,492,492,277,480,215,303,62,177,51,46,4325,2850,1400,1350,250,175,0
457,2,2,109.0,82.0,133.0,110.0,2737,2362,2267,1847,470,515,258,250,140,88,118,162,54,46,4500,3025,1400,1500,250,175,0
464,2,2,111.0,82.0,133.0,110.0,2854,2446,2407,1819,447,627,494,455,320,213,174,242,54,46,4500,3025,1500,1500,250,175,0
471,2,2,111.0,82.0,133.0,110.0,2905,2395,2435,1791,470,604,450,447,220,133,230,314,57,46,4500,3025,1500,1650,250,175,0
479,2,2,115.0,84.0,133.0,118.0,3039,2440,2547,1791,492,649,286,642,150,248,136,394,57,46,4375,3125,1500,1800,375,175,0
486,2,2,115.0,84.0,133.0,118.0,3017,2283,2547,1679,470,604,528,364,340,48,188,316,57,46,4900,3125,1500,1800,375,175,0
493,2,2,115.0,85.0,141.0,118.0,3134,2227,2687,1623,447,604,460,641,420,253,40,388,57,48,4900,3125,1500,1800,375,175,0
500,2,2,117.0,89.0,141.0,118.0,3134,2222,2687,1595,447,627,726,551,630,183,96,368,57,49,4900,3475,1650,1800,375,175,0
507,2,2,123.0,89.0,149.0,118.0,3140,2216,2715,1567,425,649,389,517,245,73,144,444,57,49,5000,3475,1800,1800,375,175,0
514,2,2,127.0,89.0,149.0,118.0,3140,2132,2715,1483,425,649,160,772,110,248,50,524,57,49,5300,3475,1800,2300,375,175,0
521,2,2,127.0,95.0,157.0,118.0,3129,2082,2659,1455,470,627,441,278,335,53,106,225,57,49,5500,3475,2100,2600,375,175,0
529,2,2,139.0,95.0,157.0,141.0,3123,2294,2631,1623,492,671,187,558,25,253,162,305,57,49,5500,3475,2450,2600,375,175,0
536,2,2,143.0,102.0,165.0,141.0,3073,2356,2603,1707,470,649,353,194,135,63,218,131,57,49,6100,4400,2450,3100,375,175,0
543,2,2,143.0,102.0,173.0,141.0,3067,2356,2575,1707,492,649,718,480,440,273,278,207,57,49,6300,4575,2450,3100,375,175,0
550,2,2,155.0,108.0,173.0,141.0,3039,2658,2547,1987,492,671,259,215,225,78,34,137,57,49,6300,4875,2450,3100,375,175,0
557,2,2,155.0,111.0,173.0,141.0,2737,2692,2267,2043,470,649,485,391,395,178,90,213,57,49,6700,5175,2450,3100,375,175,0
564,2,2,151.0,111.0,173.0,141.0,2490,2608,2043,1959,447,649,446,387,400,98,46,289,51,47,7400,5175,2450,3100,700,475,0
571,2,2,133.0,91.0,181.0,141.0,2182,2362,1735,1735,447,627,472,473,420,108,52,365,46,41,6450,3975,2450,2900,1900,2312,0
579,2,2,121.0,72.0,196.0,133.0,1712,2216,1287,1567,425,649,574,628,470,183,104,445,42,37,6125,3000,2450,2900,2600,3887,0
586,2,2,120.0,74.0,196.0,110.0,1880,2070,1455,1399,425,671,417,528,340,103,77,425,43,37,5900,3050,2450,2700,2825,4837,0
593,2,2,118.0,74.0,196.0,110.0,2042,2020,1595,1371,447,649,583,594,450,143,133,451,45,37,5700,3400,2450,2700,3075,5012,0
600,2,2,105.0,60.0,196.0,110.0,1992,2098,1567,1427,425,671,636,550,455,23,181,527,49,36,4425,1800,2450,2700,4350,6762,0
7,0,2,13.0,13.0,15.0,15.0,293,251,293,251,0,0,35,30,35,30,0,0,12,12,0,0,0,0,0,0,1
14,0,2,14.0,14.0,15.0,15.0,671,671,671,671,0,0,70,70,70,70,0,0,13,13,0,0,0,0,0,0,1
21,0,2,14.0,14.0,15.0,15.0,727,727,727,727,0,0,50,5,50,5,0,0,13,13,0,0,0,0,0,0,1
29,0,2,15.0,15.0,15.0,15.0,699,755,699,755,0,0,85,90,85,90,0,0,14,14,0,0,0,0,0,0,1
36,0,2,15.0,15.0,15.0,15.0,783,811,783,811,0,0,135,145,135,145,0,0,14,14,0,0,0,0,0,0,1
43,0,2,16.0,16.0,23.0,23.0,811,839,811,839,0,0,0,40,0,40,0,0,15,15,0,0,0,0,0,0,1
50,0,2,16.0,17.0,23.0,23.0,867,839,867,839,0,0,50,10,50,10,0,0,15,16,0,0,0,0,0,0,1
57,0,2,17.0,18.0,23.0,23.0,783,839,783,839,0,0,140,15,140,15,0,0,16,17,0,0,0,0,0,0,1
64,0,2,18.0,19.0,23.0,23.0,867,951,867,951,0,0,190,130,190,130,0,0,17,18,0,0,0,0,0,0,1
71,0,2,18.0,19.0,23.0,23.0,934,973,867,951,67,22,247,239,235,235,12,4,17,18,0,0,0,0,0,0,1
79,0,2,19.0,20.0,23.0,23.0,911,995,755,951,156,44,347,358,315,350,32,8,18,19,0,0,0,0,0,0,1
86,0,2,19.0,20.0,23.0,23.0,855,967,699,923,156,44,457,76,405,60,52,16,18,19,0,0,0,150,0,0,1
93,0,2,20.0,20.0,23.0,23.0,906,990,727,923,179,67,307,39,285,15,22,24,19,20,0,0,150,150,0,0,1
100,0,2,20.0,21.0,23.0,23.0,934,1034,755,923,179,111,412,120,370,80,42,40,19,20,0,0,150,150,0,0,1
107,0,2,20.0,22.0,23.0,23.0,911,1051,755,895,156,156,123,120,65,60,58,60,19,21,0,0,150,150,0,0,1
114,0,2,21.0,22.0,23.0,23.0,883,1051,727,895,156,156,178,100,100,20,78,80,19,21,0,0,150,150,0,0,1
121,0,2,22.0,23.0,23.0,23.0,911,1079,755,923,156,156,133,176,35,80,98,96,19,22,100,0,150,150,0,0,1
129,0,2,23.0,25.0,23.0,31.0,1107,1102,951,923,156,179,238,90,120,45,118,45,20,22,100,0,150,300,0,0,1
136,0,2,23.0,26.0,23.0,31.0,1163,1163,1007,895,156,268,78,231,40,150,38,81,20,23,100,0,150,300,0,0,1
143,0,2,25.0,26.0,31.0,31.0,1158,1236,979,923,179,313,153,86,95,65,58,21,21,23,150,0,150,300,0,0,1
150,0,2,25.0,27.0,31.0,31.0,1191,1152,1035,839,156,313,194,153,120,100,74,53,21,24,150,125,150,300,0,0,1
157,0,2,26.0,27.0,31.0,46.0,1219,1034,1063,811,156,223,204,227,110,150,94,77,22,24,150,125,150,300,0,50,1
164,0,2,26.0,30.0,31.0,46.0,1247,1158,1091,867,156,291,204,147,140,80,64,67,22,24,200,125,150,300,0,50,1
171,0,2,27.0,32.0,31.0,46.0,1303,1253,1147,895,156,358,349,227,265,120,84,107,23,26,200,125,150,300,0,50,1
179,0,2,29.0,33.0,46.0,46.0,1303,1292,1147,979,156,313,4,188,0,45,4,143,24,27,200,125,500,550,0,50,1
186,0,2,30.0,34.0,46.0,46.0,1275,1488,1007,1175,268,313,85,323,45,140,40,183,24,28,200,125,500,550,0,50,1
193,0,2,30.0,36.0,46.0,46.0,1393,1628,1035,1315,358,313,215,103,135,30,80,73,24,30,200,300,500,550,0,50,1
200,0,2,35.0,36.0,46.0,46.0,1600,1656,1287,1343,313,313,192,263,80,150,112,113,25,30,300,300,600,550,0,50,1
207,0,2,37.0,38.0,46.0,46.0,1628,1740,1315,1427,313,313,177,109,25,60,152,49,26,32,300,300,600,550,0,50,1
214,0,2,37.0,39.0,46.0,46.0,1796,1846,1483,1511,313,335,282,224,90,135,192,89,26,33,300,300,850,550,0,50,1
221,0,2,43.0,40.0,46.0,46.0,1796,1852,1483,1539,313,313,197,440,65,315,132,125,28,34,500,300,850,700,0,50,1
229,0,2,45.0,41.0,54.0,46.0,1902,1958,1567,1623,335,335,327,620,155,455,172,165,28,35,500,300,850,700,0,50,1
236,0,2,46.0,42.0,54.0,46.0,2037,1886,1679,1595,358,291,422,347,210,150,212,197,29,36,600,300,850,700,0,50,1
243,0,2,47.0,43.0,54.0,46.0,1958,1774,1623,1483,335,291,553,372,305,185,248,187,30,37,600,475,850,700,100,100,1
250,0,2,49.0,46.0,54.0,46.0,2076,1880,1763,1567,313,313,549,342,315,190,234,152,31,37,800,475,850,950,100,100,1
257,0,2,52.0,48.0,54.0,54.0,2132,1908,1819,1595,313,313,559,392,285,250,274,142,32,39,900,475,850,950,100,100,1
264,0,2,56.0,52.0,62.0,54.0,2160,2076,1847,1763,313,313,169,173,105,120,64,53,33,39,900,650,925,950,100,100,1
271,0,2,57.0,54.0,62.0,54.0,2048,2132,1735,1819,313,313,294,228,65,210,229,18,34,41,900,925,1000,950,100,100,1
279,0,2,61.0,54.0,70.0,54.0,2121,2149,1763,1791,358,358,159,572,90,435,69,137,35,41,1000,925,1000,950,100,100,1
286,0,2,63.0,56.0,70.0,62.0,2317,2294,1959,1847,358,447,334,744,225,555,109,189,36,42,1000,925,1000,950,100,100,1
293,0,2,63.0,60.0,70.0,62.0,2384,2373,2071,1903,313,470,206,475,65,330,141,145,36,42,1000,1375,1000,950,100,100,1
300,0,2,70.0,62.0,70.0,62.0,2356,2401,2043,1931,313,470,111,665,55,535,56,130,38,44,1375,1375,1000,950,100,100,1
307,0,2,70.0,60.0,70.0,85.0,2328,2334,2015,1819,313,515,301,920,205,730,96,190,40,41,1375,1375,1000,950,100,300,1
314,0,2,70.0,57.0,70.0,85.0,2244,2110,1931,1595,313,515,406,511,270,365,136,146,40,33,1375,1725,1000,950,100,700,1
321,0,2,69.0,56.0,70.0,85.0,2126,1695,1791,1203,335,492,626,642,450,440,176,202,40,32,1475,1825,1000,950,400,900,1
329,0,2,65.0,58.0,70.0,85.0,2149,1667,1791,1175,358,492,396,743,280,485,116,258,40,34,1550,1825,1000,950,600,900,1
336,0,2,67.0,60.0,70.0,85.0,2070,1751,1735,1259,335,492,587,353,435,135,152,218,42,37,1550,1725,1000,950,600,1000,1
343,0,2,73.0,61.0,85.0,85.0,1908,1953,1595,1483,313,470,688,294,525,20,163,274,44,38,1600,1725,1300,950,600,1000,1
350,0,2,73.0,68.0,85.0,85.0,1992,1953,1679,1483,313,470,708,89,530,30,178,59,44,40,1600,2025,1300,950,600,1000,1
357,0,2,75.0,70.0,93.0,85.0,2132,2171,1707,1679,425,492,573,159,435,40,138,119,47,42,1600,2025,1300,950,600,1000,1
364,0,2,75.0,71.0,93.0,85.0,2059,2244,1455,1707,604,537,778,374,564,195,214,179,47,43,1600,2025,1300,950,600,1000,1
371,0,2,75.0,71.0,93.0,85.0,1790,2395,1119,1903,671,492,576,666,332,435,244,231,45,46,1600,2000,1300,950,800,1125,1
379,0,2,81.0,78.0,93.0,85.0,2037,2457,1343,1987,694,470,285,412,115,225,170,187,45,48,1875,2350,1475,950,850,1125,1
386,0,2,83.0,80.0,93.0,85.0,2558,2563,1931,2071,627,492,474,412,236,165,238,247,46,50,1975,2350,1475,1250,850,1125,1
393,0,2,85.0,82.0,93.0,85.0,2642,2686,2015,2239,627,447,484,384,166,85,318,299,48,52,1975,2350,1475,1400,850,1125,1
400,0,2,90.0,84.0,93.0,93.0,2754,2821,2127,2351,627,470,464,419,116,60,348,359,49,54,2325,2350,1475,1400,850,1125,1
407,0,2,93.0,87.0,93.0,101.0,2782,2899,2155,2407,627,492,304,669,76,250,228,419,51,57,2325,2350,1475,1550,850,1125,1
414,0,2,101.0,88.0,109.0,101.0,2804,2983,2155,2491,649,492,279,956,96,485,183,471,53,58,2325,2350,1475,1550,850,1125,1
421,0,2,102.0,90.0,109.0,109.0,2793,3022,2099,2575,694,447,255,808,96,285,159,523,54,60,2475,2350,1725,1550,950,1125,1
429,0,2,107.0,91.0,109.0,109.0,2854,3095,2183,2715,671,380,101,671,16,300,85,371,54,62,2525,2350,1725,1550,950,1125,1
436,0,2,107.0,97.0,117.0,109.0,2810,3190,2183,2743,627,447,343,516,186,185,157,331,57,63,2575,2350,1725,1550,950,1125,1
443,0,2,107.0,103.0,117.0,109.0,2698,3274,2071,2827,627,447,413,462,226,175,187,287,57,66,3025,2700,1725,1850,950,1125,1
450,0,2,111.0,103.0,117.0,109.0,2614,3280,1987,2743,627,537,438,761,171,410,267,351,57,67,3550,2700,1725,1850,950,1125,1
457,0,2,112.0,103.0,125.0,109.0,2776,3336,2127,2575,649,761,418,466,121,215,297,251,57,68,3500,2700,1725,2150,1000,1125,1
464,0,2,112.0,106.0,125.0,117.0,2602,3566,1931,2603,671,963,568,507,191,140,377,367,57,68,3400,2725,1725,2500,1100,1400,1
471,0,2,116.0,112.0,125.0,133.0,2429,3711,1735,2771,694,940,654,314,201,35,453,279,59,68,3600,3250,1725,2500,1150,1400,1
479,0,2,120.0,118.0,125.0,149.0,2524,3756,1875,2771,649,985,366,469,141,70,225,399,59,68,3700,3350,1725,2500,1150,1400,1
486,0,2,120.0,122.0,125.0,149.0,3006,3734,2379,2771,627,963,577,505,301,290,276,215,60,68,3550,3550,1725,2500,1300,1400,1
493,0,2,120.0,124.0,141.0,149.0,2922,3627,2295,2687,627,940,627,587,271,260,356,327,60,65,3650,3450,1725,2600,1400,1650,1
500,0,2,120.0,128.0,141.0,149.0,2978,3398,2351,2435,627,963,742,623,356,330,386,293,60,65,3700,4200,2025,2700,1400,1650,1
507,0,2,129.0,133.0,141.0,149.0,2916,3622,2267,2659,649,963,242,874,26,465,216,409,63,67,4200,4975,2025,2700,1400,1650,1
514,0,2,131.0,141.0,141.0,141.0,3039,3594,2323,2631,716,963,387,694,141,165,246,529,63,68,4200,4975,2025,2700,1400,1750,1
521,0,2,127.0,135.0,141.0,141.0,2978,3566,2239,2603,739,963,406,996,151,355,255,641,64,69,4000,5075,2025,2700,1500,2050,1
529,0,2,117.0,128.0,141.0,141.0,3090,3532,2351,2547,739,985,790,362,451,255,339,107,66,69,3125,4125,2225,2700,2725,3000,1
536,0,2,118.0,128.0,141.0,165.0,3196,3532,2435,2547,761,985,441,588,256,365,185,223,66,69,3000,4725,2225,2700,3050,3100,1
543,0,2,119.0,135.0,141.0,165.0,3230,3398,2491,2435,739,963,273,576,46,245,227,331,66,69,2775,5125,2225,2700,3375,3150,1
550,0,2,118.0,133.0,141.0,165.0,3465,2636,2659,1875,806,761,426,860,116,445,310,415,66,69,2475,5025,2325,2700,3850,3250,1
557,0,2,121.0,135.0,141.0,165.0,3672,2703,2687,1987,985,716,741,528,311,75,430,453,69,69,2575,5025,2925,2700,3850,3250,1
564,0,2,130.0,137.0,141.0,173.0,3890,3213,2883,2519,1007,694,417,672,221,135,196,537,72,69,3075,5200,2825,2700,3875,3250,1
571,0,2,140.0,140.0,141.0,173.0,4002,3291,2995,2575,1007,716,433,746,146,125,287,621,72,69,3425,5200,2825,2700,3875,3250,1
579,0,2,141.0,148.0,141.0,181.0,4187,3185,3247,2491,940,694,166,741,121,40,45,701,73,69,3475,5200,2825,2700,3875,3250,1
586,0,2,141.0,149.0,141.0,181.0,4070,3269,3107,2575,963,694,446,1080,281,295,165,785,75,72,3525,5600,2825,2700,4075,3250,1
593,0,2,138.0,154.0,141.0,181.0,4098,3269,3135,2575,963,694,941,1119,656,250,285,869,76,72,3650,5975,2825,2700,4300,3425,1
600,0,2,141.0,154.0,141.0,181.0,4098,3280,3135,2631,963,649,187,654,86,105,101,549,76,73,3800,5975,2825,2850,4550,3425,1
607,0,2,145.0,153.0,165.0,181.0,4002,2798,2995,2127,1007,671,547,823,351,190,196,633,76,73,3950,5975,2825,2850,4550,3475,1
614,0,2,145.0,153.0,165.0,181.0,3717,3101,2687,2407,1030,694,488,1202,176,485,312,717,76,73,4100,5975,2825,2850,4550,3475,1
621,0,2,153.0,167.0,173.0,181.0,3459,3258,2519,2407,940,851,277,695,86,170,191,525,76,73,4450,6375,2825,2850,4550,3475,1
629,0,2,159.0,167.0,181.0,196.0,3291,3353,2351,2323,940,1030,337,781,26,290,311,491,76,73,4550,6475,2825,2850,4550,3475,1
636,0,2,159.0,169.0,189.0,196.0,3706,3560,2743,2575,963,985,822,1018,416,415,406,603,76,73,4550,6825,3025,3000,4550,3575,1
643,0,2,163.0,165.0,189.0,196.0,3711,3767,2771,2827,940,940,353,1460,56,745,297,715,76,77,4750,6625,3325,3000,4550,3775,1
650,0,2,124.0,155.0,189.0,196.0,3762,3924,2911,2939,851,985,198,1925,51,1090,147,835,71,77,3325,5325,3325,3550,6875,3975,1
7,2,0,13.0,13.0,15.0,15.0,251,293,251,293,0,0,30,35,30,35,0,0,12,12,0,0,0,0,0,0,0
14,2,0,14.0,14.0,15.0,15.0,615,671,615,671,0,0,60,70,60,70,0,0,13,13,0,0,0,0,0,0,0
21,2,0,14.0,14.0,15.0,15.0,783,727,783,727,0,0,55,0,55,0,0,0,13,13,0,0,0,0,0,0,0
29,2,0,15.0,15.0,15.0,15.0,783,727,783,727,0,0,85,90,85,90,0,0,14,14,0,0,0,0,0,0,0
36,2,0,15.0,15.0,15.0,15.0,783,811,783,811,0,0,135,140,135,140,0,0,14,14,0,0,0,0,0,0,0
43,2,0,16.0,16.0,23.0,23.0,839,867,839,867,0,0,30,85,30,85,0,0,15,15,0,0,0,0,0,0,0
50,2,0,17.0,16.0,23.0,23.0,839,811,839,811,0,0,10,45,10,45,0,0,16,15,0,0,0,0,0,0,0
57,2,0,18.0,17.0,23.0,23.0,895,811,895,811,0,0,60,145,60,145,0,0,17,16,0,0,0,0,0,0,0
64,2,0,19.0,18.0,23.0,23.0,923,783,923,783,0,0,170,190,170,190,0,0,18,17,0,0,0,0,0,0,0
71,2,0,19.0,18.0,23.0,23.0,917,805,895,783,22,22,239,234,235,230,4,4,18,17,0,0,0,0,0,0,0
79,2,0,20.0,19.0,23.0,23.0,995,889,951,755,44,134,353,349,345,325,8,24,19,18,0,0,0,0,0,0,0
86,2,0,20.0,19.0,23.0,23.0,934,883,867,727,67,156,61,454,45,410,16,44,19,18,0,0,150,0,0,0,0
93,2,0,20.0,20.0,23.0,23.0,990,962,923,783,67,179,189,324,165,310,24,14,20,19,0,0,150,150,0,0,0
100,2,0,21.0,20.0,23.0,23.0,1001,939,867,783,134,156,114,480,70,400,44,80,20,19,0,0,150,150,0,0,0
107,2,0,21.0,20.0,23.0,23.0,1046,900,867,811,179,89,159,183,95,95,64,88,20,19,0,0,150,150,0,0,0
114,2,0,22.0,20.0,23.0,23.0,995,878,839,811,156,67,130,91,50,45,80,46,21,19,0,50,150,150,0,0,0
121,2,0,22.0,21.0,23.0,23.0,1051,939,895,895,156,44,215,155,115,105,100,50,21,19,0,50,150,150,0,0,0
129,2,0,23.0,22.0,23.0,23.0,1118,1186,895,1119,223,67,352,253,220,195,132,58,22,20,0,50,150,150,0,0,0
136,2,0,26.0,22.0,31.0,31.0,1225,1174,867,1063,358,111,177,344,105,270,72,74,23,20,0,50,300,150,0,0,0
143,2,0,26.0,23.0,31.0,31.0,1225,1258,867,1147,358,111,272,501,160,415,112,86,23,21,0,50,300,150,0,0,0
150,2,0,27.0,25.0,31.0,31.0,1264,1253,951,1119,313,134,169,146,125,40,44,106,24,21,175,50,300,250,0,0,0
157,2,0,30.0,26.0,46.0,31.0,1214,1443,923,1287,291,156,45,281,15,155,30,126,24,22,175,50,300,250,0,0,0
164,2,0,31.0,27.0,46.0,31.0,1320,1331,1007,1175,313,156,155,221,85,75,70,146,25,23,175,50,300,250,0,0,0
171,2,0,33.0,29.0,46.0,31.0,1320,1382,1007,1203,313,179,161,276,55,110,106,166,27,23,175,150,300,250,0,0,0
179,2,0,33.0,29.0,46.0,46.0,1488,1387,1175,1231,313,156,296,282,150,100,146,182,27,24,175,150,300,250,0,0,0
186,2,0,34.0,29.0,46.0,46.0,1572,1247,1259,1091,313,156,186,362,150,160,36,202,29,24,350,200,550,250,0,50,0
193,2,0,36.0,31.0,46.0,46.0,1544,1359,1231,1203,313,156,257,402,185,180,72,222,30,25,350,150,550,250,0,100,0
200,2,0,37.0,31.0,46.0,46.0,1628,1331,1315,1175,313,156,423,357,315,115,108,242,31,25,350,150,650,250,0,100,0
207,2,0,38.0,33.0,46.0,46.0,1712,1387,1399,1231,313,156,133,452,85,190,48,262,32,26,350,200,650,250,0,150,0
214,2,0,39.0,32.0,46.0,46.0,1768,1410,1455,1231,313,179,339,617,255,335,84,282,33,26,350,150,650,400,0,200,0
221,2,0,40.0,32.0,46.0,61.0,1796,1410,1483,1231,313,179,454,347,330,70,124,277,34,27,350,50,650,400,0,300,0
229,2,0,41.0,33.0,46.0,61.0,1852,1695,1539,1539,313,156,389,373,225,80,164,293,35,27,350,100,650,400,0,350,0
236,2,0,43.0,35.0,46.0,61.0,1930,1975,1595,1819,335,156,444,503,240,190,204,313,37,29,350,100,650,475,0,350,0
243,2,0,45.0,35.0,46.0,61.0,1986,2003,1651,1847,335,156,300,368,110,135,190,233,37,29,350,50,650,625,0,400,0
250,2,0,46.0,36.0,46.0,61.0,1992,1947,1679,1791,313,156,536,408,310,180,226,228,39,30,525,100,650,750,0,500,0
257,2,0,46.0,38.0,46.0,61.0,2082,1779,1791,1623,291,156,543,403,285,155,258,248,40,32,525,50,1050,750,0,600,0
264,2,0,46.0,38.0,46.0,61.0,2087,2250,1819,2071,268,179,639,383,420,215,219,168,40,31,525,50,1050,925,0,650,0
271,2,0,46.0,44.0,46.0,61.0,2126,2530,1791,2351,335,179,803,203,540,165,263,38,40,34,525,150,1300,925,0,650,0
279,2,0,53.0,47.0,62.0,61.0,2210,2423,1763,2267,447,156,668,144,445,90,223,54,40,35,875,150,1450,925,0,650,0
286,2,0,59.0,49.0,70.0,61.0,2227,2507,1735,2351,492,156,378,174,270,100,108,74,42,37,1225,150,1450,925,0,650,0
293,2,0,60.0,55.0,70.0,61.0,2283,2115,1791,1959,492,156,508,84,340,40,168,44,42,39,1325,400,1450,925,0,650,0
300,2,0,64.0,58.0,70.0,61.0,2227,2143,1735,1987,492,156,244,139,70,75,174,64,44,40,1325,500,1450,925,0,650,0
307,2,0,64.0,60.0,78.0,61.0,2367,2345,1875,1987,492,358,479,201,245,85,234,116,44,43,1600,500,1450,1125,0,650,0
314,2,0,70.0,60.0,78.0,69.0,2367,2367,1875,1875,492,492,280,232,40,160,240,72,46,44,1775,750,1450,1125,0,650,0
321,2,0,72.0,68.0,78.0,69.0,2395,2563,1903,2071,492,492,420,124,220,50,200,74,46,45,1925,850,1450,1125,0,650,0
329,2,0,72.0,69.0,78.0,85.0,2345,2451,1875,1959,470,492,701,284,445,150,256,134,48,47,1925,850,1450,1125,0,650,0
336,2,0,78.0,70.0,78.0,85.0,2451,2569,1959,2099,492,470,481,435,315,245,166,190,48,47,2350,850,1450,1125,0,650,0
343,2,0,78.0,71.0,78.0,85.0,2535,2765,2043,2295,492,470,736,430,510,180,226,250,48,49,2700,1150,1450,1025,0,725,0
350,2,0,78.0,77.0,78.0,85.0,2311,2541,1819,2071,492,470,407,290,225,80,182,210,48,49,2700,1150,1450,1025,0,725,0
357,2,0,78.0,79.0,78.0,93.0,2210,2586,1763,2071,447,515,679,265,445,45,234,220,48,51,2700,1150,1450,1275,0,725,0
364,2,0,78.0,79.0,78.0,93.0,2266,2916,1819,2379,447,537,650,444,360,160,290,284,48,51,2700,1100,1450,1275,0,775,0
371,2,0,78.0,81.0,109.0,93.0,2378,3011,1931,2407,447,604,940,321,590,140,350,181,48,53,2525,1175,1450,1275,175,1050,0
379,2,0,74.0,74.0,109.0,93.0,2502,3056,1987,2407,515,649,530,586,320,325,210,261,50,55,2175,750,1450,1275,1225,1475,0
386,2,0,74.0,69.0,109.0,93.0,2395,2972,1903,2323,492,649,831,817,565,505,266,312,50,55,2175,450,1600,1275,1225,1875,0
393,2,0,71.0,69.0,109.0,93.0,2591,2838,2099,2211,492,627,1082,923,760,560,322,363,50,55,1825,350,1600,1575,1575,2225,0
400,2,0,72.0,70.0,109.0,93.0,2815,2334,2323,1707,492,627,572,403,290,185,282,218,50,54,1825,350,1600,1575,1575,2275,0
407,2,0,80.0,72.0,109.0,93.0,2692,2378,2267,1707,425,671,195,368,65,95,130,273,52,54,2175,450,1750,1925,1575,2275,0
414,2,0,81.0,78.0,109.0,93.0,2765,2530,2295,1903,470,627,476,385,290,115,186,270,52,56,2525,800,1900,1925,1575,2275,0
421,2,0,82.0,76.0,109.0,93.0,2737,2524,2267,1875,470,649,752,685,510,335,242,350,52,56,2525,775,1900,1925,1575,2500,0
429,2,0,86.0,71.0,109.0,93.0,2821,2546,2351,1875,470,671,237,540,185,210,52,330,54,58,2000,400,1900,2050,2100,2875,0
436,2,0,88.0,81.0,109.0,101.0,2877,2440,2407,1791,470,649,412,336,350,130,62,206,54,58,3050,650,1900,2125,2100,2875,0
443,2,0,80.0,74.0,109.0,101.0,2922,2446,2407,1819,515,627,757,407,635,150,122,257,54,58,2350,150,2050,2125,2800,3475,0
450,2,0,82.0,70.0,109.0,101.0,3000,2322,2463,1763,537,559,1027,382,845,115,182,267,54,53,2350,200,2500,2375,2800,3775,0
457,2,0,97.0,72.0,109.0,109.0,2933,2418,2463,1903,470,515,635,667,405,340,230,327,54,51,3050,500,2500,2375,2800,4000,0
464,2,0,93.0,61.0,109.0,109.0,2961,2373,2491,1903,470,470,1000,724,710,370,290,354,57,46,2775,375,2500,2225,3075,4775,0
7,1,2,13.0,13.0,14.0,15.0,335,293,335,293,0,0,40,35,40,35,0,0,12,12,0,0,0,0,0,0,1
14,1,2,13.0,14.0,14.0,15.0,643,643,643,643,0,0,15,65,15,65,0,0,13,13,0,0,0,0,0,0,1
21,1,2,14.0,14.0,14.0,15.0,727,671,727,671,0,0,55,45,55,45,0,0,13,13,0,0,0,0,0,0,1
29,1,2,14.0,15.0,14.0,15.0,727,699,727,699,0,0,145,80,145,80,0,0,13,14,0,0,0,0,0,0,1
36,1,2,16.0,15.0,22.0,15.0,811,783,811,783,0,0,150,135,150,135,0,0,14,14,0,0,0,0,0,0,1
43,1,2,16.0,16.0,22.0,23.0,755,783,755,783,0,0,235,25,235,25,0,0,16,15,0,0,0,0,0,0,1
50,1,2,15.0,17.0,22.0,23.0,839,839,839,839,0,0,35,0,35,0,0,0,15,16,0,0,0,0,0,0,1
57,1,2,17.0,18.0,22.0,23.0,839,839,839,839,0,0,35,55,35,55,0,0,15,17,0,0,0,0,0,0,1
64,1,2,18.0,19.0,22.0,23.0,923,923,923,923,0,0,100,115,100,115,0,0,16,18,0,0,0,0,0,0,1
71,1,2,17.0,19.0,22.0,23.0,895,1001,895,979,0,22,175,239,175,235,0,4,17,18,0,0,0,0,0,0,1
79,1,2,17.0,20.0,22.0,23.0,951,1023,951,979,0,44,35,353,35,345,0,8,16,19,0,0,0,0,0,0,1
86,1,2,18.0,20.0,22.0,23.0,951,1040,951,951,0,89,95,65,95,45,0,20,16,19,0,0,0,150,0,0,1
93,1,2,19.0,21.0,22.0,23.0,973,1034,951,923,22,111,159,136,155,100,4,36,18,20,0,0,0,150,0,0,1
100,1,2,20.0,21.0,22.0,23.0,990,1051,923,895,67,156,222,111,210,55,12,56,18,21,0,0,0,150,0,0,1
107,1,2,20.0,22.0,22.0,23.0,1085,1079,951,923,134,156,353,111,325,35,28,76,19,21,0,0,0,150,0,0,1
114,1,2,20.0,22.0,22.0,23.0,1051,1130,895,951,156,179,373,141,325,45,48,96,20,21,0,0,0,150,0,0,1
121,1,2,22.0,23.0,28.0,23.0,1023,1130,867,951,156,179,344,231,280,115,64,116,20,22,0,0,250,150,0,0,1
129,1,2,26.0,23.0,36.0,23.0,1135,1124,979,923,156,201,239,310,155,170,84,140,20,22,0,0,250,150,0,0,1
136,1,2,28.0,26.0,36.0,31.0,1034,1208,923,895,111,313,256,30,160,25,96,5,20,23,0,0,250,300,0,0,1
143,1,2,30.0,27.0,36.0,31.0,1174,1236,1063,923,111,313,312,80,200,35,112,45,22,24,100,0,250,300,0,0,1
150,1,2,30.0,28.0,36.0,31.0,1113,1281,979,923,134,358,448,130,320,95,128,35,22,25,100,0,250,300,0,0,1
157,1,2,31.0,30.0,36.0,46.0,1202,1314,1091,979,111,335,195,96,55,25,140,71,23,26,250,0,250,300,0,0,1
164,1,2,31.0,34.0,36.0,46.0,1286,1320,1175,1007,111,313,147,122,95,40,52,82,23,28,400,125,250,300,0,0,1
171,1,2,33.0,35.0,36.0,46.0,1393,1432,1259,1119,134,313,168,197,100,75,68,122,25,29,400,125,250,300,0,0,1
179,1,2,35.0,36.0,36.0,46.0,1454,1566,1343,1231,111,335,140,397,60,235,80,162,25,30,400,125,250,600,0,0,1
186,1,2,36.0,42.0,36.0,46.0,1482,1600,1371,1287,111,313,252,133,160,85,92,48,25,32,400,125,250,600,0,0,1
193,1,2,40.0,42.0,44.0,46.0,1482,1656,1371,1343,111,313,43,138,35,50,8,88,27,32,400,125,250,600,0,0,1
200,1,2,40.0,44.0,44.0,46.0,1550,1762,1483,1427,67,335,117,208,105,80,12,128,28,34,400,250,250,600,0,0,1
207,1,2,43.0,46.0,44.0,54.0,1555,1846,1511,1511,44,335,105,333,85,165,20,168,32,36,550,250,250,600,0,0,1
214,1,2,44.0,49.0,44.0,54.0,1662,1908,1595,1595,67,313,158,200,130,150,28,50,32,36,550,600,250,600,100,0,1
221,1,2,44.0,51.0,44.0,54.0,1802,2020,1735,1707,67,313,286,405,250,315,36,90,32,38,550,600,250,600,100,0,1
229,1,2,48.0,51.0,58.0,54.0,1835,1992,1791,1679,44,313,145,245,105,115,40,130,33,38,600,600,250,600,100,0,1
236,1,2,50.0,53.0,66.0,54.0,1914,2160,1847,1847,67,313,148,230,100,60,48,170,32,40,600,600,250,600,100,0,1
243,1,2,51.0,54.0,58.0,54.0,1802,2205,1735,1847,67,358,91,310,35,100,56,210,35,41,750,600,250,600,200,0,1
250,1,2,55.0,55.0,66.0,62.0,1981,2154,1847,1819,134,335,136,171,60,75,76,96,36,42,800,900,250,750,200,0,1
257,1,2,56.0,57.0,74.0,62.0,2054,2272,1875,1959,179,313,226,292,130,160,96,132,38,44,800,900,375,750,200,0,1
264,1,2,58.0,62.0,74.0,62.0,2087,2205,1931,1847,156,358,359,100,247,70,112,30,40,45,1000,900,500,750,200,0,1
271,1,2,63.0,63.0,82.0,70.0,2171,2412,2015,1875,156,537,259,198,127,100,132,98,43,46,1000,900,500,750,200,0,1
279,1,2,66.0,65.0,82.0,70.0,2311,2619,2155,2015,156,604,384,146,232,80,152,66,46,48,1000,900,500,750,200,0,1
286,1,2,68.0,66.0,90.0,70.0,2367,2541,2211,1959,156,582,219,429,147,295,72,134,48,49,1000,900,500,750,200,0,1
293,1,2,73.0,67.0,90.0,70.0,2502,2395,2323,1791,179,604,204,509,112,295,92,214,51,50,1000,900,500,1050,200,0,1
300,1,2,77.0,69.0,98.0,85.0,2698,2479,2519,1875,179,604,199,660,87,370,112,290,55,51,1000,1250,500,1050,200,0,1
307,1,2,78.0,80.0,98.0,85.0,2787,2798,2631,2127,156,671,390,200,262,130,128,70,56,54,1000,1250,500,1200,200,0,1
314,1,2,80.0,81.0,98.0,93.0,2983,2938,2827,2267,156,671,415,141,267,95,148,46,59,55,1000,1250,500,1450,200,0,1
321,1,2,84.0,83.0,98.0,93.0,2983,2966,2827,2295,156,671,360,92,192,70,168,22,60,57,1000,1250,625,1450,300,0,1
329,1,2,87.0,86.0,106.0,101.0,3151,2944,2995,2295,156,649,190,183,102,85,88,98,62,60,1150,1250,625,1550,300,0,1
336,1,2,87.0,88.0,114.0,101.0,3151,3062,2995,2435,156,627,560,155,452,85,108,70,63,62,1150,1250,625,1550,300,0,1
343,1,2,90.0,89.0,122.0,101.0,3336,3151,3135,2547,201,604,504,356,372,210,132,146,66,63,1150,1950,875,1550,300,0,1
350,1,2,90.0,91.0,122.0,101.0,3258,3330,2967,2659,291,671,565,554,397,320,168,234,65,65,1300,1950,875,1550,300,0,1
357,1,2,94.0,89.0,122.0,109.0,3308,3409,2995,2491,313,918,655,419,447,265,208,154,65,66,1300,1950,875,1550,300,0,1
364,1,2,96.0,89.0,122.0,109.0,3330,3487,2883,2547,447,940,799,392,527,130,272,262,69,66,1450,1950,875,1550,300,0,1
371,1,2,96.0,89.0,122.0,109.0,3560,3560,2911,2575,649,985,934,558,632,180,302,378,68,66,1450,1950,1000,1550,300,0,1
379,1,2,108.0,93.0,122.0,109.0,3650,3605,3023,2687,627,918,465,526,137,140,328,386,68,66,1550,1950,1000,1800,300,0,1
386,1,2,108.0,93.0,130.0,109.0,3750,3577,2855,2659,895,918,665,833,217,335,448,498,72,66,1650,1950,1000,1800,300,0,1
393,1,2,110.0,93.0,138.0,117.0,3896,3644,2911,2659,985,985,1020,1177,452,555,568,622,81,66,1950,1950,1000,2450,300,0,1
400,1,2,111.0,93.0,146.0,125.0,3795,3700,2855,2715,940,985,1092,1624,412,890,680,734,78,66,2100,1950,1000,2450,400,0,1
407,1,2,115.0,102.0,162.0,133.0,3890,3678,2883,2715,1007,963,1179,1091,379,845,800,246,82,66,2100,2325,1000,3000,400,0,1
414,1,2,120.0,106.0,162.0,133.0,3924,3734,2939,2771,985,963,1151,772,364,510,787,262,81,67,2100,2325,1200,3300,400,0,1
421,1,2,133.0,106.0,168.0,133.0,4098,3650,3135,2687,963,963,942,702,189,520,753,182,82,67,1900,3225,1200,3450,600,0,1
429,1,2,141.0,119.0,176.0,133.0,4047,3655,3107,2715,940,940,923,493,154,195,769,298,86,67,2050,3225,1200,3450,600,0,1
436,1,2,143.0,120.0,176.0,141.0,4215,3610,3163,2603,1052,1007,1275,568,374,225,901,343,86,67,2550,4100,1200,3450,600,0,1
443,1,2,143.0,126.0,176.0,149.0,4529,3750,3387,2743,1142,1007,1530,570,539,115,991,455,86,70,3250,4100,1200,3450,600,0,1
450,1,2,165.0,123.0,184.0,149.0,4809,3560,3667,2575,1142,985,992,696,144,275,848,421,86,70,3450,4200,1200,3450,600,300,1
457,1,2,169.0,123.0,184.0,149.0,4803,3739,3639,2799,1164,940,1162,849,174,320,988,529,86,70,3600,4200,1200,3450,600,300,1
464,1,2,175.0,127.0,200.0,149.0,4719,3644,3555,2659,1164,985,1334,919,289,170,1045,749,86,70,3600,4200,1200,3450,600,300,1
471,1,2,183.0,127.0,208.0,149.0,4725,3678,3583,2715,1142,963,985,871,404,160,581,711,86,70,4850,4200,1200,3850,600,300,1
479,1,2,200.0,135.0,216.0,149.0,4809,3627,3667,2687,1142,940,357,604,294,185,63,419,86,70,5650,4800,1200,3850,600,300,1
486,1,2,199.0,138.0,224.0,149.0,4725,3560,3583,2575,1142,985,727,809,524,270,203,539,85,70,6650,4800,1200,4150,600,300,1
493,1,2,198.0,141.0,224.0,164.0,4736,3314,3639,2351,1097,963,1184,697,899,250,285,447,84,73,6950,5175,1200,4450,600,300,1
500,1,2,200.0,152.0,224.0,172.0,4669,3532,3527,2547,1142,985,1549,383,1274,70,275,313,84,73,7450,5625,1200,4950,600,300,1
507,1,2,198.5,152.0,216.0,172.0,4747,3700,3583,2715,1164,985,2014,510,1624,85,390,425,84,74,7375,5325,1200,5050,975,600,1
514,1,2,196.5,155.0,216.0,172.0,4669,4014,3527,3051,1142,963,2562,796,2044,255,518,541,84,73,7275,5875,1200,5050,1075,650,1
521,1,2,199.5,151.0,216.0,172.0,4506,4014,3387,3051,1119,963,2678,677,2124,220,554,457,84,73,6925,5675,1350,5050,1275,1150,1
529,1,2,193.5,141.0,216.0,172.0,4501,4232,3359,3247,1142,985,3229,878,2539,305,690,573,84,73,6725,4825,1500,5050,1575,2000,1
536,1,2,187.5,144.0,208.0,172.0,4557,3952,3415,2967,1142,985,3159,729,2479,190,680,539,84,73,5475,4925,1500,5150,2825,2450,1
543,1,2,199.5,148.0,208.0,172.0,4641,4036,3499,3051,1142,985,2716,810,2154,155,562,655,84,73,5325,5225,1500,5150,3375,2650,1
550,1,2,185.5,140.0,200.0,180.0,4579,3963,3415,3023,1164,940,2946,932,2394,265,552,667,84,73,4525,5175,1500,5150,4475,3500,1
557,1,2,199.5,143.0,200.0,180.0,4557,4014,3415,3051,1142,963,2173,817,1814,130,359,687,84,73,4125,5025,1500,5250,5275,3950,1
564,1,2,187.5,144.0,200.0,180.0,4417,4092,3275,3107,1142,985,2469,803,2074,150,395,653,83,73,4275,5175,1500,5250,6025,4250,1
571,1,2,190.5,142.0,200.0,180.0,4366,3902,3247,2939,1119,963,2376,1260,1999,495,377,765,83,76,4575,5500,1500,5100,6525,4525,1
579,1,2,187.5,148.0,200.0,180.0,4445,4070,3303,3107,1142,963,2211,1121,1794,240,417,881,82,75,4125,5625,1500,5100,7475,4950,1
586,1,2,172.5,136.0,200.0,180.0,4344,3958,3247,2995,1097,963,2028,1382,1679,385,349,997,81,75,3275,4775,1500,5100,8625,6000,1
593,1,2,157.0,126.0,200.0,180.0,4445,4036,3303,3051,1142,985,2423,1577,1934,460,489,1117,81,78,2600,4025,1500,5100,9600,6950,1
600,1,2,135.0,131.0,200.0,180.0,4439,4098,3275,3135,1164,963,2863,1570,2234,345,629,1225,81,77,2000,3950,1750,5100,10900,7325,1
607,1,2,140.0,134.0,200.0,180.0,4299,4042,3135,3079,1164,963,2510,1771,1799,430,711,1341,81,79,1800,4450,1750,5100,11150,7325,1
614,1,2,143.0,144.0,200.0,180.0,4114,4131,2883,3191,1231,940,2357,802,1894,145,463,657,80,79,2100,4450,1750,5100,11350,7325,1
621,1,2,145.0,152.0,200.0,180.0,4260,4036,2939,3051,1321,985,2389,407,1874,230,515,177,79,82,2650,4900,1750,5100,11350,7325,1
629,1,2,150.0,156.0,200.0,180.0,4294,4266,2995,3303,1299,963,2290,724,1669,435,621,289,79,82,2700,5550,1750,5100,11550,7325,1
636,1,2,155.0,159.0,200.0,188.0,4221,4484,2967,3499,1254,985,2247,1100,1574,695,673,405,79,82,2750,6450,1750,5100,11750,7325,1
643,1,2,165.0,159.0,200.0,188.0,4092,4310,2771,3191,1321,1119,2535,1349,1714,800,821,549,80,82,3250,6450,1750,5100,11750,7325,1
650,1,2,168.0,171.0,200.0,188.0,4238,4624,2939,3303,1299,1321,2857,849,1884,440,973,409,79,85,3350,7750,1750,5100,11750,7325,1
657,1,2,176.0,177.0,200.0,188.0,4294,4462,2995,3163,1299,1299,2618,652,1889,395,729,257,79,85,4000,7750,1750,5100,11750,7325,1
664,1,2,181.5,175.0,200.0,196.0,4350,4445,3051,3191,1299,1254,1719,1189,1434,780,285,409,83,85,4275,7650,1950,5100,11925,7425,1
671,1,2,184.0,195.0,208.0,196.0,4288,4400,2967,3079,1321,1321,1385,720,1244,155,141,565,83,85,4400,8050,2075,5250,12100,7425,1
679,1,2,186.0,195.0,208.0,204.0,4103,4484,2827,3163,1276,1321,1567,746,1374,225,193,521,83,85,5800,8650,2075,5250,12100,7425,1
686,1,2,188.0,193.0,214.0,204.0,3790,4406,2491,3107,1299,1299,1623,1073,1374,400,249,673,85,85,6200,9150,2075,5250,12400,7525,1
693,1,2,185.5,176.0,214.0,204.0,4008,4378,2687,3079,1321,1299,1313,775,1179,550,134,225,85,85,5275,7350,2425,5250,13575,9325,1
700,1,2,192.5,188.0,214.0,212.0,4092,4378,2771,3079,1321,1299,1405,701,1119,320,286,381,85,85,5675,7350,2425,5250,13575,9325,1
707,1,2,195.5,188.0,214.0,212.0,3980,4299,2659,3023,1321,1276,1216,842,1024,405,192,437,85,85,6375,8850,2425,5250,13575,9325,1
714,1,2,199.5,184.0,214.0,220.0,3952,4238,2631,2939,1321,1299,1078,1344,884,755,194,589,83,85,6725,8650,2425,5250,13675,9525,1
721,1,2,199.5,184.0,214.0,220.0,4322,4210,3023,2911,1299,1299,1224,1435,1074,690,150,745,83,85,7375,8650,2425,5750,13675,9525,1
729,1,2,198.0,192.0,214.0,220.0,4512,4327,3303,3051,1209,1276,833,1147,739,250,94,897,80,85,7400,9050,2275,5750,13875,9925,1
736,1,2,193.0,194.0,214.0,220.0,4165,4187,3023,2911,1142,1276,1328,1048,1094,245,234,803,75,85,7650,8850,2125,5900,13925,10125,1
743,1,2,200.0,192.0,214.0,220.0,4081,4344,3051,3023,1030,1321,1459,968,1109,255,350,713,81,85,7650,8450,2125,5900,14000,10525,1
750,1,2,200.0,187.0,214.0,220.0,4131,4232,3191,2911,940,1321,1768,1155,1314,290,454,865,81,85,7400,7800,2125,5900,14250,11475,1
757,1,2,196.5,177.0,214.0,220.0,4154,4271,3191,2995,963,1276,1694,1067,1124,300,570,767,81,85,6375,6750,2125,5900,15625,12525,1
764,1,2,193.0,165.0,214.0,220.0,4109,4238,3191,2939,918,1299,2012,1573,1359,650,653,923,81,85,5350,5600,2125,5900,16650,13675,1
771,1,2,199.0,179.0,214.0,220.0,4193,4316,3275,2995,918,1321,2189,1398,1424,315,765,1083,81,85,5450,6300,2125,5900,16675,13675,1
779,1,2,199.0,171.0,214.0,220.0,4322,4238,3359,2939,963,1299,1515,1500,1184,565,331,935,81,85,6050,5150,2125,5900,16775,14825,1
786,1,2,196.0,171.0,214.0,220.0,4154,4456,3191,3135,963,1321,1452,1322,1184,485,268,837,78,85,6350,5150,2125,5900,16775,14825,1
793,1,2,197.0,185.0,214.0,235.0,3795,4327,2743,3051,1052,1276,841,1014,649,625,192,389,77,85,7450,6260,2125,5900,17025,14825,1
800,1,2,177.5,188.0,214.0,235.0,3862,4355,2743,3079,1119,1276,752,1095,424,550,328,545,76,85,5925,7085,2575,5900,18850,15575,1
807,1,2,157.0,168.0,214.0,243.0,4002,3790,2771,2491,1231,1299,1226,300,754,95,472,205,81,85,3700,6015,2700,5550,20925,17425,1
814,1,2,143.0,156.0,214.0,243.0,4064,3342,2855,2043,1209,1299,1829,676,1209,315,620,361,80,85,3050,5120,2700,5550,22175,18350,1
821,1,2,134.5,158.0,214.0,243.0,4154,3700,2967,2379,1187,1321,2223,698,1459,485,764,213,80,85,2425,5050,2850,5550,22800,18450,1
829,1,2,138.5,152.0,214.0,243.0,4193,4210,2939,2911,1254,1299,729,615,609,400,120,215,78,85,2125,5215,3000,5550,23400,18750,1
7,,,13.0,13.0,15.0,14.0,293,335,293,335,0,0,35,40,35,40,0,0,12,12,0,0,0,0,0,0,0
14,,,14.0,13.0,15.0,14.0,671,671,671,671,0,0,70,20,70,20,0,0,13,13,0,0,0,0,0,0,0
21,,,14.0,14.0,15.0,14.0,727,727,727,727,0,0,50,55,50,55,0,0,13,13,0,0,0,0,0,0,0
29,,,15.0,14.0,15.0,14.0,699,755,699,755,0,0,80,145,80,145,0,0,14,13,0,0,0,0,0,0,0
36,,,15.0,16.0,15.0,22.0,783,783,783,783,0,0,135,150,135,150,0,0,14,14,0,0,0,0,0,0,0
43,,,16.0,16.0,23.0,22.0,783,811,783,811,0,0,170,235,170,235,0,0,15,16,0,0,0,0,0,0,0
50,,,17.0,15.0,23.0,22.0,867,783,867,783,0,0,275,25,275,25,0,0,16,15,0,0,0,0,0,0,0
57,,,17.0,17.0,23.0,22.0,811,839,811,839,0,0,365,30,365,30,0,0,16,15,0,0,0,0,0,0,0
64,,,18.0,18.0,23.0,22.0,867,923,867,923,0,0,25,85,25,85,0,0,17,16,0,0,0,0,0,0,0
71,,,18.0,17.0,23.0,22.0,867,867,867,867,0,0,115,160,115,160,0,0,17,17,0,0,0,0,0,0,0
79,,,18.0,17.0,23.0,22.0,867,951,867,951,0,0,70,15,70,15,0,0,18,16,0,0,0,0,0,0,0
86,,,19.0,18.0,23.0,22.0,895,923,895,923,0,0,80,75,80,75,0,0,18,16,0,0,0,0,0,0,0
93,,,20.0,19.0,23.0,22.0,951,951,951,951,0,0,65,135,65,135,0,0,19,17,0,0,0,0,0,0,0
100,,,21.0,19.0,23.0,22.0,895,1018,895,951,0,67,90,252,90,240,0,12,20,19,0,0,0,0,0,0,0
107,,,22.0,20.0,23.0,22.0,951,1057,951,923,0,134,65,328,65,300,0,28,21,19,0,0,0,0,0,0,0
114,,,23.0,20.0,23.0,22.0,973,1107,951,951,22,156,89,363,85,315,4,48,22,20,0,0,0,0,0,0,0
121,,,23.0,20.0,23.0,28.0,1079,1107,923,951,156,156,218,488,190,420,28,68,23,20,0,0,150,250,0,0,0
129,,,26.0,26.0,31.0,36.0,1219,1079,951,923,268,156,74,218,10,130,64,88,23,20,0,0,150,250,0,0,0
136,,,28.0,28.0,46.0,36.0,1230,1062,895,951,335,111,119,245,15,145,104,100,24,20,0,0,150,250,0,0,0
143,,,29.0,29.0,46.0,36.0,1292,1130,979,1063,313,67,180,328,40,220,140,108,25,20,0,100,150,250,0,0,0
150,,,31.0,30.0,46.0,36.0,1376,1079,1063,1035,313,44,345,407,165,295,180,112,27,22,0,100,150,250,0,0,0
157,,,31.0,31.0,46.0,36.0,1488,1163,1175,1119,313,44,435,155,215,35,220,120,27,23,100,100,150,250,0,0,0
164,,,35.0,32.0,46.0,36.0,1566,1270,1231,1203,335,67,140,248,55,120,85,128,29,23,100,400,300,250,0,0,0
171,,,36.0,32.0,46.0,36.0,1650,1326,1315,1259,335,67,35,306,10,170,25,136,30,25,100,400,300,250,0,0,0
179,,,37.0,34.0,46.0,36.0,1678,1382,1343,1315,335,67,186,374,125,230,61,144,31,26,100,400,300,250,0,0,0
186,,,39.0,34.0,46.0,44.0,1712,1466,1399,1399,313,67,287,547,190,395,97,152,33,26,225,400,300,250,0,0,0
193,,,39.0,38.0,46.0,44.0,1796,1494,1483,1427,313,67,412,415,275,255,137,160,33,28,225,400,300,250,0,0,0
200,,,41.0,41.0,46.0,44.0,1824,1578,1511,1511,313,67,337,208,310,140,27,68,35,28,225,400,550,250,0,0,0
207,,,41.0,43.0,46.0,44.0,1886,1555,1595,1511,291,44,263,242,200,170,63,72,35,32,225,400,550,250,0,0,0
214,,,41.0,46.0,46.0,52.0,1886,1690,1595,1623,291,67,344,290,245,210,99,80,37,33,225,400,550,250,0,0,0
221,,,43.0,47.0,46.0,52.0,2104,1802,1791,1735,313,67,280,458,145,370,135,88,37,33,225,400,800,250,0,0,0
229,,,45.0,55.0,46.0,58.0,2042,1914,1707,1847,335,67,235,226,60,130,175,96,37,36,225,400,800,250,0,0,0
236,,,45.0,57.0,46.0,58.0,2048,1858,1735,1791,313,67,376,134,165,30,211,104,37,39,225,550,800,250,0,0,0
243,,,46.0,57.0,46.0,58.0,2048,1986,1735,1875,313,111,436,385,185,265,251,120,39,42,225,700,800,250,0,0,0
250,,,48.0,57.0,54.0,58.0,2154,2026,1707,1847,447,179,591,405,280,265,311,140,40,41,475,700,800,250,0,0,0
257,,,49.0,56.0,62.0,58.0,2210,1774,1539,1595,671,179,841,410,450,250,391,160,41,40,475,850,1250,250,0,0,0
264,,,50.0,56.0,70.0,58.0,2210,1863,1539,1707,671,156,1008,641,545,465,463,176,42,41,475,1000,1250,250,0,0,0
271,,,57.0,54.0,70.0,58.0,2328,1919,1679,1763,649,156,534,851,370,655,164,196,43,40,475,950,1550,375,0,100,0
279,,,57.0,69.5,70.0,74.0,2334,2031,1707,1875,627,156,550,181,435,140,115,41,44,39,1350,925,1550,700,125,125,0
286,,,55.0,65.5,70.0,74.0,2334,1538,1707,1427,627,111,835,258,640,205,195,53,45,35,1100,925,1550,575,375,400,0
293,,,55.0,69.5,70.0,74.0,2362,1270,1735,1203,627,67,545,116,270,55,275,61,45,33,1100,925,1550,575,375,450,0
300,,,59.0,68.5,70.0,74.0,2490,1354,1819,1287,671,67,270,189,115,120,155,69,45,31,1100,1775,1550,700,375,450,0
307,,,51.0,68.0,70.0,68.0,2429,1477,1735,1455,694,22,555,364,320,295,235,69,45,37,100,1750,1550,825,1375,825,0
314,,,55.0,68.0,86.0,68.0,2490,1421,1819,1399,671,22,557,123,450,50,107,73,45,38,100,1750,1550,825,1375,825,0
321,,,59.0,68.0,86.0,68.0,2446,1522,1819,1455,627,67,404,165,325,80,79,85,45,37,650,1750,1550,825,1375,825,0
329,,,63.0,68.0,86.0,76.0,2367,1774,1763,1483,604,291,305,135,250,110,55,25,45,37,1025,1750,1550,825,1375,825,0
336,,,63.0,70.5,86.0,76.0,2474,1824,1847,1511,627,313,620,160,485,95,135,65,45,37,1025,1675,1550,825,1375,900,0
343,,,71.0,76.5,86.0,84.0,2418,2009,1791,1651,627,358,90,45,75,15,15,30,45,37,1175,1725,1550,825,1375,900,0
350,,,75.0,80.5,86.0,84.0,2552,1953,1903,1595,649,358,250,80,155,10,95,70,45,37,1850,1875,1750,825,1375,900,0
357,,,75.0,82.0,86.0,84.0,2490,1964,1819,1651,671,313,386,167,215,140,171,27,45,37,1850,2150,1750,825,1375,925,0
364,,,79.0,82.0,101.0,84.0,2530,1964,1903,1651,627,313,384,362,145,295,239,67,45,37,1850,2350,1750,825,1475,925,0
371,,,75.0,78.0,101.0,84.0,2479,1992,1875,1679,604,313,671,612,360,505,311,107,45,37,1675,2350,1750,825,1850,1125,0
379,,,67.0,71.0,101.0,84.0,2479,2048,1875,1735,604,313,968,757,585,610,383,147,45,37,1175,1950,1750,825,2350,1575,0
386,,,79.0,77.0,101.0,84.0,2401,2076,1819,1763,582,313,475,557,120,495,355,62,45,37,1950,1950,1750,1075,2350,1575,0
393,,,79.0,81.0,101.0,90.0,2541,2093,1959,1735,582,358,776,557,345,530,431,27,45,37,1950,2150,1750,1075,2350,1575,0
400,,,79.0,82.0,101.0,90.0,2530,2154,1903,1819,627,335,1087,743,580,680,507,63,45,37,1950,2600,1900,1075,2350,1575,0
407,,,87.0,76.5,101.0,90.0,2530,2076,1903,1763,627,313,979,984,400,885,579,99,45,37,2350,2275,1900,1075,2500,1900,0
414,,,79.0,62.0,101.0,90.0,2552,2076,1903,1763,649,313,1176,1234,525,1095,651,139,45,37,1850,1550,1900,1075,3000,2775,0
421,,,71.0,61.5,101.0,90.0,2507,2020,1903,1707,604,313,1104,1014,485,960,619,54,45,37,1575,1125,1900,1075,3650,3250,0
429,,,79.0,60.0,101.0,90.0,2513,2020,1931,1707,582,313,801,735,110,584,691,151,47,37,1375,650,1900,1075,3850,3749,0
436,,,82.0,63.0,101.0,90.0,2401,2014,1819,1679,582,335,937,535,170,344,767,191,47,37,1975,1000,1900,1075,3850,3749,0
443,,,83.0,63.0,101.0,90.0,2429,1981,1847,1623,582,358,799,505,235,374,564,131,48,38,2350,1050,1900,1075,3850,3749,0
450,,,86.0,65.0,101.0,90.0,2558,2020,1931,1707,627,313,765,657,125,494,640,163,50,41,2350,1050,1900,1075,3850,3749,0
457,,,88.0,64.5,101.0,90.0,2636,2138,1987,1735,649,403,877,928,165,709,712,219,51,42,2450,1025,1900,1075,3950,3774,0
464,,,90.0,68.5,101.0,90.0,2698,2188,2071,1763,627,425,944,910,160,639,784,271,53,44,2550,1475,1900,1075,3950,3774,0
471,,,93.0,71.5,117.0,90.0,2709,2350,2127,1903,582,447,1027,1001,175,674,852,327,53,46,2650,1475,1900,1075,3950,3774,0
479,,,94.0,75.5,117.0,90.0,2759,2328,2155,1903,604,425,1188,1018,260,689,928,329,53,46,2650,1475,1900,1075,3950,3774,0
486,,,106.0,79.5,125.0,90.0,2821,2485,2239,2015,582,470,450,1054,200,694,250,360,54,51,3650,1475,2250,1075,3950,3774,0
493,,,109.0,86.5,125.0,90.0,2978,2507,2351,2015,627,492,391,945,215,679,176,266,55,51,2900,1475,2250,1200,3950,3774,0
500,,,111.0,88.5,133.0,90.0,3000,2630,2351,2183,649,447,602,873,350,584,252,289,57,51,3800,1775,2250,1200,3950,3774,0
507,,,111.0,90.0,133.0,90.0,2782,2714,2155,2267,627,447,900,1104,580,784,320,320,57,51,4250,1850,2250,1200,4000,3799,0
514,,,116.0,99.5,133.0,112.0,2434,2804,1875,2379,559,425,679,936,295,689,384,247,55,51,4250,2225,2250,1200,4250,3824,0
521,,,116.0,105.5,133.0,120.0,2485,2938,2015,2491,470,447,995,902,555,699,440,203,55,51,4750,2275,2250,1200,4250,3924,0
529,,,116.0,113.5,133.0,120.0,2866,2933,2239,2463,627,470,1348,638,820,554,528,84,55,51,4750,2275,2250,1200,4250,4024,0
536,,,128.0,115.0,133.0,120.0,3017,2944,2323,2407,694,537,521,877,405,754,116,123,55,51,4750,3350,2250,1200,4250,4049,0
543,,,124.0,112.5,133.0,120.0,3073,2894,2379,2267,694,627,885,910,685,794,200,116,55,51,5750,3125,2250,1200,4450,4574,0
550,,,122.0,113.5,133.0,120.0,3118,2978,2379,2351,739,627,1253,721,965,579,288,142,55,51,5650,2775,2250,1200,4550,5024,0
557,,,116.0,116.5,133.0,114.0,2978,2714,2239,2155,739,559,1603,625,1235,519,368,106,55,48,5350,2725,2250,1200,4850,5674,0
7,0,0,13.0,13.0,15.0,15.0,293,293,293,293,0,0,35,35,35,35,0,0,12,12,0,0,0,0,0,0,0
14,0,0,14.0,14.0,15.0,15.0,615,643,615,643,0,0,60,65,60,65,0,0,13,13,0,0,0,0,0,0,0
21,0,0,14.0,14.0,15.0,15.0,671,671,671,671,0,0,35,45,35,45,0,0,13,13,0,0,0,0,0,0,0
29,0,0,15.0,15.0,15.0,15.0,671,699,671,699,0,0,65,85,65,85,0,0,14,14,0,0,0,0,0,0,0
36,0,0,15.0,15.0,15.0,15.0,755,727,755,727,0,0,100,125,100,125,0,0,14,14,0,0,0,0,0,0,0
43,0,0,16.0,16.0,23.0,23.0,783,783,783,783,0,0,40,70,40,70,0,0,15,15,0,0,0,0,0,0,0
50,0,0,16.0,16.0,23.0,23.0,783,699,783,699,0,0,0,30,0,30,0,0,15,15,0,0,0,0,0,0,0
57,0,0,17.0,17.0,23.0,23.0,811,783,811,783,0,0,20,60,20,60,0,0,16,16,0,0,0,0,0,0,0
64,0,0,17.0,18.0,23.0,23.0,811,727,811,727,0,0,60,90,60,90,0,0,16,17,0,0,0,0,0,0,0
71,0,0,18.0,18.0,23.0,23.0,811,794,811,727,0,67,155,192,155,180,0,12,17,17,0,0,0,0,0,0,0
79,0,0,19.0,19.0,23.0,23.0,838,850,727,671,111,179,210,252,190,220,20,32,18,18,0,0,0,0,0,0,0
86,0,0,19.0,19.0,23.0,23.0,917,883,671,615,246,268,321,353,265,285,56,68,18,18,0,0,0,0,0,0,0
93,0,0,20.0,20.0,23.0,23.0,978,928,643,615,335,313,86,113,40,55,46,58,19,19,0,0,150,150,0,0,0
100,0,0,20.0,20.0,23.0,23.0,1029,956,671,643,358,313,216,224,130,130,86,94,19,19,0,0,150,150,0,0,0
107,0,0,20.0,20.0,23.0,23.0,984,906,671,615,313,291,73,85,55,55,18,30,19,19,0,0,150,150,0,0,0
114,0,0,20.0,20.0,23.0,31.0,939,889,671,643,268,246,180,98,130,40,50,58,19,19,0,0,150,150,0,0,0
121,0,0,22.0,22.0,31.0,31.0,973,889,727,643,246,246,147,100,115,10,32,90,19,19,100,100,150,150,0,0,0
129,0,0,23.0,22.0,31.0,31.0,1090,1029,867,783,223,246,236,183,180,65,56,118,20,19,100,100,150,150,0,0,0
136,0,0,23.0,22.0,31.0,31.0,1247,1113,979,867,268,246,343,276,255,130,88,146,20,19,100,100,150,150,0,50,0
143,0,0,24.0,23.0,31.0,31.0,1230,956,1007,755,223,201,487,341,375,175,112,166,21,19,100,150,150,150,0,100,0
150,0,0,22.0,25.0,31.0,31.0,1225,962,979,783,246,179,245,361,105,175,140,186,20,19,0,150,400,500,150,100,0
157,0,0,25.0,27.0,31.0,31.0,1247,1046,979,867,268,179,247,151,75,45,172,106,21,20,100,200,400,500,150,100,0
164,0,0,25.0,27.0,31.0,31.0,1398,1174,1175,951,223,223,176,154,80,20,96,134,21,20,100,200,400,500,150,100,0
171,0,0,26.0,30.0,31.0,31.0,1376,1314,1175,1091,201,223,184,222,60,60,124,162,22,21,100,300,400,500,150,100,0
179,0,0,26.0,31.0,31.0,31.0,1398,1342,1175,1119,223,223,222,260,95,95,127,165,22,22,200,350,400,500,150,100,0
186,0,0,27.0,31.0,31.0,39.0,1258,1258,1035,1035,223,223,350,403,195,210,155,193,23,22,200,350,400,500,150,100,0
193,0,0,31.0,31.0,31.0,39.0,1331,1281,1063,1035,268,246,221,555,130,330,91,225,24,23,200,450,475,750,150,100,0
200,0,0,31.0,33.0,39.0,39.0,1247,1270,979,979,268,291,328,626,205,365,123,261,24,23,200,450,475,825,150,100,0
207,0,0,32.0,32.0,39.0,39.0,1359,1348,1091,1035,268,313,249,131,190,55,59,76,25,23,200,350,725,825,150,200,0
214,0,0,32.0,33.0,39.0,39.0,1454,1376,1119,1063,335,313,349,236,275,170,74,66,25,23,200,350,725,725,150,225,0
221,0,0,33.0,34.0,39.0,39.0,1404,1426,1091,1091,313,335,395,261,285,155,110,106,26,24,200,350,725,725,150,225,0
229,0,0,37.0,37.0,54.0,39.0,1572,1426,1259,1091,313,335,160,141,110,95,50,46,27,24,450,350,800,800,150,225,0
236,0,0,37.0,38.0,54.0,39.0,1628,1538,1315,1203,313,335,345,332,255,250,90,82,27,25,450,350,800,800,150,225,0
243,0,0,41.0,38.0,54.0,47.0,1762,1544,1427,1231,335,313,245,383,215,265,30,118,28,25,450,350,800,800,150,225,0
250,0,0,41.0,41.0,54.0,47.0,1662,1348,1259,1035,403,313,422,328,340,220,82,108,28,26,450,650,800,900,150,225,0
257,0,0,46.0,44.0,54.0,47.0,1583,1376,1091,1063,492,313,253,178,215,155,38,23,29,26,700,900,800,900,150,275,0
264,0,0,47.0,41.0,54.0,47.0,1578,1460,1063,1147,515,313,383,378,285,315,98,63,30,25,700,800,800,900,150,425,0
271,0,0,48.0,42.0,54.0,47.0,1667,1510,1175,1175,492,335,529,208,375,105,154,103,31,26,950,900,800,900,150,425,0
279,0,0,49.0,42.0,54.0,47.0,1645,1527,1175,1147,470,380,330,382,120,235,210,147,32,26,950,900,800,900,150,425,0
286,0,0,53.0,44.0,54.0,47.0,2059,1482,1567,1147,492,335,235,253,65,170,170,83,33,27,950,900,800,900,150,425,0
293,0,0,52.0,42.0,54.0,47.0,2059,1510,1567,1175,492,335,455,433,225,310,230,123,34,27,1100,1075,800,900,250,525,0
300,0,0,54.0,42.0,54.0,47.0,2149,1516,1679,1203,470,313,436,508,250,395,186,113,36,28,1100,1125,650,900,400,525,0
307,0,0,54.0,43.0,54.0,47.0,2199,1482,1707,1147,492,335,461,629,215,472,246,157,37,28,1100,1125,650,900,400,525,0
314,0,0,54.0,45.0,54.0,47.0,2390,1292,1875,979,515,313,666,364,360,296,306,68,38,28,1000,1125,650,900,500,575,0
321,0,0,52.0,43.0,54.0,62.0,2373,1275,1903,1007,470,268,688,166,430,66,258,100,38,28,750,600,650,1200,1000,1100,0
329,0,0,56.0,43.0,62.0,62.0,2401,1561,1931,1203,470,358,793,354,475,206,318,148,39,29,750,600,650,1200,1000,1100,0
336,0,0,58.0,44.0,62.0,62.0,2451,1650,1959,1203,492,447,898,486,520,286,378,200,41,29,750,650,650,1200,1000,1100,0
343,0,0,59.0,48.0,62.0,62.0,2339,1600,1847,1175,492,425,818,349,480,101,338,248,42,30,750,750,650,1325,1000,1100,0
350,0,0,60.0,47.0,77.0,62.0,2199,1740,1707,1315,492,425,984,401,590,101,394,300,43,29,750,675,650,1325,1000,1500,0
357,0,0,65.0,51.0,85.0,62.0,2188,1762,1651,1315,537,447,748,376,390,145,358,231,44,31,1000,775,800,1325,1000,1475,0
364,0,0,66.0,55.0,85.0,62.0,2227,2048,1623,1623,604,425,510,233,280,50,230,183,46,31,1000,875,800,1325,1250,1475,0
371,0,0,67.0,57.0,85.0,62.0,2272,1936,1623,1511,649,425,591,265,335,30,256,235,47,32,1000,925,800,1325,1250,1475,0
379,0,0,69.0,60.0,85.0,62.0,2412,2261,1763,1791,649,470,682,321,350,130,332,191,49,33,1000,975,800,1325,1250,1475,0
386,0,0,73.0,62.0,85.0,62.0,2468,2238,1819,1791,649,447,237,74,75,35,162,39,50,35,1250,1075,925,1325,1250,1475,0
393,0,0,77.0,67.0,85.0,70.0,2306,2294,1679,1847,627,447,463,91,225,0,238,91,51,35,1500,1400,925,1325,1250,1475,0
400,0,0,79.0,69.0,85.0,70.0,2412,2272,1763,1847,649,425,306,278,41,135,265,143,52,35,1500,1400,1175,1325,1250,1475,0
407,0,0,80.0,69.0,85.0,70.0,2457,2328,1763,1903,694,425,370,175,125,105,245,70,53,37,1500,1600,1275,1325,1250,1475,0
414,0,0,82.0,75.0,85.0,78.0,2586,2222,1847,1819,739,403,533,202,202,80,331,122,55,37,1500,2000,1525,1325,1250,1475,0
421,0,0,83.0,78.0,85.0,78.0,2664,2518,1903,2071,761,447,294,168,130,90,164,78,57,37,1775,2050,1725,1325,1250,1475,0
429,0,0,84.0,78.0,85.0,78.0,2854,2457,2071,1987,783,470,169,219,63,185,106,34,58,38,2050,2050,1950,1325,1300,1475,0
436,0,0,93.0,84.0,93.0,94.0,2888,2406,2127,1959,761,447,377,177,181,95,196,82,58,38,2050,2150,2050,1325,1300,1575,0
443,0,0,93.0,88.0,93.0,94.0,2877,2294,2071,1847,806,447,571,314,273,180,298,134,59,39,2050,2475,2050,1325,1300,1575,0
450,0,0,98.0,89.0,101.0,94.0,3000,2294,2127,1847,873,447,490,531,88,345,402,186,59,40,2150,2475,2050,1325,1300,1575,0
457,0,0,100.0,96.0,101.0,102.0,3028,2356,2155,1931,873,425,249,88,43,75,206,13,59,42,2250,2575,2050,1325,1300,1575,0
464,0,0,101.0,99.0,101.0,102.0,3190,2384,2295,1959,895,425,73,170,13,105,60,65,62,42,2800,3125,2150,1325,1300,1575,0
471,0,0,113.0,101.0,117.0,102.0,3168,2462,2295,2015,873,447,167,321,128,200,39,121,63,44,2900,3225,2400,1325,1300,1575,0
479,0,0,115.0,102.0,117.0,102.0,3168,2541,2295,2071,873,470,336,578,193,405,143,173,63,44,3000,3275,2300,1325,1400,1575,0
486,0,0,104.0,82.0,117.0,110.0,3202,2350,2351,1903,851,447,730,840,483,615,247,225,63,44,2100,2350,2300,1325,2300,2875,0
493,0,0,108.0,85.0,117.0,110.0,3286,2188,2435,1763,851,425,904,668,553,520,351,148,65,44,2100,2300,2075,1325,2525,3025,0
500,0,0,105.0,86.0,125.0,110.0,3286,2210,2435,1763,851,447,744,439,543,235,201,204,62,44,2150,2350,2075,1325,3175,3075,0
507,0,0,105.0,91.0,125.0,110.0,2670,2272,1931,1847,739,425,453,66,318,60,135,6,60,45,2150,2300,2075,1325,3350,3225,0
514,0,0,109.0,94.0,125.0,110.0,2188,2182,1539,1735,649,447,704,163,493,105,211,58,60,45,2950,2350,2075,1325,3350,3225,0
521,0,0,104.0,91.0,125.0,110.0,2597,2261,1903,1791,694,470,1053,449,758,335,295,114,62,46,2575,2575,2075,1325,3725,3375,0
529,0,0,105.0,94.0,125.0,110.0,2681,2182,1987,1735,694,447,957,332,578,295,379,37,62,47,2050,2575,2075,1325,4295,3475,0
536,0,0,108.0,89.0,125.0,110.0,2714,2188,2043,1763,671,425,759,399,446,310,313,89,63,47,2600,2175,2075,1325,4345,3925,0
543,0,0,108.0,91.0,125.0,110.0,3123,2188,2407,1763,716,425,892,566,566,425,326,141,64,48,2850,2425,2075,1325,4545,3925,0
550,0,0,108.0,94.0,125.0,110.0,3112,2272,2351,1847,761,425,286,308,247,115,39,193,65,49,3050,2775,2075,1325,4545,3925,0
557,0,0,108.0,97.0,125.0,110.0,3056,2244,2295,1819,761,425,639,309,512,135,127,174,65,50,3050,2925,2075,1325,4545,3925,0
564,0,0,114.0,102.0,125.0,110.0,3140,2490,2267,2043,873,447,452,211,342,110,110,101,65,51,3325,3250,2075,1325,4545,3925,0
571,0,0,119.0,106.0,125.0,125.0,3230,2569,2267,2099,963,470,534,197,412,115,122,82,67,51,3775,3300,2300,1325,4545,3925,0
579,0,0,107.0,97.0,125.0,125.0,2972,2698,2099,2183,873,515,393,492,292,350,101,142,56,52,3325,2575,2300,1325,5595,4750,0
586,0,0,96.0,94.0,133.0,125.0,2720,1930,1959,1483,761,447,180,516,137,330,43,186,55,49,2300,2750,2300,1325,6720,5050,0
593,0,0,95.0,89.0,141.0,125.0,2546,928,1875,615,671,313,330,536,207,310,123,226,55,49,2350,2550,2300,1625,6945,5525,0
600,0,0,98.0,81.0,141.0,125.0,2300,1012,1651,699,649,313,161,657,87,395,74,262,55,48,2450,2350,2075,1625,7820,6050,0
607,0,0,94.0,75.0,141.0,125.0,1645,894,1063,671,582,223,241,671,107,385,134,286,51,48,2725,2050,2075,1625,8070,6550,0
614,0,0,95.0,71.0,141.0,125.0,1482,990,1035,811,447,179,187,641,105,335,82,306,53,48,2725,1475,2075,1625,8120,7125,0
621,0,0,98.0,73.0,141.0,125.0,1734,1387,1399,1231,335,156,207,381,85,105,122,276,55,48,2825,1475,2000,1625,8195,7125,0
629,0,0,99.0,79.0,141.0,125.0,2244,2070,1931,1623,313,447,427,294,265,75,162,219,56,49,3100,1625,2000,1625,8195,7125,0
636,0,0,105.0,80.0,141.0,125.0,2272,2737,1959,2155,313,582,232,277,55,40,177,237,58,45,3550,1675,2225,1775,8195,7379,0
643,0,0,103.0,81.0,141.0,125.0,2479,2524,2099,2099,380,425,431,349,210,135,221,214,59,45,3250,1775,2225,1775,8495,7429,0
650,0,0,108.0,87.0,141.0,125.0,2798,2793,2239,2323,559,470,393,339,225,65,168,274,61,46,3250,1825,2550,1775,8495,7429,0
657,0,0,113.0,89.0,141.0,125.0,2905,2328,2323,1791,582,537,677,359,445,25,232,334,63,46,3450,2400,2550,1775,8495,7579,0
663,0,0,113.0,87.0,141.0,125.0,2905,2143,2323,1539,582,604,677,599,445,205,232,394,63,44,3450,2525,2550,1775,8495,7679,0
7,1,1,13.0,13.0,14.0,14.0,377,293,377,293,0,0,45,35,45,35,0,0,12,12,0,0,0,0,0,0,1
14,1,1,13.0,13.0,14.0,14.0,671,671,671,671,0,0,20,20,20,20,0,0,13,13,0,0,0,0,0,0,1
21,1,1,14.0,14.0,14.0,14.0,727,699,727,699,0,0,50,50,50,50,0,0,13,13,0,0,0,0,0,0,1
29,1,1,14.0,14.0,14.0,14.0,783,783,783,783,0,0,155,150,155,150,0,0,13,13,0,0,0,0,0,0,1
36,1,1,16.0,16.0,22.0,22.0,783,783,783,783,0,0,145,145,145,145,0,0,14,14,0,0,0,0,0,0,1
43,1,1,16.0,16.0,22.0,22.0,811,811,811,811,0,0,240,240,240,240,0,0,16,14,0,0,0,0,0,0,1
50,1,1,15.0,15.0,22.0,22.0,867,811,867,811,0,0,45,30,45,30,0,0,15,15,0,0,0,0,0,0,1
57,1,1,17.0,17.0,22.0,22.0,867,811,867,811,0,0,45,35,45,35,0,0,15,15,0,0,0,0,0,0,1
64,1,1,18.0,18.0,22.0,22.0,895,923,895,923,0,0,100,95,100,95,0,0,16,16,0,0,0,0,0,0,1
71,1,1,17.0,17.0,22.0,22.0,923,979,923,979,0,0,185,175,185,175,0,0,17,17,0,0,0,0,0,0,1
79,1,1,17.0,17.0,22.0,22.0,951,951,951,951,0,0,45,30,45,30,0,0,16,16,0,0,0,0,0,0,1
86,1,1,18.0,18.0,22.0,22.0,1007,979,1007,979,0,0,115,100,115,100,0,0,16,16,0,0,0,0,0,0,1
93,1,1,19.0,19.0,22.0,22.0,945,923,923,923,22,0,169,150,165,150,4,0,18,18,0,0,0,0,0,0,1
100,1,1,20.0,20.0,22.0,22.0,1001,1018,867,951,134,67,244,227,220,215,24,12,19,19,0,0,0,0,0,0,1
107,1,1,20.0,20.0,22.0,22.0,1023,1085,867,951,156,134,360,353,320,325,40,28,19,19,0,0,0,0,0,0,1
114,1,1,21.0,21.0,22.0,22.0,1079,1079,923,923,156,156,450,438,390,390,60,48,20,20,0,0,0,0,0,0,1
121,1,1,26.0,24.0,28.0,28.0,1079,1051,923,895,156,156,130,363,50,295,80,68,21,21,0,0,250,250,0,0,1
129,1,1,26.0,26.0,28.0,28.0,1107,1158,951,979,156,179,65,263,65,175,0,88,21,21,0,0,250,250,0,0,1
136,1,1,28.0,28.0,28.0,28.0,1062,1158,951,979,111,179,97,93,85,85,12,8,21,21,0,0,250,250,0,0,1
143,1,1,30.0,30.0,36.0,36.0,1146,1197,1035,1063,111,134,143,145,115,125,28,20,23,21,50,50,250,250,0,0,1
150,1,1,30.0,30.0,36.0,36.0,1174,1197,1063,1063,111,134,295,286,255,250,40,36,23,23,50,50,250,250,0,0,1
157,1,1,30.0,30.0,36.0,36.0,1208,1258,1119,1147,89,111,92,93,40,45,52,48,24,24,350,200,250,250,0,0,1
164,1,1,31.0,31.0,36.0,36.0,1370,1314,1259,1203,111,111,218,209,150,145,68,64,24,24,350,350,250,250,0,0,1
171,1,1,32.0,33.0,36.0,36.0,1337,1393,1203,1259,134,134,119,80,85,50,34,30,24,25,350,350,250,250,0,0,1
179,1,1,33.0,33.0,36.0,36.0,1426,1421,1315,1287,111,134,146,96,100,50,46,46,25,24,400,400,250,250,0,0,1
186,1,1,35.0,35.0,36.0,36.0,1426,1426,1315,1315,111,111,203,168,145,110,58,58,26,24,400,400,250,250,0,0,1
193,1,1,36.0,40.0,44.0,44.0,1561,1426,1427,1315,134,111,349,89,275,15,74,74,27,26,400,400,250,250,0,0,1
200,1,1,41.0,43.0,44.0,44.0,1538,1443,1427,1287,111,156,166,119,80,25,86,94,29,28,400,400,250,250,0,0,1
207,1,1,41.0,44.0,44.0,44.0,1695,1606,1539,1427,156,179,241,159,135,45,106,114,28,32,450,550,250,250,0,0,1
214,1,1,43.0,44.0,44.0,44.0,1634,1527,1455,1371,179,156,131,220,105,90,26,130,28,32,700,600,450,250,0,0,1
221,1,1,46.0,45.0,52.0,52.0,1639,1695,1483,1539,156,156,172,285,130,185,42,100,28,32,750,650,450,450,0,0,1
229,1,1,49.0,51.0,58.0,58.0,1583,1807,1427,1651,156,156,107,205,45,85,62,120,30,33,950,700,450,450,25,0,1
236,1,1,50.0,49.0,58.0,58.0,1723,1807,1567,1651,156,156,272,200,190,60,82,140,35,31,950,750,575,575,25,50,1
243,1,1,47.5,51.0,58.0,58.0,1751,1779,1595,1623,156,156,347,275,245,115,102,160,36,33,625,850,575,575,350,50,1
250,1,1,49.0,48.0,66.0,58.0,1975,1858,1819,1679,156,179,127,205,105,25,22,180,37,35,350,500,575,575,550,400,1
257,1,1,53.0,48.0,66.0,58.0,2026,1914,1847,1735,179,179,177,375,135,200,42,175,37,35,350,600,575,575,550,400,1
264,1,1,55.0,49.0,66.0,66.0,2026,1824,1847,1623,179,201,247,154,185,55,62,99,38,36,500,600,575,575,550,400,1
271,1,1,58.0,50.0,66.0,66.0,2031,1880,1875,1567,156,313,143,339,90,200,53,139,43,36,600,650,575,575,550,400,1
279,1,1,58.0,60.0,66.0,74.0,2143,2042,1987,1707,156,335,228,84,155,30,73,54,43,38,600,650,575,775,550,400,1
286,1,1,62.0,63.5,66.0,82.0,2283,2154,2127,1819,156,335,268,129,175,85,93,44,44,38,800,775,575,775,550,425,1
293,1,1,64.5,73.5,66.0,82.0,2244,2216,2043,1903,201,313,31,100,10,45,21,55,46,38,775,775,575,775,575,425,1
300,1,1,66.0,75.0,74.0,82.0,2474,2210,2183,1875,291,335,247,145,190,50,57,95,50,38,750,1350,575,775,600,450,1
307,1,1,67.0,80.0,74.0,82.0,2569,2238,2211,1903,358,335,396,175,295,40,101,135,54,38,750,1650,575,775,600,450,1
314,1,1,72.5,80.5,82.0,90.0,2798,2188,2351,1875,447,313,442,76,360,55,82,21,56,38,725,1925,775,775,625,475,1
321,1,1,81.0,83.0,82.0,90.0,2849,2182,2379,1847,470,335,281,131,218,95,63,36,55,38,600,2100,775,775,812,475,1
329,1,1,81.0,85.5,90.0,90.0,3151,2182,2659,1847,492,335,101,251,78,175,23,76,53,38,600,2525,775,775,812,525,1
336,1,1,82.5,90.0,90.0,90.0,2877,2104,2407,1791,470,313,122,152,118,40,4,112,53,38,825,2600,775,775,1337,550,1
343,1,1,79.0,87.0,98.0,90.0,2569,2210,2099,1875,470,335,110,167,77,90,33,77,53,38,625,2150,775,775,2124,875,1
7,1,2,13.0,13.0,14.0,15.0,335,335,335,335,0,0,40,40,40,40,0,0,12,12,0,0,0,0,0,0,1
14,1,2,13.0,14.0,14.0,15.0,643,643,643,643,0,0,15,65,15,65,0,0,13,13,0,0,0,0,0,0,1
21,1,2,14.0,14.0,14.0,15.0,671,727,671,727,0,0,45,50,45,50,0,0,13,13,0,0,0,0,0,0,1
29,1,2,14.0,15.0,14.0,15.0,699,727,699,727,0,0,140,40,140,40,0,0,13,14,0,0,0,0,0,0,1
36,1,2,16.0,15.0,22.0,15.0,755,783,755,783,0,0,135,130,135,130,0,0,14,14,0,0,0,0,0,0,1
43,1,2,16.0,16.0,22.0,23.0,755,811,755,811,0,0,220,20,220,20,0,0,14,15,0,0,0,0,0,0,1
50,1,2,15.0,17.0,22.0,23.0,811,783,811,783,0,0,25,40,25,40,0,0,15,16,0,0,0,0,0,0,1
57,1,2,17.0,18.0,22.0,23.0,783,811,783,811,0,0,15,40,15,40,0,0,15,17,0,0,0,0,0,0,1
64,1,2,18.0,18.0,22.0,23.0,867,895,867,895,0,0,70,145,70,145,0,0,15,17,0,0,0,0,0,0,1
71,1,2,17.0,19.0,22.0,23.0,811,923,811,923,0,0,135,260,135,260,0,0,16,18,0,0,0,0,0,0,1
79,1,2,16.0,20.0,22.0,23.0,839,917,839,895,0,22,35,324,35,320,0,4,16,19,0,0,0,0,0,0,1
86,1,2,18.0,20.0,22.0,23.0,839,956,839,867,0,89,30,41,30,25,0,16,16,19,0,0,0,150,0,0,1
93,1,2,19.0,20.0,22.0,23.0,839,1001,839,867,0,134,75,162,75,130,0,32,17,20,0,0,0,150,0,0,1
100,1,2,20.0,21.0,22.0,23.0,827,1051,783,895,44,156,128,92,120,40,8,52,18,20,0,0,0,150,0,0,1
107,1,2,20.0,21.0,22.0,23.0,889,1074,755,895,134,179,233,92,205,20,28,72,19,20,0,0,0,150,0,0,1
114,1,2,20.0,22.0,22.0,23.0,1051,1079,895,923,156,156,253,113,205,25,48,88,20,21,0,0,0,150,0,0,1
121,1,2,20.0,22.0,28.0,23.0,1051,1107,895,951,156,156,378,188,310,80,68,108,20,21,0,0,0,150,0,0,1
129,1,2,26.0,23.0,28.0,23.0,1079,1135,923,979,156,156,108,273,20,145,88,128,20,22,0,0,250,150,0,0,1
136,1,2,26.0,24.0,36.0,31.0,1102,1225,923,979,179,246,33,424,25,260,8,164,20,23,0,0,250,300,0,0,1
143,1,2,28.0,26.0,36.0,31.0,1012,1242,923,951,89,291,37,85,25,60,12,25,20,23,50,0,250,300,0,0,1
150,1,2,30.0,27.0,36.0,31.0,1074,1258,1007,923,67,335,80,140,60,75,20,65,21,24,100,0,250,300,0,0,1
157,1,2,30.0,30.0,36.0,46.0,1102,1230,1035,895,67,335,208,151,180,75,28,76,22,25,100,125,250,300,0,0,1
164,1,2,30.0,32.0,36.0,46.0,1186,1292,1119,979,67,313,346,117,310,55,36,62,24,26,400,125,250,300,0,0,1
171,1,2,29.0,33.0,36.0,46.0,1298,1320,1231,1007,67,313,199,177,155,75,44,102,23,27,400,125,250,300,0,0,1
179,1,2,33.0,35.0,36.0,46.0,1326,1460,1259,1147,67,313,112,207,60,65,52,142,23,29,400,125,250,300,0,0,1
186,1,2,34.0,37.0,36.0,46.0,1275,1488,1231,1175,44,313,101,392,45,210,56,182,23,31,400,125,250,600,0,0,1
193,1,2,36.0,41.0,36.0,46.0,1331,1650,1287,1315,44,335,164,197,100,125,64,72,25,31,400,250,250,600,0,0,1
200,1,2,37.0,43.0,44.0,46.0,1382,1678,1315,1343,67,335,287,243,215,135,72,108,27,33,400,250,250,600,0,0,1
207,1,2,41.0,43.0,44.0,46.0,1410,1718,1343,1427,67,291,145,245,65,105,80,140,28,33,400,250,250,600,0,0,1
214,1,2,43.0,45.0,44.0,46.0,1494,1774,1427,1483,67,291,173,426,85,250,88,176,32,35,550,600,250,600,0,0,1
221,1,2,44.0,51.0,44.0,54.0,1522,1824,1455,1511,67,313,246,86,150,20,96,66,33,37,550,600,250,600,0,0,1
229,1,2,48.0,51.0,52.0,54.0,1662,1964,1595,1651,67,313,194,326,90,220,104,106,33,37,550,600,250,600,0,0,1
236,1,2,48.0,52.0,44.0,54.0,1723,2020,1679,1707,44,313,303,576,195,430,108,146,33,39,550,600,250,600,100,0,1
243,1,2,49.0,53.0,50.0,62.0,1718,2121,1651,1763,67,358,181,361,65,175,116,186,37,39,550,600,250,600,100,0,1
250,1,2,50.0,54.0,50.0,62.0,1634,2149,1567,1791,67,358,329,311,205,85,124,226,37,41,700,950,375,600,100,0,1
257,1,2,56.0,52.0,66.0,62.0,1830,2244,1763,1931,67,313,212,578,80,320,132,258,37,42,650,825,375,750,150,125,1
264,1,2,57.5,54.0,66.0,62.0,1998,2216,1931,1903,67,313,240,528,100,230,140,298,38,42,625,825,500,750,175,125,1
271,1,2,57.0,54.0,58.0,62.0,2110,2244,2043,1931,67,313,303,193,155,55,148,138,47,42,600,825,500,750,300,125,1
279,1,2,56.0,56.0,58.0,70.0,2110,2104,2043,1679,67,425,191,348,135,150,56,198,46,44,750,825,500,750,300,125,1
286,1,2,60.0,56.0,66.0,78.0,2205,2238,2071,1679,134,559,221,261,145,145,76,116,45,44,750,825,500,850,300,125,1
293,1,2,64.0,62.0,82.0,78.0,2390,2278,2211,1651,179,627,211,247,115,105,96,142,46,46,750,1075,500,850,300,125,1
300,1,2,70.0,64.0,82.0,78.0,2558,2334,2379,1707,179,627,221,69,105,5,116,64,50,48,750,1075,500,850,300,125,1
307,1,2,69.0,64.0,90.0,78.0,2586,2395,2407,1791,179,604,191,202,55,70,136,132,51,48,750,1075,625,850,300,125,1
314,1,2,71.0,67.0,90.0,93.0,2698,2429,2407,1847,291,582,316,441,140,245,176,196,55,50,750,1075,625,1350,300,125,1
321,1,2,76.0,73.0,90.0,93.0,2608,2490,2295,1931,313,559,351,44,135,30,216,14,58,50,750,1075,625,1350,300,125,1
329,1,2,79.0,76.0,90.0,93.0,2216,2675,1903,2071,313,604,466,165,210,75,256,90,61,53,750,1075,625,1650,300,125,1
336,1,2,78.0,79.0,90.0,101.0,2373,2653,2015,2071,358,582,365,392,265,230,100,162,60,56,1000,1075,875,1650,300,125,1
343,1,2,77.0,77.0,90.0,101.0,2647,2681,2043,2099,604,582,575,663,395,425,180,238,60,56,1000,950,875,1650,450,250,1
350,1,2,86.0,83.0,90.0,101.0,2742,2782,2071,2043,671,739,461,295,205,215,256,80,60,59,1000,825,1075,1950,450,375,1
357,1,2,86.0,83.0,90.0,101.0,3129,2899,2323,1959,806,940,755,382,445,190,310,192,63,59,1000,825,1075,1950,450,375,1
364,1,2,89.5,85.0,90.0,101.0,3370,2955,2407,2015,963,940,646,420,320,120,326,300,71,61,1075,825,1075,1950,475,375,1
371,1,2,89.0,87.0,90.0,101.0,3420,3179,2435,2239,985,940,846,707,400,295,446,412,72,61,1050,1025,1075,1950,500,375,1
379,1,2,85.0,93.0,90.0,117.0,3482,3269,2519,2351,963,918,877,500,315,230,562,270,74,61,900,1685,1075,2050,650,375,1
386,1,2,91.0,101.0,106.0,125.0,3868,3381,2883,2463,985,918,888,162,210,55,678,107,74,61,900,1700,1075,2050,650,375,1
393,1,2,91.0,101.0,114.0,125.0,3974,3375,2967,2435,1007,940,1349,333,555,210,794,123,74,61,900,2500,1075,2050,650,375,1
400,1,2,89.0,101.0,122.0,125.0,3958,3375,2995,2435,963,940,1666,545,760,310,906,235,72,61,900,2515,1075,2200,650,375,1
407,1,2,89.0,107.0,122.0,125.0,3874,3347,2911,2407,963,940,2112,103,1090,10,1022,93,72,61,900,2545,1525,2200,650,375,1
414,1,2,100.5,108.0,122.0,133.0,3896,3403,2911,2463,985,940,1382,440,840,235,542,205,72,61,875,2575,1525,2200,675,375,1
421,1,2,106.5,108.0,122.0,141.0,3874,3370,2911,2407,963,963,1398,642,740,425,658,217,72,62,1325,3235,1775,2200,675,375,1
429,1,2,118.5,114.0,122.0,157.0,3386,3426,2491,2463,895,963,1077,432,315,345,762,87,70,62,1325,3265,1775,2200,775,375,1
436,1,2,115.5,110.0,122.0,157.0,2647,3431,1931,2491,716,940,1387,813,545,610,842,203,67,62,2525,2985,1775,2200,925,670,1
443,1,2,121.5,110.0,122.0,157.0,2692,3286,1931,2323,761,963,1214,434,380,115,834,319,67,62,3225,3630,1775,2200,925,685,1
450,1,2,121.5,112.0,128.0,157.0,3342,3067,2379,2127,963,940,1640,571,690,190,950,381,67,62,3225,3675,1775,2200,925,685,1
457,1,2,127.5,112.0,128.0,157.0,3678,3062,2715,2099,963,963,1661,893,595,400,1066,493,73,62,3675,3895,1775,2200,925,685,1
464,1,2,125.5,121.0,128.0,157.0,3454,3224,2491,2239,963,985,1387,284,205,75,1182,209,73,61,3475,4585,1775,2200,1125,735,1
471,1,2,127.5,123.0,128.0,157.0,3678,3146,2715,2183,963,963,1392,145,190,70,1202,75,79,61,3475,4630,1775,2950,1125,735,1
479,1,2,126.0,123.0,144.0,157.0,3930,3196,2967,2211,963,985,1858,505,540,310,1318,195,79,61,3400,4795,1775,2950,1200,735,1
486,1,2,138.0,127.0,192.0,157.0,4232,3140,3247,2155,985,985,869,381,35,70,834,311,79,61,3400,5455,1775,2950,1200,735,1
493,1,2,139.0,131.0,208.0,157.0,4322,3095,3359,2267,963,828,1136,364,290,115,846,249,79,61,3350,5835,1775,2950,1250,735,1
500,1,2,140.0,132.0,208.0,157.0,4238,3067,3275,2351,963,716,897,899,235,570,662,329,79,60,3350,5865,1775,2950,1500,685,1
507,1,2,148.0,132.0,208.0,165.0,4288,2871,3303,2155,985,716,407,1113,25,700,382,413,79,60,3350,5980,1775,2950,1500,685,1
514,1,2,152.0,132.0,208.0,165.0,4154,2877,3191,2183,963,694,413,292,115,95,298,197,79,60,4850,5995,1775,2950,1500,685,1
521,1,2,156.0,136.0,208.0,173.0,4210,3034,3247,2295,963,739,414,349,200,210,214,139,79,60,5100,6345,1775,2950,1500,685,1
529,1,2,157.5,140.0,208.0,173.0,4198,2961,3191,2155,1007,806,259,689,125,450,134,239,77,60,5625,7355,1775,2950,1725,685,1
536,1,2,161.5,144.0,208.0,173.0,4030,3011,3023,2183,1007,828,135,580,85,395,50,185,79,60,6625,7370,1775,2950,1725,685,1
543,1,2,164.5,148.0,208.0,173.0,4070,3084,3107,2211,963,873,302,545,240,260,62,285,79,60,7125,7585,1775,2950,1725,685,1
550,1,2,169.5,148.0,208.0,181.0,4126,3039,3163,2211,963,828,558,222,380,145,178,77,79,60,7625,7600,1775,2950,1725,685,1
557,1,2,165.0,152.0,216.0,181.0,4316,2994,3331,2099,985,895,1073,584,775,395,298,189,79,60,7900,8315,1775,2950,1950,685,1
564,1,2,170.0,152.0,216.0,181.0,4462,2955,3499,2015,963,940,659,474,545,165,114,309,78,60,8700,8665,1775,2950,1950,685,1
571,1,2,178.0,156.0,216.0,181.0,4159,3062,3107,2099,1052,963,391,354,145,75,246,279,78,60,8950,8665,1775,3450,1950,685,1
579,1,2,178.0,160.0,216.0,181.0,4288,2978,2967,2015,1321,963,566,349,335,100,231,249,78,60,8950,8665,1775,3450,1950,685,1
586,1,2,182.0,167.0,224.0,196.0,4148,3162,2827,2155,1321,1007,587,374,500,309,87,65,84,59,8700,9015,1775,3450,2200,685,1
593,1,2,180.0,167.0,224.0,196.0,4372,3106,3051,2099,1321,1007,974,371,735,344,239,27,84,59,9200,9015,1900,3750,2450,685,1
600,1,2,182.0,175.0,224.0,196.0,4400,3140,3079,2155,1321,985,700,302,505,159,195,143,82,59,9200,9365,1900,3900,2450,685,1
607,1,2,188.0,181.0,224.0,196.0,4378,3095,3079,2155,1299,940,426,174,275,69,151,105,82,63,8900,9365,1900,3900,2900,685,1
614,1,2,189.0,181.0,224.0,196.0,4411,3151,3135,2211,1276,940,502,309,395,84,107,225,81,63,9650,10065,1900,3900,2900,685,1
621,1,2,189.0,185.0,224.0,196.0,4322,3090,3023,2127,1299,963,1023,224,760,29,263,195,81,65,9650,10415,2150,3900,2900,685,1
629,1,2,195.0,189.0,224.0,196.0,4288,3336,2967,2351,1321,985,789,290,670,129,119,161,81,65,10450,10765,2150,3900,2900,685,1
636,1,2,199.0,193.0,224.0,196.0,4182,3269,2883,2239,1299,1030,781,460,710,179,71,281,81,65,10950,10865,2150,4050,2900,685,1
643,1,2,198.5,193.0,224.0,212.0,4350,3106,3051,2099,1299,1007,1067,797,940,404,127,393,81,65,11075,11315,2150,4200,3025,685,1
650,1,2,189.5,193.0,224.0,212.0,4400,2894,3079,1707,1321,1187,1338,804,1155,409,183,395,81,65,10225,10905,2150,4200,3875,1095,1
657,1,2,157.0,169.0,224.0,212.0,4406,3112,3107,1903,1299,1209,1864,471,1525,224,339,247,81,65,7400,7825,2150,4200,7450,4525,1
664,1,2,137.0,151.0,224.0,212.0,4551,3073,3275,1819,1276,1254,2406,852,1915,449,491,403,81,65,5500,6075,2150,4200,9850,6640,1
671,1,2,144.0,155.0,224.0,212.0,4512,3230,3191,1931,1321,1299,2141,888,1590,479,551,409,81,65,5100,6075,2150,4200,10500,6640,1
679,1,2,163.0,155.0,216.0,212.0,4484,3118,3163,1819,1321,1299,867,291,660,159,207,132,81,65,5150,5775,2150,4200,10700,6940,1
686,1,2,175.0,153.0,222.0,212.0,4406,3011,3107,1735,1299,1276,389,535,130,259,259,276,80,65,5700,5925,2150,4200,10700,7140,1
693,1,2,177.0,159.0,222.0,212.0,4434,3241,3135,1987,1299,1254,661,258,350,84,311,174,80,67,5950,6625,2150,4200,10700,7140,1
700,1,2,177.0,161.0,222.0,212.0,4322,3325,3023,2071,1299,1254,1167,200,700,74,467,126,87,67,6200,7125,2150,4200,10700,7290,1
707,1,2,189.0,167.0,222.0,212.0,4355,3375,3079,2099,1276,1276,188,138,165,102,23,36,87,67,7450,7125,2150,4200,10700,7290,1
714,1,2,189.0,168.0,222.0,212.0,4355,3672,3079,2351,1276,1321,669,518,490,322,179,196,87,67,7750,7125,2150,4200,10700,7290,1
721,1,2,199.0,177.0,222.0,212.0,4484,3594,3163,2295,1321,1299,234,206,95,112,139,94,87,67,8450,7125,2400,4300,10700,7290,1
729,1,2,197.0,177.0,222.0,212.0,4540,3700,3219,2379,1321,1321,581,636,440,382,141,254,87,68,8450,7785,2400,4300,10700,7290,1
736,1,2,199.0,183.0,222.0,212.0,4574,3728,3275,2407,1299,1321,608,448,515,292,93,156,85,71,9950,7800,2400,4300,10700,7290,1
743,1,2,199.0,189.0,222.0,212.0,4658,3711,3359,2435,1299,1276,1164,295,915,237,249,58,85,71,9950,7815,2400,4300,10700,7290,1
750,1,2,199.0,191.0,222.0,212.0,4686,3823,3387,2547,1299,1276,1180,536,925,322,255,214,85,71,10450,7655,2400,4300,10700,7465,1
757,1,2,193.0,197.0,222.0,212.0,4299,3868,3023,2547,1276,1321,702,356,295,232,407,124,79,71,10750,9190,2400,4300,10700,7465,1
764,1,2,182.0,197.0,230.0,212.0,3952,3958,2631,2659,1321,1299,857,397,440,117,417,280,70,71,11150,9220,2400,4300,10800,7465,1
771,1,2,183.5,199.0,230.0,212.0,3952,3812,2631,2491,1321,1321,1093,1019,670,587,423,432,70,71,11125,9150,2400,4300,10825,7565,1
779,1,2,187.5,199.0,230.0,212.0,3958,3918,2659,2575,1299,1343,1060,1450,785,862,275,588,70,71,11125,9165,3150,4300,10825,7565,1
786,1,2,187.5,199.0,230.0,212.0,3778,3846,2435,2547,1343,1299,1490,1582,1055,992,435,590,70,71,11125,10040,4275,4300,10825,7565,1
793,1,2,183.0,199.0,230.0,212.0,3722,3773,2155,2519,1567,1254,1426,1504,845,762,581,742,68,71,11000,10745,4275,4300,10950,7565,1
800,1,2,191.0,199.0,230.0,212.0,3739,3683,2127,2407,1612,1276,973,1894,800,992,173,902,67,71,11000,11435,4625,4300,10950,7565,1
807,1,2,191.0,199.0,230.0,212.0,3795,3672,2183,2351,1612,1321,1424,1559,1055,847,369,712,67,71,11250,11465,4625,4300,10950,7565,1
814,1,2,195.5,197.0,230.0,212.0,3840,3616,2183,2295,1657,1321,880,1981,715,1117,165,864,67,71,11575,11395,4625,4300,11125,7665,1
821,1,2,199.5,197.0,230.0,220.0,3722,3728,2043,2407,1679,1321,596,1887,235,867,361,1020,63,71,11575,12100,4750,4300,11125,7665,1
829,1,2,199.5,197.0,230.0,220.0,3678,3672,2043,2351,1635,1321,1049,2299,500,1127,549,1172,63,71,12475,12130,4750,4300,11125,7665,1
836,1,2,194.5,195.0,230.0,220.0,3459,3762,1847,2463,1612,1299,826,2755,85,1427,741,1328,58,71,12475,12060,4950,4300,11125,7765,1
843,1,2,191.5,195.0,230.0,220.0,3179,3627,1567,2351,1612,1276,1207,3172,270,1692,937,1480,55,71,13875,12075,5450,4300,11125,7765,1
850,1,2,190.5,195.0,230.0,220.0,3095,3706,1483,2407,1612,1299,1569,3622,440,1982,1129,1640,55,71,13825,12075,5450,4650,11175,7765,1
857,1,2,188.0,195.0,230.0,220.0,3168,3762,1511,2463,1657,1299,1949,4048,620,2252,1329,1796,55,71,13700,12060,5825,4900,11550,7795,1
864,1,2,176.0,189.0,230.0,220.0,3140,3762,1483,2463,1657,1299,2316,4420,795,2472,1521,1948,55,69,12650,11485,5575,4900,13225,8810,1
871,1,2,155.0,172.0,236.0,220.0,3095,3750,1483,2407,1612,1343,2684,4795,975,2687,1709,2108,54,68,10800,9665,5325,4900,15375,10725,1
879,1,2,160.5,150.0,236.0,220.0,3067,3706,1455,2407,1612,1299,1550,3423,245,1917,1305,1506,54,68,10025,5780,5325,4750,16150,14685,1
886,1,2,167.5,159.0,236.0,212.0,3062,3633,1427,2379,1635,1254,1111,2795,110,1687,1001,1108,54,68,10025,5840,5325,4550,16150,14833,1
893,1,2,172.5,157.0,236.0,212.0,3045,3683,1455,2407,1590,1276,1228,2200,35,1432,1193,768,54,68,10025,5485,5325,4550,16150,15233,1
900,1,2,173.5,158.0,236.0,212.0,2860,3728,1427,2407,1433,1321,1302,1195,45,567,1257,628,57,68,10025,5875,5325,4550,16150,15233,1
907,1,2,175.5,171.0,236.0,212.0,3101,3672,1735,2351,1366,1321,1586,891,165,107,1421,784,60,68,11525,7115,5325,4550,16150,15233,1
914,1,2,181.5,175.0,236.0,212.0,3129,3560,1763,2239,1366,1321,1505,1728,120,792,1385,936,62,69,11825,7540,5325,4550,16150,14933,1
921,1,2,184.5,177.0,236.0,212.0,3269,3532,1903,2211,1366,1321,1750,911,205,302,1545,609,65,67,12325,7965,5325,4550,16150,15033,1
929,1,2,187.5,178.0,236.0,212.0,3269,3538,1903,2239,1366,1299,1685,957,130,342,1555,615,68,67,12325,8140,5325,4550,16150,15033,1
936,1,2,187.5,182.0,236.0,220.0,3493,3549,2127,2295,1366,1254,2134,744,415,227,1719,517,68,67,12325,8535,5325,4800,16150,15033,1
943,1,2,186.5,188.0,236.0,220.0,3694,3571,2351,2295,1343,1276,1718,824,285,147,1433,677,70,67,12625,9325,5325,4800,16150,15033,1
950,1,2,183.0,188.0,236.0,220.0,3980,3370,2659,2127,1321,1243,2193,1234,600,407,1593,827,70,67,12450,9820,5325,4800,16325,15033,1
957,1,2,197.0,194.0,236.0,220.0,3986,3358,2575,2183,1411,1175,1526,1030,365,317,1161,713,70,67,12450,10170,5325,5050,16325,15033,1
964,1,2,197.0,194.0,236.0,220.0,4075,3314,2687,2127,1388,1187,2006,1425,685,572,1321,853,70,67,12450,10170,5325,5050,16325,15033,1
971,1,2,200.0,195.0,236.0,220.0,3941,3207,2575,2099,1366,1108,2146,1338,765,642,1381,696,70,67,12700,10520,5325,5350,16325,15033,1
979,1,2,200.0,195.0,236.0,220.0,3717,3118,2351,2155,1366,963,2180,1460,835,727,1345,733,70,67,12700,10520,5325,5350,16325,15033,1
986,1,2,200.0,195.0,236.0,220.0,3554,3095,2211,2155,1343,940,2620,1386,1115,762,1505,624,71,67,13600,10520,5725,5350,16325,15033,1
993,1,2,200.0,196.0,236.0,235.0,3644,2978,2323,2015,1321,963,2450,1741,1085,997,1365,744,71,67,13600,11420,5725,5350,16325,15033,1
1000,1,2,199.0,196.0,236.0,235.0,3655,3062,2267,2099,1388,963,1793,2101,810,1237,983,864,70,67,13850,11420,5725,5350,16325,15033,1
1007,1,2,199.0,196.0,236.0,235.0,3935,3050,2547,2043,1388,1007,2272,2452,1125,1472,1147,980,70,67,13850,12080,5725,5700,16325,15033,1
1014,1,2,199.0,196.0,236.0,235.0,3902,3302,2547,2295,1355,1007,2740,2809,1435,1717,1305,1092,70,67,13850,12195,5725,5700,16325,15033,1
1021,1,2,199.0,200.0,236.0,235.0,3958,3308,2715,2323,1243,985,2809,2075,1560,1367,1249,708,70,67,13850,12855,5725,5700,16325,15033,1
1029,1,2,199.0,200.0,236.0,235.0,3840,3431,2631,2491,1209,940,3249,2467,1860,1647,1389,820,70,67,14050,13285,5725,5700,16325,15033,1
1036,1,2,200.0,200.0,236.0,235.0,3762,3325,2575,2295,1187,1030,3654,2818,2125,1862,1529,956,70,67,14050,13315,5725,5700,16325,15033,1
1043,1,2,200.0,200.0,236.0,235.0,3930,3627,2743,2351,1187,1276,4133,3263,2460,2147,1673,1116,71,67,14050,13330,5725,5700,16325,15033,1
1050,1,2,200.0,200.0,236.0,235.0,3896,3644,2687,2323,1209,1321,3296,3669,1975,2397,1321,1272,71,67,14050,13345,5725,5700,16325,15033,1
1057,1,2,200.0,200.0,236.0,235.0,3666,3560,2435,2239,1231,1321,3025,3195,1560,1767,1465,1428,64,67,14050,13360,5725,5700,16325,15033,1
1064,1,2,200.0,200.0,236.0,235.0,3280,3644,2071,2323,1209,1321,3410,3017,1805,1737,1605,1280,64,67,14750,13360,5725,5700,16350,15033,1
1071,1,2,200.0,200.0,236.0,235.0,3426,3588,2239,2267,1187,1321,3520,3748,1925,2312,1595,1436,71,67,14750,13360,6175,6000,16350,15033,1
1079,1,2,200.0,200.0,236.0,251.0,3588,3683,2379,2407,1209,1276,3954,4195,2215,2607,1739,1588,71,67,14750,13360,6550,6000,16350,15033,1
1086,1,2,199.5,200.0,236.0,251.0,3790,3706,2603,2407,1187,1299,4408,4626,2525,2882,1883,1744,71,67,14725,13360,6550,6300,16375,15033,1
1093,1,2,196.0,192.0,236.0,259.0,3700,3358,2491,2127,1209,1231,4842,4619,2815,2727,2027,1892,71,59,14200,13360,7150,6300,16825,15433,1
1100,1,2,193.0,199.0,236.0,259.0,3952,2569,2743,1539,1209,1030,5321,3020,3150,1837,2171,1183,71,48,13750,13260,7150,6300,16975,16083,1
1107,1,2,192.5,199.0,236.0,259.0,3958,2367,2771,1427,1187,940,5796,3285,3485,2002,2311,1283,71,48,13675,13260,7150,6600,17050,16083,1
1114,1,2,192.5,198.0,236.0,259.0,4036,2160,2827,1455,1209,705,5080,3526,3200,2167,1880,1359,71,48,13675,13160,7150,6900,17050,16183,1
1121,1,2,192.5,200.0,236.0,259.0,3890,2154,2659,1483,1231,671,4854,3580,2830,2287,2024,1293,71,48,13675,13460,7150,6900,17050,16183,1
1129,1,2,189.5,200.0,236.0,259.0,3706,2278,2519,1539,1187,739,5284,3157,3120,1772,2164,1385,68,48,14075,13460,7150,6900,17050,16183,1
1136,1,2,197.5,200.0,244.0,259.0,3616,2306,2463,1567,1153,739,4782,3430,2880,1957,1902,1473,66,48,13925,13460,7150,6900,17200,16183,1
1143,1,2,196.5,200.0,244.0,259.0,3560,2546,2519,1651,1041,895,4906,3282,2880,1922,2026,1360,65,48,13925,13460,7150,6900,17200,16183,1
1150,1,2,199.5,200.0,244.0,259.0,3521,2742,2491,1735,1030,1007,5184,3618,3030,2142,2154,1476,65,48,13925,13460,7400,6900,17200,16183,1
1157,1,2,199.5,200.0,244.0,259.0,3627,2642,2575,1679,1052,963,5593,3921,3315,2337,2278,1584,65,48,13925,13460,7650,7050,17200,16183,1
1164,1,2,196.5,200.0,244.0,274.0,3566,2586,2547,1623,1019,963,6012,4151,3620,2447,2392,1704,62,48,14075,15410,7275,7300,17700,16213,1
1171,1,2,196.5,200.0,244.0,274.0,3297,2642,2491,1679,806,963,6393,4457,3915,2637,2478,1820,62,48,15075,15455,7275,7600,17700,16213,1
1179,1,2,193.0,200.0,236.0,274.0,3213,2496,2519,1511,694,985,6762,4702,4200,2762,2562,1940,62,48,14700,15455,6775,7600,18575,16243,1
1186,1,2,193.0,196.0,236.0,274.0,3162,2552,2491,1567,671,985,7146,4608,4500,2702,2646,1906,62,48,14700,14630,7400,7600,18575,17113,1
1193,1,2,193.0,200.0,236.0,274.0,3162,2451,2491,1455,671,996,7521,4497,4795,2627,2726,1870,62,48,14700,14675,7400,7600,18575,17128,1
1200,1,2,200.0,200.0,242.0,274.0,2961,2261,2491,1399,470,862,7514,4718,4740,2752,2774,1966,62,48,14700,14690,6775,7600,19200,17173,1
1207,1,2,192.0,194.0,242.0,274.0,2782,2238,2379,1455,403,783,7837,4910,5015,2852,2822,2058,62,48,13950,13955,6275,7600,20450,17953,1
1214,1,2,200.0,198.0,242.0,274.0,2782,2266,2379,1483,403,783,7181,4765,4715,2757,2466,2008,62,48,13950,13435,5775,7600,20950,18118,1
1221,1,2,187.0,198.0,242.0,274.0,2759,2289,2379,1483,380,806,7510,4975,5000,2867,2510,2108,62,48,13100,13860,5375,7600,22550,18148,1
1229,1,2,167.0,186.0,236.0,274.0,2513,2339,2155,1511,358,828,7799,3075,5245,1767,2554,1308,62,48,11400,11300,5375,7600,24600,21583,1
1236,1,2,183.0,170.0,228.0,274.0,2563,2362,2183,1511,380,851,3877,3286,2975,1882,902,1404,59,48,9700,9860,5375,7600,26550,23098,1
1243,1,2,187.0,162.0,228.0,274.0,2535,2339,2155,1567,380,772,3545,2618,2995,1582,550,1036,59,48,10450,8730,5375,7600,26800,24228,1
1250,1,2,189.0,180.0,228.0,274.0,2334,2082,1931,1455,403,627,3233,960,2835,702,398,258,58,48,10450,9940,5375,7600,26800,24228,1
1257,1,2,196.0,190.0,228.0,274.0,2496,2110,2071,1483,425,627,2886,460,2740,272,146,188,58,48,10450,10715,5375,7600,26800,24228,1
1264,1,2,200.0,191.0,228.0,274.0,2233,1992,1763,1343,470,649,2782,700,2580,432,202,268,56,51,14700,12145,5375,7600,26800,24228,1
1271,1,2,200.0,189.0,228.0,266.0,2384,2020,1735,1371,649,649,3048,1090,2770,742,278,348,59,51,15300,12160,5375,7600,26800,24728,1
1279,1,2,195.0,192.0,228.0,266.0,2558,2020,1931,1371,627,649,3338,526,2980,352,358,174,60,48,15600,12260,5375,7600,26950,24928,1
1286,1,2,199.5,191.0,228.0,266.0,2776,2154,2127,1483,649,671,2918,807,2780,557,138,250,60,47,15525,12960,5375,7600,27025,24978,1
1293,1,2,199.5,197.0,228.0,266.0,2826,2300,2155,1651,671,649,3259,528,3045,502,214,26,60,47,16025,12760,5375,7600,27025,24978,1
1300,1,2,199.0,197.0,228.0,267.0,2636,2334,1875,1707,761,627,3325,804,3015,702,310,102,60,47,16000,13310,5375,7600,27050,25378,1
1307,1,2,196.0,198.0,228.0,267.0,2670,2278,1707,1651,963,627,3642,889,3220,857,422,32,57,46,16000,13310,5375,7600,27050,25428,1
1314,1,2,197.0,199.0,228.0,267.0,2462,2272,1455,1623,1007,649,3622,764,3080,727,542,37,55,46,16750,13510,5375,7600,27050,25428,1
1321,1,2,199.0,199.0,234.0,267.0,2418,2322,1455,1651,963,671,3549,1044,2895,927,654,117,55,46,16750,13510,5175,7600,27050,25428,1
1329,1,2,200.0,199.0,234.0,267.0,2502,2322,1539,1651,963,671,3445,1310,2675,1117,770,193,57,46,16750,13510,5550,7600,27050,25428,1
1336,1,2,200.0,199.0,234.0,267.0,2451,2322,1287,1651,1164,671,3451,1591,2525,1322,926,269,51,46,16750,13960,5800,7600,27050,25428,1
1343,1,2,199.0,199.0,234.0,267.0,2804,2300,1483,1651,1321,649,2893,1842,2265,1497,628,345,51,46,16800,14620,5800,7900,27100,25428,1
1350,1,2,199.0,199.0,228.0,267.0,2535,2390,1371,1763,1164,627,2415,2113,1880,1692,535,421,51,46,16800,15435,5925,7900,27450,25428,1
1357,1,2,198.0,198.0,228.0,267.0,2300,2222,1315,1595,985,627,2691,2328,2040,1827,651,501,50,46,17550,15320,6675,7900,27450,25558,1
1364,1,2,191.5,200.0,228.0,267.0,2300,2244,1315,1595,985,649,2070,2373,1595,1942,475,431,46,46,17025,15350,6675,7900,27975,25558,1
1371,1,2,195.5,200.0,228.0,267.0,2278,2216,1315,1567,963,649,1116,2624,1025,2117,91,507,44,46,17025,15565,6675,7900,27975,25558,1
1379,1,2,194.5,200.0,228.0,267.0,2378,2177,1371,1483,1007,694,1400,2869,1185,2282,215,587,43,46,17025,15580,6675,7900,27975,25558,1
1386,1,2,194.5,200.0,228.0,267.0,2294,2042,1287,1371,1007,671,1212,3115,1110,2452,102,663,43,46,17125,15580,7175,7900,28000,25558,1
1393,1,2,197.5,200.0,228.0,267.0,2322,2110,1315,1483,1007,627,1342,3367,1120,2632,222,735,43,46,18625,15580,7425,7900,28000,25558,1
1400,1,2,197.5,196.0,228.0,267.0,2026,2250,1175,1623,851,627,1555,3632,1245,2817,310,815,43,46,19075,15215,6925,7900,28650,25923,1
1407,1,2,197.5,196.0,228.0,267.0,1617,2412,979,1763,638,649,1750,3902,1360,3007,390,895,46,46,19075,15215,6400,7900,29250,25938,1
1414,1,2,191.5,196.0,222.0,267.0,1202,2378,755,1707,447,671,1868,4187,1430,3212,438,975,43,46,18825,15215,6275,7900,30125,25953,1
1421,1,2,184.0,192.0,216.0,267.0,861,2434,503,1763,358,671,1963,4418,1485,3367,478,1051,42,46,17850,14770,6275,7900,31500,26383,1
1429,1,2,169.0,178.0,222.0,267.0,805,2406,447,1735,358,671,2067,4649,1545,3522,522,1127,42,46,15950,13250,6150,7900,33525,27933,1
1436,1,2,169.0,178.0,206.0,267.0,1158,2412,755,1763,403,649,2226,3505,1660,2902,566,603,42,46,15550,11825,6150,7900,34000,29433,1
1443,1,2,162.0,178.0,206.0,267.0,1074,2390,671,1763,403,627,1439,2676,1425,2447,14,229,42,46,13850,11050,6150,7900,35700,30223,1
1450,1,2,162.0,178.0,198.0,267.0,1107,2390,727,1763,380,627,1573,2921,1515,2612,58,309,42,46,13650,11125,6150,7900,35900,30223,1
1457,1,2,166.0,178.0,190.0,267.0,1253,2412,783,1763,470,649,2137,2511,1715,2422,422,89,42,46,13650,11155,6025,7900,36125,30223,1
1464,1,2,171.0,183.0,182.0,267.0,1382,2300,755,1651,627,649,1712,2517,1285,2352,427,165,41,46,13650,11170,4875,7900,37375,30223,1
1471,1,2,157.0,177.0,136.0,267.0,1432,2429,783,1735,649,694,1092,2797,585,2552,507,245,42,46,12750,10425,4750,7900,40200,32383,1
1479,1,2,157.0,177.0,136.0,267.0,1426,2250,755,1679,671,571,1157,3035,570,2732,587,303,42,51,12750,11140,4550,7900,40550,32383,1
1486,1,2,156.0,182.0,136.0,267.0,1421,2065,727,1651,694,414,933,2826,470,2702,463,124,41,51,12750,11140,4550,7900,40550,32383,1
1493,1,2,162.0,178.0,200.0,267.0,1404,1992,755,1679,649,313,340,2501,255,2337,85,164,41,51,13500,10805,4550,7900,40550,32733,1
1500,1,2,162.0,186.0,208.0,267.0,1270,1986,643,1651,627,335,486,1841,325,1637,161,204,41,51,13500,11570,4550,7900,40550,32733,1
1507,1,2,162.0,186.0,208.0,267.0,1242,2098,615,1763,627,335,636,2096,395,1852,241,244,41,51,13500,12370,4550,7900,40550,32733,1
1514,1,2,162.0,192.0,208.0,267.0,1634,1992,1007,1679,627,313,851,1712,530,1682,321,30,41,51,13500,12370,4550,7900,40550,32733,1
1521,1,2,162.0,192.0,208.0,267.0,1874,2042,1203,1707,671,335,1086,1457,685,1387,401,70,41,51,13500,12720,4550,7900,40550,32733,1
1529,1,2,166.0,184.0,208.0,267.0,1986,1936,1315,1623,671,313,817,1683,640,1577,177,106,41,51,14250,12320,4550,7900,40550,33133,1
1536,1,2,172.0,193.0,214.0,267.0,2126,2048,1455,1735,671,313,768,1833,515,1762,253,71,41,51,14250,12320,4550,8400,40550,33133,1
1543,1,2,174.0,193.0,214.0,267.0,1858,1796,1231,1483,627,313,730,2038,405,1927,325,111,41,51,14250,12720,4550,8400,40550,33133,1
1550,1,2,172.0,193.0,214.0,275.0,1858,1841,1231,1371,627,470,960,2267,555,2092,405,175,45,51,14250,12720,4550,8400,40550,33133,1
1557,1,2,172.0,195.0,214.0,275.0,1998,1583,1371,1203,627,380,745,2242,510,2177,235,65,47,51,14250,12820,5000,8400,40550,33133,1
1564,1,2,183.0,195.0,214.0,275.0,2272,1471,1623,1091,649,380,475,2301,160,2192,315,109,47,51,14750,13020,5000,8400,40550,33133,1
1571,1,2,183.0,195.0,214.0,290.0,2317,1499,1623,1007,694,492,759,2491,360,2322,399,169,47,51,14950,13020,5250,8400,40550,33133,1
1579,1,2,183.0,197.0,214.0,290.0,2530,1796,1679,1371,851,425,1064,2504,565,2437,499,67,47,51,15300,13880,5250,8400,40550,33133,1
1586,1,2,183.5,197.0,214.0,298.0,2518,1942,1623,1427,895,515,1254,1536,655,1397,599,139,47,51,15425,13895,5250,8400,40625,33133,1
1593,1,2,191.0,189.0,214.0,298.0,2451,1970,1623,1343,828,627,650,1901,255,1682,395,219,47,51,15350,13510,5250,8400,40700,33533,1
1600,1,2,198.0,189.0,214.0,298.0,2530,1992,1679,1343,851,649,173,2136,120,1837,53,299,49,51,15350,13525,5250,8400,40700,33533,1
1607,1,2,198.0,197.0,214.0,298.0,2782,2042,1931,1371,851,671,516,1377,355,1302,161,75,52,51,15350,13525,5250,8400,40700,33533,1
1614,1,2,200.0,197.0,214.0,298.0,2804,1880,1931,1231,873,649,749,1254,480,1107,269,147,53,51,15350,13940,5250,8700,40700,33533,1
1621,1,2,200.0,189.0,214.0,298.0,2916,1852,1931,1203,985,649,995,1474,610,1247,385,227,53,51,16000,13540,5250,9050,40800,33933,1
1629,1,2,200.0,197.0,214.0,298.0,3050,1886,2043,1259,1007,627,1362,1320,865,1017,497,303,55,51,16000,13540,5500,9050,40800,33933,1
1636,1,2,198.0,197.0,214.0,298.0,3084,1858,2099,1231,985,627,1498,1540,885,1157,613,383,55,51,16750,13940,5500,9050,40800,33933,1
1643,1,2,200.0,197.0,214.0,306.0,2983,2104,2043,1455,940,649,1175,1810,750,1347,425,463,53,51,16750,13940,5500,9050,40800,33933,1
1650,1,2,200.0,195.0,214.0,306.0,2927,2278,1987,1539,940,739,1080,2078,760,1527,320,551,53,51,16750,13840,5500,9150,40800,34033,1
1657,1,2,199.5,189.0,214.0,321.0,3056,2222,2071,1483,985,739,1395,1628,955,997,440,631,53,51,16675,13540,5750,9150,40875,34333,1
1664,1,2,199.5,197.0,214.0,321.0,3028,2362,2043,1623,985,739,1741,1116,1185,797,556,319,53,51,16975,13540,6000,9150,40875,34333,1
1671,1,2,198.5,197.0,214.0,321.0,2966,2714,1959,1931,1007,783,1887,837,1215,722,672,115,52,51,17275,13540,6000,9150,40875,34333,1
1679,1,2,199.5,199.0,214.0,321.0,2798,2709,1791,1903,1007,806,1403,1062,615,847,788,215,46,51,17325,13640,6000,9150,40875,34333,1
1686,1,2,199.5,199.0,214.0,321.0,2558,2854,1595,2071,963,783,1710,1403,810,1092,900,311,46,51,17325,13640,6000,9300,40875,34333,1
1693,1,2,198.5,197.0,214.0,321.0,2563,2877,1623,2071,940,806,2022,1743,1010,1332,1012,411,53,51,17275,13540,6000,9850,40925,34433,1
1700,1,2,198.5,197.0,208.0,321.0,1835,2950,1119,2099,716,851,2202,2093,1110,1582,1092,511,53,51,17275,13540,5800,9850,42225,34433,1
1707,1,2,198.5,198.0,208.0,321.0,1656,2894,1007,2043,649,851,2087,2324,915,1792,1172,532,53,51,17275,13540,5800,9850,42300,34433,1
1714,1,2,196.5,200.0,208.0,321.0,1645,2877,951,2071,694,806,2292,2461,1040,1837,1252,624,51,51,17275,13540,6050,9850,42300,34433,1
1721,1,2,196.5,200.0,208.0,321.0,1981,2798,1287,2015,694,783,2538,2178,1210,1612,1328,566,51,51,17275,13540,6050,9850,42300,34433,1
1729,1,2,196.5,200.0,208.0,321.0,2300,2642,1651,1903,649,739,2805,2500,1405,1842,1400,658,51,51,17275,13740,6050,9850,42300,34433,1
1736,1,2,196.5,200.0,208.0,337.0,1914,2798,1287,2015,627,783,3026,2836,1550,2082,1476,754,51,51,17275,13740,6050,9550,42300,34733,1
1743,1,2,197.5,200.0,208.0,337.0,1746,2882,1119,2099,627,783,2571,3183,1415,2337,1156,846,50,51,17275,13740,6050,9550,42150,34733,1
1750,1,2,196.5,200.0,208.0,337.0,1796,2720,1147,1959,649,761,2781,3515,1545,2577,1236,938,49,51,17275,13740,6050,9200,42225,35183,1
1757,1,2,196.5,197.0,208.0,337.0,1818,2087,1147,1483,671,604,2991,3065,1675,2067,1316,998,51,48,17275,14540,6050,9150,42225,35483,1
1764,1,2,193.5,195.0,208.0,321.0,2009,1706,1315,1147,694,559,2942,2977,1550,2057,1392,920,48,46,17275,14540,6050,8950,42225,35983,1
1771,1,2,192.5,200.0,208.0,298.0,2350,1634,1679,1119,671,515,3208,2128,1740,1627,1468,501,47,46,17275,14540,6050,9050,42225,36758,1
1779,1,2,198.5,200.0,208.0,298.0,2362,1650,1735,1203,627,447,2595,2635,1505,1932,1090,703,47,46,17275,14540,6175,9050,42350,36833,1
1786,1,2,198.5,200.0,208.0,306.0,2474,2009,1847,1539,627,470,2540,2685,1370,1922,1170,763,47,46,17275,14540,6550,9050,42350,36833,1
1793,1,2,197.5,198.0,208.0,306.0,2390,2115,1763,1623,627,492,2825,2376,1575,1557,1250,819,47,46,17125,14440,7075,9050,42350,36933,1
1800,1,2,194.0,198.0,208.0,306.0,2384,1874,1735,1427,649,447,2745,2388,1565,1517,1180,871,44,46,18000,14865,7325,9050,42375,36933,1
1807,1,2,194.0,198.0,208.0,306.0,2434,1813,1763,1343,671,470,3035,2799,1775,1872,1260,927,44,46,18000,14865,7325,9050,42375,36933,1
1814,1,2,200.0,198.0,208.0,322.0,2429,1942,1735,1427,694,515,2336,3044,1450,2057,886,987,44,46,18000,14865,7325,9650,42375,36933,1
1821,1,2,199.0,198.0,208.0,322.0,2210,1841,1539,1371,671,470,1757,3256,1095,2217,662,1039,43,46,18000,14865,7325,9650,42375,36933,1
1829,1,2,196.0,196.0,208.0,322.0,2166,1958,1539,1399,627,559,2019,3497,1285,2382,734,1115,40,45,18000,14765,7325,9650,42375,37083,1
1836,1,2,196.0,200.0,208.0,322.0,2166,1897,1539,1427,627,470,2279,3324,1465,2382,814,942,40,45,18900,14765,7325,10200,42375,37083,1
1843,1,2,196.0,200.0,208.0,337.0,2160,1992,1567,1455,593,537,2533,2881,1645,1867,888,1014,40,45,18900,14765,7450,10200,42375,37083,1
1850,1,2,196.0,200.0,208.0,337.0,1897,2233,1371,1539,526,694,2753,3150,1805,2052,948,1098,40,45,18900,14765,7825,10200,42375,37083,1
1857,1,2,200.0,200.0,208.0,337.0,1802,2322,1287,1651,515,671,2463,3425,1655,2247,808,1178,40,45,18900,14865,7825,10200,42375,37083,1
1864,1,2,200.0,200.0,208.0,345.0,1774,2339,1259,1623,515,716,2379,3508,1665,2242,714,1266,40,45,18900,14865,7825,10200,42375,37083,1
1871,1,2,200.0,200.0,214.0,345.0,1858,2412,1343,1651,515,761,2604,3801,1830,2447,774,1354,40,45,19200,15165,8175,10200,42375,37083,1
1879,1,2,200.0,200.0,214.0,345.0,1740,2418,1091,1679,649,739,2803,4088,1945,2642,858,1446,40,45,19200,15165,8175,10400,42375,37083,1
1886,1,2,200.0,200.0,214.0,345.0,1505,2406,923,1623,582,783,2966,4379,2040,2837,926,1542,40,45,19700,15165,8175,10800,42375,37083,1
1893,1,2,200.0,200.0,214.0,345.0,1650,2569,979,1763,671,806,3183,4700,2165,3062,1018,1638,40,45,19700,15165,8175,10800,42375,37083,1
1900,1,2,200.0,200.0,214.0,329.0,1919,2468,1091,1707,828,761,3428,4983,2310,3257,1118,1726,40,45,19700,15165,8050,11000,42500,37283,1
1907,1,2,199.0,200.0,214.0,329.0,2222,2490,1371,1707,851,783,3534,5265,2370,3447,1164,1818,39,45,19700,15165,8050,11000,42500,37283,1
1914,1,2,199.0,200.0,214.0,329.0,2115,2518,1287,1735,828,783,3785,5467,2525,3632,1260,1835,39,45,19700,15065,8050,11000,42500,37383,1
1921,1,2,199.0,200.0,214.0,329.0,2121,2474,1315,1735,806,739,3982,5765,2630,3842,1352,1923,39,45,19700,15065,8050,11000,42500,37383,1
1929,1,2,198.0,200.0,208.0,329.0,2121,2468,1315,1707,806,761,4227,5811,2775,3892,1452,1919,38,45,19700,15065,6850,11000,43700,37383,1
1936,1,2,198.0,200.0,208.0,329.0,2154,2406,1371,1623,783,783,4493,6072,2945,4057,1548,2015,38,45,19700,15165,6725,11000,43900,37383,1
1943,1,2,198.0,200.0,208.0,329.0,2205,2272,1399,1511,806,761,4753,6370,3105,4267,1648,2103,38,45,19700,15165,6475,10850,44225,37533,1
1950,1,2,198.0,200.0,208.0,329.0,2121,2406,1315,1623,806,783,5009,6641,3265,4442,1744,2199,38,45,19700,15165,6800,10550,44225,37833,1
1957,1,2,198.0,200.0,208.0,329.0,2194,2350,1343,1567,851,783,5264,6929,3420,4642,1844,2287,38,45,19700,15165,6800,9900,44225,38483,1
1964,1,2,198.0,200.0,208.0,321.0,2149,2412,1343,1651,806,761,5521,7212,3585,4837,1936,2375,38,45,19700,15165,6800,9300,44225,39258,1
1971,1,2,190.0,200.0,208.0,313.0,2149,2356,1343,1595,806,761,5767,7493,3735,5022,2032,2471,38,45,18600,15165,6800,9000,45325,39658,1
1979,1,2,184.0,193.0,200.0,313.0,2166,2384,1371,1623,795,761,6040,7775,3910,5212,2130,2563,38,45,17600,14515,6800,9250,46325,40308,1
1986,1,2,184.0,185.0,200.0,313.0,2054,2356,1371,1595,683,761,6266,8066,4060,5407,2206,2659,38,45,17600,13815,6800,9250,46325,41008,1
1993,1,2,200.0,186.0,200.0,313.0,2042,2412,1371,1651,671,761,4451,8239,3165,5567,1286,2672,38,45,17600,13815,6800,9250,46325,41008,1
2000,1,2,200.0,186.0,200.0,305.0,1992,2434,1343,1651,649,783,4677,7746,3315,5332,1362,2414,38,45,17600,13815,6800,9250,46325,41108,1
2007,1,2,200.0,186.0,200.0,305.0,2132,2485,1483,1679,649,806,4933,8047,3495,5537,1438,2510,38,45,17600,13815,6800,8950,46325,41408,1
2014,1,2,200.0,189.0,186.0,290.0,2048,2468,1399,1707,649,761,4479,8025,3315,5577,1164,2448,38,45,17900,13915,6800,8800,46775,41958,1
2021,1,2,200.0,189.0,186.0,290.0,2076,2474,1483,1735,593,739,4024,8357,2790,5817,1234,2540,38,45,18900,13915,6800,8800,46775,41958,1
2029,1,2,198.0,189.0,186.0,290.0,1880,2546,1455,1763,425,783,4264,8648,2980,6012,1284,2636,38,45,20050,13915,6675,8550,47325,42208,1
2036,1,2,198.0,189.0,242.0,290.0,1835,2490,1511,1707,324,783,4179,8940,2855,6212,1324,2728,38,45,20050,13915,6675,8550,47325,42208,1
2043,1,2,194.0,189.0,242.0,290.0,1762,2518,1427,1735,335,783,4394,9232,3030,6412,1364,2820,34,45,20050,13915,6675,8700,47325,42558,1
2050,1,2,194.0,199.0,242.0,282.0,1813,2401,1455,1595,358,806,4599,7909,3195,5697,1404,2212,34,45,20050,14215,6675,8700,47325,42958,1
2057,1,2,193.0,196.0,242.0,274.0,1734,2434,1399,1651,335,783,4580,8196,3140,5892,1440,2304,33,42,20050,14215,6675,8700,47325,43058,1
2064,1,2,197.0,200.0,242.0,274.0,1740,2194,1427,1455,313,739,4286,8024,3010,5807,1276,2217,31,41,20050,14215,7175,8700,47325,43058,1
2071,1,2,197.0,200.0,242.0,282.0,1740,2160,1427,1399,313,761,4496,7680,3180,5667,1316,2013,31,41,20050,14215,7175,8400,47325,43358,1
2079,1,2,197.0,200.0,242.0,282.0,1712,2042,1399,1147,313,895,4701,7626,3345,5497,1356,2129,31,41,20050,14215,7300,8400,47325,43358,1
2086,1,2,197.0,200.0,242.0,282.0,1768,2255,1455,1315,313,940,4921,7699,3525,5462,1396,2237,31,41,20050,14215,7550,8400,47325,43433,1
2093,1,2,197.0,200.0,242.0,282.0,1762,2216,1427,1231,335,985,5136,7940,3700,5587,1436,2353,31,41,20050,15065,7550,8650,47325,43533,1
2100,1,2,197.0,200.0,242.0,290.0,1790,2227,1455,1287,335,940,5342,8108,3870,5647,1472,2461,31,41,20050,15065,7550,8650,47325,43533,1
2107,1,2,197.0,200.0,242.0,306.0,1768,2065,1455,1147,313,918,5553,7756,4045,5187,1508,2569,31,41,20550,15490,7550,8650,47325,43533,1
2114,1,2,197.0,200.0,242.0,306.0,1852,2266,1539,1371,313,895,5778,7728,4230,5047,1548,2681,31,41,20550,15490,7550,8950,47325,43533,1
2121,1,2,197.0,199.0,242.0,322.0,1740,2194,1427,1231,313,963,5963,8189,4375,5392,1588,2797,31,41,20550,15390,7550,9250,47325,43633,1
2129,1,2,197.0,199.0,242.0,330.0,1628,2328,1315,1343,313,985,6158,8365,4530,5452,1628,2913,31,41,20550,15390,7550,9250,47325,43633,1
2136,1,2,197.0,199.0,242.0,338.0,1650,2205,1315,1287,335,918,6358,8624,4690,5607,1668,3017,31,41,20550,15390,7425,9350,47450,43633,1
2143,1,2,199.0,199.0,242.0,338.0,1589,2283,1231,1343,358,940,6303,8586,4695,5607,1608,2979,31,41,20550,15090,7425,9850,47450,43933,1
2150,1,2,199.0,199.0,242.0,338.0,1706,2199,1371,1259,335,940,6504,8748,4860,5657,1644,3091,31,41,20550,15090,7425,9850,47450,43933,1
2157,1,2,199.0,199.0,242.0,338.0,1628,2182,1315,1287,313,895,6695,9006,5015,5807,1680,3199,31,41,20550,15090,7300,9950,47575,43933,1
2164,1,2,199.0,198.0,242.0,338.0,1684,2205,1371,1287,313,918,6900,9187,5180,5947,1720,3240,31,39,20550,15090,7175,9950,47700,44033,1
2171,1,2,198.0,198.0,242.0,338.0,1516,2194,1203,1231,313,963,6700,9433,4940,6077,1760,3356,30,39,20800,15090,7175,9950,47700,44033,1
2179,1,2,194.0,198.0,242.0,338.0,1376,2171,1063,1231,313,940,6870,9096,5070,5632,1800,3464,26,39,20800,15090,7175,10050,47700,44033,1
2186,1,2,194.0,198.0,242.0,338.0,1510,2115,1175,1175,335,940,7055,8898,5215,5322,1840,3576,26,39,20800,15490,7175,10050,47700,44033,1
2193,1,2,194.0,198.0,242.0,338.0,1533,2143,1175,1203,358,940,7225,9151,5345,5467,1880,3684,26,39,20800,15490,7300,10050,47700,44033,1
2200,1,2,194.0,198.0,242.0,338.0,1566,2087,1231,1147,335,940,7406,9403,5490,5607,1916,3796,26,39,20800,15490,7800,10050,47700,44033,1
2207,1,2,200.0,198.0,242.0,338.0,1460,2121,1147,1203,313,918,7272,9560,5320,5652,1952,3908,26,39,20800,15490,7800,10250,47700,44033,1
2214,1,2,200.0,197.0,242.0,338.0,1460,2087,1147,1147,313,940,7442,9812,5450,5792,1992,4020,26,39,20800,15390,7800,10350,47700,44133,1
2221,1,2,196.0,197.0,242.0,346.0,1331,2115,1119,1175,212,940,7594,10073,5580,5937,2014,4136,26,39,20250,15390,7800,10850,48250,44133,1
2229,1,2,194.0,196.0,242.0,346.0,1354,2149,1175,1231,179,918,7749,10332,5715,6092,2034,4240,26,39,20300,15290,7800,11100,48500,44233,1
2236,1,2,200.0,199.0,242.0,346.0,1113,2143,1035,1203,78,940,6826,9874,5190,5672,1636,4202,26,39,20300,15290,7800,11100,48500,44233,1
2243,1,2,194.0,199.0,242.0,346.0,1119,1914,1119,951,0,963,6366,9500,5030,5182,1336,4318,20,39,20300,15290,7800,11100,48500,44233,1
2250,1,2,194.0,199.0,242.0,346.0,1063,1813,1063,895,0,918,6496,9708,5160,5282,1336,4426,20,39,20300,15290,7800,11100,48500,44233,1
2257,1,2,194.0,199.0,242.0,346.0,1091,1762,1091,867,0,895,6636,9925,5300,5387,1336,4538,20,39,20900,15290,7800,11000,48500,44333,1
2264,1,2,194.0,197.0,242.0,338.0,1175,1830,1175,867,0,963,6776,10146,5440,5492,1336,4654,20,37,21500,15290,8550,11400,48500,44533,1
2271,1,2,200.0,197.0,242.0,338.0,1119,1858,1119,895,0,963,6151,10353,5115,5587,1036,4766,20,37,21500,15575,8550,11300,48500,44648,1
2279,1,2,200.0,197.0,242.0,338.0,1147,1779,1147,839,0,940,6296,9706,5260,5182,1036,4524,20,37,21500,14740,8550,11300,48500,45498,1
2286,1,2,200.0,197.0,242.0,346.0,1091,1858,1091,895,0,963,6416,9528,5380,4892,1036,4636,20,37,21500,14740,8550,11450,48500,45498,1
2293,1,2,200.0,191.0,242.0,346.0,1175,1807,1175,867,0,940,6561,9745,5525,4997,1036,4748,20,37,21500,14140,8550,11800,48500,46098,1
2300,1,2,200.0,196.0,242.0,346.0,1091,1762,1091,867,0,895,6691,9528,5655,4847,1036,4681,20,37,22250,14140,8550,11800,48500,46098,1
2307,1,2,200.0,199.0,242.0,346.0,1203,1779,1203,839,0,940,6836,9440,5800,4797,1036,4643,20,37,22250,14140,8550,11800,48500,46098,1
2314,1,2,200.0,197.0,242.0,346.0,1007,1751,1007,811,0,940,6566,9556,5530,4797,1036,4759,20,35,22250,14140,8550,11800,48500,46198,1
2321,1,2,198.0,194.0,242.0,346.0,839,1751,839,811,0,940,6661,9769,5625,4902,1036,4867,18,32,22250,14990,8550,11800,48500,46348,1
2329,1,2,199.0,194.0,242.0,346.0,727,1768,727,783,0,985,6246,9675,5410,4692,836,4983,15,32,22250,14990,8550,11800,48500,46348,1
2336,1,2,199.0,193.0,242.0,346.0,755,1723,755,783,0,940,6336,10083,5500,4992,836,5091,15,31,22250,14990,8550,11700,48500,46598,1
2343,1,2,199.0,194.0,242.0,346.0,727,1729,727,811,0,918,6426,10086,5590,5037,836,5049,15,31,22250,15415,8800,11600,48500,46698,1
2350,1,2,199.0,199.0,242.0,354.0,727,1678,727,783,0,895,6521,9873,5685,4887,836,4986,15,31,22250,15715,9175,11600,48500,46698,1
2357,1,2,199.0,199.0,242.0,369.0,755,1774,755,811,0,963,6611,9879,5775,4777,836,5102,15,31,22750,15715,9175,11600,48500,46698,1
2364,1,2,199.0,200.0,242.0,369.0,727,1768,727,783,0,985,6691,10090,5855,4872,836,5218,15,31,22750,15815,9175,11600,48500,46698,1
2371,1,2,199.0,200.0,242.0,369.0,727,1701,727,783,0,918,6781,10284,5945,4962,836,5322,15,31,22750,15815,9050,11600,48625,46698,1
2379,1,2,199.0,200.0,234.0,369.0,783,1779,783,839,0,940,6876,10486,6040,5052,836,5434,15,31,22550,15815,9050,11600,48825,46698,1
2386,1,2,199.0,200.0,234.0,369.0,671,1695,671,755,0,940,6951,10683,6115,5137,836,5546,15,31,22550,15915,9050,11600,48825,46698,1
2393,1,2,199.0,200.0,234.0,369.0,615,1734,615,839,0,895,6726,10891,6040,5237,686,5654,15,31,22550,16340,9050,11600,48825,46698,1
2400,1,2,199.0,200.0,234.0,385.0,531,1634,531,727,0,907,6791,11081,6105,5317,686,5764,15,31,22550,16340,8925,11600,48950,46698,1
2407,1,2,185.0,192.0,234.0,385.0,503,1572,503,755,0,817,6851,11267,6165,5407,686,5860,15,31,20850,15020,8925,11400,49900,47818,1
2414,1,2,162.0,192.0,234.0,385.0,531,1488,531,727,0,761,6921,11375,6235,5427,686,5948,15,31,18500,14900,8925,11400,52250,47938,1
2421,1,2,159.0,200.0,194.0,385.0,531,1510,531,727,0,783,6986,9746,6300,4452,686,5294,15,31,17200,14345,8925,11000,53550,49418,1
2429,1,2,168.0,192.0,194.0,377.0,531,1510,531,727,0,783,6151,9899,6065,4517,86,5382,15,31,17200,13425,8925,11000,53550,50438,1
2436,1,2,181.0,200.0,194.0,377.0,531,1488,531,727,0,761,5266,8942,5180,4222,86,4720,15,31,17200,13715,8925,10900,53550,50538,1
2443,1,2,181.0,200.0,194.0,377.0,475,1438,475,699,0,739,4866,8199,4780,3387,86,4812,15,31,17200,14345,8925,10900,53550,50538,1
2450,1,2,181.0,200.0,194.0,377.0,391,1466,391,727,0,739,4716,7857,4630,2957,86,4900,15,31,17250,14375,8925,10900,53550,50538,1
2457,1,2,176.0,199.0,194.0,377.0,419,1466,419,727,0,739,4836,8329,4750,3187,86,5142,10,30,18450,16140,8925,10900,53550,50588,1
2464,1,2,174.0,199.0,194.0,377.0,391,1438,391,755,0,683,4736,8482,4650,3262,86,5220,8,30,18450,16155,8925,10900,53550,50588,1
2471,1,2,178.0,199.0,210.0,377.0,419,1398,419,783,0,615,4631,8654,4545,3362,86,5292,8,30,18900,16155,8925,11000,53550,50588,1
2479,1,2,180.0,197.0,210.0,377.0,279,1410,279,783,0,627,4361,8665,4275,3297,86,5368,8,28,18900,16170,9550,11300,53550,50688,1
2486,1,2,180.0,197.0,210.0,377.0,279,1460,279,867,0,593,4401,8836,4315,3402,86,5434,8,28,18900,16170,9800,11700,53625,50688,1
2493,1,2,180.0,200.0,210.0,377.0,279,1438,279,979,0,459,4431,8703,4345,3367,86,5336,8,28,18900,16170,9800,11800,53625,50688,1
2500,1,2,180.0,200.0,210.0,377.0,279,1566,279,1175,0,391,4471,8881,4385,3507,86,5374,8,28,18900,16170,9800,11900,53625,50688,1
2507,1,2,182.0,200.0,210.0,377.0,223,1410,223,1119,0,291,4391,9028,4355,3622,36,5406,8,28,19200,16170,9800,12050,53625,50688,1
2514,1,2,186.0,200.0,210.0,377.0,139,1410,139,1119,0,291,3811,8405,3775,2967,36,5438,8,28,19450,16170,9800,12050,53625,50688,1
2521,1,2,186.0,200.0,210.0,377.0,139,1410,139,1119,0,291,3826,8471,3790,2997,36,5474,8,28,19450,16170,9800,12050,53625,50688,1
2529,1,2,186.0,200.0,210.0,377.0,167,1387,167,1119,0,268,3846,8633,3810,3127,36,5506,8,28,19450,16470,9800,12050,53625,50688,1
2536,1,2,186.0,200.0,210.0,377.0,139,1443,139,1175,0,268,3411,8809,3375,3267,36,5542,8,28,19450,16470,9800,12050,53625,50688,1
2543,1,2,188.0,200.0,210.0,392.0,139,1438,139,1147,0,291,3276,8976,3240,3402,36,5574,8,28,19600,16470,9800,12050,53625,50688,1
2550,1,2,192.0,200.0,210.0,400.0,27,1466,27,1175,0,291,3276,7882,3240,2797,36,5085,8,28,19900,15195,9800,12050,53625,51963,1
2557,1,2,192.0,200.0,210.0,400.0,0,1494,0,1203,0,291,2676,8049,2640,2932,36,5117,8,28,19900,15195,9800,12850,53625,51963,1
2564,1,2,191.0,200.0,210.0,400.0,0,1494,0,1203,0,291,2751,8230,2715,3077,36,5153,7,28,19900,15195,9675,12850,53625,51963,1
2571,1,2,184.0,200.0,210.0,400.0,0,1527,0,1259,0,268,2676,8397,2640,3212,36,5185,0,28,19900,15195,9675,12850,53625,51963,1
2579,1,2,186.0,200.0,210.0,400.0,0,1550,0,1259,0,291,2676,8588,2640,3367,36,5221,0,28,20050,15195,9675,12850,53625,51963,1
2586,1,2,190.0,200.0,210.0,400.0,0,1527,0,1259,0,268,2676,8760,2640,3507,36,5253,0,28,20350,16045,9800,12850,53625,51963,1
2593,1,2,190.0,200.0,210.0,400.0,0,1516,0,1203,0,313,2226,8926,2190,3637,36,5289,0,28,20350,16470,10550,12850,53625,51963,1
2600,1,2,190.0,199.0,210.0,400.0,0,1544,0,1231,0,313,2226,9112,2190,3787,36,5325,0,28,20350,16370,10550,12850,53625,52063,1
2607,1,2,190.0,199.0,210.0,400.0,0,1443,0,1175,0,268,2226,9275,2190,3922,36,5353,0,28,20350,16370,10550,12850,53625,52063,1
2614,1,2,192.0,199.0,210.0,400.0,0,1415,0,1147,0,268,2226,9446,2190,4057,36,5389,0,28,20500,16370,10300,12850,53875,52063,1
2621,1,2,196.0,199.0,210.0,400.0,0,1460,0,1203,0,257,2226,8781,2190,3712,36,5069,0,28,20800,15520,10175,12850,54000,52913,1
2629,1,2,196.0,199.0,210.0,400.0,0,1342,0,1175,0,167,2226,8941,2190,3852,36,5089,0,28,20800,15520,10175,12850,54000,52913,1
2636,1,2,196.0,199.0,210.0,400.0,0,1247,0,1091,0,156,2226,9086,2190,3977,36,5109,0,28,20800,15520,10175,12850,54000,52913,1
2643,1,2,196.0,199.0,210.0,400.0,0,1270,0,1091,0,179,2226,9246,2190,4117,36,5129,0,28,20800,15520,10175,12850,54000,52913,1
2650,1,2,196.0,199.0,210.0,400.0,0,1275,0,1119,0,156,2226,9397,2190,4252,36,5145,0,28,20950,15520,10175,12850,54000,52913,1
2657,1,2,196.0,199.0,210.0,400.0,0,1303,0,1147,0,156,2226,9542,2190,4377,36,5165,0,28,21250,15520,10175,12850,54000,52913,1
2664,1,2,196.0,199.0,210.0,400.0,0,1163,0,1007,0,156,2226,9677,2190,4492,36,5185,0,28,21250,16370,10175,12850,54000,52913,1
2671,1,2,196.0,199.0,210.0,400.0,0,1331,0,1175,0,156,2226,9837,2190,4632,36,5205,0,28,21250,16370,10175,12850,54000,52913,1
2679,1,2,196.0,199.0,210.0,400.0,0,1443,0,1287,0,156,2226,10017,2190,4792,36,5225,0,28,21250,16370,10175,12850,54000,52913,1
2686,1,2,198.0,199.0,210.0,400.0,0,1550,0,1371,0,179,2076,10082,2040,4837,36,5245,0,28,21250,16370,10175,12850,54000,52913,1
2693,1,2,200.0,199.0,210.0,400.0,0,1354,0,1175,0,179,1926,10247,1890,4982,36,5265,0,28,21250,16370,10175,12850,54000,52913,1
2700,1,2,200.0,199.0,210.0,400.0,0,1247,0,1091,0,156,1926,10383,1890,5102,36,5281,0,28,21250,16370,10175,12850,54000,52913,1
2707,1,2,200.0,200.0,210.0,408.0,0,1191,0,1035,0,156,1876,10028,1840,4802,36,5226,0,28,21200,16370,10175,12850,54050,52913,1
2714,1,2,200.0,199.0,210.0,408.0,0,1303,0,1147,0,156,1876,9783,1840,4462,36,5321,0,28,21200,16370,10175,12850,54050,52913,1
2721,1,2,200.0,199.0,210.0,408.0,0,1303,0,1147,0,156,1876,9848,1840,4507,36,5341,1,28,21350,16370,10175,12850,54050,52913,1
2729,1,2,200.0,199.0,210.0,408.0,0,1275,0,1119,0,156,1876,9903,1840,4542,36,5361,1,28,21500,16370,10175,12850,54050,52913,1
2736,1,2,200.0,199.0,210.0,408.0,0,1354,0,1175,0,179,1876,10068,1840,4687,36,5381,1,28,21500,16370,10050,13250,54175,52913,1
2743,1,2,200.0,199.0,210.0,408.0,0,1247,0,1091,0,156,1876,10189,1840,4792,36,5397,1,28,21500,16355,9925,13650,54300,52928,1
2750,1,2,200.0,199.0,210.0,408.0,0,1219,0,1063,0,156,1876,10349,1840,4932,36,5417,1,28,21500,16370,9925,13850,54300,52928,1
2757,1,2,200.0,199.0,210.0,408.0,0,1163,0,1007,0,156,1876,10479,1840,5042,36,5437,1,28,21500,16370,9675,13950,54550,52928,1
2764,1,2,200.0,199.0,210.0,408.0,0,1303,0,1147,0,156,1876,10244,1840,4937,36,5307,1,28,21500,16070,9675,13950,54550,53228,1
2771,1,2,200.0,199.0,210.0,408.0,0,1163,0,1007,0,156,1876,10374,1840,5047,36,5327,1,28,21500,16070,9550,13950,54675,53228,1
2779,1,2,198.0,199.0,210.0,408.0,0,1242,0,1063,0,179,1876,10534,1840,5187,36,5347,1,28,21250,16070,9550,13950,54925,53228,1
2786,1,2,196.0,199.0,210.0,416.0,0,1046,0,867,0,179,1876,10449,1840,5082,36,5367,1,28,21100,16070,9550,13950,55075,53228,1
2793,1,2,196.0,199.0,210.0,416.0,0,1079,0,923,0,156,1876,10085,1840,4702,36,5383,1,28,21100,16070,9550,13950,55075,53228,1
2800,1,2,196.0,199.0,202.0,416.0,0,1051,0,895,0,156,1876,10210,1840,4807,36,5403,1,28,20900,16370,9550,13950,55275,53228,1
2807,1,2,196.0,199.0,202.0,416.0,0,1107,0,951,0,156,1876,10355,1840,4932,36,5423,1,28,20900,16370,9425,13950,55400,53228,1
2814,1,2,196.0,199.0,202.0,416.0,0,1135,0,979,0,156,1876,10490,1840,5047,36,5443,1,28,20900,16370,9175,13950,55650,53228,1
2821,1,2,196.0,185.0,202.0,416.0,0,1135,0,979,0,156,1876,10620,1840,5157,36,5463,1,28,20900,15170,9050,14450,55775,54428,1
2829,1,2,194.0,173.0,202.0,416.0,0,1130,0,951,0,179,1876,10755,1840,5272,36,5483,1,28,20650,14120,9050,14650,56025,55478,1
2836,1,2,190.0,178.0,202.0,416.0,0,1158,0,979,0,179,1876,1960,1840,132,36,1828,1,28,20350,12420,9050,14650,56325,57178,1
2843,1,2,190.0,178.0,202.0,416.0,0,1163,0,1007,0,156,1876,4541,1840,1647,36,2894,1,28,20350,12420,9050,14650,56325,57178,1
2850,1,2,189.0,178.0,202.0,416.0,0,1107,0,951,0,156,1801,4761,1765,1847,36,2914,0,28,20350,12420,9050,14650,56325,57178,1
2857,1,2,189.0,178.0,202.0,416.0,0,1163,0,1007,0,156,1801,4906,1765,1972,36,2934,0,28,20350,12420,9050,14650,56325,57178,1
2864,1,2,195.0,178.0,202.0,416.0,0,1051,0,895,0,156,1351,4926,1315,1972,36,2954,0,28,20350,12420,9050,14650,56325,57178,1
2871,1,2,200.0,193.0,202.0,416.0,0,1107,0,951,0,156,1101,5051,1065,2077,36,2974,0,28,20350,13680,9175,14650,56325,57193,1
2879,1,2,200.0,198.0,202.0,416.0,0,1102,0,923,0,179,1101,6026,1065,2682,36,3344,0,28,20350,14545,9175,14650,56325,57193,1
2886,1,2,200.0,198.0,202.0,424.0,0,1107,0,951,0,156,1101,6162,1065,2802,36,3360,0,28,20600,14545,9175,14650,56325,57193,1
2893,1,2,200.0,198.0,202.0,424.0,0,1135,0,979,0,156,1101,6297,1065,2917,36,3380,0,28,20600,14545,9175,14650,56325,57193,1
2900,1,2,200.0,198.0,202.0,424.0,0,1113,0,1035,0,78,1101,6438,1065,3052,36,3386,0,28,21050,14545,9175,14650,56325,57193,1
2907,1,2,200.0,188.0,202.0,424.0,0,1091,0,1091,0,0,1101,6993,1065,3432,36,3561,0,28,21050,14120,9175,14650,56325,58043,1
2914,1,2,198.0,198.0,202.0,424.0,0,923,0,923,0,0,1101,7063,1065,3502,36,3561,0,28,20800,14925,9175,14650,56575,58088,1
2921,1,2,198.0,198.0,202.0,424.0,0,923,0,923,0,0,1101,7583,1065,3847,36,3736,0,28,20800,15380,9175,14650,56575,58088,1
2929,1,2,198.0,192.0,202.0,424.0,0,867,0,867,0,0,1101,7688,1065,3952,36,3736,0,28,20800,14795,9175,14650,56575,58688,1
2936,1,2,198.0,198.0,202.0,424.0,0,923,0,923,0,0,1101,7198,1065,3762,36,3436,0,28,20800,14795,9175,14650,56575,58688,1
2943,1,2,198.0,198.0,202.0,424.0,0,811,0,811,0,0,1101,7293,1065,3857,36,3436,0,28,20800,14795,8925,14650,56825,58688,1
2950,1,2,198.0,198.0,194.0,424.0,0,755,0,755,0,0,801,7378,765,3942,36,3436,0,28,20600,14795,8800,14650,57150,58688,1
2957,1,2,198.0,198.0,194.0,424.0,0,727,0,727,0,0,601,7368,565,3932,36,3436,0,28,20600,15645,8800,14650,57150,58688,1
2964,1,2,198.0,198.0,218.0,424.0,0,783,0,783,0,0,601,7458,565,4022,36,3436,0,28,20600,15645,8800,14650,57150,58688,1
2971,1,2,198.0,198.0,234.0,424.0,0,811,0,811,0,0,601,7558,565,4122,36,3436,0,28,20600,15645,8800,14650,57150,58688,1
2979,1,2,198.0,198.0,234.0,424.0,0,839,0,839,0,0,601,7548,565,4112,36,3436,0,28,20600,16245,8800,14650,57150,58688,1
2986,1,2,198.0,198.0,234.0,432.0,0,839,0,839,0,0,601,7658,565,4222,36,3436,0,28,20600,16245,8800,14650,57150,58688,1
2993,1,2,196.0,198.0,234.0,432.0,0,811,0,811,0,0,601,7748,565,4312,36,3436,0,28,20450,16245,8800,14650,57300,58688,1
3000,1,2,196.0,198.0,234.0,440.0,0,811,0,811,0,0,601,7553,565,4117,36,3436,0,28,20450,16245,8800,14650,57300,58688,1
3007,1,2,196.0,198.0,234.0,440.0,0,587,0,587,0,0,601,7608,565,4172,36,3436,0,28,20450,16245,8800,14650,57300,58688,1
3014,1,2,196.0,198.0,218.0,440.0,0,419,0,419,0,0,601,7663,565,4227,36,3436,0,28,20450,16245,8800,14650,57650,58688,1
3021,1,2,196.0,198.0,218.0,440.0,0,447,0,447,0,0,601,7713,565,4277,36,3436,0,28,20450,16245,8800,14650,57650,58688,1
3029,1,2,196.0,197.0,218.0,440.0,0,391,0,391,0,0,601,7458,565,4022,36,3436,0,28,20450,16145,8800,14750,57650,58788,1
3036,1,2,197.0,197.0,218.0,440.0,0,279,0,279,0,0,551,7493,515,4057,36,3436,0,28,20450,16145,8800,14950,57650,58788,1
3043,1,2,197.0,197.0,218.0,440.0,0,223,0,223,0,0,551,7513,515,4077,36,3436,0,28,20450,16145,8675,14950,57775,58788,1
3050,1,2,197.0,197.0,218.0,440.0,0,111,0,111,0,0,551,7523,515,4087,36,3436,1,28,20450,16145,8300,14950,58150,58788,1
3057,1,2,197.0,197.0,218.0,440.0,27,0,27,0,0,0,556,7523,520,4087,36,3436,1,28,20450,16145,8175,14950,58275,58788,1
3064,1,2,193.0,197.0,218.0,440.0,83,0,83,0,0,0,566,7523,530,4087,36,3436,1,28,19900,16145,8175,15150,58825,58888,1
3071,1,2,190.0,197.0,218.0,432.0,55,0,55,0,0,0,571,7523,535,4087,36,3436,1,28,19600,16145,8175,15150,59125,58988,1
3079,1,2,190.0,197.0,218.0,432.0,83,0,83,0,0,0,581,7523,545,4087,36,3436,1,28,19600,16145,8175,15150,59125,58988,1
3086,1,2,190.0,197.0,218.0,432.0,55,0,55,0,0,0,586,7523,550,4087,36,3436,1,28,19600,16145,8175,15150,59125,58988,1
3093,1,2,188.0,197.0,218.0,432.0,55,0,55,0,0,0,591,7523,555,4087,36,3436,1,28,19350,16145,8050,15150,59500,58988,1
3100,1,2,188.0,197.0,218.0,432.0,55,0,55,0,0,0,601,7523,565,4087,36,3436,1,28,19350,16145,7925,15150,59625,58988,1
3107,1,2,188.0,196.0,218.0,432.0,55,0,55,0,0,0,606,7523,570,4087,36,3436,1,27,19350,16145,7925,15150,59625,59038,1
3114,1,2,188.0,194.0,218.0,432.0,55,0,55,0,0,0,616,6923,580,3737,36,3186,1,19,19350,16145,7925,15150,59625,59438,1
3121,1,2,189.0,196.0,218.0,432.0,55,0,55,0,0,0,571,5723,535,3037,36,2686,1,9,19350,16145,7925,15150,59625,59938,1
3129,1,2,188.0,200.0,218.0,432.0,27,0,27,0,0,0,501,4523,465,2337,36,2186,0,1,19350,16145,7925,15150,59625,60338,1
3136,1,2,188.0,200.0,218.0,432.0,0,0,0,0,0,0,501,4523,465,2337,36,2186,1,1,19350,16145,7925,15150,59625,60338,1
3143,1,2,188.0,200.0,218.0,432.0,27,0,27,0,0,0,506,4523,470,2337,36,2186,1,1,19350,16145,7925,15150,59625,60338,1
3150,1,2,188.0,200.0,218.0,432.0,83,0,83,0,0,0,516,4523,480,2337,36,2186,1,1,19350,16145,7800,15150,59875,60338,1
3157,1,2,188.0,200.0,218.0,432.0,55,0,55,0,0,0,521,4523,485,2337,36,2186,1,1,19350,16145,7800,15150,59875,60338,1
3164,1,2,188.0,200.0,218.0,432.0,83,0,83,0,0,0,531,4523,495,2337,36,2186,1,1,19350,16145,7800,15150,59875,60338,1
3171,1,2,188.0,193.0,218.0,432.0,55,0,55,0,0,0,536,4223,500,2187,36,2036,1,1,19350,15195,7675,15150,60000,61288,1
3179,1,2,188.0,193.0,218.0,432.0,83,0,83,0,0,0,546,4208,510,2172,36,2036,1,1,19350,15855,7675,15150,60000,61288,1
3186,1,2,188.0,193.0,218.0,432.0,55,0,55,0,0,0,551,4163,515,2127,36,2036,1,1,19350,17190,7425,15150,60250,61288,1
3193,1,2,188.0,199.0,218.0,432.0,55,0,55,0,0,0,556,3488,520,1752,36,1736,1,1,19350,18555,7425,15150,60250,61288,1
3200,1,2,188.0,199.0,218.0,432.0,55,0,55,0,0,0,566,3458,530,1722,36,1736,1,1,19350,18585,7425,15150,60250,61288,1
3207,1,2,188.0,199.0,218.0,432.0,55,0,55,0,0,0,571,3398,535,1662,36,1736,1,1,19350,18945,7425,15150,60250,61288,1
3214,1,2,188.0,199.0,218.0,432.0,55,0,55,0,0,0,581,3353,545,1617,36,1736,1,1,19350,19005,7425,15150,60250,61288,1
3221,1,2,188.0,199.0,218.0,432.0,55,0,55,0,0,0,586,3323,550,1587,36,1736,1,1,19350,19065,7425,15150,60250,61288,1
3229,1,2,188.0,199.0,218.0,432.0,55,0,55,0,0,0,596,3323,560,1587,36,1736,1,1,19350,19695,7425,15150,60250,61288,1
3236,1,2,188.0,199.0,218.0,432.0,55,0,55,0,0,0,601,3323,565,1587,36,1736,1,1,19350,19695,7425,15150,60250,61288,1
3243,1,2,188.0,199.0,218.0,432.0,55,0,55,0,0,0,611,3323,575,1587,36,1736,1,1,19350,19695,7425,15150,60250,61288,1
3250,1,2,188.0,199.0,218.0,432.0,55,0,55,0,0,0,616,3323,580,1587,36,1736,1,1,19350,19695,7425,15150,60250,61288,1
3257,1,2,188.0,199.0,218.0,432.0,83,0,83,0,0,0,626,3323,590,1587,36,1736,1,1,19350,19695,7425,15150,60250,61288,1
3264,1,2,188.0,199.0,218.0,432.0,55,0,55,0,0,0,631,3323,595,1587,36,1736,1,1,19350,19695,7425,15150,60250,61288,1
3271,1,2,188.0,199.0,218.0,432.0,83,0,83,0,0,0,641,3323,605,1587,36,1736,1,1,19350,19695,7175,15150,60500,61288,1
3279,1,2,186.0,199.0,218.0,432.0,55,0,55,0,0,0,646,3323,610,1587,36,1736,1,1,19200,19695,7175,15150,60650,61288,1
3286,1,2,186.0,199.0,218.0,432.0,83,0,83,0,0,0,656,3323,620,1587,36,1736,1,1,19200,19695,7175,15150,60650,61288,1
3293,1,2,184.0,199.0,218.0,432.0,55,0,55,0,0,0,661,3263,625,1527,36,1736,1,1,18950,19605,7050,15150,61025,61378,1
3300,1,2,184.0,199.0,218.0,432.0,55,0,55,0,0,0,666,3233,630,1497,36,1736,1,1,18950,19665,7050,15150,61025,61378,1
3307,1,2,196.0,199.0,218.0,432.0,55,0,55,0,0,0,76,3233,40,1497,36,1736,1,1,18950,19695,6800,15150,61275,61378,1
3314,1,2,196.0,199.0,218.0,432.0,55,0,55,0,0,0,81,3233,45,1497,36,1736,1,1,18950,19695,6675,15150,61400,61378,1
3321,1,2,194.0,199.0,218.0,432.0,55,0,55,0,0,0,91,3233,55,1497,36,1736,1,1,19300,19695,6675,15150,61650,61378,1
3329,1,2,194.0,199.0,218.0,432.0,55,0,55,0,0,0,96,3233,60,1497,36,1736,1,1,19300,19695,6675,15150,61650,61378,1
3336,1,2,194.0,199.0,218.0,432.0,55,0,55,0,0,0,106,3233,70,1497,36,1736,1,1,19300,19695,6550,15150,61775,61378,1
3343,1,2,194.0,199.0,218.0,432.0,55,0,55,0,0,0,111,3233,75,1497,36,1736,1,1,19300,19695,6425,15150,61900,61378,1
3350,1,2,192.0,199.0,218.0,432.0,55,0,55,0,0,0,121,3233,85,1497,36,1736,1,1,19050,19695,6300,15150,62275,61378,1
3357,1,2,192.0,199.0,218.0,432.0,55,0,55,0,0,0,126,3233,90,1497,36,1736,1,1,19050,19695,6175,15150,62400,61378,1
3364,1,2,192.0,200.0,218.0,432.0,83,0,83,0,0,0,136,3133,100,1472,36,1661,1,1,19050,19695,6175,15150,62400,61378,1
3371,1,2,192.0,200.0,218.0,432.0,27,0,27,0,0,0,136,3133,100,1472,36,1661,1,1,19050,19695,6175,15150,62400,61378,1
3379,1,2,192.0,200.0,218.0,432.0,0,0,0,0,0,0,136,3133,100,1472,36,1661,1,1,19050,19695,6175,15150,62400,61378,1
3386,1,2,192.0,200.0,218.0,432.0,0,0,0,0,0,0,136,3133,100,1472,36,1661,1,1,19050,19795,6175,15150,62400,61378,1
3393,1,2,192.0,200.0,210.0,432.0,0,0,0,0,0,0,136,2283,100,972,36,1311,1,1,18850,18945,6175,15150,62600,62228,1
3400,1,2,192.0,200.0,210.0,432.0,0,0,0,0,0,0,136,2283,100,972,36,1311,1,1,18850,18945,5925,15150,62850,62228,1
3407,1,2,191.0,200.0,210.0,432.0,0,0,0,0,0,0,136,2283,100,972,36,1311,1,1,18800,18945,5925,15150,62900,62228,1
3414,1,2,188.0,200.0,210.0,432.0,0,0,0,0,0,0,136,2283,100,972,36,1311,1,1,18650,18945,5925,15150,63050,62228,1
3421,1,2,182.0,200.0,210.0,432.0,0,0,0,0,0,0,136,2283,100,972,36,1311,1,1,18350,18945,5925,15150,63350,62228,1
3429,1,2,176.5,200.0,202.0,417.0,0,0,0,0,0,0,136,2268,100,957,36,1311,1,1,18075,18930,5925,14850,63725,62943,1
3436,1,2,176.0,200.0,202.0,417.0,0,0,0,0,0,0,136,2268,100,957,36,1311,1,1,18050,19765,5925,14700,63750,63108,1
3443,1,2,176.0,200.0,202.0,401.0,0,0,0,0,0,0,136,2253,100,942,36,1311,1,1,18050,19780,5925,14600,63750,63483,1
3450,1,2,176.0,200.0,202.0,401.0,0,0,0,0,0,0,136,2253,100,942,36,1311,1,1,18050,19795,5925,14400,63750,63683,1
3457,1,2,173.5,200.0,202.0,401.0,0,0,0,0,0,0,136,2253,100,942,36,1311,1,1,17925,19795,5925,14400,63875,63683,1
3464,1,2,173.5,200.0,202.0,401.0,0,0,0,0,0,0,136,2253,100,942,36,1311,1,1,17925,19795,5925,14400,63875,63683,1
3471,1,2,172.5,200.0,202.0,401.0,0,0,0,0,0,0,136,2253,100,942,36,1311,1,1,17875,19795,5925,14250,63925,63833,1
3479,1,2,172.5,200.0,202.0,401.0,0,0,0,0,0,0,136,2253,100,942,36,1311,1,1,17875,19795,5925,14250,63925,63833,1
3486,1,2,172.5,200.0,202.0,401.0,0,0,0,0,0,0,136,2253,100,942,36,1311,1,1,17875,19795,5925,14250,63925,63833,1
3493,1,2,172.5,200.0,202.0,401.0,0,0,0,0,0,0,136,2253,100,942,36,1311,1,1,17875,19795,5925,14250,63925,63833,1
3500,1,2,172.5,200.0,202.0,401.0,0,0,0,0,0,0,136,2253,100,942,36,1311,1,1,17875,19795,5925,14250,63925,63833,1
3507,1,2,172.5,200.0,202.0,401.0,0,0,0,0,0,0,136,2253,100,942,36,1311,1,1,17875,19795,5925,14250,63925,63833,1
3514,1,2,172.5,200.0,202.0,401.0,0,0,0,0,0,0,136,2253,100,942,36,1311,1,1,17875,19795,5925,14250,63925,63833,1
3521,1,2,172.5,200.0,202.0,401.0,0,0,0,0,0,0,136,2253,100,942,36,1311,1,1,17875,19795,5800,14250,64050,63833,1
3529,1,2,172.0,200.0,202.0,401.0,0,0,0,0,0,0,136,2253,100,942,36,1311,1,1,17850,19795,5800,14100,64075,63983,1
3536,1,2,172.0,200.0,202.0,401.0,0,0,0,0,0,0,136,2253,100,942,36,1311,1,1,17850,19795,5675,14100,64200,63983,1
3543,1,2,171.5,200.0,196.0,401.0,0,0,0,0,0,0,136,2253,100,942,36,1311,1,1,17825,19795,5550,13850,64700,64233,1
3550,1,2,171.0,200.0,196.0,401.0,0,0,0,0,0,0,36,2253,0,942,36,1311,1,1,17700,19795,4850,13850,65525,64233,1
3557,1,2,171.0,200.0,196.0,401.0,0,0,0,0,0,0,36,2253,0,942,36,1311,2,1,17700,19795,4850,13850,65525,64233,1
3564,1,2,171.0,200.0,196.0,401.0,27,0,27,0,0,0,41,2253,5,942,36,1311,2,1,17700,19795,4850,13850,65525,64233,1
3571,1,2,171.0,200.0,196.0,401.0,55,0,55,0,0,0,46,2253,10,942,36,1311,2,1,17750,19795,4725,13850,65650,64233,1
3579,1,2,171.0,200.0,196.0,401.0,55,0,55,0,0,0,56,2253,20,942,36,1311,2,1,17750,19795,4725,13850,65650,64233,1
3586,1,2,168.0,200.0,196.0,401.0,55,0,55,0,0,0,61,2253,25,942,36,1311,2,1,17450,19795,4725,13850,65950,64233,1
3593,1,2,168.0,200.0,196.0,401.0,55,0,55,0,0,0,71,2253,35,942,36,1311,2,1,17450,19795,4725,13850,65950,64233,1
3600,1,2,168.0,200.0,196.0,401.0,83,0,83,0,0,0,81,2253,45,942,36,1311,2,1,17450,19795,4725,13850,65950,64233,1
3607,1,2,168.0,200.0,196.0,401.0,55,0,55,0,0,0,86,2253,50,942,36,1311,2,1,17450,19795,4725,13850,65950,64233,1
3614,1,2,168.0,200.0,196.0,401.0,83,0,83,0,0,0,96,2253,60,942,36,1311,2,1,17450,19795,4725,13850,65950,64233,1
3621,1,2,168.0,200.0,196.0,401.0,55,0,55,0,0,0,101,2253,65,942,36,1311,2,1,17450,19795,4725,13850,65950,64233,1
3629,1,2,166.0,200.0,196.0,401.0,83,0,83,0,0,0,111,2253,75,942,36,1311,2,1,17200,19795,4725,13850,66200,64233,1
3636,1,2,166.0,200.0,196.0,401.0,55,0,55,0,0,0,116,2253,80,942,36,1311,2,1,17200,19795,4600,13850,66325,64233,1
3643,1,2,166.0,200.0,196.0,401.0,55,0,55,0,0,0,126,2253,90,942,36,1311,2,1,17200,19795,4475,13850,66450,64233,1
3650,1,2,166.0,200.0,196.0,401.0,55,0,55,0,0,0,131,2253,95,942,36,1311,2,1,17200,19795,4475,13850,66450,64233,1
3657,1,2,166.0,200.0,196.0,401.0,55,0,55,0,0,0,141,2253,105,942,36,1311,2,1,17200,19795,4475,13850,66450,64233,1
3664,1,2,164.0,200.0,196.0,401.0,83,0,83,0,0,0,151,2253,115,942,36,1311,2,1,17050,19795,4475,13850,66600,64233,1
3671,1,2,164.0,200.0,196.0,401.0,55,0,55,0,0,0,156,2253,120,942,36,1311,2,1,17050,19795,4350,13850,66725,64233,1
3679,1,2,164.0,200.0,196.0,401.0,83,0,83,0,0,0,166,2253,130,942,36,1311,2,1,17050,19795,4350,13850,66725,64233,1
3686,1,2,164.0,200.0,196.0,401.0,27,0,27,0,0,0,166,2253,130,942,36,1311,2,1,17050,19795,4350,13850,66725,64233,1
3693,1,2,164.0,200.0,196.0,401.0,0,0,0,0,0,0,166,2253,130,942,36,1311,2,1,17050,19795,4225,13850,66850,64233,1
3700,1,2,164.0,200.0,196.0,401.0,0,0,0,0,0,0,166,2253,130,942,36,1311,2,1,17050,19795,3975,13850,67100,64233,1
3707,1,2,164.0,200.0,196.0,401.0,0,0,0,0,0,0,166,2253,130,942,36,1311,2,1,17050,19795,3850,13850,67225,64233,1
3714,1,2,164.0,200.0,196.0,401.0,0,0,0,0,0,0,166,2253,130,942,36,1311,2,1,17050,19795,3850,13850,67225,64233,1
3721,1,2,162.0,200.0,196.0,401.0,0,0,0,0,0,0,166,2253,130,942,36,1311,2,1,16800,19795,3725,13850,67600,64233,1
3729,1,2,164.0,200.0,196.0,401.0,0,0,0,0,0,0,66,2253,30,942,36,1311,2,1,16800,19795,3725,13850,67600,64233,1
3736,1,2,164.0,200.0,196.0,401.0,0,0,0,0,0,0,66,2253,30,942,36,1311,2,1,16800,19795,3600,13850,67725,64233,1
3743,1,2,164.0,200.0,196.0,401.0,0,0,0,0,0,0,66,2253,30,942,36,1311,2,1,16900,19795,3600,13850,67725,64233,1
3750,1,2,164.0,200.0,196.0,401.0,0,0,0,0,0,0,66,2253,30,942,36,1311,2,1,16900,19795,3475,13850,67850,64233,1
3757,1,2,164.0,200.0,196.0,401.0,0,0,0,0,0,0,66,2253,30,942,36,1311,2,1,16900,19795,3475,13850,67850,64233,1
3764,1,2,164.0,200.0,196.0,401.0,0,0,0,0,0,0,66,2253,30,942,36,1311,2,1,16900,19795,3225,13850,68100,64233,1
3771,1,2,164.0,200.0,196.0,401.0,0,0,0,0,0,0,66,2253,30,942,36,1311,2,1,16900,19795,3225,13850,68100,64233,1
3779,1,2,164.0,200.0,196.0,401.0,0,0,0,0,0,0,66,2253,30,942,36,1311,2,1,16900,19795,3225,13850,68100,64233,1
3786,1,2,164.0,200.0,196.0,401.0,0,0,0,0,0,0,66,2253,30,942,36,1311,2,1,16900,19795,3225,13850,68100,64233,1
3793,1,2,164.0,200.0,196.0,401.0,0,0,0,0,0,0,66,2253,30,942,36,1311,2,1,16900,19795,3225,13850,68100,64233,1
3800,1,2,164.0,200.0,196.0,401.0,0,0,0,0,0,0,66,2253,30,942,36,1311,2,1,16900,19795,3225,13850,68100,64233,1
3807,1,2,164.0,200.0,196.0,401.0,0,0,0,0,0,0,66,2253,30,942,36,1311,2,1,16900,19795,3100,13850,68225,64233,1
3814,1,2,164.0,200.0,196.0,401.0,0,0,0,0,0,0,66,2253,30,942,36,1311,2,1,16900,19795,3100,13850,68225,64233,1
3821,1,2,164.0,200.0,196.0,401.0,0,0,0,0,0,0,66,2253,30,942,36,1311,2,1,16900,19795,3100,13850,68225,64233,1
3829,1,2,164.0,200.0,196.0,401.0,0,0,0,0,0,0,66,2253,30,942,36,1311,2,1,16900,19795,2850,13850,68225,64233,1
3836,1,2,164.0,200.0,196.0,401.0,0,0,0,0,0,0,66,1953,30,792,36,1161,2,1,16900,19495,2850,13850,68225,64533,1
3843,1,2,163.5,200.0,196.0,401.0,0,0,0,0,0,0,66,1953,30,792,36,1161,2,1,16875,19495,2850,13850,68250,64533,1
3850,1,2,163.0,200.0,196.0,401.0,0,0,0,0,0,0,66,1953,30,792,36,1161,2,1,16850,19495,2850,13850,68275,64533,1
3857,1,2,163.0,200.0,196.0,401.0,0,0,0,0,0,0,66,1953,30,792,36,1161,2,1,16850,19495,2850,13850,68275,64533,1
3864,1,2,161.0,200.0,196.0,401.0,0,0,0,0,0,0,66,1953,30,792,36,1161,2,1,16600,19495,2725,13850,68650,64533,1
3871,1,2,161.0,200.0,196.0,401.0,0,0,0,0,0,0,66,1953,30,792,36,1161,2,1,16600,19795,2600,13850,68775,64533,1
3879,1,2,161.0,200.0,196.0,401.0,27,0,27,0,0,0,71,1953,35,792,36,1161,2,1,16600,19795,2350,13850,69025,64533,1
3886,1,2,161.0,200.0,196.0,401.0,111,0,111,0,0,0,86,1953,50,792,36,1161,2,1,16600,19795,2350,13850,69025,64533,1
3893,1,2,161.0,200.0,196.0,401.0,139,0,139,0,0,0,101,1953,65,792,36,1161,2,1,16600,19795,2350,13850,69025,64533,1
3900,1,2,161.0,200.0,196.0,401.0,139,0,139,0,0,0,116,1953,80,792,36,1161,2,1,16600,19795,2225,13850,69150,64533,1
3907,1,2,161.0,200.0,196.0,401.0,139,0,139,0,0,0,131,1953,95,792,36,1161,2,1,16600,19795,2100,13850,69275,64533,1
3914,1,2,161.0,200.0,196.0,401.0,139,0,139,0,0,0,146,1953,110,792,36,1161,2,1,16600,19795,2100,13850,69275,64533,1
3921,1,2,161.0,200.0,196.0,401.0,139,0,139,0,0,0,161,1953,125,792,36,1161,2,1,16600,19795,2100,13850,69275,64533,1
3929,1,2,161.0,200.0,196.0,401.0,111,0,111,0,0,0,171,1953,135,792,36,1161,2,1,16600,19795,1975,13850,69400,64533,1
3936,1,2,161.0,200.0,196.0,401.0,139,0,139,0,0,0,191,1953,155,792,36,1161,2,1,16600,19795,1850,13850,69525,64533,1
3943,1,2,154.0,200.0,196.0,401.0,111,0,111,0,0,0,201,1953,165,792,36,1161,2,1,15750,19795,1725,13850,70500,64533,1
3950,1,2,134.5,192.0,196.0,401.0,139,0,139,0,0,0,221,1878,185,717,36,1161,2,1,13425,18860,1725,13850,72825,65393,1
3957,1,2,116.0,184.0,196.0,401.0,111,0,111,0,0,0,231,1788,195,627,36,1161,2,1,11350,17685,1725,13850,74900,66523,1
3964,1,2,82.0,168.0,196.0,401.0,111,0,111,0,0,0,246,983,210,122,36,861,2,1,7350,15540,1725,13850,78900,68788,1
3971,1,2,58.0,144.0,196.0,401.0,111,0,111,0,0,0,261,863,225,2,36,861,2,1,4550,13305,1725,13850,81700,71158,1
7,1,0,13.0,13.0,14.0,15.0,377,293,377,293,0,0,45,35,45,35,0,0,12,12,0,0,0,0,0,0,0
14,1,0,13.0,14.0,14.0,15.0,699,671,699,671,0,0,25,70,25,70,0,0,13,13,0,0,0,0,0,0,0
21,1,0,14.0,14.0,14.0,15.0,727,727,727,727,0,0,55,0,55,0,0,0,13,13,0,0,0,0,0,0,0
29,1,0,14.0,15.0,14.0,15.0,755,671,755,671,0,0,155,80,155,80,0,0,13,14,0,0,0,0,0,0,0
36,1,0,16.0,15.0,22.0,15.0,755,783,755,783,0,0,145,135,145,135,0,0,14,14,0,0,0,0,0,0,0
43,1,0,16.0,16.0,22.0,23.0,783,811,783,811,0,0,235,70,235,70,0,0,16,15,0,0,0,0,0,0,0
50,1,0,15.0,16.0,22.0,23.0,755,755,755,755,0,0,35,35,35,35,0,0,15,15,0,0,0,0,0,0,0
57,1,0,18.0,17.0,22.0,23.0,839,783,839,783,0,0,0,85,0,85,0,0,15,16,0,0,0,0,0,0,0
64,1,0,18.0,18.0,22.0,23.0,895,839,895,839,0,0,110,180,110,180,0,0,16,17,0,0,0,0,0,0,0
71,1,0,17.0,18.0,22.0,23.0,895,855,895,811,0,44,185,228,185,220,0,8,17,17,0,0,0,0,0,0,0
79,1,0,17.0,19.0,22.0,23.0,923,939,923,783,0,156,55,343,55,315,0,28,16,18,0,0,0,0,0,0,0
86,1,0,18.0,19.0,22.0,23.0,923,967,923,811,0,156,115,463,115,415,0,48,16,18,0,0,0,0,0,0,0
93,1,0,19.0,20.0,22.0,23.0,945,1046,923,867,22,179,179,333,175,315,4,18,18,19,0,0,0,150,0,0,0
100,1,0,20.0,20.0,22.0,23.0,1012,995,923,839,89,156,246,444,230,410,16,34,19,19,0,0,0,150,0,0,0
107,1,0,20.0,20.0,22.0,23.0,1113,995,979,839,134,156,382,159,350,105,32,54,19,19,0,0,0,150,0,0,0
114,1,0,21.0,21.0,22.0,23.0,1158,911,979,755,179,156,472,119,420,45,52,74,20,19,0,0,0,150,0,0,0
121,1,0,27.0,22.0,28.0,23.0,1135,911,979,755,156,156,188,179,120,85,68,94,21,19,0,100,250,150,0,0,0
129,1,0,27.0,23.0,28.0,23.0,1191,1074,1035,895,156,179,338,259,250,145,88,114,21,20,0,100,250,150,0,0,0
136,1,0,28.0,23.0,28.0,31.0,1090,1074,979,895,111,179,310,104,210,70,100,34,21,20,0,100,250,150,0,0,0
143,1,0,27.0,24.0,28.0,31.0,1051,1219,1007,1063,44,156,143,165,35,165,108,0,21,21,100,150,250,150,0,0,0
150,1,0,29.0,25.0,36.0,31.0,1130,1247,1063,1091,67,156,176,255,60,235,116,20,21,22,100,150,250,150,0,0,0
157,1,0,31.0,25.0,36.0,31.0,1135,1219,1091,1063,44,156,230,395,110,355,120,40,22,22,400,150,250,150,0,0,0
164,1,0,30.5,25.0,36.0,31.0,1191,1275,1147,1119,44,156,183,555,155,495,28,60,24,23,375,150,250,150,25,0,0
171,1,0,32.5,26.0,36.0,31.0,1326,1331,1259,1175,67,156,91,255,55,175,36,80,25,23,375,150,250,150,25,0,0
179,1,0,35.5,27.0,36.0,46.0,1382,1410,1315,1231,67,179,119,210,75,110,44,100,25,24,375,150,250,500,25,0,0
186,1,0,35.5,27.0,36.0,46.0,1415,1298,1371,1119,44,179,188,105,140,85,48,20,27,24,375,150,250,500,25,0,0
193,1,0,39.5,28.0,44.0,46.0,1494,1275,1427,1119,67,156,171,136,115,100,56,36,28,25,375,150,250,500,25,0,0
200,1,0,42.5,32.0,44.0,46.0,1578,1331,1511,1175,67,156,164,111,100,55,64,56,31,25,375,150,250,500,25,0,0
207,1,0,44.5,34.0,52.0,46.0,1639,1331,1595,1175,44,156,208,101,140,50,68,51,32,26,525,150,250,500,25,0,0
214,1,0,49.5,35.0,58.0,46.0,1611,1510,1567,1287,44,223,111,158,35,75,76,83,33,27,525,150,250,500,25,0,0
221,1,0,51.5,40.0,58.0,46.0,1942,1824,1875,1511,67,313,149,248,65,125,84,123,36,28,525,350,250,825,25,0,0
229,1,0,53.5,43.0,58.0,46.0,1886,1818,1819,1483,67,335,167,188,75,100,92,88,36,29,525,350,250,825,25,0,0
236,1,0,56.5,44.0,66.0,46.0,1998,1986,1931,1651,67,335,165,389,65,265,100,124,39,30,675,350,250,825,25,0,0
243,1,0,59.5,45.0,66.0,61.0,2177,1964,2043,1651,134,313,226,295,110,160,116,135,41,31,825,550,250,825,25,0,0
250,1,0,62.5,50.0,74.0,61.0,2283,1992,2127,1679,156,313,236,225,100,50,136,175,42,33,1025,550,250,825,25,0,0
257,1,0,67.5,54.0,74.0,61.0,2311,2020,2155,1707,156,313,176,195,20,80,156,115,42,34,1075,775,250,825,125,0,0
264,1,0,68.5,55.0,82.0,61.0,2334,2244,2155,1931,179,313,401,220,225,165,176,55,45,35,1125,775,250,900,125,0,0
271,1,0,73.0,61.0,82.0,61.0,2446,2322,2267,1987,179,335,196,190,50,95,146,95,49,36,1100,975,250,900,150,0,0
279,1,0,71.0,63.0,90.0,69.0,2614,2345,2435,1987,179,358,226,65,160,30,66,35,48,37,1250,975,250,900,150,0,0
286,1,0,77.0,65.0,98.0,69.0,2619,2658,2463,2323,156,335,132,236,50,165,82,71,48,38,1300,1025,250,900,150,0,0
293,1,0,79.0,67.0,98.0,69.0,2675,2804,2519,2491,156,313,252,197,150,190,102,7,48,40,1450,1125,250,900,150,0,0
300,1,0,81.0,72.0,98.0,77.0,2647,2832,2491,2519,156,313,347,282,225,235,122,47,52,42,1450,1475,250,900,150,0,0
307,1,0,83.0,71.0,106.0,77.0,2821,2860,2575,2547,246,313,423,262,265,225,158,37,54,44,1450,1475,250,900,150,0,0
314,1,0,82.0,72.0,98.0,77.0,2804,2636,2379,2323,425,313,400,527,190,450,210,77,51,44,1500,1475,250,900,250,0,0
321,1,0,82.0,73.0,106.0,85.0,2754,2826,2239,2491,515,335,730,412,460,295,270,117,53,44,1650,1475,575,900,250,0,0
329,1,0,85.0,74.0,106.0,93.0,2955,2737,2463,2379,492,358,637,322,315,165,322,157,57,45,1650,1475,575,900,250,0,0
336,1,0,84.0,76.0,98.0,93.0,3011,2546,2519,2211,492,335,197,438,65,245,132,193,59,46,1650,1475,1075,900,350,0,0
343,1,0,88.0,77.0,114.0,93.0,3090,2832,2463,2519,627,313,166,734,25,505,141,229,58,47,1650,1725,1075,1250,350,0,0
350,1,0,89.0,78.0,122.0,93.0,3162,2698,2267,2183,895,515,397,970,140,715,257,255,58,50,1750,1725,1075,1250,350,0,0
357,1,0,92.0,80.0,122.0,101.0,3241,2933,2323,2351,918,582,474,847,105,720,369,127,63,50,1900,1725,1075,1400,125,0,0
364,1,0,92.0,83.0,130.0,101.0,3364,3006,2379,2379,985,627,379,814,140,615,239,199,67,51,1900,1725,1075,1550,125,0,0
371,1,0,95.0,90.0,130.0,101.0,3554,3011,2547,2407,1007,604,445,751,90,605,355,146,67,53,1900,1725,1075,1550,125,0,0
379,1,0,94.0,91.0,138.0,101.0,3610,2810,2603,2183,1007,627,797,953,330,785,467,168,69,55,1950,1825,1075,1850,325,0,0
386,1,0,101.0,96.0,138.0,101.0,3599,2759,2659,2155,940,604,785,485,210,395,575,90,69,55,1950,1875,1075,1850,325,0,0
393,1,0,101.0,98.0,154.0,117.0,3683,3017,2743,2435,940,582,915,772,220,610,695,162,70,56,1950,1975,1075,1850,325,0,0
400,1,0,101.0,104.0,154.0,117.0,3711,3095,2771,2491,940,604,1275,683,460,545,815,138,70,58,2100,2025,1075,1850,325,0,0
407,1,0,101.0,108.0,170.0,133.0,3706,3347,2743,2743,963,604,1730,875,795,665,935,210,70,61,2300,2450,1075,1850,325,0,0
414,1,0,121.0,117.0,194.0,133.0,3806,3375,2799,2771,1007,604,130,182,100,125,30,57,70,61,2300,2550,1525,1950,325,0,0
421,1,0,128.0,120.0,194.0,133.0,3773,3644,2743,2995,1030,649,132,318,90,285,42,33,70,63,2300,2650,1525,2050,325,0,0
429,1,0,127.0,123.0,200.0,141.0,3806,3482,2799,2855,1007,627,233,495,175,390,58,105,69,63,2350,2900,1525,2050,325,0,0
436,1,0,132.0,130.0,200.0,157.0,3627,3521,2687,2939,940,582,161,308,95,235,66,73,68,65,2350,3050,1525,2050,325,0,0
443,1,0,134.0,134.0,200.0,157.0,3711,3459,2771,2855,940,604,166,489,80,440,86,49,68,65,4800,3625,1525,2150,325,0,0
450,1,0,134.0,136.0,192.0,165.0,3790,3459,2827,2855,963,604,741,306,535,185,206,121,68,65,4800,3875,1525,2150,525,100,0
457,1,0,145.0,138.0,192.0,165.0,3868,3291,2883,2687,985,604,441,198,215,130,226,68,68,65,5300,3975,1775,2150,525,100,0
464,1,0,151.0,143.0,192.0,165.0,3946,3230,2939,2603,1007,627,317,284,275,140,42,144,68,64,5300,4075,1775,2150,525,150,0
471,1,0,151.0,143.0,192.0,165.0,3722,3123,2715,2519,1007,604,739,92,585,55,154,37,68,64,5850,4475,1775,2400,525,150,0
479,1,0,165.0,148.0,192.0,165.0,3756,2838,2771,2211,985,627,500,192,230,75,270,117,68,64,6000,4475,1775,2700,525,150,0
486,1,0,165.0,150.0,192.0,165.0,3739,3039,2799,2211,940,828,337,336,205,240,132,96,81,65,6000,5050,1775,2700,525,150,0
493,1,0,172.0,156.0,192.0,165.0,3879,3314,2939,2351,940,963,227,391,175,175,52,216,82,65,6600,5150,1775,2800,525,300,0
500,1,0,175.0,157.0,184.0,165.0,3846,3319,2883,2379,963,940,312,347,190,190,122,157,80,64,6400,5150,1775,2800,725,350,0
507,1,0,182.0,158.0,192.0,165.0,4114,3364,3107,2379,1007,985,232,124,90,55,142,69,83,65,6400,5150,1775,2800,725,350,0
514,1,0,182.0,161.0,192.0,165.0,4226,3297,3219,2379,1007,918,733,519,475,325,258,194,83,65,7150,5500,1775,2800,725,425,0
521,1,0,176.5,165.0,192.0,165.0,4254,3157,3135,2351,1119,806,1225,450,835,160,390,290,82,65,7225,5775,1775,2800,1100,525,0
529,1,0,185.0,169.0,192.0,180.0,4467,3246,3191,2463,1276,783,833,466,495,105,338,361,82,65,7300,5875,1775,2800,1175,525,0
536,1,0,189.0,170.0,192.0,180.0,4495,3073,3219,2267,1276,806,988,686,690,225,298,461,82,65,7300,5925,1775,2800,1175,775,0
543,1,0,192.0,169.0,192.0,180.0,4221,3022,2967,2239,1254,783,484,752,230,295,254,457,83,65,7900,5725,1775,2800,1425,1025,0
550,1,0,192.0,172.0,192.0,180.0,4260,3039,2939,2211,1321,828,899,762,485,205,414,557,83,67,7900,5975,1775,2800,1425,1025,0
557,1,0,185.5,173.0,192.0,196.0,4288,3028,2967,2155,1321,873,795,1031,525,370,270,661,82,69,8075,6025,1775,3050,1775,1075,0
564,1,0,195.5,184.0,200.0,196.0,4310,3084,2967,2211,1343,873,762,781,340,95,422,686,81,71,8475,6025,1775,3050,1825,1075,0
571,1,0,184.5,170.0,208.0,196.0,4378,3274,3079,2379,1299,895,1274,890,700,200,574,690,80,73,8025,5175,1775,3050,2325,1975,0
579,1,0,179.0,172.0,208.0,196.0,4383,3314,3107,2463,1276,851,951,840,500,150,451,690,80,74,7450,5075,1775,3150,3125,2025,0
586,1,0,188.0,174.0,208.0,196.0,4501,3566,3247,2715,1254,851,747,718,140,170,607,548,80,75,7700,5600,1775,3150,3125,2025,0
593,1,0,189.0,173.0,208.0,196.0,4518,4131,3219,3303,1299,828,787,592,245,140,542,452,80,77,8550,5325,1775,3150,3175,2300,0
600,1,0,184.5,174.0,208.0,196.0,4534,4730,3191,3835,1343,895,1207,725,555,290,652,435,79,78,8725,5375,1775,3250,3300,2450,0
607,1,0,188.5,180.0,208.0,196.0,4512,4926,3191,4031,1321,895,249,685,20,375,229,310,79,80,9025,5575,1775,3250,3575,2450,0
614,1,0,192.5,173.0,208.0,196.0,4624,3924,3303,3051,1321,873,586,487,205,277,381,210,79,74,9075,5575,1775,3150,3575,3188,0
621,1,0,197.5,176.0,208.0,196.0,4568,3146,3247,2295,1321,851,522,716,160,402,362,314,79,70,9825,5625,1775,3150,3575,3488,0
629,1,0,197.5,173.0,214.0,196.0,4523,3151,3247,2323,1276,828,859,488,445,270,414,218,79,66,10025,5875,1775,3425,3575,3940,0
636,1,0,194.0,178.0,214.0,196.0,4473,3123,3219,2407,1254,716,1390,216,820,110,570,106,78,67,9900,6125,1775,3325,3700,4040,0
643,1,0,195.0,180.0,214.0,196.0,4546,3414,3247,2631,1299,783,1875,322,1145,145,730,177,78,69,10150,6025,1775,3475,3700,4190,0
650,1,0,195.0,181.0,214.0,196.0,4478,3599,3135,2771,1343,828,1845,428,1230,205,615,223,78,70,10150,6025,1775,3475,3700,4190,0
657,1,0,200.0,186.0,214.0,196.0,4562,3605,3219,2799,1343,806,1978,326,1290,115,688,211,79,72,10150,6325,1775,3575,3700,4190,0
664,1,0,200.0,193.0,214.0,188.0,4456,3980,3135,3219,1321,761,2494,604,1650,330,844,274,79,74,10500,7125,1775,3725,3725,4290,0
671,1,0,200.0,190.0,220.0,172.0,4411,4266,3135,3527,1276,739,3022,557,2030,195,992,362,84,76,10650,6925,2025,3725,3725,4690,0
679,1,0,200.0,190.0,220.0,172.0,4327,4434,3051,3695,1276,739,3452,968,2300,510,1152,458,84,76,10450,6925,2025,4050,3925,4690,0
686,1,0,196.0,182.0,220.0,172.0,4417,4434,3163,3695,1254,739,3973,1290,2665,740,1308,550,84,76,10050,6325,2025,4050,4325,5240,0
693,1,0,192.0,170.0,220.0,196.0,4456,3862,3135,3079,1321,783,4223,1157,2755,715,1468,442,81,69,9100,5775,2025,3950,5425,6440,0
700,1,0,192.5,168.0,220.0,196.0,4344,3112,3023,2351,1321,761,3430,510,2360,205,1070,305,81,69,8925,5375,2025,4100,5550,6840,0
707,1,0,199.5,174.0,220.0,196.0,4204,3179,2883,2463,1321,716,3097,376,2025,45,1072,331,80,72,9225,5300,2025,4200,5550,7415,0
714,1,0,199.5,175.0,220.0,196.0,3924,3297,2603,2603,1321,694,3563,380,2335,140,1228,240,84,73,10325,5650,2025,4300,5600,7415,0
721,1,0,195.0,176.0,220.0,196.0,4187,2955,2911,2351,1276,604,4090,483,2710,225,1380,258,92,76,9650,6075,2025,4500,5975,7515,0
729,1,0,198.5,169.0,220.0,196.0,4361,2502,3107,1987,1254,515,4126,142,2590,20,1536,122,92,74,8675,5825,2150,4150,6875,8440,0
736,1,0,196.5,170.0,220.0,188.0,4294,2479,2995,1987,1299,492,4456,202,2760,70,1696,132,90,74,8675,5825,2150,4400,6875,8540,0
743,1,0,198.5,174.0,220.0,203.0,4450,3162,3107,2603,1343,559,4776,249,2920,170,1856,79,89,75,9175,5925,2150,4650,6875,8540,0
750,1,0,198.5,184.0,220.0,203.0,4674,4019,3331,3303,1343,716,5028,402,3170,360,1858,42,89,75,9175,6575,2150,4650,6875,8540,0
757,1,0,198.5,183.0,220.0,203.0,4932,4232,3611,3471,1321,761,5560,747,3575,650,1985,97,92,74,9175,6575,2275,4750,6875,8590,0
764,1,0,178.5,168.0,220.0,203.0,4747,3325,3471,2631,1276,694,5423,1047,3640,870,1783,177,92,72,7775,5650,2400,4750,8400,9365,0
771,1,0,195.0,170.0,220.0,203.0,4803,2860,3527,2211,1276,649,4198,333,3155,72,1043,261,92,73,7750,5950,2550,4800,8475,9465,0
779,1,0,196.0,172.0,220.0,203.0,4837,2737,3583,2043,1254,694,3289,305,2740,106,549,199,92,74,8450,6150,2900,4800,8475,9465,0
786,1,0,199.0,172.0,220.0,203.0,4988,2882,3667,2099,1321,783,3379,535,2670,236,709,299,91,75,8450,6150,2900,4800,8475,9465,0
793,1,0,200.0,172.0,220.0,203.0,5016,3560,3695,2687,1321,873,3490,415,2825,191,665,224,92,76,10100,6150,2900,4800,8475,9465,0
800,1,0,192.0,170.0,220.0,203.0,5038,4092,3695,3219,1343,873,4072,641,3255,371,817,270,95,76,9550,5800,2900,4800,8800,9815,0
807,1,0,198.5,166.0,220.0,203.0,5134,3958,3835,3107,1299,851,4134,1113,3165,751,969,362,96,75,9125,5650,2900,5000,9150,10015,0
814,1,0,193.5,163.0,220.0,180.0,4971,4075,3695,3247,1276,828,4731,918,3610,506,1121,412,96,75,8725,5925,2900,5000,9400,11065,0
821,1,0,192.5,174.0,220.0,180.0,4921,4221,3667,3415,1254,806,5007,528,3730,291,1277,237,96,75,8675,6125,2900,5300,9450,11165,0
829,1,0,192.5,176.0,220.0,180.0,4966,4075,3667,3247,1299,828,4502,434,3615,343,887,91,96,77,9225,6125,3300,5200,9450,11278,0
836,1,0,189.5,179.0,220.0,180.0,5234,3582,3891,2799,1343,783,5132,737,4085,558,1047,179,95,78,9025,6425,3300,5000,9650,11528,0
843,1,0,199.5,179.0,220.0,180.0,5156,3616,3835,2855,1321,761,5204,230,4005,163,1199,67,95,76,9025,6875,3300,5000,9650,11628,0
850,1,0,193.5,188.0,220.0,203.0,4820,3711,3499,2995,1321,716,5641,815,4290,518,1351,297,94,80,9025,7425,3300,4750,9650,11628,0
857,1,0,199.5,188.0,220.0,203.0,4848,3375,3527,2659,1321,716,5767,1053,4260,668,1507,385,96,80,9025,7700,3300,4850,9650,11628,0
864,1,0,192.0,181.0,226.0,218.0,4551,3386,3275,2603,1276,783,6314,1248,4655,863,1659,385,96,81,8400,7600,3300,4850,10200,12003,0
871,1,0,193.5,160.0,226.0,234.0,4753,2826,3499,2043,1254,783,5395,1305,4180,828,1215,477,95,74,6825,6550,3300,4650,12150,13903,0
879,1,0,199.0,165.0,226.0,234.0,4798,2401,3499,1707,1299,694,4985,1199,4010,638,975,561,95,74,6000,6425,3425,4875,12975,14103,0
886,1,0,197.0,168.0,226.0,234.0,5094,2916,3751,2155,1343,761,3920,1302,3635,678,285,624,95,74,5800,6575,3575,4775,13175,14203,0
893,1,0,200.0,170.0,226.0,249.0,4982,3370,3639,2631,1343,739,4368,886,3935,278,433,608,95,74,5800,7525,3875,4775,13175,14203,0
900,1,0,200.0,173.0,226.0,249.0,5262,3739,3807,3079,1455,660,4713,315,4100,108,613,207,95,74,7500,7525,3875,4775,13350,14203,0
907,1,0,200.0,173.0,232.0,249.0,5089,3784,3723,3191,1366,593,5329,462,4560,212,769,250,95,74,7650,7525,3875,4775,13350,14203,0
914,1,0,199.0,178.0,232.0,249.0,5302,3666,3891,3107,1411,559,5915,215,4995,172,920,43,94,74,9150,7525,3875,5600,13350,14203,0
921,1,0,199.5,178.0,232.0,249.0,5240,3526,3695,2967,1545,559,6339,618,5215,507,1124,111,92,74,10075,7525,3875,5800,13425,14203,0
929,1,0,199.5,191.0,232.0,249.0,5134,3252,3499,2715,1635,537,6661,476,5495,347,1166,129,92,74,10125,8675,3875,5800,13425,14203,0
936,1,0,198.5,191.0,232.0,249.0,4994,2714,3359,2155,1635,559,7248,660,5890,463,1358,197,95,73,10075,8675,3875,5800,13475,14253,0
943,1,0,189.0,186.0,232.0,249.0,5262,2983,3583,2379,1679,604,7813,983,6255,718,1558,265,95,77,9000,8350,3875,5800,14550,14628,0
950,1,0,200.0,192.0,232.0,249.0,5458,2434,3555,1875,1903,559,7929,692,6135,613,1794,79,95,78,9000,9250,3875,5800,14550,14628,0
957,1,0,200.0,194.0,232.0,249.0,5167,2065,3219,1483,1948,582,8287,835,6365,688,1922,147,95,78,9050,9250,3875,5800,14550,14628,0
964,1,0,200.0,194.0,232.0,249.0,4887,2037,2939,1455,1948,582,8878,822,6720,703,2158,119,95,78,9600,9250,3875,5800,14550,14628,0
971,1,0,192.5,180.0,232.0,249.0,4943,1673,2995,1091,1948,582,9470,1009,7080,818,2390,191,95,80,8975,7800,3875,5800,15000,16078,0
979,1,0,199.5,182.0,232.0,234.0,4938,1656,2967,1007,1971,649,9311,589,6685,493,2626,96,95,80,8175,7750,3875,5800,15800,17001,0
986,1,0,198.5,182.0,238.0,234.0,4971,1695,3023,979,1948,716,9893,798,7035,618,2858,180,95,80,8025,7750,3875,5800,15950,17001,0
993,1,0,195.5,185.0,238.0,234.0,5318,1706,3359,1035,1959,671,10503,510,7415,433,3088,77,95,80,7875,7800,3875,5800,16150,17001,0
1000,1,0,200.0,185.0,238.0,234.0,5274,1964,3471,1315,1803,649,10611,355,7315,198,3296,157,95,80,8200,8100,3875,5800,16525,17001,0
1007,1,0,193.5,180.0,238.0,234.0,5369,2322,3555,1651,1814,671,11262,654,7750,413,3512,241,95,80,7775,8100,3875,6050,16950,17151,0
1014,1,0,181.0,146.0,238.0,234.0,5234,2009,3443,1315,1791,694,11888,323,8160,248,3728,75,95,66,7150,6575,3875,6050,18125,19051,0
1021,1,0,199.5,125.0,238.0,234.0,5268,1858,3499,1231,1769,627,11286,180,7350,83,3936,97,95,40,6575,6525,3875,6050,18625,20401,0
1029,1,0,199.5,127.0,238.0,234.0,5234,1762,3443,1091,1791,671,10551,279,7070,98,3481,181,95,40,6575,6525,3875,6050,18625,20401,0
1036,1,0,198.5,130.0,238.0,234.0,5341,1690,3527,951,1814,739,10733,193,7040,53,3693,140,91,40,7475,6625,3875,5800,18625,20651,0
1043,1,0,200.0,130.0,238.0,234.0,5038,1662,3247,1091,1791,571,10570,277,6990,83,3580,194,91,40,9150,7525,3875,5800,18775,20651,0
1048,1,0,200.0,118.0,238.0,234.0,5038,1538,3247,1035,1791,503,10570,234,6990,13,3580,221,91,38,9150,6425,3875,5800,18775,21851,0
7,2,1,13.0,13.0,15.0,14.0,335,251,335,251,0,0,40,30,40,30,0,0,12,12,0,0,0,0,0,0,1
14,2,1,14.0,13.0,15.0,14.0,671,643,671,643,0,0,70,15,70,15,0,0,13,13,0,0,0,0,0,0,1
21,2,1,14.0,14.0,15.0,14.0,699,727,699,727,0,0,50,50,50,50,0,0,13,13,0,0,0,0,0,0,1
29,2,1,15.0,14.0,15.0,14.0,699,755,699,755,0,0,40,140,40,140,0,0,14,13,0,0,0,0,0,0,1
36,2,1,15.0,16.0,15.0,22.0,783,755,783,755,0,0,135,135,135,135,0,0,14,14,0,0,0,0,0,0,1
43,2,1,16.0,16.0,23.0,22.0,811,811,811,811,0,0,25,225,25,225,0,0,15,16,0,0,0,0,0,0,1
50,2,1,17.0,15.0,23.0,22.0,811,839,811,839,0,0,50,15,50,15,0,0,16,15,0,0,0,0,0,0,1
57,2,1,18.0,17.0,23.0,22.0,867,895,867,895,0,0,50,25,50,25,0,0,17,15,0,0,0,0,0,0,1
64,2,1,19.0,18.0,23.0,22.0,923,895,923,895,0,0,115,75,115,75,0,0,18,16,0,0,0,0,0,0,1
71,2,1,19.0,17.0,23.0,22.0,973,839,951,839,22,0,234,145,230,145,4,0,18,16,0,0,0,0,0,0,1
79,2,1,20.0,17.0,23.0,22.0,1034,923,923,923,111,0,350,15,330,15,20,0,19,16,0,0,0,0,0,0,1
86,2,1,20.0,18.0,23.0,22.0,1051,923,895,923,156,0,76,80,40,80,36,0,19,16,0,0,0,0,0,0,1
93,2,1,20.0,19.0,23.0,22.0,1051,895,895,895,156,0,191,125,135,125,56,0,20,17,0,0,150,0,0,0,1
100,2,1,21.0,20.0,23.0,22.0,1079,962,923,895,156,67,126,207,50,195,76,12,20,18,0,0,150,0,0,0,1
107,2,1,21.0,20.0,23.0,22.0,1085,1029,951,895,134,134,137,333,45,305,92,28,20,19,0,0,150,0,0,0,1
114,2,1,22.0,21.0,23.0,22.0,1079,1051,923,895,156,156,112,404,0,360,112,44,21,20,0,0,150,0,0,0,1
121,2,1,23.0,25.0,23.0,28.0,1135,1023,979,867,156,156,247,234,115,170,132,64,22,20,0,0,150,250,0,0,1
129,2,1,23.0,26.0,23.0,28.0,1174,1107,951,951,223,156,335,234,175,150,160,84,22,21,0,0,150,250,0,0,1
136,2,1,26.0,28.0,31.0,28.0,1258,1085,923,951,335,134,65,60,40,60,25,0,23,21,0,0,300,250,0,0,1
143,2,1,27.0,28.0,31.0,28.0,1264,1085,951,1063,313,22,56,190,45,190,11,0,24,21,0,50,300,250,0,0,1
150,2,1,28.0,30.0,31.0,36.0,1286,1119,951,1119,335,0,161,235,110,235,51,0,25,23,0,50,300,250,0,0,1
157,2,1,29.0,29.0,46.0,36.0,1292,1287,979,1287,313,0,162,70,75,70,87,0,25,22,0,350,300,250,0,0,1
164,2,1,33.0,32.0,46.0,36.0,1376,1287,1063,1287,313,0,152,40,50,40,102,0,27,24,125,350,300,250,0,0,1
171,2,1,35.0,33.0,46.0,36.0,1404,1399,1091,1399,313,0,277,45,135,45,142,0,29,25,125,350,300,250,0,0,1
179,2,1,38.0,36.0,46.0,36.0,1622,1455,1287,1455,335,0,67,55,35,55,32,0,29,25,125,350,600,250,0,0,1
186,2,1,40.0,36.0,46.0,36.0,1566,1399,1231,1399,335,0,92,235,20,235,72,0,31,26,125,350,600,250,0,0,1
193,2,1,40.0,40.0,46.0,44.0,1678,1595,1343,1595,335,0,158,70,50,70,108,0,31,29,250,350,600,250,0,0,1
200,2,1,42.0,42.0,46.0,44.0,1818,1595,1483,1595,335,0,323,150,175,150,148,0,33,29,250,500,600,250,0,0,1
207,2,1,46.0,44.0,54.0,52.0,1796,1707,1483,1707,313,0,279,210,245,210,34,0,34,32,550,500,600,250,0,0,1
214,2,1,47.0,46.0,54.0,52.0,1824,1679,1511,1679,313,0,114,190,40,190,74,0,35,32,550,500,600,250,0,0,1
221,2,1,49.0,47.0,54.0,52.0,1874,1763,1539,1763,335,0,129,245,15,245,114,0,37,33,550,500,600,250,0,0,1
229,2,1,49.0,47.0,54.0,58.0,2014,1645,1679,1623,335,22,284,239,130,235,154,4,37,31,550,650,600,250,0,200,1
236,2,1,54.0,52.0,54.0,58.0,2076,1762,1763,1651,313,111,85,220,45,200,40,20,39,35,850,650,600,375,0,200,1
243,2,1,55.0,56.0,62.0,66.0,2042,1729,1707,1595,335,134,165,171,85,135,80,36,40,37,850,800,600,375,0,200,1
250,2,1,56.0,59.0,62.0,66.0,2188,1975,1875,1819,313,156,176,221,60,165,116,56,41,42,850,800,600,375,0,200,1
257,2,1,58.0,62.0,62.0,66.0,2110,2003,1819,1847,291,156,377,156,225,80,152,76,43,41,850,800,600,375,0,350,1
264,2,1,55.0,65.0,70.0,66.0,2238,2143,1903,1987,335,156,497,166,305,70,192,96,43,41,850,800,600,375,300,350,1
271,2,1,59.0,66.0,70.0,66.0,2283,2395,1791,2239,492,156,166,316,110,200,56,116,45,47,850,800,600,375,300,350,1
279,2,1,60.0,66.0,70.0,66.0,2334,2474,1707,2295,627,179,138,311,10,175,128,136,46,51,1000,950,600,375,300,350,1
286,2,1,61.0,65.0,85.0,74.0,2395,2670,1791,2491,604,179,431,531,235,375,196,156,47,50,1000,1100,600,375,300,350,1
293,2,1,64.0,72.0,85.0,82.0,2502,2703,1875,2547,627,156,277,82,5,10,272,72,49,50,1000,1100,600,375,300,350,1
300,2,1,68.0,76.0,85.0,82.0,2642,2815,2015,2659,627,156,293,157,45,65,248,92,51,49,1150,1100,750,375,300,350,1
307,2,1,70.0,81.0,85.0,98.0,2726,2843,2099,2687,627,156,74,237,0,125,74,112,53,57,1150,1100,1150,375,300,350,1
314,2,1,72.0,80.0,85.0,98.0,2838,2927,2211,2771,627,156,274,417,120,285,154,132,55,61,1150,1100,1150,375,300,350,1
321,2,1,76.0,87.0,85.0,98.0,3000,3062,2351,2883,649,179,249,172,65,20,184,152,57,59,1150,1100,1150,500,300,350,1
329,2,1,80.0,90.0,85.0,98.0,3185,3146,2491,2967,694,179,369,192,155,120,214,72,59,59,1500,1300,1450,500,300,350,1
336,2,1,83.0,92.0,93.0,114.0,3112,3123,2463,2967,649,156,406,353,170,265,236,88,61,66,1675,1300,1450,500,300,350,1
343,2,1,86.0,94.0,93.0,114.0,3252,3123,2603,2967,649,156,577,533,315,425,262,108,62,69,1850,1300,1750,500,300,350,1
350,2,1,93.0,94.0,93.0,114.0,3174,3398,2547,2995,627,403,288,502,100,380,188,122,64,68,1850,1300,1750,750,300,450,1
357,2,1,93.0,92.5,93.0,120.0,3263,3482,2659,2855,604,627,489,768,225,570,264,198,64,67,2375,1525,1750,750,300,475,1
364,2,1,93.0,104.0,93.0,128.0,3370,3622,2743,2995,627,627,909,413,565,235,344,178,65,67,2375,1700,1900,750,300,500,1
371,2,1,93.0,108.0,93.0,128.0,3448,3722,2799,3051,649,671,925,663,505,405,420,258,65,67,2375,1750,1900,750,300,500,1
379,2,1,101.0,109.0,109.0,128.0,3554,3778,2883,3107,671,671,650,1059,350,725,300,334,65,67,3075,2350,1900,750,300,500,1
386,2,1,106.0,112.5,109.0,128.0,3566,3840,2939,3191,627,649,568,1180,300,770,268,410,65,67,3425,2275,2000,750,300,575,1
393,2,1,107.0,117.5,109.0,128.0,3510,3784,2883,3135,627,649,788,1091,440,605,348,486,65,67,3425,2475,2000,750,300,575,1
400,2,1,109.0,123.5,117.0,136.0,3532,3868,2883,3219,649,649,1034,1191,660,675,374,516,67,66,3425,2775,2000,950,300,575,1
407,2,1,98.0,112.5,117.0,136.0,3594,3706,2967,3079,627,627,1400,1437,950,845,450,592,67,66,2675,2275,2000,950,1225,1325,1
414,2,1,109.0,117.5,117.0,136.0,3476,3784,2827,3135,649,649,455,1397,325,825,130,572,67,69,3550,2425,2000,950,1225,1375,1
421,2,1,110.0,122.0,117.0,142.0,3526,3857,2855,3163,671,694,610,1497,400,845,210,652,68,69,3550,2400,2150,950,1225,1400,1
429,2,1,111.0,125.5,117.0,142.0,3588,3890,2939,3219,649,671,876,1553,640,825,236,728,69,69,3725,2675,2150,950,1275,1625,1
436,2,1,117.0,141.5,117.0,142.0,3526,3986,2855,3359,671,627,712,1135,550,660,162,475,68,69,3725,2925,2150,950,1325,1625,1
443,2,1,116.0,137.0,140.0,150.0,3588,3924,2939,3275,649,649,853,1595,715,1040,138,555,67,69,4250,3250,2150,950,1375,1850,1
450,2,1,112.0,142.5,140.0,150.0,3588,3874,2939,3247,649,627,1264,1361,1050,880,214,481,68,69,3925,3175,2250,950,1700,1975,1
457,2,1,122.0,147.5,148.0,150.0,3672,3874,3023,3247,649,627,944,1441,800,880,144,561,68,69,3925,3825,2250,950,1700,2025,1
464,2,1,129.0,149.5,148.0,150.0,3538,3890,2911,3219,627,671,615,1811,395,1170,220,641,72,69,4750,4225,2400,950,1700,2025,1
471,2,1,134.0,149.0,148.0,156.0,3554,3997,2883,3303,671,694,690,1931,390,1235,300,696,72,69,4750,4500,2400,950,1700,2050,1
479,2,1,138.0,158.0,148.0,164.0,3582,3896,2911,3247,671,649,736,1903,510,1135,226,768,73,69,4850,4450,2400,950,1700,2100,1
486,2,1,141.0,161.0,148.0,188.0,3784,3840,3135,3191,649,649,702,1819,400,975,302,844,76,68,4950,4400,2400,950,2000,2250,1
493,2,1,143.0,166.0,148.0,188.0,4014,3588,3387,2939,627,649,559,1794,385,995,174,799,78,75,4950,4500,2400,950,2100,2250,1
500,2,1,147.0,188.0,148.0,188.0,3935,3538,3331,2911,604,627,635,1025,385,425,250,600,78,75,5150,4850,2400,950,2100,2250,1
507,2,1,146.0,186.5,164.0,196.0,3980,3952,3331,3303,649,649,856,1405,530,725,326,680,79,75,5450,5075,2400,1075,2150,2325,1
514,2,1,157.0,195.5,164.0,196.0,3784,4086,3135,3415,649,671,647,1455,245,695,402,760,79,75,5950,5075,2850,1075,2150,2325,1
521,2,1,164.0,195.5,164.0,212.0,3790,4366,3051,3695,739,671,703,1971,205,1135,498,836,79,75,6250,6175,2850,1075,2150,2325,1
529,2,1,163.0,194.0,180.0,212.0,3902,4238,2939,3611,963,627,999,2478,385,1570,614,908,80,75,6250,6550,2850,1075,2150,2400,1
536,2,1,171.0,199.5,172.0,212.0,3694,4232,2687,3583,1007,649,1054,2638,320,1650,734,988,80,75,6250,6475,3200,1275,2250,2475,1
543,2,1,165.0,194.0,172.0,212.0,3924,4288,2939,3639,985,649,1506,3163,660,2095,846,1068,80,75,6350,6200,3200,1275,2550,2750,1
550,2,1,167.0,190.5,172.0,212.0,3902,4182,2939,3555,963,627,1168,3169,810,2275,358,894,80,75,6700,6025,3300,1275,3000,2925,1
557,2,1,168.0,186.0,172.0,212.0,4137,4428,3107,3779,1030,649,1230,3209,1040,2235,190,974,80,73,6100,5750,3450,1275,3200,3650,1
564,2,1,168.0,173.5,180.0,212.0,4366,3801,3247,3107,1119,694,1360,3264,1030,2210,330,1054,80,68,6050,5175,3450,1275,3750,4675,1
571,2,1,162.0,186.5,180.0,212.0,4226,3672,3107,3023,1119,649,1305,2451,835,1475,470,976,81,68,6600,5375,3450,1275,4050,4975,1
579,2,1,150.0,180.5,180.0,212.0,4333,3616,3079,2967,1254,649,1342,2887,920,1835,422,1052,81,75,6000,5075,3450,1275,4750,5275,1
586,2,1,168.0,182.0,180.0,212.0,4434,3728,3135,3079,1299,649,790,2822,220,1690,570,1132,81,75,6400,5250,3450,1275,4750,5475,1
593,2,1,162.0,183.5,180.0,212.0,4490,3566,3191,2939,1299,627,1332,2848,610,1640,722,1208,81,72,6500,5725,3450,1275,5050,5875,1
600,2,1,173.0,190.5,180.0,212.0,4417,3846,3163,3219,1254,627,819,2968,695,1680,124,1288,83,72,6900,5925,3600,1275,5050,5875,1
607,2,1,173.0,188.0,180.0,212.0,4495,4142,3219,3471,1276,671,945,3453,815,2085,130,1368,77,72,6900,6150,3600,1275,5350,5975,1
614,2,1,145.0,195.5,180.0,212.0,3801,4170,2547,3499,1254,671,1273,2144,995,1425,278,719,68,72,6250,6125,3450,1275,6900,6275,1
621,2,1,130.0,186.5,180.0,212.0,3034,4120,1847,3471,1187,649,1514,2635,1100,1840,414,795,63,72,5450,5575,3450,1275,8400,6750,1
629,2,1,134.0,197.5,180.0,204.0,2580,4120,1595,3471,985,649,1265,2371,1035,1500,230,871,62,72,5900,6475,3600,1725,8550,7050,1
636,2,1,147.0,197.5,180.0,204.0,3006,4232,2043,3583,963,649,787,2066,445,1515,342,551,64,72,6800,7175,3600,1725,8550,7050,1
643,2,1,150.0,197.5,195.0,204.0,3297,3986,2155,3359,1142,627,929,1442,435,1365,494,77,66,72,6400,7925,3600,1725,8550,7050,1
650,2,1,160.0,197.0,203.0,204.0,3342,4092,2043,3443,1299,649,262,1727,220,1670,42,57,70,72,6750,8700,3600,1725,8650,7350,1
657,2,1,162.0,197.0,203.0,204.0,3515,3941,2239,3247,1276,694,274,2197,80,2060,194,137,72,72,6750,9800,3600,1725,8650,7450,1
664,2,1,150.0,183.5,211.0,204.0,3588,3868,2379,3219,1209,649,673,2639,335,2430,338,209,74,72,6975,8775,3600,1725,9525,8475,1
671,2,1,115.0,170.5,203.0,204.0,3241,3706,2099,3079,1142,627,1040,2285,570,2000,470,285,72,72,4075,5425,3350,1725,13025,11375,1
679,2,1,82.0,167.5,203.0,204.0,2597,3700,1679,3051,918,649,733,2285,155,2020,578,265,43,72,3275,4225,3350,1725,15875,12275,1
7,1,2,13.0,13.0,14.0,15.0,419,251,419,251,0,0,50,30,50,30,0,0,12,12,0,0,0,0,0,0,0
14,1,2,13.0,14.0,14.0,15.0,671,643,671,643,0,0,20,65,20,65,0,0,13,13,0,0,0,0,0,0,0
21,1,2,14.0,14.0,14.0,15.0,699,643,699,643,0,0,50,40,50,40,0,0,13,13,0,0,0,0,0,0,0
29,1,2,14.0,15.0,14.0,15.0,755,699,755,699,0,0,155,75,155,75,0,0,13,14,0,0,0,0,0,0,0
36,1,2,16.0,15.0,22.0,15.0,727,783,727,783,0,0,140,135,140,135,0,0,14,14,0,0,0,0,0,0,0
43,1,2,16.0,16.0,22.0,23.0,783,783,783,783,0,0,225,70,225,70,0,0,16,15,0,0,0,0,0,0,0
50,1,2,15.0,17.0,22.0,23.0,755,811,755,811,0,0,20,40,20,40,0,0,15,16,0,0,0,0,0,0,0
57,1,2,17.0,18.0,22.0,23.0,811,811,811,811,0,0,20,45,20,45,0,0,15,17,0,0,0,0,0,0,0
64,1,2,18.0,19.0,22.0,23.0,895,895,895,895,0,0,75,110,75,110,0,0,16,18,0,0,0,0,0,0,0
71,1,2,17.0,19.0,22.0,23.0,895,945,895,923,0,22,155,219,155,215,0,4,17,18,0,0,0,0,0,0,0
79,1,2,17.0,20.0,22.0,23.0,951,984,951,895,0,89,20,341,20,325,0,16,16,19,0,0,0,0,0,0,0
86,1,2,18.0,20.0,22.0,23.0,951,978,951,867,0,111,75,63,75,35,0,28,16,19,0,0,0,0,0,0,0
93,1,2,19.0,21.0,22.0,23.0,895,973,895,839,0,134,130,124,130,80,0,44,17,20,0,0,0,150,0,0,0
100,1,2,20.0,21.0,22.0,23.0,990,995,923,839,67,156,202,99,190,35,12,64,19,21,0,0,0,150,0,0,0
107,1,2,20.0,22.0,22.0,23.0,1085,1051,951,895,134,156,328,104,300,20,28,84,19,21,0,0,0,150,0,0,0
114,1,2,20.0,22.0,22.0,23.0,1051,1107,895,951,156,156,343,139,295,35,48,104,20,21,0,0,0,150,0,0,0
121,1,2,20.0,23.0,28.0,23.0,1018,1107,839,951,179,156,468,219,400,95,68,124,20,22,0,0,250,150,0,0,0
129,1,2,26.0,23.0,36.0,23.0,1029,1146,895,923,134,223,185,307,105,155,80,152,20,22,0,0,250,150,0,0,0
136,1,2,28.0,26.0,36.0,31.0,1018,1174,951,839,67,335,213,317,125,150,88,167,22,23,0,0,250,300,0,0,0
143,1,2,30.0,27.0,36.0,31.0,1130,1230,1063,895,67,335,251,113,155,60,96,53,22,24,0,0,250,300,0,0,0
150,1,2,30.0,28.0,36.0,31.0,1270,1225,1203,867,67,358,409,113,305,70,104,43,24,25,0,0,250,300,0,0,0
157,1,2,31.0,30.0,36.0,46.0,1242,1236,1175,923,67,313,157,110,45,35,112,75,25,26,0,0,250,300,0,0,0
164,1,2,33.0,33.0,36.0,46.0,1410,1292,1343,979,67,313,185,105,65,15,120,90,25,27,300,125,250,300,0,0,0
171,1,2,34.0,35.0,36.0,46.0,1387,1404,1343,1091,44,313,199,180,75,50,124,130,27,29,300,125,250,300,0,0,0
179,1,2,36.0,36.0,36.0,46.0,1499,1600,1455,1287,44,313,82,285,50,115,32,170,27,30,300,125,250,300,0,0,0
186,1,2,36.0,42.0,44.0,46.0,1634,1516,1567,1203,67,313,180,110,140,50,40,60,28,32,300,125,250,600,0,0,0
193,1,2,36.0,42.0,44.0,46.0,1578,1729,1511,1371,67,358,238,225,190,125,48,100,28,32,350,125,250,600,0,0,0
200,1,2,42.0,44.0,44.0,46.0,1550,1790,1483,1455,67,335,73,341,17,205,56,136,29,34,500,250,250,600,0,0,0
207,1,2,43.0,45.0,52.0,46.0,1690,1880,1623,1567,67,313,226,307,162,135,64,172,32,35,550,250,250,600,0,0,0
214,1,2,46.0,49.0,52.0,54.0,1690,1902,1623,1567,67,335,134,237,62,175,72,62,33,36,550,600,250,600,0,0,0
221,1,2,47.0,51.0,52.0,54.0,1751,1986,1707,1651,44,335,278,377,202,275,76,102,33,38,550,600,250,600,100,0,0
229,1,2,53.0,51.0,66.0,54.0,1863,1964,1819,1651,44,313,156,198,72,60,84,138,34,38,550,600,250,600,100,0,0
236,1,2,57.0,53.0,66.0,54.0,1914,2132,1847,1819,67,313,184,268,92,90,92,178,36,40,700,600,250,600,100,0,0
243,1,2,59.0,53.0,66.0,54.0,1970,2154,1903,1819,67,335,267,318,167,100,100,218,41,40,700,900,250,600,100,0,0
250,1,2,62.0,55.0,66.0,62.0,1970,2244,1903,1931,67,313,245,134,137,30,108,104,43,42,850,900,250,600,100,0,0
257,1,2,66.0,56.0,66.0,62.0,2138,2210,2071,1875,67,335,208,294,92,150,116,144,43,43,850,900,250,750,100,0,0
264,1,2,66.0,61.0,74.0,62.0,2306,2250,2239,1847,67,403,381,112,257,70,124,42,44,44,1150,900,250,750,100,0,0
271,1,2,71.0,63.0,74.0,70.0,2384,2289,2295,1707,89,582,123,244,87,130,36,114,46,46,1150,900,250,750,150,0,0
279,1,2,73.0,64.0,82.0,70.0,2199,2418,2043,1791,156,627,138,134,82,40,56,94,48,47,1300,900,250,750,200,0,0
286,1,2,71.5,65.0,90.0,70.0,2530,2524,2351,1875,179,649,193,394,117,220,76,174,49,48,1275,900,250,750,225,0,0
293,1,2,77.5,66.0,90.0,70.0,2642,2580,2463,1931,179,649,108,654,12,400,96,254,51,49,1275,900,250,1050,225,0,0
300,1,2,80.5,76.0,98.0,85.0,2670,2440,2491,1791,179,649,183,140,67,110,116,30,53,51,1275,1250,250,1050,225,0,0
307,1,2,82.5,79.0,98.0,85.0,2843,2681,2687,1987,156,694,244,275,112,165,132,110,56,53,1275,1250,250,1200,225,0,0
314,1,2,85.5,81.0,98.0,85.0,2866,2910,2687,2239,179,671,343,161,187,75,156,86,59,55,1275,1250,250,1450,225,0,0
321,1,2,87.5,83.0,106.0,85.0,3062,3034,2659,2407,403,627,508,58,292,0,216,58,63,57,1275,1250,250,1450,225,0,0
329,1,2,86.0,85.0,106.0,85.0,3179,3118,2687,2491,492,627,543,383,267,245,276,138,58,59,1400,1250,700,1450,500,0,0
336,1,2,93.0,86.0,114.0,93.0,3123,3196,2631,2547,492,649,449,553,117,335,332,218,60,60,1400,1250,700,1550,600,0,0
343,1,2,94.5,88.0,122.0,93.0,3011,3252,2519,2603,492,649,659,429,267,235,392,194,63,63,1375,1950,700,1550,625,0,0
350,1,2,104.5,89.0,122.0,93.0,3056,3269,2295,2575,761,694,238,269,17,195,221,74,69,64,1525,1950,700,1550,625,0,0
357,1,2,107.5,90.0,122.0,93.0,3448,3302,2463,2407,985,895,348,460,57,270,291,190,68,65,1525,1950,700,1550,625,0,0
364,1,2,109.5,90.0,122.0,109.0,3459,3437,2519,2519,940,918,619,578,212,280,407,298,68,66,1675,1950,700,1550,625,0,0
371,1,2,117.5,90.0,122.0,109.0,3694,3599,2687,2659,1007,940,579,708,152,290,427,418,68,67,2175,1950,700,1550,625,0,0
379,1,2,123.5,90.0,130.0,109.0,3700,3622,2715,2659,985,963,665,758,172,220,493,538,68,67,2525,1950,700,1550,625,0,0
386,1,2,128.5,94.0,130.0,109.0,3756,3700,2771,2715,985,985,507,664,152,110,355,554,68,67,2525,1950,700,2300,625,0,0
393,1,2,136.5,98.0,138.0,109.0,3784,3588,2799,2603,985,985,122,496,22,130,100,366,68,67,3225,2350,1050,2300,625,0,0
400,1,2,142.5,100.0,146.0,109.0,3762,3616,2799,2631,963,985,219,487,82,155,137,332,68,67,3975,1950,1050,2600,625,0,0
407,1,2,144.5,102.0,154.0,109.0,3818,3622,2855,2659,963,963,369,478,262,180,107,298,68,67,4175,2600,1200,3000,625,0,0
414,1,2,144.5,106.0,162.0,109.0,3812,3599,2827,2659,985,940,825,329,602,15,223,314,68,67,4725,2775,1200,3300,625,0,0
421,1,2,153.0,106.0,170.0,117.0,3862,3588,2855,2603,1007,985,680,669,487,235,193,434,68,67,4800,3225,1200,3850,800,0,0
429,1,2,165.5,116.0,170.0,117.0,3818,3638,2855,2631,963,1007,113,604,37,50,76,554,68,67,4575,3225,1200,4100,1025,0,0
436,1,2,163.5,120.0,170.0,125.0,3784,3560,2799,2575,985,985,268,616,72,150,196,466,68,67,4525,3725,1200,3900,1275,300,0
443,1,2,155.5,115.0,170.0,125.0,3790,3728,2827,2743,963,985,380,862,197,280,183,582,68,67,4575,3425,1200,4000,2025,1050,0
450,1,2,135.0,101.0,170.0,125.0,3734,3560,2771,2575,963,985,470,1283,242,585,228,698,68,67,3000,3125,1200,4000,3900,1925,0
457,1,2,150.0,111.0,170.0,133.0,3711,3655,2771,2715,940,940,121,840,27,130,94,710,68,67,3000,3175,1350,4100,3900,2375,0
464,1,2,157.0,115.0,170.0,133.0,3694,3622,2687,2659,1007,963,166,865,102,235,64,630,68,67,3650,3475,1350,4100,4000,2375,0
471,1,2,150.0,117.0,170.0,133.0,3750,3672,2743,2687,1007,985,216,1010,132,260,84,750,68,67,3500,3475,1350,4100,4900,2475,0
479,1,2,151.0,111.0,170.0,133.0,3756,3638,2771,2631,985,1007,509,976,342,110,167,866,68,67,3750,3025,1350,4100,5050,3025,0
486,1,2,150.0,109.0,170.0,133.0,3756,3672,2771,2687,985,985,619,1217,457,235,162,982,68,67,3800,3125,1200,4100,5375,3325,0
493,1,2,151.0,115.0,170.0,141.0,3650,3700,2687,2715,963,985,891,834,642,340,249,494,68,67,4250,4050,1200,4200,5475,3575,0
500,1,2,146.0,115.0,170.0,141.0,3678,3650,2715,2687,963,963,1186,1170,842,560,344,610,68,67,4200,3200,1350,4200,5875,3725,0
507,1,2,154.0,123.0,170.0,141.0,3454,3599,2491,2659,963,940,427,896,367,470,60,426,67,67,4350,4300,1350,4200,5875,3725,0
514,1,2,152.0,113.0,170.0,141.0,3610,3616,2603,2631,1007,985,857,951,677,505,180,446,66,67,4750,3500,1350,4200,5925,4525,0
521,1,2,165.0,117.0,170.0,141.0,3487,3650,2547,2687,940,963,420,827,282,515,138,312,66,67,4750,4200,1350,4200,5925,4525,0
529,1,2,162.0,115.0,170.0,141.0,3532,3179,2547,2351,985,828,435,1065,277,665,158,400,66,67,4950,4100,1475,4200,6225,4625,0
536,1,2,152.0,113.0,170.0,141.0,3566,2938,2603,2267,963,671,756,820,507,740,249,80,73,67,4450,3700,1475,4300,6825,5625,0
543,1,2,152.0,113.0,186.0,149.0,3370,3168,2407,2519,963,649,552,697,537,545,15,152,73,67,4050,3000,1475,4300,7225,6325,0
550,1,2,158.0,113.0,186.0,149.0,3543,3045,2603,2351,940,694,493,965,387,725,106,240,73,67,4150,3875,1475,4300,7225,6325,0
557,1,2,164.0,107.0,186.0,149.0,3666,3246,2659,2351,1007,895,433,1367,357,1015,76,352,73,67,5050,3525,1475,4150,7325,6825,0
564,1,2,162.0,121.0,186.0,149.0,3750,3258,2743,2295,1007,963,658,583,512,215,146,368,74,67,4700,2975,1475,4150,7725,7375,0
571,1,2,157.0,113.0,186.0,157.0,3353,3291,2435,2351,918,940,894,755,677,475,217,280,68,67,4800,3000,1475,4550,8125,8300,0
579,1,2,159.5,115.0,186.0,157.0,2815,3235,2099,2295,716,940,1018,1053,767,665,251,388,67,67,5075,3100,1475,4550,8200,8300,0
586,1,2,166.0,113.0,192.0,157.0,2541,3314,1847,2351,694,963,722,1360,537,860,185,500,67,67,5200,3000,1475,4550,8475,8400,0
593,1,2,170.0,119.0,192.0,157.0,2731,3157,2015,2239,716,918,705,653,482,645,223,8,67,67,5200,3000,1475,4550,8625,8400,0
600,1,2,174.0,131.0,192.0,157.0,3179,3325,2463,2407,716,918,914,555,607,435,307,120,67,67,5800,4000,1475,4250,8625,8800,0
607,1,2,176.0,129.0,192.0,157.0,3510,3353,2771,2435,739,918,1217,767,822,535,395,232,67,67,6000,4350,1475,4250,8625,8900,0
614,1,2,171.0,125.0,192.0,157.0,3571,3319,2855,2379,716,940,1271,1158,842,810,429,348,69,67,6000,3900,1475,4350,8825,9350,0
621,1,2,177.0,129.0,192.0,149.0,3560,3403,2687,2463,873,940,1408,970,867,710,541,260,71,67,6000,3900,1475,4350,8825,9450,0
629,1,2,177.0,145.0,200.0,149.0,3734,3420,2771,2435,963,985,1405,371,752,220,653,151,72,67,6150,5100,1475,4350,8825,9450,0
636,1,2,184.0,145.0,200.0,149.0,3958,3403,2995,2463,963,940,1296,764,752,505,544,259,78,67,6150,5100,1325,4450,8943,9450,0
643,1,2,189.0,145.0,200.0,157.0,3874,3269,2911,2351,963,918,1301,650,737,425,564,225,78,67,6450,5600,1450,4550,8943,9450,0
650,1,2,191.0,145.0,208.0,157.0,3952,3431,2967,2491,985,940,1492,1075,812,730,680,345,76,67,6450,5700,1575,4550,8943,9450,0
657,1,2,193.0,153.0,208.0,157.0,3896,3392,2911,2407,985,985,1817,580,1017,365,800,215,76,67,6850,6475,1775,4550,8993,9550,0
664,1,2,169.0,149.0,208.0,173.0,4142,3364,3135,2379,1007,985,1914,981,1102,650,812,331,75,67,5350,6575,1775,4550,10693,9750,0
671,1,2,189.0,149.0,208.0,173.0,4170,3246,3163,2239,1007,1007,664,1347,357,900,307,447,77,67,5400,6575,1750,4550,10843,9750,0
679,1,2,192.0,163.0,208.0,173.0,3986,3218,3023,2211,963,1007,367,498,252,285,115,213,77,67,5600,6925,1750,4550,10843,9750,0
686,1,2,195.0,159.0,208.0,173.0,3874,3090,2911,2127,963,963,442,855,332,530,110,325,77,67,7050,7525,1750,4550,10843,10025,0
693,1,2,189.5,159.0,208.0,173.0,3907,3011,2967,2071,940,940,908,1226,682,785,226,441,77,67,7425,7525,1750,4550,11218,10025,0
700,1,2,195.5,161.0,200.0,173.0,3812,3062,2827,2099,985,963,413,1491,167,930,246,561,77,67,6725,7525,2000,4550,12218,10025,0
707,1,2,184.5,139.0,200.0,173.0,3890,3112,2883,2127,1007,985,793,646,452,315,341,331,77,67,5525,4800,2000,4550,13018,12850,0
714,1,2,174.5,117.0,200.0,173.0,3890,3106,2883,2099,1007,1007,1000,702,572,405,428,297,77,67,4875,4200,2000,4550,13693,14675,0
721,1,2,173.0,105.0,206.0,173.0,3790,3140,2827,2155,963,985,842,979,377,570,465,409,77,67,4550,3150,2000,4550,14418,15725,0
729,1,2,173.5,95.0,206.0,173.0,3846,2944,2883,1959,963,985,1108,705,577,180,531,525,77,67,4725,1150,2000,4550,14593,17825,0
7,0,2,13.0,13.0,15.0,15.0,335,335,335,335,0,0,40,40,40,40,0,0,12,12,0,0,0,0,0,0,1
14,0,2,14.0,14.0,15.0,15.0,671,671,671,671,0,0,70,70,70,70,0,0,13,13,0,0,0,0,0,0,1
21,0,2,14.0,14.0,15.0,15.0,671,671,671,671,0,0,45,45,45,45,0,0,13,13,0,0,0,0,0,0,1
29,0,2,15.0,15.0,15.0,15.0,671,699,671,699,0,0,80,95,80,95,0,0,14,14,0,0,0,0,0,0,1
36,0,2,15.0,15.0,15.0,23.0,755,755,755,755,0,0,130,140,130,140,0,0,14,14,0,0,0,0,0,0,1
43,0,2,16.0,16.0,23.0,23.0,727,867,727,867,0,0,55,40,55,40,0,0,15,15,0,0,0,0,0,0,1
50,0,2,16.0,17.0,23.0,23.0,783,811,783,811,0,0,25,10,25,10,0,0,15,16,0,0,0,0,0,0,1
57,0,2,17.0,18.0,23.0,23.0,699,839,699,839,0,0,115,65,115,65,0,0,16,17,0,0,0,0,0,0,1
64,0,2,18.0,19.0,23.0,23.0,783,951,783,951,0,0,100,180,100,180,0,0,17,18,0,0,0,0,0,0,1
71,0,2,18.0,19.0,23.0,23.0,749,945,727,923,22,22,59,239,55,235,4,4,17,18,0,0,0,0,0,0,1
79,0,2,19.0,20.0,23.0,23.0,861,1018,727,951,134,67,174,357,150,345,24,12,18,19,0,0,0,0,0,0,1
86,0,2,19.0,20.0,23.0,23.0,850,1018,671,951,179,67,274,260,230,240,44,20,18,19,0,0,0,150,0,0,1
93,0,2,20.0,23.0,23.0,23.0,878,934,699,867,179,67,174,108,110,80,64,28,19,20,0,0,150,150,0,0,1
100,0,2,20.0,23.0,23.0,23.0,911,973,755,839,156,134,290,174,210,130,80,44,19,20,0,0,150,150,0,0,1
107,0,2,20.0,24.0,23.0,31.0,911,1029,755,895,156,134,400,260,300,200,100,60,19,21,0,0,150,150,0,0,1
114,0,2,20.0,24.0,23.0,31.0,911,1079,755,923,156,156,405,390,335,310,70,80,19,21,50,100,150,150,0,0,1
121,0,2,21.0,27.0,23.0,31.0,939,1102,783,923,156,179,475,290,385,240,90,50,19,22,50,100,150,300,0,0,1
129,0,2,21.0,27.0,23.0,31.0,939,1124,783,923,156,201,190,229,80,205,110,24,19,22,50,100,150,300,0,0,1
136,0,2,22.0,28.0,23.0,31.0,1298,1085,1119,839,179,246,205,311,75,255,130,56,20,23,50,100,150,300,0,0,1
143,0,2,22.0,31.0,23.0,31.0,1270,1124,1091,811,179,313,105,271,55,225,50,46,20,24,50,275,150,300,0,0,1
150,0,2,23.0,31.0,23.0,31.0,1247,1146,1091,811,156,335,86,356,20,270,66,86,21,24,50,275,250,300,0,0,1
157,0,2,25.0,32.0,31.0,39.0,1247,1152,1091,839,156,313,245,487,159,365,86,122,21,25,50,275,250,300,0,0,1
164,0,2,26.0,32.0,31.0,39.0,1247,1230,1091,895,156,335,140,237,34,75,106,162,22,25,50,450,250,300,0,0,1
171,0,2,28.0,32.0,31.0,39.0,1331,1342,1175,1007,156,335,240,152,114,50,126,102,22,26,150,450,250,300,0,0,1
179,0,2,28.0,33.0,31.0,39.0,1270,1376,1091,1063,179,313,320,263,174,125,146,138,22,26,150,450,250,300,50,0,1
186,0,2,28.0,35.0,31.0,39.0,1046,1348,755,1035,291,313,405,249,219,125,186,124,22,27,200,450,500,300,50,0,1
193,0,2,28.0,34.0,39.0,39.0,1006,1398,671,1063,335,335,451,314,254,150,197,164,23,27,200,350,500,300,100,100,1
200,0,2,28.0,34.0,39.0,39.0,1180,1398,867,1063,313,335,432,434,199,230,233,204,22,27,150,350,500,300,200,100,1
207,0,2,27.0,35.0,54.0,39.0,1208,1376,895,1063,313,313,317,495,144,255,173,240,22,28,100,350,575,550,300,100,1
214,0,2,30.0,36.0,54.0,39.0,1236,1348,923,1035,313,313,192,115,104,85,88,30,22,29,200,525,575,550,350,100,1
221,0,2,33.0,36.0,54.0,39.0,1348,1342,1035,1007,313,335,197,175,69,105,128,70,22,29,200,525,575,550,350,100,1
229,0,2,33.0,37.0,54.0,39.0,1426,1236,1091,923,335,313,212,166,44,60,168,106,23,30,200,525,575,550,350,100,1
236,0,2,33.0,37.0,54.0,54.0,1421,1236,1063,923,358,313,362,261,154,115,208,146,23,30,300,525,575,550,350,100,1
243,0,2,35.0,39.0,54.0,54.0,1342,1566,1007,1231,335,335,411,316,173,130,238,186,24,31,575,525,825,550,350,100,1
250,0,2,37.0,39.0,54.0,54.0,1404,1656,1091,1343,313,313,349,457,177,235,172,222,24,33,575,350,825,550,350,275,1
257,0,2,38.0,41.0,54.0,54.0,1264,1712,951,1399,313,313,379,492,167,280,212,212,24,33,625,350,825,550,400,275,1
264,0,2,40.0,44.0,54.0,54.0,1264,1734,951,1399,313,335,449,547,197,370,252,177,24,35,625,525,825,800,400,275,1
271,0,2,42.0,44.0,54.0,54.0,1544,1846,1231,1511,313,335,529,277,237,60,292,217,26,35,625,525,825,950,400,275,1
279,0,2,42.0,47.0,54.0,54.0,1818,1852,1483,1539,335,313,439,398,107,220,332,178,26,37,925,625,825,1100,400,275,1
286,0,2,44.0,48.0,54.0,54.0,1841,1958,1483,1623,358,335,564,438,192,220,372,218,28,38,925,625,825,1100,400,275,1
293,0,2,48.0,49.0,54.0,54.0,1790,1986,1455,1651,335,335,265,393,57,135,208,258,28,39,925,625,825,1100,400,275,1
300,0,2,48.0,52.0,54.0,54.0,2020,1970,1707,1679,313,291,386,210,142,45,244,165,30,41,925,725,825,1100,400,275,1
307,0,2,52.0,54.0,54.0,54.0,1880,2082,1567,1791,313,291,391,365,107,160,284,205,30,41,1025,900,825,1100,400,275,1
314,0,2,47.0,55.0,62.0,70.0,1824,2104,1511,1791,313,313,611,560,287,315,324,245,32,43,775,900,825,1200,650,275,1
321,0,2,49.0,56.0,62.0,70.0,1902,2115,1567,1735,335,380,666,722,327,425,339,297,32,43,775,1000,825,1200,650,275,1
329,0,2,53.0,58.0,62.0,70.0,2009,2334,1651,1819,358,515,411,457,132,100,279,357,34,45,875,1000,1250,1350,650,275,1
336,0,2,53.0,58.0,62.0,70.0,1958,2384,1623,1847,335,537,538,632,225,215,313,417,34,45,1175,1000,1250,1350,650,275,1
343,0,2,55.0,64.0,62.0,85.0,1992,2395,1679,1903,313,492,774,114,430,45,344,69,36,47,1175,900,1325,1350,650,375,1
350,0,2,61.0,66.0,62.0,85.0,2244,2289,1931,1819,313,470,544,210,290,135,254,75,36,48,1275,1375,1325,1350,650,375,1
357,0,2,62.0,69.0,62.0,93.0,2244,2513,1931,2043,313,470,172,270,59,135,113,135,38,50,1275,1375,1425,1350,650,375,1
364,0,2,62.0,70.0,62.0,93.0,2216,2569,1903,2099,313,470,315,330,188,135,127,195,38,51,1275,1375,1425,1350,650,375,1
371,0,2,62.0,73.0,62.0,93.0,2294,2798,1959,2351,335,447,405,476,238,225,167,251,40,54,1375,1375,1425,1350,650,375,1
379,0,2,68.0,78.0,70.0,93.0,2306,2922,1903,2407,403,515,398,511,308,200,90,311,40,57,1650,1475,1500,1650,650,375,1
386,0,2,70.0,84.0,70.0,93.0,2507,3000,2015,2463,492,537,304,411,183,40,121,371,40,57,1650,1575,1500,1800,650,375,1
393,0,2,75.0,84.0,78.0,101.0,2541,3017,2071,2547,470,470,395,529,218,110,177,419,42,58,1650,1775,1500,1800,650,375,1
400,0,2,77.0,88.0,78.0,101.0,2619,3073,2127,2603,492,470,385,589,273,110,112,479,42,58,1875,1975,1500,1800,650,375,1
407,0,2,83.0,88.0,86.0,109.0,2541,3106,2071,2659,470,447,386,665,318,130,68,535,44,58,2000,1975,1500,1800,650,375,1
414,0,2,87.0,92.0,94.0,109.0,2793,3106,2211,2659,582,447,396,671,273,180,123,491,44,58,2100,2225,1500,2100,650,375,1
421,0,2,90.0,98.0,94.0,125.0,2664,3011,2015,2519,649,492,376,387,273,40,103,347,46,58,2375,2525,1500,2100,650,375,1
429,0,2,93.0,100.0,94.0,125.0,2832,3207,2183,2715,649,492,327,678,273,275,54,403,46,58,2500,2625,1500,2250,650,375,1
436,0,2,99.0,108.0,102.0,125.0,2944,3151,2295,2659,649,492,323,558,243,95,80,463,47,58,2725,3025,1500,2250,650,375,1
443,0,2,99.0,108.0,110.0,125.0,2944,3157,2295,2687,649,470,743,635,583,270,160,365,47,58,2925,3400,1400,2450,650,375,1
450,0,2,100.0,112.0,110.0,125.0,2944,3157,2295,2687,649,470,339,640,153,315,186,325,47,58,3175,3400,1400,2450,650,375,1
457,0,2,102.0,110.0,118.0,133.0,2804,3146,2155,2631,649,515,654,1015,388,630,266,385,47,58,3600,3225,1400,2450,800,550,1
464,0,2,105.0,126.0,118.0,133.0,2726,3235,2099,2743,627,492,391,411,228,270,163,141,47,58,3600,4225,1400,2800,800,550,1
471,0,2,100.0,122.0,118.0,133.0,2345,3213,1763,2743,582,470,344,777,163,580,181,197,43,58,3525,3550,1400,2800,1175,825,1
479,0,2,102.0,118.0,118.0,133.0,2182,3213,1623,2743,559,470,597,1163,348,910,249,253,43,58,3675,3800,1400,2800,1275,1025,1
486,0,2,106.0,126.0,118.0,133.0,2294,3207,1735,2715,559,492,471,548,358,435,113,113,43,58,3725,4575,1400,2800,1275,1225,1
493,0,2,98.0,110.0,118.0,133.0,2474,3218,1847,2771,627,447,756,905,563,740,193,165,43,58,3625,3775,1400,2800,1650,2025,1
500,0,2,92.0,101.0,118.0,133.0,2552,3067,1903,2575,649,492,922,820,678,595,244,225,43,58,3000,3275,1400,2800,2525,2525,1
507,0,2,98.0,111.0,118.0,133.0,2412,3039,1763,2547,649,492,672,130,498,45,174,85,43,58,3000,3975,1400,2800,2525,2525,1
514,0,2,98.0,112.0,118.0,133.0,2552,2938,1903,2491,649,447,793,482,643,345,150,137,43,59,3400,3975,1400,2800,2525,2525,1
521,0,2,107.0,119.0,118.0,133.0,2692,2871,2043,2379,649,492,375,522,316,325,59,197,45,61,3700,4275,1400,2800,2525,2525,1
529,0,2,109.0,124.0,133.0,133.0,2580,2955,1931,2463,649,492,290,447,217,290,73,157,45,62,3700,4275,1400,2800,2525,2525,1
536,0,2,111.0,124.0,133.0,133.0,2916,2843,2267,2351,649,492,516,588,384,375,132,213,47,64,3975,4275,1400,2800,2525,2525,1
543,0,2,111.0,132.0,133.0,133.0,3090,2737,2463,2043,627,694,382,309,274,150,108,159,47,64,4325,4775,1400,2800,2525,2525,1
550,0,2,117.0,130.0,133.0,141.0,2888,2950,2239,2099,649,851,362,665,224,410,138,255,49,64,4325,4675,1400,2800,2525,2625,1
557,0,2,119.0,134.0,133.0,149.0,2972,2933,2323,2127,649,806,588,602,374,555,214,47,49,64,4325,4675,1400,2800,2525,2625,1
564,0,2,120.0,134.0,133.0,157.0,2490,3162,1819,2379,671,783,508,1003,264,860,244,143,48,64,4725,5450,1500,2800,2575,2625,1
571,0,2,123.0,142.0,133.0,157.0,2412,3398,1763,2570,649,828,799,798,479,559,320,239,49,64,4975,5250,2000,2800,2625,2825,1
579,0,2,126.0,142.0,133.0,172.0,2412,3141,1763,2335,649,806,155,709,84,374,71,335,49,64,4975,5850,2100,2800,2625,2825,1
586,0,2,127.0,140.0,133.0,172.0,2636,2950,1987,2189,649,761,380,772,229,495,151,277,51,64,5075,5750,2200,2800,2625,2925,1
593,0,2,133.0,142.0,133.0,172.0,2748,3516,2099,2710,649,806,446,1102,269,725,177,377,52,64,5325,5750,2200,2800,2625,2925,1
600,0,2,133.0,156.0,133.0,172.0,3028,3633,2379,2805,649,828,461,436,204,159,257,277,53,64,5325,6550,2275,2800,2625,2925,1
607,0,2,137.0,148.0,141.0,172.0,2625,3645,2043,2839,582,806,830,861,509,492,321,369,52,60,5375,6350,2275,2800,2725,3325,1
614,0,2,115.0,133.0,141.0,172.0,1415,3465,923,2659,492,806,954,659,577,194,377,465,37,59,4850,4875,2375,2950,3678,4850,1
621,0,2,122.0,123.0,157.0,172.0,1068,3476,643,2648,425,828,492,966,146,401,346,565,36,59,5400,4975,2275,2950,3859,5450,1
629,0,2,110.0,111.0,157.0,172.0,1247,3403,867,2620,380,783,651,1366,261,713,390,653,36,59,4700,4375,2275,2950,4759,6050,1
636,0,2,102.0,122.0,157.0,172.0,1365,3347,1007,2564,358,783,635,586,226,183,409,403,34,59,4350,3775,2275,3550,5409,6150,1
643,0,2,99.0,118.0,157.0,172.0,1393,3353,1035,2525,358,828,633,367,201,318,432,49,34,59,4075,3975,2275,3550,6096,6925,1
650,0,2,96.0,108.0,157.0,172.0,1438,3409,1035,2581,403,828,791,689,311,540,480,149,34,62,3775,3650,2275,3550,6396,7950,1
657,0,2,100.0,114.0,157.0,172.0,1270,3247,867,2441,403,806,529,616,201,375,328,241,34,62,3875,3750,2275,3550,6396,7950,1
664,0,2,103.0,117.0,157.0,172.0,1320,3487,783,2659,537,828,552,971,156,634,396,337,34,65,4125,3750,2275,3550,6396,7950,1
671,0,2,105.0,127.0,157.0,172.0,1824,3325,1175,2497,649,828,499,478,156,241,343,237,34,67,4125,4150,2275,3550,6396,7950,1
679,0,2,109.0,135.0,157.0,172.0,2132,3572,1483,2811,649,761,199,301,26,176,173,125,34,69,4275,4650,2275,3550,6396,7950,1
686,0,2,109.0,141.0,157.0,172.0,2250,3824,1623,3018,627,806,470,391,221,166,249,225,34,71,4675,4950,2275,3550,6396,7950,1
693,0,2,113.0,145.0,157.0,172.0,2390,3762,1763,2956,627,806,570,333,241,312,329,21,34,71,4675,5150,2275,3550,6396,7950,1
700,0,2,113.0,145.0,157.0,172.0,2580,4031,1931,3225,649,806,900,344,491,227,409,117,34,73,4950,5350,2275,3550,6396,7950,1
707,0,2,122.0,137.0,157.0,172.0,2933,3924,2239,3118,694,806,285,804,171,591,114,213,34,73,5700,4800,2275,3550,6396,8500,1
714,0,2,122.0,141.0,157.0,172.0,2742,4064,2071,3236,671,828,601,784,411,671,190,113,34,73,5700,5200,2275,3800,6396,8600,1
721,0,2,123.0,154.0,157.0,180.0,2468,3885,1819,3079,649,806,356,259,169,204,187,55,34,73,5700,5100,2275,3800,6396,8700,1
729,0,2,123.0,154.0,157.0,180.0,1964,4008,1315,3225,649,783,600,747,333,596,267,151,34,73,5750,5700,2275,3900,6496,8700,1
736,0,2,129.0,150.0,157.0,180.0,1830,3991,1203,3096,627,895,465,1209,172,946,293,263,34,73,6525,5500,2275,3900,6546,8900,1
743,0,2,124.0,146.0,157.0,180.0,1662,4181,1035,3174,627,1007,464,1716,116,1333,348,383,34,73,5750,5200,2275,3900,7471,9200,1
750,0,2,108.0,137.0,157.0,180.0,1432,4148,783,3163,649,985,453,1408,53,913,400,495,30,73,5125,4325,2275,3900,8346,11175,1
757,0,2,85.0,122.0,157.0,180.0,1286,4237,615,3230,671,1007,516,1663,44,1052,472,611,22,73,4125,3250,2275,3900,10181,12450,1
763,0,2,71.0,121.0,157.0,180.0,1292,4142,643,3202,649,940,582,1749,54,1196,528,553,20,73,3400,3550,2275,3900,11106,12650,1
7,,,13.0,13.0,15.0,15.0,251,335,251,335,0,0,30,40,30,40,0,0,12,12,0,0,0,0,0,0,0
14,,,14.0,14.0,15.0,15.0,671,643,671,643,0,0,70,65,70,65,0,0,13,13,0,0,0,0,0,0,0
21,,,14.0,14.0,15.0,15.0,727,727,727,727,0,0,50,50,50,50,0,0,13,13,0,0,0,0,0,0,0
29,,,15.0,15.0,15.0,15.0,727,643,727,643,0,0,40,85,40,85,0,0,14,14,0,0,0,0,0,0,0
36,,,16.0,15.0,23.0,15.0,839,783,839,783,0,0,150,130,150,130,0,0,15,14,0,0,0,0,0,0,0
43,,,16.0,16.0,23.0,23.0,839,727,839,727,0,0,40,65,40,65,0,0,15,15,0,0,0,0,0,0,0
50,,,17.0,16.0,23.0,23.0,839,755,839,755,0,0,15,35,15,35,0,0,16,15,0,0,0,0,0,0,0
57,,,18.0,17.0,23.0,23.0,923,755,923,755,0,0,85,80,85,80,0,0,17,16,0,0,0,0,0,0,0
64,,,19.0,18.0,23.0,23.0,979,783,979,783,0,0,200,175,200,175,0,0,18,17,0,0,0,0,0,0,0
71,,,19.0,18.0,23.0,23.0,1001,827,979,783,22,44,314,233,310,225,4,8,18,17,0,0,0,0,0,0,0
79,,,19.0,19.0,23.0,23.0,1018,911,951,755,67,156,32,343,20,315,12,28,19,18,0,0,0,0,0,0,0
86,,,19.0,19.0,23.0,23.0,1034,939,923,783,111,156,153,458,125,410,28,48,19,18,0,0,150,0,0,0,0
93,,,20.0,20.0,23.0,23.0,1006,911,895,755,111,156,65,318,25,300,40,18,19,19,0,0,150,150,0,0,0
100,,,20.0,20.0,23.0,23.0,1034,1023,923,867,111,156,117,438,65,400,52,38,19,19,0,0,150,150,0,0,0
107,,,21.0,20.0,23.0,23.0,1046,967,979,811,67,156,85,158,25,100,60,58,20,19,0,0,150,150,0,0,0
114,,,21.0,20.0,23.0,23.0,1090,1018,979,839,111,179,216,168,140,90,76,78,20,19,0,0,150,150,0,0,0
121,,,22.0,21.0,23.0,23.0,1107,878,951,699,156,179,296,168,200,70,96,98,21,19,0,100,150,150,0,0,0
129,,,24.0,23.0,31.0,23.0,1230,1051,1007,895,223,156,169,109,145,45,24,64,21,20,0,100,300,150,0,0,0
136,,,25.0,23.0,31.0,31.0,1253,1079,1007,923,246,156,162,94,110,10,52,84,22,20,0,100,300,150,0,0,0
143,,,25.0,24.0,31.0,31.0,1247,1135,979,979,268,156,124,189,90,85,34,104,22,21,0,100,300,150,0,0,0
150,,,28.0,24.0,46.0,31.0,1242,1107,951,951,291,156,225,139,155,15,70,124,23,21,175,100,300,150,0,0,0
157,,,30.0,24.0,54.0,31.0,1286,1130,951,951,335,179,265,304,155,160,110,144,24,21,175,200,300,150,0,50,0
164,,,30.0,25.0,54.0,31.0,1314,1102,979,923,335,179,280,299,130,185,150,114,24,22,175,200,300,150,0,50,0
171,,,30.0,25.0,54.0,31.0,1236,1331,923,1175,313,156,266,475,80,345,186,130,26,22,175,200,300,150,0,50,0
179,,,33.0,26.0,54.0,46.0,1370,1331,1035,1175,335,156,216,475,40,325,176,150,26,23,350,200,300,150,0,50,0
186,,,34.0,26.0,54.0,46.0,1370,1219,1035,1063,335,156,336,485,120,340,216,145,26,23,350,200,300,300,0,50,0
193,,,34.0,27.0,54.0,46.0,1460,1219,1147,1063,313,156,512,485,260,320,252,165,28,24,350,200,300,300,0,50,0
200,,,35.0,30.0,54.0,46.0,1488,1303,1175,1147,313,156,547,355,255,195,292,160,28,25,350,200,300,550,0,50,0
207,,,36.0,30.0,54.0,46.0,1566,1326,1231,1147,335,179,677,165,345,85,332,80,28,25,525,100,300,625,0,150,0
214,,,38.0,33.0,54.0,46.0,1650,1606,1315,1427,335,179,852,185,480,85,372,100,30,26,525,100,600,625,0,250,0
221,,,38.0,34.0,54.0,46.0,1656,1695,1343,1539,313,156,943,86,535,70,408,16,30,26,525,100,600,800,0,250,0
229,,,46.0,37.0,54.0,46.0,1796,1992,1483,1791,313,201,279,239,85,195,194,44,32,28,1050,150,600,800,0,250,0
236,,,46.0,41.0,62.0,46.0,1712,2082,1399,1791,313,291,475,160,245,80,230,80,32,29,1050,300,600,800,0,250,0
243,,,48.0,43.0,62.0,46.0,1930,2104,1595,1791,335,313,600,150,330,130,270,20,34,30,1050,350,600,800,0,250,0
250,,,54.0,46.0,62.0,46.0,1880,1992,1567,1679,313,313,206,115,50,55,156,60,34,32,1575,450,600,800,0,250,0
257,,,55.0,49.0,62.0,54.0,1964,1986,1651,1651,313,335,391,135,195,60,196,75,36,32,1575,500,600,800,0,250,0
264,,,53.0,46.0,62.0,54.0,2048,1331,1735,1063,313,268,631,149,395,50,236,99,37,32,1400,400,600,700,175,525,0
271,,,59.0,45.0,70.0,62.0,2154,984,1819,783,335,201,361,278,235,155,126,123,37,30,1400,500,850,700,175,625,0
279,,,61.0,48.0,70.0,62.0,2126,1191,1791,1035,335,156,496,208,330,90,166,118,37,31,1925,625,850,700,175,625,0
286,,,61.0,50.0,70.0,62.0,2126,1023,1791,867,335,156,697,165,495,52,202,113,37,32,1925,575,850,950,175,675,0
293,,,63.0,51.0,70.0,62.0,2076,743,1763,587,313,156,388,156,300,23,88,133,39,32,1925,675,850,950,175,675,0
300,,,66.0,51.0,70.0,62.0,2048,1298,1735,1119,313,179,493,206,465,53,28,153,41,32,2075,800,850,950,175,750,0
307,,,67.0,53.0,70.0,54.0,2048,1522,1735,1343,313,179,193,162,125,14,68,148,41,32,2075,925,850,950,175,850,0
314,,,67.0,53.0,70.0,62.0,2104,1639,1791,1483,313,156,458,348,350,184,108,164,43,32,2075,1025,850,950,175,850,0
321,,,65.0,44.0,70.0,62.0,2115,1499,1735,1343,380,156,191,283,185,149,6,134,43,32,1400,425,850,1050,850,1450,0
329,,,60.0,42.0,78.0,62.0,2272,1550,1847,1371,425,179,429,237,375,104,54,133,43,32,1400,225,850,1050,1375,1775,0
336,,,61.0,43.0,78.0,70.0,2311,1516,1931,1315,380,201,594,320,500,159,94,161,43,34,1400,175,850,1050,1375,1825,0
343,,,62.0,45.0,78.0,70.0,2154,1454,1707,1231,447,223,604,119,550,80,54,39,44,34,1400,300,850,1050,1375,1825,0
350,,,63.0,49.0,78.0,70.0,2244,1690,1595,1399,649,291,724,115,590,65,134,50,45,34,1400,525,850,1050,1375,1825,0
357,,,70.0,49.0,78.0,70.0,2446,2014,1819,1679,627,335,300,135,240,45,60,90,46,34,1575,525,850,1050,1375,1825,0
364,,,71.0,50.0,86.0,70.0,2440,1908,1791,1595,649,313,530,266,390,140,140,126,47,34,1925,650,850,1050,1375,1825,0
371,,,72.0,53.0,86.0,70.0,2496,1712,1847,1399,649,313,440,131,220,40,220,91,48,34,1925,875,850,1050,1375,1825,0
379,,,81.0,53.0,101.0,70.0,2552,1790,1903,1455,649,335,171,211,25,105,146,106,50,34,1925,875,850,1400,1375,1825,0
386,,,82.0,59.0,101.0,78.0,2681,1740,1987,1427,694,313,421,232,195,90,226,142,51,34,2450,1075,850,1400,1375,1825,0
393,,,85.0,61.0,101.0,78.0,2720,1740,2071,1427,649,313,253,162,180,80,73,82,53,34,2450,1075,1100,1400,1375,1825,0
400,,,86.0,63.0,117.0,78.0,2866,1762,2239,1427,627,335,109,82,60,60,49,22,54,34,2450,1075,1100,1400,1375,1825,0
407,,,89.0,67.0,117.0,86.0,2838,1712,2211,1399,627,313,279,183,225,150,54,33,56,34,2550,1425,1100,1400,1375,1825,0
414,,,92.0,67.0,125.0,86.0,3084,1740,2435,1427,649,313,554,313,420,240,134,73,59,34,2550,1425,1100,1400,1375,1825,0
421,,,99.0,71.0,125.0,94.0,3162,1762,2491,1427,671,335,299,278,235,190,64,88,60,34,3075,1775,1100,1400,1375,1825,0
429,,,101.0,75.0,125.0,94.0,3174,1706,2435,1371,739,335,577,153,500,125,77,28,62,34,3175,2025,1100,1400,1375,1825,0
436,,,101.0,74.0,133.0,102.0,3398,1544,2435,1231,963,313,983,324,790,260,193,64,63,34,3175,1975,1100,1400,1375,1875,0
443,,,97.0,74.0,133.0,102.0,3420,1706,2435,1371,985,335,1384,519,1075,415,309,104,64,34,2825,2200,1400,1400,1725,1875,0
450,,,97.0,80.0,133.0,102.0,3510,1734,2547,1399,963,335,1821,354,1400,260,421,94,64,34,2925,2325,1400,1400,1725,1875,0
457,,,106.0,82.0,133.0,102.0,3482,1740,2519,1427,963,313,391,370,250,340,141,30,64,34,3125,2525,1400,1525,1825,1875,0
464,,,107.0,84.0,133.0,102.0,3493,1790,2575,1455,918,335,279,305,180,285,99,20,64,34,3125,2625,1400,1425,1825,1909,0
471,,,108.0,88.0,133.0,102.0,3448,1986,2575,1651,873,335,237,555,30,495,207,60,64,34,3125,2875,1400,1425,1825,1909,0
479,,,108.0,88.0,133.0,102.0,3493,2272,2575,1959,918,313,584,176,265,130,319,46,66,34,3125,2875,1400,1425,1825,1909,0
486,,,108.0,90.0,141.0,102.0,3470,2356,2575,2043,895,313,778,366,355,280,423,86,66,34,3125,3175,1400,1425,1825,1909,0
493,,,114.0,98.0,157.0,102.0,3470,2378,2575,2043,895,335,706,326,375,200,331,126,66,36,3625,3425,1400,1425,1825,1909,0
500,,,120.0,98.0,173.0,102.0,3521,2328,2603,2015,918,313,838,227,395,165,443,62,66,36,3925,3425,1500,1425,1825,1909,0
507,,,120.0,101.0,181.0,102.0,3599,2384,2659,2071,940,313,1260,207,705,105,555,102,66,38,3925,3475,2050,1425,1825,1959,0
514,,,126.0,94.0,181.0,110.0,3588,2630,2603,2295,985,335,1180,397,505,255,675,142,66,38,3650,3375,2450,1425,2100,2309,0
521,,,132.0,100.0,181.0,110.0,3694,2714,2687,2379,1007,335,1206,462,490,330,716,132,66,40,4150,3375,2750,1425,2100,2309,0
529,,,133.0,102.0,181.0,118.0,3554,2384,2547,2071,1007,313,1227,538,395,370,832,168,66,40,4950,3475,2750,1425,2100,2309,0
536,,,133.0,106.0,181.0,118.0,3482,2126,2519,1791,963,335,1114,168,370,60,744,108,66,42,4950,3475,2750,1425,2100,2309,0
543,,,147.0,108.0,181.0,118.0,3342,2154,2379,1819,963,335,1120,263,260,115,860,148,66,44,5050,3725,2750,1425,2100,2309,0
550,,,147.0,90.0,173.0,133.0,3314,2132,2351,1819,963,313,1525,409,545,250,980,159,66,44,5450,2525,2750,1575,2200,3609,0
557,,,145.0,92.0,173.0,133.0,3314,2216,2351,1903,963,313,1926,444,830,245,1096,199,66,46,5350,2525,2750,1575,2300,3609,0
564,,,163.0,93.0,173.0,141.0,3386,2423,2379,2043,1007,380,1431,292,215,270,1216,22,66,46,6150,2550,2750,1675,2300,3784,0
571,,,161.0,100.0,173.0,141.0,3274,2390,2267,1987,1007,403,1832,205,500,160,1332,45,66,48,6150,2675,2750,1675,2400,3784,0
579,,,164.0,102.0,173.0,141.0,3308,2390,2323,1875,985,515,1334,157,90,90,1244,67,66,48,6150,2675,2750,1750,2400,3784,0
586,,,164.0,108.0,173.0,141.0,3202,2496,2239,1847,963,649,1575,168,215,75,1360,93,66,50,6150,2825,2750,1900,2400,3784,0
593,,,172.0,108.0,173.0,141.0,3118,2328,2155,1679,963,649,1956,523,480,350,1476,173,69,50,6650,3350,2750,1800,2400,3809,0
600,,,172.0,116.0,188.0,141.0,3224,2468,2239,1819,985,649,2361,379,765,280,1596,99,71,52,6650,3475,2750,1800,2400,3809,0
607,,,170.0,106.0,188.0,141.0,3700,2574,2715,1903,985,671,2812,684,1100,505,1712,179,71,54,6550,3025,2750,1800,2500,4484,0
614,,,184.0,89.0,188.0,141.0,3616,2384,2631,1735,985,649,2138,950,310,695,1828,255,71,44,7150,2625,2900,1800,2900,5384,0
621,,,156.0,86.0,188.0,141.0,4036,2104,3051,1455,985,649,2614,726,670,470,1944,256,71,36,5750,2700,3050,1900,4300,5959,0
629,,,148.0,85.0,188.0,141.0,3986,2322,3023,1651,963,671,2176,626,520,490,1656,136,73,35,5350,2700,3050,1900,4700,6209,0
636,,,137.0,68.0,188.0,141.0,4098,2440,3135,1791,963,649,1892,907,320,695,1572,212,73,37,4650,1675,3050,1900,5900,7234,0
643,,,127.0,62.0,188.0,141.0,3930,2446,2967,1819,963,627,2357,663,665,450,1692,213,75,37,3900,900,3050,1900,6650,8384,0
650,,,147.0,58.0,188.0,141.0,4098,2328,3135,1679,963,649,1843,943,35,650,1808,293,76,37,3900,575,3050,1900,6650,8709,0
657,,,150.0,57.0,188.0,126.0,4064,2378,3079,1707,985,671,2158,1213,230,840,1928,373,76,36,4900,1125,3050,1900,6650,9309,0
7,2,2,13.0,13.0,15.0,15.0,293,293,293,293,0,0,35,35,35,35,0,0,12,12,0,0,0,0,0,0,0
14,2,2,14.0,14.0,15.0,15.0,671,671,671,671,0,0,70,70,70,70,0,0,13,13,0,0,0,0,0,0,0
21,2,2,14.0,14.0,15.0,15.0,699,699,699,699,0,0,50,50,50,50,0,0,13,13,0,0,0,0,0,0,0
29,2,2,15.0,15.0,15.0,15.0,727,755,727,755,0,0,90,95,90,95,0,0,14,14,0,0,0,0,0,0,0
36,2,2,15.0,15.0,23.0,23.0,783,811,783,811,0,0,190,140,190,140,0,0,14,14,0,0,0,0,0,0,0
43,2,2,16.0,16.0,23.0,23.0,839,811,839,811,0,0,85,35,85,35,0,0,15,15,0,0,0,0,0,0,0
50,2,2,17.0,17.0,23.0,23.0,811,895,811,895,0,0,55,20,55,20,0,0,16,16,0,0,0,0,0,0,0
57,2,2,18.0,18.0,23.0,23.0,839,895,839,895,0,0,40,40,40,40,0,0,17,17,0,0,0,0,0,0,0
64,2,2,19.0,19.0,23.0,23.0,895,923,895,923,0,0,100,95,100,95,0,0,18,18,0,0,0,0,0,0,0
71,2,2,19.0,19.0,23.0,23.0,923,979,923,979,0,0,0,15,0,15,0,0,18,18,0,0,0,0,0,0,0
79,2,2,20.0,20.0,23.0,23.0,1023,995,979,951,44,44,133,83,125,75,8,8,19,19,0,0,0,0,0,0,0
86,2,2,21.0,21.0,23.0,23.0,1001,1034,867,923,134,111,44,195,20,175,24,20,20,20,0,0,150,150,0,0,0
93,2,2,22.0,22.0,23.0,23.0,1090,855,867,811,223,44,122,89,70,65,52,24,21,21,0,0,150,150,0,0,0
100,2,2,22.0,22.0,23.0,23.0,1074,956,895,867,179,89,103,110,35,70,68,40,21,21,0,0,150,150,0,0,0
107,2,2,23.0,23.0,23.0,23.0,1202,1174,979,951,223,223,250,202,150,130,100,72,22,22,0,0,150,150,0,0,0
114,2,2,23.0,24.0,31.0,31.0,1242,1130,951,839,291,291,341,288,205,180,136,108,22,23,0,0,300,300,0,0,0
121,2,2,28.0,24.0,31.0,31.0,1242,1174,951,839,291,335,137,438,65,290,72,148,23,23,0,0,450,300,0,0,0
129,2,2,28.0,28.0,31.0,31.0,1292,1208,979,895,313,313,197,134,135,100,62,34,24,24,0,0,450,450,0,0,0
136,2,2,29.0,28.0,31.0,31.0,1264,1208,951,895,313,313,192,179,90,105,102,74,24,24,0,0,450,450,0,0,0
143,2,2,29.0,28.0,31.0,31.0,1309,1236,951,923,358,313,242,334,100,220,142,114,24,24,0,0,450,450,0,0,0
150,2,2,29.0,28.0,39.0,39.0,1286,1230,951,895,335,335,363,479,185,325,178,154,25,24,0,0,450,450,0,0,0
157,2,2,33.0,29.0,39.0,39.0,1292,1281,979,923,313,358,289,584,275,390,14,194,25,24,350,350,450,450,0,0,0
164,2,2,33.0,30.0,39.0,39.0,1208,1258,895,923,313,335,434,185,380,55,54,130,25,23,350,350,450,450,0,50,0
171,2,2,34.0,33.0,39.0,39.0,1236,1208,923,895,313,313,139,126,45,60,94,66,25,24,350,350,450,450,0,50,0
179,2,2,34.0,33.0,39.0,39.0,1264,1236,951,923,313,313,194,131,60,25,134,106,25,24,350,350,450,450,0,50,0
186,2,2,37.0,36.0,39.0,39.0,1309,1236,951,923,358,313,149,131,75,85,74,46,26,25,650,500,450,450,0,50,0
193,2,2,38.0,37.0,39.0,39.0,1309,1264,951,951,358,313,149,136,35,50,114,86,27,26,650,500,450,450,0,50,0
200,2,2,38.0,37.0,39.0,39.0,1292,1370,979,1035,313,335,256,56,110,30,146,26,27,26,650,650,450,450,0,50,0
207,2,2,39.0,38.0,39.0,39.0,1292,1376,979,1063,313,313,111,163,25,105,86,58,28,27,650,650,550,550,0,50,0
214,2,2,40.0,38.0,47.0,47.0,1404,1320,1091,1007,313,313,286,263,160,165,126,98,29,27,800,800,550,550,0,50,0
221,2,2,41.0,39.0,47.0,47.0,1376,1286,1063,951,313,335,397,358,235,220,162,138,30,28,800,800,550,550,0,50,0
229,2,2,41.0,44.0,47.0,47.0,1264,1342,951,1007,313,335,337,278,135,150,202,128,30,29,800,1050,550,550,0,50,0
236,2,2,42.0,45.0,47.0,62.0,1236,1348,923,1035,313,313,438,194,200,30,238,164,31,29,800,1050,550,800,0,50,0
243,2,2,44.0,47.0,62.0,62.0,1561,1505,1203,1147,358,358,488,319,210,115,278,204,32,31,800,1050,800,800,0,50,0
250,2,2,46.0,49.0,62.0,62.0,1678,1538,1343,1203,335,335,289,105,125,15,164,90,34,33,800,1050,800,800,0,50,0
257,2,2,47.0,50.0,62.0,62.0,1852,1740,1539,1427,313,313,415,226,215,100,200,126,35,34,800,1050,800,800,0,50,0
264,2,2,52.0,51.0,62.0,62.0,1936,1712,1623,1399,313,313,115,376,75,210,40,166,36,35,800,1050,950,950,0,50,0
271,2,2,54.0,53.0,62.0,62.0,1992,1824,1679,1511,313,313,280,361,200,255,80,106,38,37,1150,1050,950,950,0,50,0
279,2,2,55.0,54.0,62.0,62.0,2070,1992,1735,1679,335,313,480,311,360,265,120,46,39,39,1150,1050,950,950,0,50,0
286,2,2,56.0,53.0,62.0,62.0,2098,2098,1763,1763,335,335,495,456,335,370,160,86,40,39,1150,925,950,950,0,175,0
293,2,2,57.0,54.0,62.0,62.0,2070,2149,1735,1791,335,358,441,236,345,110,96,126,41,40,1150,925,950,950,0,175,0
300,2,2,58.0,53.0,62.0,62.0,2126,2098,1791,1763,335,335,261,437,125,275,136,162,42,41,1150,800,950,950,0,300,0
307,2,2,60.0,58.0,62.0,62.0,2160,2104,1847,1791,313,313,417,183,245,85,172,98,44,42,1150,1150,950,950,0,300,0
314,2,2,60.0,60.0,62.0,62.0,2250,2188,1847,1875,403,313,388,308,160,170,228,138,45,44,1150,1150,950,950,0,300,0
321,2,2,64.0,61.0,70.0,62.0,2345,2076,1875,1763,470,313,318,298,130,120,188,178,46,45,1150,1150,950,950,0,300,0
329,2,2,66.0,62.0,70.0,62.0,2339,2244,1847,1819,492,425,359,333,115,170,244,163,46,46,1500,1150,950,1200,0,300,0
336,2,2,66.0,62.0,70.0,62.0,2423,2334,1931,1819,492,515,385,458,85,235,300,223,48,47,1500,1150,1200,1200,0,300,0
343,2,2,69.0,64.0,70.0,70.0,2384,2468,1959,1931,425,537,373,603,25,395,348,208,48,47,1500,1150,1200,1200,0,300,0
350,2,2,69.0,69.0,70.0,78.0,2373,2367,1903,1875,470,492,563,485,155,325,408,160,48,47,1500,1600,1200,1200,0,300,0
357,2,2,69.0,71.0,78.0,78.0,2485,2205,2015,1735,470,470,869,641,405,425,464,216,49,49,1500,1600,1500,1200,0,300,0
364,2,2,73.0,73.0,78.0,93.0,2367,2401,1875,1931,492,470,489,291,140,15,349,276,49,50,1850,1600,1500,1500,0,300,0
371,2,2,78.0,76.0,101.0,93.0,2317,2541,1847,2071,470,470,421,551,120,215,301,336,49,53,2100,1700,1500,1500,0,300,0
379,2,2,78.0,79.0,101.0,93.0,2507,2703,2015,2211,492,492,626,281,265,135,361,146,49,53,2450,1700,1800,1500,0,300,0
386,2,2,86.0,83.0,117.0,93.0,2569,2922,2099,2407,470,515,228,201,15,145,213,56,49,53,2450,2025,1800,1500,0,300,0
393,2,2,86.0,88.0,117.0,93.0,2569,3090,2099,2575,470,515,538,232,265,170,273,62,49,53,3250,2375,1800,1500,0,300,0
400,2,2,86.0,84.0,117.0,93.0,2737,3045,2267,2575,470,470,878,364,545,250,333,114,49,53,3250,2075,1800,1500,0,550,0
407,2,2,78.0,82.0,117.0,93.0,2759,3045,2267,2575,492,470,1199,354,810,280,389,74,49,56,2550,1950,1900,1500,700,1225,0
414,2,2,86.0,77.0,117.0,101.0,2838,2961,2323,2491,515,470,484,344,335,310,149,34,49,57,3250,1625,1900,1950,1050,2025,0
421,2,2,80.0,70.0,117.0,101.0,2787,2485,2295,2015,492,470,800,534,595,440,205,94,49,50,2750,1625,1900,2100,1550,2550,0
429,2,2,73.0,69.0,117.0,101.0,2681,2479,2211,1987,470,492,1067,279,810,225,257,54,49,49,2075,1075,1900,2100,2225,3325,0
436,2,2,77.0,68.0,117.0,101.0,2737,2300,2267,1763,470,537,377,194,310,80,67,114,49,45,1375,1275,1900,2100,2925,3800,0
443,2,2,72.0,62.0,117.0,101.0,2793,2367,2323,1875,470,492,707,356,580,240,127,116,52,44,1750,1450,1900,2100,3425,4150,0
450,2,2,75.0,67.0,117.0,101.0,2759,2373,2267,1903,492,470,497,222,360,100,137,122,52,44,1750,1450,1900,2100,3425,4150,0
457,2,2,85.0,69.0,117.0,101.0,2765,2401,2295,1931,470,470,144,262,55,180,89,82,53,44,1925,1775,1900,2100,3425,4150,0
464,2,2,85.0,77.0,117.0,101.0,2989,2429,2519,1959,470,470,490,122,345,80,145,42,53,46,2425,1950,1900,2100,3425,4150,0
471,2,2,83.0,75.0,117.0,93.0,2961,2401,2491,1931,470,470,546,407,495,305,51,102,54,46,2325,2225,1900,2100,3525,4350,0
479,2,2,80.0,75.0,117.0,93.0,2955,2558,2463,2043,492,515,827,422,720,260,107,162,54,47,2125,2125,1900,2200,3725,4750,0
486,2,2,92.0,82.0,117.0,93.0,3101,2446,2631,1931,470,515,613,163,450,45,163,118,54,47,2725,2125,1900,2200,3725,4750,0
493,2,2,95.0,87.0,117.0,93.0,2933,2339,2463,1847,470,492,348,239,275,65,73,174,55,50,2725,2575,1900,2200,3725,4750,0
500,2,2,95.0,90.0,117.0,93.0,2899,2345,2407,1875,492,470,618,85,485,5,133,80,55,51,2725,2675,2200,2200,3725,4750,0
507,2,2,107.0,92.0,117.0,93.0,2619,2737,2127,2267,492,470,339,230,150,90,189,140,58,53,2725,2675,2200,2200,3725,4750,0
514,2,2,107.0,92.0,117.0,93.0,2759,2793,2267,2323,492,470,560,565,315,365,245,200,58,55,3325,2675,2200,2200,3725,4750,0
521,2,2,107.0,92.0,117.0,93.0,2899,2899,2407,2407,492,492,815,410,510,150,305,260,58,56,3325,2675,2200,2200,3725,4750,0
529,2,2,105.0,92.0,117.0,101.0,2882,3112,2323,2575,559,537,657,765,280,445,377,320,58,56,3225,2675,2350,2200,3825,4750,0
536,2,2,113.0,100.0,117.0,101.0,3006,3006,2379,2491,627,515,613,371,160,195,453,176,58,56,3525,2975,2350,2200,3825,4750,0
543,2,2,117.0,106.0,133.0,109.0,3006,3017,2379,2547,627,470,673,323,140,95,533,228,58,58,3625,2975,2350,2200,3825,4750,0
550,2,2,113.0,106.0,133.0,109.0,3022,2933,2351,2463,671,470,1033,668,420,380,613,288,58,58,3550,3275,2350,2200,4100,4750,0
557,2,2,125.0,108.0,149.0,109.0,3050,2933,2379,2463,671,470,783,868,90,595,693,273,58,58,3750,3275,2350,2200,4100,4750,0
564,2,2,125.0,108.0,149.0,117.0,3106,2849,2435,2379,671,470,1055,1108,290,775,765,333,58,59,4150,3275,2650,2200,4100,4750,0
571,2,2,129.0,116.0,149.0,117.0,3056,3006,2407,2491,649,515,911,1143,320,750,591,393,58,59,4650,3675,2650,2550,4100,4675,0
579,2,2,133.0,110.0,157.0,117.0,3062,2978,2435,2463,627,515,1077,1374,410,925,667,449,58,59,4650,3475,2650,2550,4100,4675,0
586,2,2,140.0,104.0,157.0,117.0,3034,2787,2407,2295,627,492,407,1395,160,890,247,505,58,51,4750,3575,2650,2550,4200,5275,0
593,2,2,134.0,95.0,157.0,117.0,3162,2003,2491,1623,671,380,777,950,450,480,327,470,58,38,5300,3525,2650,2550,4650,6475,0
600,2,2,140.0,91.0,172.0,102.0,3129,1466,2435,1175,694,291,752,1066,345,560,407,506,59,38,5125,3250,2650,2550,4825,7200,0
7,2,0,13.0,13.0,15.0,15.0,335,293,335,293,0,0,40,35,40,35,0,0,12,12,0,0,0,0,0,0,1
14,2,0,14.0,14.0,15.0,15.0,671,671,671,671,0,0,70,70,70,70,0,0,13,13,0,0,0,0,0,0,1
21,2,0,14.0,14.0,15.0,15.0,699,671,699,671,0,0,50,45,50,45,0,0,13,13,0,0,0,0,0,0,1
29,2,0,15.0,15.0,15.0,15.0,755,671,755,671,0,0,100,85,100,85,0,0,14,14,0,0,0,0,0,0,1
36,2,0,15.0,15.0,23.0,15.0,783,727,783,727,0,0,145,125,145,125,0,0,14,14,0,0,0,0,0,0,1
43,2,0,16.0,16.0,23.0,23.0,811,783,811,783,0,0,35,70,35,70,0,0,15,15,0,0,0,0,0,0,1
50,2,0,17.0,16.0,23.0,23.0,811,783,811,783,0,0,10,35,10,35,0,0,16,15,0,0,0,0,0,0,1
57,2,0,18.0,17.0,23.0,23.0,811,755,811,755,0,0,15,50,15,50,0,0,17,16,0,0,0,0,0,0,1
64,2,0,19.0,18.0,23.0,23.0,951,755,951,755,0,0,130,90,130,90,0,0,18,17,0,0,0,0,0,0,1
71,2,0,19.0,18.0,23.0,23.0,945,771,923,727,22,44,239,78,235,70,4,8,18,17,0,0,0,0,0,0,1
79,2,0,20.0,19.0,23.0,23.0,962,794,895,615,67,179,352,132,340,100,12,32,19,18,0,0,0,0,0,0,1
86,2,0,20.0,19.0,23.0,23.0,990,928,923,615,67,313,80,242,60,170,20,72,19,18,0,0,150,0,0,0,1
93,2,0,20.0,20.0,23.0,23.0,1018,1001,951,643,67,358,48,107,20,45,28,62,20,19,0,0,150,150,0,0,1
100,2,0,21.0,20.0,23.0,23.0,1029,1040,895,727,134,313,113,234,65,140,48,94,20,19,0,0,150,150,0,0,1
107,2,0,22.0,20.0,23.0,31.0,1051,990,895,699,156,291,118,95,50,65,68,30,21,19,0,0,150,150,0,0,1
114,2,0,22.0,20.0,23.0,31.0,1074,984,895,783,179,201,148,204,60,150,88,54,21,19,0,0,150,150,0,0,1
121,2,0,23.0,21.0,23.0,31.0,1102,1107,923,839,179,268,218,191,110,155,108,36,22,19,0,100,150,150,0,0,1
129,2,0,23.0,22.0,23.0,31.0,1118,1225,895,979,223,246,181,284,70,220,111,64,22,20,0,100,300,150,0,0,1
136,2,0,26.0,22.0,31.0,31.0,1124,1225,811,979,313,246,221,437,70,345,151,92,23,20,0,100,300,150,0,0,1
143,2,0,26.0,23.0,31.0,31.0,1096,1275,783,1007,313,268,51,144,10,20,41,124,23,21,0,100,300,150,0,0,1
150,2,0,27.0,23.0,31.0,31.0,1146,1202,811,979,335,223,141,238,60,90,81,148,24,21,125,100,300,400,0,0,1
157,2,0,30.0,24.0,46.0,31.0,1225,1146,867,923,358,223,116,135,20,55,96,80,24,22,125,100,300,400,0,0,1
164,2,0,31.0,24.0,46.0,31.0,1286,1225,951,979,335,246,222,198,90,90,132,108,25,23,125,100,400,500,0,0,1
171,2,0,33.0,29.0,46.0,31.0,1404,1174,1091,951,313,223,133,106,15,20,118,86,27,23,125,100,400,500,0,0,1
179,2,0,36.0,29.0,46.0,31.0,1404,1214,1091,923,313,291,173,256,40,130,133,126,28,23,250,100,400,500,0,0,1
186,2,0,38.0,29.0,46.0,39.0,1488,1236,1175,923,313,313,273,426,100,260,173,166,30,24,250,100,700,500,0,0,1
193,2,0,40.0,35.0,46.0,39.0,1656,1264,1343,951,313,313,213,196,100,140,113,56,30,24,250,300,700,750,0,0,1
200,2,0,42.0,36.0,46.0,39.0,1706,1348,1371,1035,335,313,218,321,65,225,153,96,32,24,250,300,700,750,0,0,1
207,2,0,45.0,36.0,46.0,39.0,1762,1421,1427,1063,335,358,249,236,85,200,164,36,33,24,375,300,700,750,0,0,1
214,2,0,46.0,41.0,46.0,54.0,1790,1533,1455,1175,335,358,159,181,55,155,104,26,34,25,625,500,700,750,0,0,1
221,2,0,49.0,41.0,54.0,54.0,1880,1544,1567,1231,313,313,175,158,35,100,140,58,35,25,625,500,700,750,0,0,1
229,2,0,50.0,42.0,54.0,54.0,1796,1600,1483,1287,313,313,90,338,10,240,80,98,36,26,625,700,700,750,0,0,1
236,2,0,53.0,44.0,54.0,54.0,1874,1600,1539,1287,335,313,275,323,155,285,120,38,37,27,875,900,700,750,0,0,1
243,2,0,54.0,49.0,54.0,54.0,1964,1600,1651,1287,313,313,261,253,105,225,156,28,38,27,1000,900,700,750,0,0,1
250,2,0,55.0,45.0,62.0,54.0,1600,1488,1287,1175,313,313,281,423,85,355,196,68,39,27,1000,600,700,1000,50,300,1
257,2,0,51.0,45.0,70.0,54.0,1202,1393,867,1035,335,358,376,288,140,230,236,58,39,28,875,600,700,1000,425,300,1
264,2,0,56.0,49.0,70.0,54.0,1544,1533,1231,1175,313,358,292,423,170,325,122,98,41,28,875,900,700,1000,425,400,1
271,2,0,57.0,52.0,70.0,54.0,2076,1460,1763,1147,313,313,252,230,90,200,162,30,42,29,875,900,700,1000,425,400,1
279,2,0,60.0,52.0,70.0,54.0,1622,1348,1287,1035,335,313,197,270,45,225,152,45,43,29,875,900,700,1000,425,400,1
286,2,0,60.0,52.0,70.0,62.0,1202,1628,867,1315,335,313,237,375,45,290,192,85,43,30,1350,1000,700,1000,525,500,1
293,2,0,55.0,51.0,70.0,62.0,665,1768,419,1455,246,313,241,375,25,300,216,75,38,31,1350,700,700,1075,775,800,1
300,2,0,55.0,51.0,70.0,62.0,558,1874,335,1539,223,335,424,290,180,175,244,115,39,32,1350,700,700,1075,825,1000,1
307,2,0,58.0,48.0,70.0,62.0,866,1841,643,1483,223,358,242,175,20,120,222,55,39,34,1525,500,700,1175,825,1200,1
314,2,0,61.0,50.0,70.0,62.0,1230,1908,1007,1595,223,313,155,227,5,190,150,37,40,34,1525,600,700,1175,825,1300,1
321,2,0,62.0,52.0,70.0,62.0,1678,2020,1455,1707,223,313,218,77,40,50,178,27,42,35,1525,650,1000,1175,825,1300,1
329,2,0,63.0,53.0,70.0,62.0,2194,1992,1903,1679,291,313,184,282,70,215,114,67,42,35,1525,650,1000,1175,825,1300,1
336,2,0,65.0,57.0,70.0,62.0,2093,2384,1735,2071,358,313,414,372,260,290,154,82,43,37,1775,850,1000,1175,825,1300,1
343,2,0,63.0,56.0,70.0,62.0,2216,2468,1903,2155,313,313,291,637,105,515,186,122,44,39,1600,850,1000,1175,1000,1300,1
350,2,0,65.0,58.0,78.0,62.0,2216,2586,1903,2183,313,403,396,440,170,370,226,70,44,39,1600,900,1000,1450,1000,1300,1
357,2,0,67.0,54.0,78.0,62.0,2328,2535,2015,2043,313,492,526,730,260,600,266,130,46,39,1850,800,1000,1600,1000,1500,1
364,2,0,67.0,57.0,78.0,62.0,2334,2149,2043,1679,291,470,347,462,145,330,202,132,46,38,1850,800,1000,1675,1000,1550,1
371,2,0,66.0,60.0,78.0,62.0,2328,2093,2015,1623,313,470,577,527,335,335,242,192,45,38,1850,850,1000,1775,1150,1550,1
379,2,0,54.0,62.0,78.0,62.0,2014,2177,1679,1707,335,470,692,313,410,188,282,125,33,39,1850,750,1000,1775,1750,1654,1
386,2,0,56.0,67.0,78.0,70.0,1740,2311,1427,1819,313,492,848,388,530,203,318,185,35,40,1850,950,1000,1875,1750,1704,1
393,2,0,58.0,68.0,78.0,78.0,1846,2591,1511,2099,335,492,823,378,465,133,358,245,37,40,1850,1000,1000,1875,1750,1704,1
400,2,0,60.0,76.0,78.0,78.0,1656,2530,1343,2015,313,515,419,109,125,58,294,51,39,42,1850,1050,1400,1875,1750,1704,1
407,2,0,61.0,77.0,78.0,78.0,1242,2675,951,2183,291,492,265,240,35,133,230,107,40,42,1850,1250,1400,1875,1800,1704,1
414,2,0,59.0,77.0,93.0,78.0,1410,2765,1119,2295,291,470,406,246,140,183,266,63,38,44,1850,1325,1400,1875,1900,1904,1
421,2,0,61.0,77.0,93.0,86.0,1650,2653,1315,2183,335,470,446,356,140,233,306,123,40,45,1850,1325,1400,1875,1900,2004,1
429,2,0,62.0,82.0,93.0,86.0,1846,2737,1511,2267,335,470,436,186,90,128,346,58,40,46,1850,1425,1400,1875,1900,2004,1
436,2,0,71.0,87.0,93.0,94.0,2048,2860,1735,2323,313,537,127,239,45,138,82,101,43,46,1850,1675,1400,1875,1900,2004,1
443,2,0,74.0,88.0,93.0,94.0,2188,3162,1875,2491,313,671,192,559,70,378,122,181,46,48,2300,2025,1700,1875,1900,2004,1
450,2,0,76.0,89.0,93.0,102.0,2182,3218,1847,2547,335,671,297,840,135,583,162,257,48,48,2300,2175,1850,1875,1900,2004,1
457,2,0,79.0,95.0,93.0,110.0,2412,2894,2099,2267,313,627,303,237,105,133,198,104,49,48,2050,2575,1850,1875,2150,2004,1
464,2,0,86.0,99.0,101.0,110.0,2686,2922,2351,2295,335,627,328,192,90,108,238,84,51,48,2250,2425,1850,1875,2150,2204,1
471,2,0,88.0,100.0,101.0,110.0,2742,2922,2407,2295,335,627,333,387,55,223,278,164,53,48,2650,2525,2150,1875,2150,2204,1
479,2,0,87.0,103.0,93.0,110.0,2642,2882,2351,2211,291,671,660,572,350,328,310,244,52,50,2650,2625,2150,1875,2300,2204,1
486,2,0,88.0,101.0,93.0,110.0,2104,2938,1903,2267,201,671,360,922,180,598,180,324,47,50,3175,2725,2150,1875,2650,2304,1
493,2,0,88.0,105.0,109.0,118.0,1695,2910,1651,2239,44,671,355,689,175,518,180,171,45,51,3275,3050,2150,1875,2850,2604,1
500,2,0,84.0,102.0,109.0,118.0,1679,2664,1679,2015,0,649,265,870,85,623,180,247,45,51,2975,2750,2150,1875,3350,2904,1
507,2,0,70.0,92.0,109.0,118.0,1735,2334,1735,1707,0,627,365,1141,185,818,180,323,45,52,2325,2100,2150,1875,4200,3554,1
514,2,0,62.0,91.0,109.0,118.0,1819,2306,1819,1679,0,627,235,1086,55,783,180,303,45,52,1025,1775,2150,1875,5500,3979,1
521,2,0,63.0,84.0,109.0,118.0,2295,2334,2295,1707,0,627,365,1021,185,638,180,383,46,52,1225,1375,2150,1875,5600,4479,1
529,2,0,69.0,90.0,109.0,133.0,2479,2350,2435,1679,44,671,113,151,25,88,88,63,46,53,1225,1750,2150,1875,5600,4579,1
536,2,0,73.0,92.0,109.0,133.0,2602,2485,2379,1791,223,694,230,256,210,113,20,143,49,53,1525,1900,2150,1875,5600,4579,1
543,2,0,79.0,97.0,109.0,133.0,2558,2742,2267,2071,291,671,211,333,155,118,56,215,49,54,1975,2200,2150,1875,5600,4579,1
550,2,0,85.0,97.0,109.0,133.0,2586,2810,2295,2183,291,627,132,640,40,353,92,287,49,54,2075,2300,2150,1875,5600,4579,1
557,2,0,86.0,100.0,109.0,133.0,2580,3034,2267,2407,313,627,288,875,160,508,128,367,49,56,2275,2825,2150,2000,5600,4579,1
564,2,0,88.0,105.0,109.0,133.0,2602,3090,2267,2463,335,627,448,855,280,533,168,322,51,58,2275,2875,2150,2000,5600,4579,1
571,2,0,94.0,111.0,117.0,133.0,2496,3336,2183,2687,313,649,314,610,110,358,204,252,54,58,2575,2875,2150,2300,5600,4579,1
579,2,0,98.0,113.0,117.0,133.0,2608,3918,2295,3247,313,671,374,545,230,213,144,332,54,61,2825,2875,2150,2300,5600,4579,1
586,2,0,108.0,115.0,117.0,133.0,2748,4058,2435,3387,313,671,224,827,40,423,184,404,54,62,3025,3100,2150,2300,5600,4579,1
593,2,0,108.0,120.0,117.0,133.0,2754,4142,2351,3471,403,671,456,692,220,233,236,459,54,63,3325,3425,2150,2400,5600,4579,1
600,2,0,114.0,126.0,117.0,133.0,2832,3734,2407,3107,425,627,508,649,220,218,288,431,54,63,3325,3325,2150,2575,5600,4679,1
607,2,0,116.0,128.0,125.0,141.0,2955,3510,2463,2883,492,627,559,649,215,163,344,486,54,66,3725,3425,2150,2675,5600,4679,1
614,2,0,116.0,132.0,125.0,157.0,2927,3566,2435,2939,492,627,920,649,520,158,400,491,54,66,3725,3550,2150,2675,5600,4679,1
621,2,0,116.0,140.0,125.0,157.0,2804,3907,2379,3079,425,828,884,782,640,258,244,524,54,66,3725,4000,2300,2675,5600,4679,1
629,2,0,132.0,142.0,141.0,165.0,2882,3991,2435,3051,447,940,435,1144,135,508,300,636,54,66,4425,4200,2300,2675,5600,4679,1
636,2,0,134.0,146.0,141.0,165.0,2877,3784,2407,2799,470,985,681,1117,325,423,356,694,54,66,4625,4325,2300,2775,5600,4679,1
643,2,0,132.0,151.0,141.0,165.0,2938,3482,2491,2519,447,963,1008,663,600,353,408,310,54,66,4375,4700,2300,2975,5850,4729,1
650,2,0,138.0,150.0,141.0,157.0,2804,3347,2379,2407,425,940,950,794,490,393,460,401,54,65,4675,4525,2300,2875,5950,5154,1
657,2,0,128.0,150.0,141.0,157.0,2961,3398,2491,2435,470,963,1306,1154,790,633,516,521,54,64,4025,4625,2300,2875,6600,5304,1
664,2,0,112.0,145.0,141.0,157.0,2966,3224,2519,2351,447,873,1133,1374,565,753,568,621,54,61,2725,4525,2650,2875,7900,5704,1
671,2,0,94.0,138.0,141.0,157.0,2916,3174,2491,2323,425,851,1070,1708,450,983,620,725,54,61,1675,5225,2650,2875,9450,6229,1
679,2,0,68.0,138.0,141.0,157.0,2938,3274,2491,2379,447,895,1436,1338,760,613,676,725,54,64,700,4425,2650,2875,10825,6879,1
7,1,1,13.0,13.0,14.0,14.0,293,335,293,335,0,0,35,40,35,40,0,0,12,12,0,0,0,0,0,0,0
14,1,1,13.0,13.0,14.0,14.0,671,671,671,671,0,0,20,20,20,20,0,0,13,13,0,0,0,0,0,0,0
21,1,1,14.0,14.0,14.0,14.0,671,699,671,699,0,0,45,50,45,50,0,0,13,13,0,0,0,0,0,0,0
29,1,1,14.0,14.0,14.0,14.0,755,727,755,727,0,0,150,145,150,145,0,0,13,13,0,0,0,0,0,0,0
36,1,1,16.0,16.0,22.0,22.0,755,755,755,755,0,0,145,145,145,145,0,0,14,14,0,0,0,0,0,0,0
43,1,1,16.0,16.0,22.0,22.0,811,783,811,783,0,0,235,235,235,235,0,0,16,16,0,0,0,0,0,0,0
50,1,1,15.0,15.0,22.0,22.0,811,867,811,867,0,0,40,35,40,35,0,0,15,15,0,0,0,0,0,0,0
57,1,1,17.0,17.0,22.0,22.0,839,839,839,839,0,0,40,35,40,35,0,0,15,15,0,0,0,0,0,0,0
64,1,1,18.0,18.0,22.0,22.0,895,895,895,895,0,0,100,90,100,90,0,0,16,16,0,0,0,0,0,0,0
71,1,1,17.0,17.0,22.0,22.0,923,923,923,923,0,0,180,175,180,175,0,0,17,17,0,0,0,0,0,0,0
79,1,1,17.0,17.0,22.0,22.0,979,923,979,923,0,0,40,30,40,30,0,0,16,16,0,0,0,0,0,0,0
86,1,1,18.0,18.0,22.0,22.0,951,979,951,979,0,0,100,95,100,95,0,0,16,16,0,0,0,0,0,0,0
93,1,1,19.0,19.0,22.0,22.0,979,889,979,867,0,22,160,144,160,140,0,4,18,18,0,0,0,0,0,0,0
100,1,1,20.0,20.0,22.0,22.0,984,1006,895,895,89,111,226,220,210,200,16,20,19,19,0,0,0,0,0,0,0
107,1,1,20.0,20.0,22.0,22.0,1079,1074,923,895,156,179,351,345,315,305,36,40,19,19,0,0,0,0,0,0,0
114,1,1,21.0,21.0,22.0,22.0,1051,1107,895,951,156,156,436,421,380,365,56,56,20,20,0,0,0,0,0,0,0
121,1,1,26.0,26.0,28.0,28.0,1051,1079,895,923,156,156,201,206,125,130,76,76,21,21,0,0,250,250,0,0,0
129,1,1,26.0,26.0,28.0,28.0,1107,1135,951,979,156,156,251,241,155,145,96,96,21,21,0,0,250,250,0,0,0
136,1,1,28.0,28.0,28.0,28.0,1057,1085,923,951,134,134,83,72,75,60,8,12,21,21,0,0,250,250,0,0,0
143,1,1,30.0,28.0,36.0,36.0,1174,1146,1063,1035,111,111,129,214,105,190,24,24,21,21,50,50,250,250,0,0,0
150,1,1,30.0,30.0,36.0,36.0,1225,1146,1091,1035,134,111,275,270,235,230,40,40,23,23,50,50,250,250,0,0,0
157,1,1,29.0,32.0,36.0,36.0,1253,1337,1119,1203,134,134,131,326,75,270,56,56,24,23,350,350,250,250,0,0,0
164,1,1,33.0,31.0,36.0,36.0,1314,1258,1203,1147,111,111,88,173,20,105,68,68,24,23,350,400,250,250,0,0,0
171,1,1,32.0,31.0,36.0,36.0,1337,1314,1203,1203,134,111,99,39,65,5,34,34,23,24,350,400,250,250,0,0,0
179,1,1,33.0,31.0,36.0,36.0,1426,1365,1315,1231,111,134,121,105,75,55,46,50,26,25,400,400,250,250,0,0,0
186,1,1,33.0,33.0,36.0,36.0,1365,1421,1231,1287,134,134,272,171,210,105,62,66,26,25,400,400,250,250,0,0,0
193,1,1,36.0,35.5,36.0,44.0,1561,1454,1427,1343,134,111,218,193,140,115,78,78,27,25,400,375,250,250,0,25,0
200,1,1,40.0,39.5,44.0,52.0,1538,1421,1427,1287,111,134,135,164,45,70,90,94,28,27,400,375,250,250,0,25,0
207,1,1,43.0,42.5,44.0,52.0,1594,1561,1483,1427,111,134,181,155,75,45,106,110,30,27,400,425,250,250,0,25,0
214,1,1,45.0,44.5,52.0,52.0,1734,1555,1623,1399,111,156,303,190,185,85,118,105,30,31,400,525,450,450,0,25,0
221,1,1,46.0,47.5,52.0,52.0,1706,1611,1595,1455,111,156,439,155,305,30,134,125,32,33,600,525,450,450,0,25,0
229,1,1,54.0,48.5,58.0,52.0,1785,1751,1651,1595,134,156,255,225,105,80,150,145,33,34,600,525,450,450,0,75,0
236,1,1,55.0,49.5,58.0,58.0,1891,1863,1735,1707,156,156,185,190,115,25,70,165,40,36,750,525,450,450,0,75,0
243,1,1,53.5,49.5,58.0,58.0,1998,1886,1819,1707,179,179,175,415,85,230,90,185,41,39,725,675,450,450,25,75,0
250,1,1,57.5,51.5,58.0,66.0,2138,1914,1959,1735,179,179,225,355,115,150,110,205,42,39,725,675,450,575,25,75,0
257,1,1,57.5,53.5,66.0,74.0,2311,2115,2155,1959,156,156,406,156,280,60,126,96,44,39,725,675,450,575,25,75,0
264,1,1,62.5,53.5,66.0,74.0,2395,2199,2239,2043,156,156,196,271,50,155,146,116,44,40,725,675,450,575,25,75,0
271,1,1,64.5,58.5,66.0,82.0,2479,2227,2323,2071,156,156,271,291,105,155,166,136,50,42,725,725,450,575,25,100,0
279,1,1,64.5,63.0,74.0,82.0,2479,2367,2323,2211,156,156,376,71,190,15,186,56,51,43,725,800,450,575,25,125,0
286,1,1,70.5,63.0,90.0,82.0,2759,2362,2603,2183,156,179,416,255,210,175,206,80,53,48,725,800,650,775,25,125,0
293,1,1,66.5,69.0,98.0,82.0,2815,2619,2435,2239,380,380,272,177,210,120,62,57,49,52,725,800,900,775,25,125,0
300,1,1,74.5,75.0,106.0,82.0,2737,2675,2267,2183,470,492,198,88,80,50,118,38,55,52,725,800,900,775,25,125,0
307,1,1,77.5,79.0,106.0,98.0,2905,2754,2435,2351,470,403,204,218,130,190,74,28,60,52,725,900,900,775,25,125,0
314,1,1,80.0,83.0,106.0,98.0,3123,2944,2631,2519,492,425,304,374,220,340,84,34,63,52,700,1300,900,775,50,125,0
321,1,1,88.0,88.0,106.0,106.0,3235,2944,2519,2519,716,425,289,481,205,395,84,86,65,52,700,1400,900,775,50,125,0
329,1,1,98.0,96.0,106.0,106.0,3370,2922,2407,2519,963,403,200,338,125,250,75,88,65,55,700,1700,900,775,50,125,0
336,1,1,106.0,97.0,106.0,106.0,3476,3011,2491,2519,985,492,172,609,77,465,95,144,65,57,1200,1800,900,1025,50,125,0
343,1,1,105.0,100.5,106.0,106.0,3588,2905,2603,2435,985,470,203,546,92,375,111,171,64,63,1300,1875,900,1025,50,175,0
350,1,1,107.0,100.5,106.0,106.0,3515,3129,2575,2659,940,470,908,326,613,184,295,142,66,67,1800,1875,900,1025,98,187,0
357,1,1,107.0,99.5,114.0,106.0,3650,3241,2687,2771,963,470,654,611,243,459,411,152,66,69,2200,1875,900,1025,98,187,0
364,1,1,106.5,104.5,114.0,106.0,3678,3202,2715,2687,963,515,681,450,158,384,523,66,64,69,2175,1875,1350,1025,123,187,0
371,1,1,106.5,112.5,146.0,114.0,3650,3532,2687,2771,963,761,1137,389,498,319,639,70,64,69,2175,1975,1350,825,123,187,0
379,1,1,120.5,112.5,154.0,114.0,3627,3790,2687,2827,940,963,158,360,103,349,55,11,66,69,2175,1825,1350,825,223,337,0
386,1,1,120.5,114.5,154.0,122.0,3812,3834,2827,2827,985,1007,508,620,333,489,175,131,66,69,2175,2025,1350,825,223,337,0
393,1,1,131.5,128.5,154.0,130.0,3840,3571,2855,2631,985,940,353,264,208,179,145,85,66,69,2125,2425,1475,825,273,337,0
400,1,1,131.5,129.0,162.0,130.0,3834,3487,2827,2771,1007,716,590,490,433,354,157,136,66,71,2125,2350,1475,825,273,512,0
407,1,1,149.5,130.0,162.0,130.0,3801,3666,2771,2995,1030,671,140,625,88,459,52,166,66,71,3525,2000,1475,950,273,862,0
414,1,1,149.5,130.0,162.0,138.0,3790,3706,2827,2855,963,851,468,360,308,174,160,186,66,67,4125,2600,1475,950,273,862,0
421,1,1,153.5,130.0,162.0,130.0,3655,3672,2715,2687,940,985,504,590,278,284,226,306,66,67,4125,2900,1475,950,273,962,0
429,1,1,156.5,127.0,170.0,144.0,3678,3722,2715,2715,963,1007,764,761,468,339,296,422,66,66,4975,2900,1475,950,323,1112,0
436,1,1,170.5,128.0,176.0,160.0,3644,3694,2659,2687,985,1007,394,1245,178,711,216,534,66,67,5075,2900,1475,1325,423,1112,0
443,1,1,170.5,132.0,192.0,160.0,3588,3426,2603,2575,985,851,815,1012,483,536,332,476,66,66,5275,2900,1475,1575,423,1112,0
450,1,1,188.5,143.0,192.0,176.0,3442,3235,2435,2631,1007,604,341,543,118,241,223,302,66,69,5275,3200,1475,1575,423,1187,0
457,1,1,188.5,152.0,192.0,176.0,3196,3487,2211,2883,985,604,733,189,398,61,335,128,66,70,6075,3200,1475,1575,423,1187,0
464,1,1,190.5,155.0,192.0,176.0,3286,3487,2323,2771,963,716,1029,406,603,211,426,195,66,70,6075,3200,1475,1700,423,1187,0
471,1,1,191.5,165.0,192.0,176.0,3627,3773,2687,2967,940,806,1390,117,923,76,467,41,66,70,6975,3950,1475,1700,423,1187,0
479,1,1,191.5,168.0,192.0,168.0,3616,3661,2631,2855,985,806,1630,308,1043,196,587,112,66,72,7075,4050,1475,1825,423,1287,0
486,1,1,191.5,168.0,192.0,168.0,3728,3762,2743,2911,985,851,2090,466,1383,246,707,220,66,72,7175,5000,1475,1825,423,1287,0
493,1,1,191.5,176.0,192.0,176.0,3616,3907,2631,2967,985,940,2522,453,1703,221,819,232,66,73,7175,5350,1475,1825,423,1287,0
500,1,1,199.5,176.0,208.0,200.0,3834,3902,2827,2939,1007,963,2187,714,1848,366,339,348,66,73,7175,5450,1475,1825,423,1287,0
507,1,1,199.5,192.0,208.0,200.0,3812,3918,2827,2911,985,1007,2624,284,2173,141,451,143,66,73,7975,5450,1475,1825,423,1287,0
514,1,1,197.5,197.5,208.0,216.0,3795,3784,2855,2799,940,985,3071,131,2508,26,563,105,66,73,7875,5675,1475,1825,523,1662,0
521,1,1,165.5,168.0,208.0,224.0,3767,3694,2827,2799,940,895,3216,180,2683,71,533,109,66,72,6175,4150,1475,1825,2223,3737,0
529,1,1,189.5,163.0,208.0,218.0,3812,3258,2827,2519,985,739,1471,153,1368,56,103,97,66,69,5075,3950,1475,1825,3323,4912,0
536,1,1,199.5,166.0,208.0,218.0,3818,2524,2855,1987,963,537,1317,204,1248,151,69,53,66,69,4975,4250,1475,1825,3423,4912,0
543,1,1,199.5,171.0,208.0,218.0,3750,2373,2743,1903,1007,470,1738,89,1553,76,185,13,66,66,4975,4950,1475,1825,3423,4962,0
550,1,1,199.5,175.0,208.0,218.0,3834,2955,2827,2463,1007,492,2194,260,1893,241,301,19,66,66,7175,5250,1475,1825,3423,4962,0
557,1,1,199.5,176.0,208.0,210.0,3706,3129,2743,2659,963,470,2626,511,2213,461,413,50,66,65,7775,5550,1475,1700,3423,5080,0
564,1,1,198.5,182.0,208.0,202.0,3711,3112,2771,2575,940,537,2877,578,2448,531,429,47,65,65,7775,5750,1475,1700,3423,5180,0
571,1,1,192.5,192.0,208.0,202.0,3622,3224,2659,2463,963,761,3322,469,2773,451,549,18,65,65,7475,6050,1475,1700,3723,5180,0
579,1,1,168.5,180.0,208.0,202.0,3644,3218,2659,2435,985,783,3767,541,3098,506,669,35,65,65,6175,5150,1475,1700,5023,6080,0
586,1,1,176.5,142.0,208.0,202.0,3616,3347,2631,2519,985,828,2089,551,1833,516,256,35,65,65,4375,3250,1475,1700,6823,8480,0
593,1,1,160.5,138.0,208.0,202.0,3666,3213,2659,2407,1007,806,2389,523,2013,496,376,27,65,65,3375,3000,1475,1700,7823,9130,0
600,1,1,177.5,146.0,208.0,202.0,3616,3319,2631,2491,985,828,1776,218,1713,191,63,27,65,65,4775,3300,1725,1700,7823,9130,0
607,1,1,182.5,151.0,208.0,202.0,3650,3129,2687,2323,963,806,1887,284,1783,236,104,48,64,64,5775,3700,1725,1700,7823,9130,0
614,1,1,184.5,157.0,208.0,202.0,3543,3207,2603,2379,940,828,1908,378,1688,301,220,77,64,64,6575,4000,1725,1700,7823,9130,0
621,1,1,198.5,172.0,216.0,186.0,3588,3342,2603,2379,985,963,1598,294,1408,276,190,18,65,65,6675,4600,1725,1700,7823,9055,0
629,1,1,199.5,182.0,216.0,186.0,3616,3420,2631,2435,985,985,1938,209,1703,196,235,13,65,65,6875,4900,1725,1700,7823,9055,0
636,1,1,199.5,186.0,216.0,186.0,3605,3403,2575,2463,1030,940,1744,306,1693,231,51,75,68,65,6975,5400,1725,1700,7823,9055,0
643,1,1,180.5,178.0,216.0,186.0,3722,3398,2603,2435,1119,963,2206,106,2023,61,183,45,68,65,6575,4600,1725,1700,8823,10155,0
650,1,1,175.5,168.0,216.0,186.0,3734,3437,2659,2407,1075,1030,1731,506,1653,341,78,165,68,65,5375,4600,1725,1700,10123,10655,0
657,1,1,184.5,178.0,216.0,186.0,3851,3202,2799,2239,1052,963,1589,284,1533,186,56,98,68,65,5175,4800,1725,1700,10323,10755,0
664,1,1,190.5,186.0,216.0,186.0,3823,3286,2771,2323,1052,963,1756,175,1643,111,113,64,68,65,5175,5400,1725,1700,10323,10755,0
671,1,1,172.5,173.0,216.0,178.0,3896,3336,2799,2351,1097,985,1522,160,1448,76,74,84,68,65,4475,4550,1725,1700,11923,12005,0
679,1,1,172.5,177.0,216.0,178.0,3728,3314,2631,2351,1097,963,1520,296,1418,171,102,125,68,65,4975,4850,1725,1700,12323,12005,0
686,1,1,187.5,177.0,216.0,178.0,3465,3196,2323,2211,1142,985,1027,582,1018,341,9,241,67,65,4875,5350,1725,1700,12423,12005,0
693,1,1,187.5,173.0,222.0,178.0,3571,3050,2407,2043,1164,1007,1454,743,1313,486,141,257,67,65,5975,5550,1725,1700,12423,12205,0
700,1,1,199.5,177.0,222.0,178.0,3582,3224,2463,2239,1119,985,1276,439,1153,191,123,248,67,64,5975,5800,1725,1700,12423,12205,0
707,1,1,195.5,173.0,222.0,178.0,3448,2955,2351,2015,1097,940,1377,457,1193,215,184,242,67,64,6375,5600,1725,1700,12923,12629,0
714,1,1,159.5,155.0,222.0,186.0,3398,2950,2211,1987,1187,963,1815,322,1483,85,332,237,67,64,5075,4150,1725,1700,14823,14079,0
721,1,1,169.5,151.0,222.0,186.0,3594,3022,2295,2015,1299,1007,935,287,768,30,167,257,67,64,4275,3750,1725,1700,15623,14679,0
729,1,1,169.5,152.0,222.0,186.0,3706,2978,2407,2015,1299,963,1107,344,863,100,244,244,67,64,4275,3550,1725,1700,15923,14879,0
736,1,1,186.5,161.0,222.0,186.0,3801,2978,2435,2015,1366,963,652,100,523,40,129,60,67,64,5575,4650,1725,1700,15923,14879,0
743,1,1,190.5,167.0,214.0,178.0,3734,3050,2435,2043,1299,1007,891,170,668,65,223,105,67,64,5675,5150,1725,1700,16023,14979,0
750,1,1,178.5,165.0,214.0,170.0,3633,3028,2379,2043,1254,985,1328,131,953,10,375,121,67,64,5175,4700,1725,1700,16823,15729,0
757,1,1,188.5,163.0,214.0,170.0,3717,3006,2463,2043,1254,963,683,348,423,165,260,183,67,64,5375,4800,1725,1700,17623,15929,0
764,1,1,194.5,159.0,214.0,170.0,3734,2972,2435,1987,1299,985,428,404,183,205,245,199,67,64,4975,4700,1725,1700,18023,16429,0
771,1,1,196.5,159.0,214.0,176.0,3706,2978,2407,2015,1299,963,279,165,28,50,251,115,67,64,4475,4600,1725,1700,18523,16829,0
779,1,1,192.5,160.0,214.0,176.0,3722,3028,2379,2155,1343,873,726,384,323,215,403,169,67,63,5375,4750,1725,1700,18723,16879,0
786,1,1,186.5,160.0,214.0,176.0,3778,2591,2435,1875,1343,716,1182,168,623,40,559,128,67,63,5775,4350,1725,1700,19023,17579,0
793,1,1,198.5,147.0,214.0,176.0,3739,2726,2463,1987,1276,739,715,196,233,55,482,141,67,61,6075,3800,1725,1700,19323,18754,0
800,1,1,192.5,134.0,206.0,176.0,3773,2602,2519,1931,1254,671,981,97,393,30,588,67,67,57,5375,3150,1725,1700,20023,19904,0
7,0,0,13.0,13.0,15.0,15.0,251,293,251,293,0,0,30,35,30,35,0,0,12,12,0,0,0,0,0,0,0
14,0,0,14.0,14.0,15.0,15.0,671,671,671,671,0,0,70,70,70,70,0,0,13,13,0,0,0,0,0,0,0
21,0,0,14.0,14.0,15.0,15.0,699,727,699,727,0,0,0,55,0,55,0,0,13,13,0,0,0,0,0,0,0
29,0,0,15.0,15.0,15.0,15.0,727,671,727,671,0,0,15,80,15,80,0,0,14,14,0,0,0,0,0,0,0
36,0,0,15.0,15.0,15.0,15.0,727,727,727,727,0,0,55,130,55,130,0,0,14,14,0,0,0,0,0,0,0
43,0,0,16.0,16.0,23.0,23.0,755,755,755,755,0,0,140,70,140,70,0,0,15,15,0,0,0,0,0,0,0
50,0,0,16.0,16.0,23.0,23.0,839,811,839,811,0,0,35,45,35,45,0,0,15,15,0,0,0,0,0,0,0
57,0,0,17.0,17.0,23.0,23.0,827,755,783,755,44,0,78,55,70,55,8,0,16,16,0,0,0,0,0,0,0
64,0,0,18.0,18.0,23.0,23.0,911,755,755,755,156,0,183,95,155,95,28,0,17,17,0,0,0,0,0,0,0
71,0,0,18.0,18.0,23.0,23.0,939,777,783,755,156,22,238,194,190,190,48,4,17,17,0,0,0,0,0,0,0
79,0,0,19.0,19.0,23.0,23.0,967,833,811,699,156,134,348,239,280,215,68,24,18,18,0,0,0,0,0,0,0
86,0,0,19.0,19.0,23.0,23.0,967,889,811,643,156,246,473,345,385,285,88,60,18,18,0,0,0,0,0,0,0
93,0,0,20.0,20.0,23.0,23.0,1018,950,839,615,179,335,343,110,285,60,58,50,19,19,0,0,150,150,0,0,0
100,0,0,20.0,20.0,23.0,23.0,1046,950,867,615,179,335,458,216,380,130,78,86,19,19,0,0,150,150,0,0,0
107,0,0,20.0,20.0,23.0,23.0,1023,934,867,643,156,291,184,73,90,55,94,18,19,19,0,0,150,150,0,0,0
114,0,0,20.0,21.0,23.0,31.0,967,906,811,727,156,179,59,148,45,110,14,38,19,19,0,0,150,150,0,0,0
121,0,0,21.0,22.0,23.0,31.0,939,934,783,755,156,179,119,157,85,145,34,12,19,19,0,100,150,150,0,0,0
129,0,0,22.0,23.0,23.0,31.0,1023,1130,867,951,156,179,104,252,50,220,54,32,19,20,100,100,150,150,0,0,0
136,0,0,23.0,23.0,23.0,31.0,1219,1130,1063,951,156,179,119,402,45,350,74,52,20,20,100,100,150,150,0,0,0
143,0,0,23.0,24.0,23.0,31.0,1214,1376,1035,1175,179,201,204,131,110,55,94,76,21,21,100,100,150,150,0,0,0
150,0,0,25.0,26.0,31.0,31.0,1102,1370,923,1147,179,223,289,189,175,85,114,104,21,21,150,100,150,400,0,0,0
157,0,0,28.0,27.0,31.0,31.0,1135,1342,979,1119,156,223,290,188,160,110,130,78,22,22,150,200,400,400,0,0,0
164,0,0,29.0,28.0,31.0,31.0,1169,1460,923,1147,246,313,141,63,75,45,66,18,22,23,200,200,400,400,0,0,0
171,0,0,30.0,28.0,31.0,31.0,1264,1404,951,1091,313,313,256,118,150,60,106,58,23,23,200,300,400,400,0,0,0
179,0,0,32.0,31.0,46.0,31.0,1320,1482,1007,1147,313,335,131,138,10,65,121,73,23,24,300,300,400,400,0,0,0
186,0,0,33.0,31.0,46.0,31.0,1421,1314,1063,979,358,335,226,278,90,165,136,113,24,24,350,300,400,400,0,0,0
193,0,0,34.0,34.0,46.0,39.0,1482,1348,1147,1035,335,313,362,294,190,145,172,149,25,25,350,300,400,500,0,0,0
200,0,0,34.0,34.0,46.0,39.0,1544,1342,1231,1007,313,335,463,389,255,225,208,164,25,25,450,400,725,750,0,0,0
207,0,0,41.0,35.0,46.0,39.0,1488,1432,1175,1119,313,313,193,450,45,250,148,200,26,26,450,400,725,750,0,0,0
214,0,0,41.0,37.0,46.0,54.0,1628,1628,1315,1315,313,313,138,470,75,255,63,215,26,26,450,500,725,825,0,0,0
221,0,0,43.0,40.0,46.0,54.0,1852,1566,1539,1231,313,335,148,140,45,85,103,55,28,27,450,500,725,825,0,0,0
229,0,0,43.0,41.0,46.0,54.0,1835,1706,1455,1371,380,335,366,290,215,195,151,95,29,28,550,600,725,825,0,0,0
236,0,0,45.0,43.0,46.0,54.0,2093,1684,1623,1371,470,313,272,386,165,255,107,131,30,28,550,600,800,825,0,0,0
243,0,0,49.0,48.0,54.0,54.0,2059,1880,1567,1455,492,425,118,232,55,170,63,62,31,29,550,600,800,900,0,0,0
250,0,0,53.0,50.0,54.0,54.0,1981,1746,1511,1231,470,515,89,317,70,195,19,122,32,29,800,700,800,900,0,0,0
257,0,0,54.0,52.0,54.0,54.0,1947,2031,1455,1539,492,492,219,383,140,205,79,178,34,31,800,700,800,900,0,0,0
264,0,0,55.0,50.0,62.0,54.0,1975,2009,1483,1539,492,470,474,474,335,290,139,184,34,31,800,1000,800,900,0,0,0
271,0,0,56.0,52.0,62.0,54.0,2031,2171,1539,1679,492,492,205,224,10,105,195,119,35,33,800,1275,800,900,0,0,0
279,0,0,57.0,56.0,62.0,62.0,1975,2255,1483,1763,492,492,345,129,90,50,255,79,36,35,1050,1275,800,900,0,0,0
286,0,0,61.0,58.0,62.0,62.0,1947,2233,1455,1763,492,470,276,275,65,140,211,135,37,35,1050,1275,800,900,0,0,0
293,0,0,62.0,57.0,62.0,62.0,1925,2149,1455,1679,470,470,447,461,180,270,267,191,38,34,1300,1325,800,900,0,50,0
300,0,0,66.0,58.0,70.0,70.0,2003,2149,1511,1679,492,470,387,607,160,360,227,247,39,35,1300,1325,800,900,0,100,0
307,0,0,67.0,60.0,70.0,70.0,2031,2311,1539,1819,492,492,247,687,110,380,137,307,40,37,1300,1600,800,900,0,100,0
314,0,0,68.0,66.0,70.0,70.0,2037,1925,1567,1455,470,470,248,258,155,45,93,213,41,37,1550,1500,800,1050,0,200,0
321,0,0,70.0,67.0,70.0,70.0,2227,1830,1735,1315,492,515,318,428,165,155,153,273,43,39,1550,1450,800,1200,0,250,0
329,0,0,70.0,65.0,70.0,70.0,2250,2233,1735,1763,515,470,318,720,105,395,213,325,44,37,1550,1550,800,1200,0,350,0
336,0,0,70.0,62.0,70.0,70.0,2199,2233,1707,1763,492,470,524,943,255,578,269,365,45,38,1550,1500,800,1200,0,500,0
343,0,0,75.0,67.0,78.0,70.0,2205,2037,1735,1567,470,470,205,286,105,171,100,115,45,34,1800,1900,800,1325,0,750,0
350,0,0,72.0,70.0,86.0,70.0,2143,2395,1651,1903,492,492,365,186,205,136,160,50,45,34,1550,1900,800,1325,250,750,0
357,0,0,77.0,70.0,101.0,70.0,2250,2507,1735,2015,515,492,294,276,170,166,124,110,47,36,1550,1900,800,1325,250,750,0
364,0,0,75.0,69.0,101.0,70.0,2356,2502,1819,1987,537,515,468,492,280,326,188,166,48,36,1300,1650,875,1325,500,1200,0
371,0,0,73.0,71.0,109.0,78.0,2440,2558,1903,2043,537,515,592,626,340,405,252,221,49,36,1050,2050,875,1325,750,1200,0
379,0,0,75.0,75.0,109.0,86.0,2474,2401,1847,1931,627,470,548,533,345,396,203,137,51,37,1050,2325,875,1325,1000,1250,0
386,0,0,75.0,80.0,109.0,86.0,2608,2317,1959,1847,649,470,404,278,175,181,229,97,51,37,1050,2425,1125,1325,1000,1250,0
393,0,0,77.0,83.0,109.0,86.0,2530,1975,1903,1483,627,492,350,195,145,138,205,57,53,38,1050,2525,1375,1325,1000,1250,0
400,0,0,79.0,83.0,109.0,86.0,2636,1891,1987,1399,649,492,455,280,170,163,285,117,53,39,1200,2525,1500,1325,1100,1308,0
407,0,0,81.0,88.0,109.0,94.0,2496,2065,1847,1595,649,470,335,176,120,103,215,73,55,40,1200,2625,1500,1325,1100,1308,0
414,0,0,81.0,79.0,109.0,94.0,2608,2110,1959,1595,649,515,646,276,355,143,291,133,57,40,1375,2350,1500,1325,1200,2258,0
421,0,0,86.0,79.0,109.0,94.0,2854,2278,2183,1763,671,515,346,516,225,323,121,193,55,41,1375,2350,1500,1325,1300,2308,0
429,0,0,83.0,72.0,109.0,94.0,2535,2429,1931,1959,604,470,510,818,325,573,185,245,52,41,1375,1900,1925,1325,1550,2808,0
436,0,0,84.0,78.0,109.0,110.0,2121,2457,1651,1987,470,470,427,533,290,353,137,180,53,41,1375,2050,1925,1325,1550,2958,0
443,0,0,94.0,78.0,109.0,110.0,2530,2395,2127,1903,403,492,181,333,127,93,54,240,56,43,1625,2050,2025,1325,1550,2958,0
450,0,0,97.0,79.0,109.0,110.0,2731,2339,2351,1847,380,492,321,558,229,258,92,300,57,43,2175,2200,2025,1325,1550,2958,0
457,0,0,95.0,80.0,109.0,110.0,2770,2446,2323,1931,447,515,598,729,451,373,147,356,59,43,1925,2200,2025,1325,1800,3008,0
464,0,0,97.0,85.0,109.0,110.0,3022,2474,2463,1959,559,515,552,284,443,193,109,91,59,43,2125,2200,2025,1325,1800,3008,0
471,0,0,98.0,87.0,109.0,110.0,2854,2423,2183,1931,671,492,440,365,376,218,64,147,60,44,2125,2575,2125,1325,1800,3008,0
479,0,0,108.0,93.0,109.0,110.0,3504,2154,2631,1595,873,559,353,257,306,163,47,94,63,45,2125,2575,2125,1325,1800,3008,0
486,0,0,107.0,93.0,109.0,110.0,3510,2446,2659,1819,851,627,762,523,611,353,151,170,64,47,2600,2475,2225,1400,1850,3108,0
7,1,1,13.0,13.0,14.0,14.0,293,335,293,335,0,0,35,40,35,40,0,0,12,12,0,0,0,0,0,0,1
14,1,1,13.0,13.0,14.0,14.0,671,615,671,615,0,0,20,10,20,10,0,0,13,13,0,0,0,0,0,0,1
21,1,1,14.0,14.0,14.0,14.0,727,727,727,727,0,0,50,55,50,55,0,0,13,13,0,0,0,0,0,0,1
29,1,1,14.0,14.0,14.0,14.0,755,727,755,727,0,0,145,145,145,145,0,0,13,13,0,0,0,0,0,0,1
36,1,1,16.0,16.0,22.0,22.0,755,811,755,811,0,0,140,145,140,145,0,0,14,14,0,0,0,0,0,0,1
43,1,1,16.0,16.0,22.0,22.0,783,839,783,839,0,0,225,240,225,240,0,0,14,16,0,0,0,0,0,0,1
50,1,1,15.0,15.0,22.0,22.0,755,783,755,783,0,0,20,30,20,30,0,0,15,15,0,0,0,0,0,0,1
57,1,1,17.0,17.0,22.0,22.0,839,867,839,867,0,0,25,40,25,40,0,0,15,15,0,0,0,0,0,0,1
64,1,1,18.0,18.0,22.0,22.0,895,839,895,839,0,0,75,85,75,85,0,0,16,16,0,0,0,0,0,0,1
71,1,1,17.0,17.0,22.0,22.0,867,923,867,923,0,0,155,170,155,170,0,0,17,17,0,0,0,0,0,0,1
79,1,1,17.0,17.0,22.0,22.0,923,895,923,895,0,0,10,35,10,35,0,0,16,16,0,0,0,0,0,0,1
86,1,1,18.0,18.0,22.0,22.0,923,951,923,951,0,0,70,95,70,95,0,0,16,16,0,0,0,0,0,0,1
93,1,1,19.0,19.0,22.0,22.0,979,951,979,951,0,0,130,155,130,155,0,0,17,18,0,0,0,0,0,0,1
100,1,1,20.0,19.0,22.0,22.0,928,978,839,867,89,111,186,275,170,255,16,20,18,19,0,0,0,0,0,0,1
107,1,1,20.0,20.0,22.0,22.0,1051,1023,895,867,156,156,312,355,280,315,32,40,19,19,0,0,0,0,0,0,1
114,1,1,21.0,21.0,22.0,22.0,967,1079,811,923,156,156,377,430,325,370,52,60,20,20,0,0,0,0,0,0,1
121,1,1,21.0,26.0,28.0,28.0,1051,1079,895,923,156,156,307,215,235,135,72,80,20,20,0,0,250,250,0,0,1
129,1,1,25.0,26.0,28.0,28.0,1079,1130,923,951,156,179,142,45,50,45,92,0,21,21,0,0,250,250,0,0,1
136,1,1,26.0,28.0,28.0,28.0,1085,1135,951,979,134,156,18,86,10,70,8,16,21,21,0,0,250,250,0,0,1
143,1,1,27.0,30.0,44.0,36.0,1197,1225,1063,1091,134,134,114,137,90,105,24,32,21,22,0,50,250,250,0,0,1
150,1,1,29.0,30.0,44.0,36.0,1141,1230,1007,1119,134,111,155,274,115,230,40,44,22,23,0,50,250,250,0,0,1
157,1,1,31.0,29.0,44.0,36.0,1281,1225,1147,1091,134,134,211,125,155,65,56,60,24,24,50,350,250,250,0,0,1
164,1,1,31.0,31.0,44.0,36.0,1202,1286,1091,1175,111,111,358,132,290,60,68,72,24,24,350,350,250,250,0,0,1
171,1,1,30.0,33.0,44.0,36.0,1393,1365,1259,1231,134,134,234,208,150,120,84,88,25,24,350,350,250,250,0,0,1
179,1,1,32.0,33.0,44.0,36.0,1314,1365,1203,1231,111,134,86,64,40,10,46,54,24,23,350,350,250,250,0,0,1
186,1,1,34.0,35.0,44.0,36.0,1426,1337,1315,1203,111,134,152,130,90,60,62,70,24,25,350,350,250,250,0,0,1
193,1,1,38.0,36.0,44.0,36.0,1359,1454,1203,1343,156,111,122,257,40,175,82,82,28,26,350,350,250,250,0,0,1
200,1,1,40.0,40.0,44.0,44.0,1438,1471,1259,1315,179,156,142,107,40,5,102,102,30,25,350,500,250,250,0,0,1
207,1,1,42.0,40.0,44.0,44.0,1611,1415,1455,1259,156,156,138,167,20,45,118,122,30,26,350,600,250,250,0,0,1
214,1,1,42.5,41.0,44.0,44.0,1723,1522,1567,1343,156,179,218,312,80,170,138,142,31,31,475,600,250,250,25,0,1
221,1,1,43.5,44.0,44.0,44.0,1723,1611,1567,1455,156,156,323,348,165,190,158,158,32,32,475,600,450,575,25,0,1
229,1,1,45.5,46.0,52.0,58.0,1723,1807,1567,1651,156,156,428,53,250,25,178,28,34,32,475,600,450,575,25,0,1
236,1,1,50.5,47.0,52.0,58.0,1835,1863,1679,1707,156,156,253,233,80,185,173,48,34,35,625,600,450,575,25,0,1
243,1,1,51.5,48.0,58.0,66.0,1942,1835,1763,1679,179,156,138,118,45,50,93,68,39,35,625,600,575,575,25,0,1
250,1,1,51.5,52.0,58.0,66.0,1891,1947,1735,1791,156,156,149,148,40,60,109,88,41,36,675,600,575,575,25,0,1
257,1,1,54.5,52.0,74.0,66.0,2003,1998,1847,1819,156,179,254,293,125,235,129,58,41,36,675,600,575,575,25,0,1
264,1,1,59.5,55.0,74.0,66.0,2087,1970,1931,1791,156,179,264,263,115,185,149,78,43,36,675,850,575,575,25,0,1
271,1,1,60.0,55.0,74.0,66.0,2339,2003,2183,1847,156,156,349,414,255,320,94,94,48,36,650,1050,575,575,50,50,1
279,1,1,63.0,58.0,74.0,74.0,2283,1992,2127,1791,156,201,274,227,185,105,89,122,47,38,650,1050,575,775,50,50,1
286,1,1,62.5,57.5,74.0,82.0,2502,2048,2323,1735,179,313,599,487,490,325,109,162,47,42,825,1025,575,775,50,75,1
293,1,1,65.5,69.0,74.0,90.0,2614,2182,2435,1847,179,335,704,67,575,40,129,27,47,42,1025,800,775,775,150,150,1
300,1,1,68.5,72.5,74.0,98.0,2731,2294,2575,1959,156,335,620,132,575,115,45,17,47,42,1025,775,775,775,150,175,1
307,1,1,73.5,76.5,74.0,98.0,2647,2266,2491,1819,156,447,600,158,535,85,65,73,49,42,1075,725,775,775,225,225,1
314,1,1,73.0,79.0,74.0,98.0,2787,2395,2631,1903,156,492,820,263,735,130,85,133,50,42,1000,1350,775,775,300,300,1
321,1,1,74.0,82.0,74.0,98.0,2686,2373,2463,1903,223,470,982,394,865,205,117,189,56,42,1000,1650,775,775,300,300,1
329,1,1,72.5,82.5,74.0,98.0,2630,2457,2183,1987,447,470,492,624,315,375,177,249,55,42,975,1975,775,775,325,325,1
336,1,1,77.0,86.5,82.0,98.0,2390,2446,1875,1931,515,515,147,679,35,370,112,309,52,42,900,2075,775,775,325,375,1
343,1,1,79.0,92.0,90.0,98.0,2446,2446,1931,1931,515,515,222,639,150,270,72,369,52,42,900,2100,775,775,325,400,1
350,1,1,87.0,94.0,114.0,98.0,2793,2479,2323,1987,470,492,139,236,115,115,24,121,52,42,900,2350,775,775,325,400,1
357,1,1,86.5,96.0,114.0,98.0,2927,2507,2435,2015,492,492,320,226,298,45,22,181,52,42,1475,2300,1025,775,449,600,1
364,1,1,89.0,96.0,114.0,98.0,3039,2429,2547,1959,492,470,533,297,482,160,51,137,52,42,1625,3050,1025,775,511,725,1
371,1,1,86.0,92.5,114.0,98.0,2933,2401,2463,1931,470,470,564,237,532,40,32,197,52,42,1375,2175,1475,775,1361,1400,1
379,1,1,89.0,88.5,114.0,98.0,2961,2373,2491,1903,470,470,419,322,377,65,42,257,52,42,1025,2125,1475,775,1711,1875,1
386,1,1,97.0,87.0,114.0,98.0,2922,2362,2407,1847,515,515,329,547,302,230,27,317,52,42,1425,2000,1325,775,1861,2000,1
393,1,1,82.0,86.5,114.0,98.0,2787,2367,2295,1875,492,492,295,483,262,110,33,373,42,42,1175,1775,1325,775,2961,2350,1
400,1,1,80.0,80.0,114.0,98.0,2373,2367,1903,1875,470,492,286,629,272,200,14,429,42,42,875,1550,1325,775,3361,2825,1
407,1,1,81.0,75.0,114.0,98.0,2395,2339,1903,1847,492,492,366,789,342,300,24,489,42,42,1275,1550,1325,775,3511,3175,1
414,1,1,82.5,70.0,114.0,98.0,2479,2317,1987,1847,492,470,416,540,382,195,34,345,42,42,1350,1300,1325,775,3686,3525,1
421,1,1,85.0,71.0,114.0,98.0,2356,2289,1819,1819,537,470,439,680,387,275,52,405,42,42,1775,1250,1325,775,3711,3625,1
429,1,1,88.0,75.0,114.0,98.0,2462,2367,1791,1875,671,492,570,755,442,290,128,465,42,45,2025,1350,1325,775,3711,3625,1
436,1,1,90.0,74.0,114.0,98.0,2406,2446,1735,1931,671,515,555,1050,472,525,83,525,45,47,2325,1300,1325,775,3761,3675,1
443,1,1,96.0,83.0,114.0,98.0,2474,2395,1847,1903,627,492,562,676,432,195,130,481,48,51,2325,1300,1325,775,3761,3675,1
450,1,1,96.0,84.0,114.0,98.0,2552,2675,1903,2183,649,492,847,897,637,360,210,537,48,53,2325,1300,1325,775,3761,3675,1
457,1,1,99.0,83.0,114.0,98.0,2686,2709,2015,2239,671,470,472,813,382,220,90,593,52,58,2475,1300,1325,775,3811,3675,1
464,1,1,103.0,86.0,114.0,98.0,2720,2821,2071,2351,649,470,528,958,362,305,166,653,52,59,2475,1300,1325,775,3811,3675,1
471,1,1,102.0,91.0,122.0,98.0,2731,2927,2015,2435,716,492,465,1047,407,330,58,717,54,63,2575,1300,1325,1025,3811,3675,1
479,1,1,108.0,91.0,122.0,98.0,2978,3140,2127,2491,851,649,515,1022,357,375,158,647,59,63,2575,1300,1325,1025,3811,3675,1
486,1,1,110.0,97.0,122.0,98.0,3174,3308,2323,2435,851,873,500,1133,242,445,258,688,62,68,2575,1400,1325,1025,3811,3675,1
493,1,1,113.0,98.0,122.0,106.0,3157,3538,2351,2575,806,963,527,856,202,185,325,671,65,67,2575,1400,1325,1025,3811,3675,1
500,1,1,120.0,106.0,122.0,106.0,3319,3566,2379,2603,940,963,452,871,107,180,345,691,67,67,2575,1700,1325,1025,3811,3675,1
507,1,1,121.0,106.0,130.0,106.0,3392,3678,2407,2715,985,963,687,1212,197,405,490,807,66,67,2375,1700,1325,1025,3811,3675,1
514,1,1,129.0,124.0,130.0,138.0,3398,3538,2435,2575,963,963,178,732,122,30,56,702,64,67,2475,1800,1325,1025,3811,3675,1
521,1,1,129.0,128.0,138.0,146.0,3470,3560,2463,2575,1007,985,384,898,212,155,172,743,64,67,3675,2200,1325,1275,3811,3675,1
529,1,1,130.0,135.5,138.0,146.0,3302,3577,2295,2547,1007,1030,420,928,182,165,238,763,65,67,3675,2175,1575,1275,3811,3700,1
536,1,1,138.0,141.5,154.0,152.0,3314,3448,2351,2463,963,985,417,535,167,210,250,325,66,67,3775,3075,1575,1275,3811,3700,1
543,1,1,144.0,151.5,154.0,152.0,3487,3370,2547,2407,940,963,548,437,257,125,291,312,66,67,3875,3875,1700,1275,3811,3700,1
550,1,1,158.0,151.5,170.0,152.0,3476,3286,2491,2323,985,963,253,622,17,190,236,432,66,67,4175,4475,1950,1275,3811,3750,1
557,1,1,158.0,151.5,170.0,152.0,3342,3370,2379,2407,963,963,359,928,157,380,202,548,66,67,4375,4775,1950,1275,3811,3750,1
564,1,1,160.0,151.5,170.0,152.0,3370,3291,2407,2351,963,940,230,1014,87,350,143,664,66,67,4575,4975,1950,1275,3811,3750,1
571,1,1,162.0,161.0,176.0,168.0,3437,3420,2407,2435,1030,985,530,634,267,125,263,509,66,67,5275,4950,1950,1275,3811,3775,1
579,1,1,175.0,168.0,176.0,176.0,3582,3610,2575,2603,1007,1007,311,670,57,145,254,525,66,67,5275,4900,1950,1275,3811,3825,1
586,1,1,174.5,167.0,184.0,200.0,3599,3784,2659,2799,940,985,739,722,377,185,362,537,68,67,5300,4950,1950,1275,3811,4275,1
593,1,1,177.5,169.5,184.0,200.0,3706,3734,2743,2771,963,963,384,568,127,65,257,503,66,67,5100,4225,1950,1275,4211,4700,1
600,1,1,163.5,163.5,184.0,200.0,3504,3818,2519,2855,985,963,799,524,422,30,377,494,66,67,4900,3825,1950,1275,4911,5500,1
607,1,1,157.5,148.0,184.0,200.0,3622,3678,2659,2715,963,963,535,559,217,45,318,514,68,67,3900,3050,1950,1275,5911,6675,1
614,1,1,141.5,133.0,184.0,200.0,3532,3734,2547,2771,985,963,456,725,147,170,309,555,68,67,2900,2450,1950,1275,7411,7875,1
621,1,1,144.5,145.0,184.0,200.0,3829,3834,2799,2827,1030,1007,466,575,112,50,354,525,68,67,2600,3050,2200,1275,7711,7875,1
629,1,1,142.5,151.0,176.0,200.0,3734,3728,2771,2743,963,985,914,707,452,145,462,562,68,67,3300,3450,2200,1275,7811,7875,1
636,1,1,160.5,161.0,176.0,200.0,3269,3706,2463,2743,806,963,366,639,37,90,329,549,68,67,3500,3650,2550,1275,7811,7875,1
643,1,1,160.5,171.0,176.0,200.0,3140,3566,2491,2603,649,963,756,474,347,55,409,419,68,67,3800,4450,2550,1275,7811,7875,1
650,1,1,171.5,175.0,176.0,200.0,3549,3650,2743,2687,806,963,384,715,317,230,67,485,68,67,3800,4950,2550,1275,7811,7875,1
657,1,1,165.5,175.0,168.0,200.0,3582,3566,2687,2603,895,963,587,845,412,315,175,530,67,67,5050,4950,2550,1275,8211,8175,1
664,1,1,167.5,189.0,168.0,200.0,3504,3616,2519,2631,985,985,587,581,392,110,195,471,67,67,4750,5450,2550,1275,8511,8175,1
671,1,1,167.0,191.0,184.0,200.0,3778,3801,2771,2771,1007,1030,858,746,547,230,311,516,67,67,4975,5450,2550,1275,8511,8375,1
679,1,1,170.0,197.0,184.0,200.0,3734,3734,2771,2771,963,963,490,474,267,25,223,449,67,67,4675,5750,2550,1275,9211,8775,1
686,1,1,171.0,193.0,192.0,200.0,3739,3846,2799,2883,940,963,536,645,297,155,239,490,64,67,4425,5650,2550,1275,9711,9275,1
693,1,1,158.0,169.0,192.0,200.0,3616,3706,2631,2743,985,963,656,786,372,255,284,531,63,67,3625,4550,2550,1275,10661,10775,1
700,1,1,144.0,155.0,192.0,200.0,3538,3930,2575,2967,963,963,787,766,462,240,325,526,63,67,3325,3850,2550,1275,11661,11975,1
707,1,1,134.0,163.0,186.0,200.0,3482,3823,2519,2883,963,940,993,607,602,115,391,492,63,67,3325,4050,2550,1275,12711,12175,1
714,1,1,146.0,170.0,186.0,200.0,3442,3918,2435,2911,1007,1007,703,467,367,5,336,462,63,67,3525,4250,2550,1275,12811,12475,1
721,1,1,154.0,178.0,186.0,200.0,3364,3890,2379,2883,985,1007,600,528,277,50,323,478,63,67,3425,4750,2550,1275,12911,12475,1
729,1,1,154.0,184.0,186.0,200.0,3314,3846,2351,2883,963,963,491,461,152,200,339,261,62,67,3925,5150,2550,1275,13011,12475,1
736,1,1,165.0,198.0,186.0,200.0,3286,3790,2323,2827,963,963,182,221,52,15,130,206,62,67,4225,6050,2550,1275,13011,12475,1
743,1,1,165.0,200.0,186.0,200.0,3140,3762,2155,2799,985,963,447,562,247,265,200,297,62,67,5225,6350,2550,1275,13011,12475,1
750,1,1,175.0,200.0,186.0,200.0,2866,3762,1903,2799,963,963,298,1017,107,600,191,417,62,67,5225,6750,2400,1275,13161,12475,1
757,1,1,165.0,197.0,186.0,200.0,2978,3728,2015,2743,963,985,646,863,347,480,299,383,60,67,5275,6450,2400,1275,13711,13275,1
764,1,1,149.0,188.0,186.0,200.0,3084,3745,2211,2715,873,1030,430,313,177,60,253,253,60,67,3875,4950,2400,1275,15111,14775,1
771,1,1,123.0,165.0,186.0,200.0,2972,3644,2099,2659,873,985,574,340,267,75,307,265,60,67,2775,3350,2400,1275,16711,16375,1
779,1,1,116.0,161.0,186.0,200.0,2754,3734,1903,2771,851,963,513,392,202,115,311,277,60,67,2375,3250,2400,1275,17611,17075,1
786,1,1,126.0,165.0,186.0,200.0,2782,3622,1931,2659,851,963,347,527,57,305,290,222,60,67,2675,4350,2400,1275,17611,17075,1
793,1,1,128.0,155.0,186.0,200.0,2714,3734,1819,2771,895,963,475,568,127,380,348,188,60,67,2975,4050,2250,1275,17861,17975,1
800,1,1,122.0,150.0,192.0,200.0,2776,3706,1903,2743,873,963,505,733,132,500,373,233,60,67,2675,3850,2250,1275,18461,18575,1
807,1,1,120.0,152.0,192.0,200.0,2938,3728,2043,2743,895,985,373,869,17,595,356,274,60,67,2275,3750,2250,1275,19061,18775,1
814,1,1,112.0,168.0,192.0,200.0,3056,3717,2183,2687,873,1030,633,209,202,90,431,119,60,67,1875,3950,2250,1275,19661,19075,1
821,1,1,114.0,164.0,192.0,200.0,3314,3448,2463,2463,851,985,452,422,67,245,385,177,56,67,2075,3750,2250,1275,20161,19475,1
829,1,1,101.0,166.0,192.0,200.0,3168,3482,2295,2519,873,963,501,543,87,325,414,218,47,67,1875,3850,2250,1275,21111,19675,1
7,,,13.0,13.0,15.0,15.0,293,209,293,209,0,0,35,25,35,25,0,0,12,12,0,0,0,0,0,0,0
14,,,14.0,14.0,15.0,15.0,643,643,643,643,0,0,65,65,65,65,0,0,13,13,0,0,0,0,0,0,0
21,,,14.0,14.0,15.0,15.0,699,699,699,699,0,0,40,45,40,45,0,0,13,13,0,0,0,0,0,0,0
29,,,15.0,15.0,15.0,15.0,699,727,699,727,0,0,70,35,70,35,0,0,14,14,0,0,0,0,0,0,0
36,,,15.0,15.0,15.0,23.0,783,755,783,755,0,0,45,120,45,120,0,0,15,14,0,0,0,0,0,0,0
43,,,16.0,16.0,23.0,23.0,811,727,811,727,0,0,90,10,90,10,0,0,15,15,0,0,0,0,0,0,0
50,,,17.0,17.0,23.0,23.0,867,811,867,811,0,0,45,40,45,40,0,0,16,16,0,0,0,0,0,0,0
57,,,18.0,18.0,23.0,23.0,861,811,839,811,22,0,29,15,25,15,4,0,17,17,0,0,0,0,0,0,0
64,,,18.0,19.0,23.0,23.0,917,895,783,895,134,0,89,70,65,70,24,0,17,18,0,0,0,0,0,0,0
71,,,19.0,19.0,23.0,23.0,939,923,783,923,156,0,154,35,110,35,44,0,18,18,0,0,0,0,0,0,0
79,,,20.0,20.0,23.0,23.0,995,911,839,867,156,44,280,98,220,90,60,8,19,19,0,0,0,0,0,0,0
86,,,21.0,20.0,23.0,23.0,950,1057,727,923,223,134,197,34,105,10,92,24,20,19,0,0,0,150,0,50,0
93,,,22.0,20.0,23.0,23.0,1040,1046,727,867,313,179,277,163,145,115,132,48,21,19,0,0,0,150,0,50,0
100,,,22.0,21.0,23.0,23.0,1068,1062,755,839,313,223,267,137,95,65,172,72,21,20,0,0,150,150,0,50,0
107,,,23.0,21.0,23.0,23.0,1180,1124,867,923,313,201,257,221,45,125,212,96,22,20,0,0,150,150,0,50,0
114,,,23.0,22.0,23.0,31.0,1118,1062,783,839,335,223,397,349,145,225,252,124,22,21,0,0,150,150,0,50,0
121,,,23.0,23.0,31.0,31.0,1253,1191,895,923,358,268,547,450,255,290,292,160,23,22,0,0,150,300,0,50,0
129,,,23.0,27.0,31.0,31.0,1236,1214,923,923,313,291,694,141,370,95,324,46,23,22,0,0,150,450,0,50,0
136,,,27.0,28.0,31.0,31.0,1270,1236,979,923,291,313,145,231,35,145,110,86,23,23,0,0,450,450,0,50,0
143,,,27.0,28.0,31.0,31.0,1191,1242,923,951,268,291,291,227,145,105,146,122,23,23,0,0,450,450,0,50,0
150,,,27.0,29.0,31.0,31.0,1292,1208,979,895,313,313,346,368,160,210,186,158,23,24,0,0,450,450,0,50,0
157,,,27.0,31.0,31.0,31.0,1264,1342,951,1007,313,335,496,178,270,80,226,98,23,25,0,350,450,450,0,50,0
164,,,31.0,33.0,31.0,39.0,1342,1298,1007,1007,335,291,301,75,135,45,166,30,23,25,350,350,450,450,0,50,0
171,,,31.0,33.0,31.0,39.0,1286,1270,951,979,335,291,226,230,170,160,56,70,23,25,350,350,700,450,0,50,0
179,,,31.0,34.0,31.0,39.0,1236,1286,923,951,313,335,268,335,180,225,88,110,23,25,350,350,700,450,0,50,0
186,,,31.0,34.0,31.0,39.0,1258,1292,923,979,335,313,418,490,290,340,128,150,23,26,350,525,700,450,0,50,0
193,,,31.0,34.0,39.0,39.0,1236,1230,923,895,313,335,569,635,405,445,164,190,23,26,350,700,700,450,0,50,0
200,,,35.0,38.0,39.0,39.0,1264,1253,951,895,313,358,229,450,125,320,104,130,23,26,700,700,700,450,0,50,0
207,,,35.0,38.0,39.0,39.0,1292,1208,979,895,313,313,374,197,230,185,144,12,23,26,700,700,700,700,0,50,0
214,,,35.0,38.0,39.0,39.0,1314,1292,979,979,335,313,529,352,345,300,184,52,23,26,700,700,700,700,0,50,0
221,,,35.0,38.0,39.0,39.0,1286,1236,951,923,335,313,384,457,310,315,74,142,23,26,700,700,700,700,0,50,0
229,,,35.0,37.0,39.0,47.0,1258,1247,923,979,335,268,520,209,410,185,110,24,23,25,700,1050,700,700,0,100,0
236,,,35.0,37.0,39.0,47.0,1286,1225,951,979,335,246,275,352,125,300,150,52,23,25,1050,1050,700,700,0,100,0
243,,,35.0,39.0,39.0,63.0,1236,1258,923,1035,313,223,321,180,135,150,186,30,23,25,1050,1225,1150,700,0,100,0
250,,,37.0,39.0,39.0,63.0,1236,1197,923,951,313,246,226,317,125,255,101,62,23,25,1050,1225,1150,700,0,100,0
257,,,39.0,39.0,39.0,63.0,1236,1298,923,1007,313,291,121,478,105,380,16,98,23,25,1300,1225,1150,700,0,100,0
264,,,39.0,39.0,39.0,63.0,1314,1270,979,979,335,291,236,510,180,380,56,130,23,25,1550,1225,1150,950,0,100,0
271,,,40.0,40.0,47.0,63.0,1264,1331,951,1063,313,268,387,573,295,490,92,83,23,25,1550,1225,1150,950,0,100,0
279,,,42.0,44.0,47.0,55.0,1286,1326,951,1035,335,291,357,374,275,355,82,19,24,25,1725,1575,1150,950,0,200,0
286,,,42.0,44.0,47.0,55.0,1292,1331,979,1063,313,268,418,531,300,480,118,51,24,25,1725,1675,1150,950,0,200,0
293,,,46.0,44.0,47.0,63.0,1292,1247,979,979,313,268,218,273,160,190,58,83,24,25,2075,1675,1150,1100,0,200,0
300,,,47.0,43.0,47.0,63.0,1320,1275,1007,1007,313,268,328,429,230,310,98,119,24,24,2075,1675,1150,1100,0,250,0
307,,,47.0,49.0,47.0,63.0,1342,1314,1007,979,335,335,478,54,340,45,138,9,25,24,2075,2025,1150,1100,0,250,0
314,,,53.0,50.0,62.0,63.0,1370,1314,1035,979,335,335,118,154,90,105,28,49,25,24,2250,2200,1250,1100,0,250,0
321,,,53.0,50.0,62.0,63.0,1454,1314,1119,979,335,335,284,255,220,170,64,85,25,24,2600,2200,1250,1100,0,250,0
329,,,55.0,51.0,62.0,55.0,1538,1314,1203,979,335,335,359,360,255,235,104,125,25,25,2600,2200,1250,1100,0,350,0
336,,,55.0,52.0,62.0,55.0,1516,1348,1203,1035,313,313,530,121,390,110,140,11,25,26,2600,2200,1250,1100,0,350,0
343,,,61.0,53.0,62.0,55.0,1432,1326,1119,1035,313,291,170,222,140,175,30,47,27,27,3125,2200,1250,1100,0,350,0
350,,,62.0,51.0,62.0,55.0,1544,1348,1231,1035,313,313,310,337,240,250,70,87,27,27,3125,2025,1250,1100,0,525,0
357,,,60.0,49.0,62.0,63.0,1538,1398,1203,1063,335,335,485,497,375,370,110,127,28,27,2875,1850,1250,1100,250,750,0
364,,,60.0,50.0,62.0,63.0,1600,1029,1287,671,313,358,681,257,535,190,146,67,28,27,2875,2025,1250,1100,250,975,0
371,,,58.0,37.0,62.0,78.0,1538,536,1203,335,335,201,866,289,680,210,186,79,28,14,2700,2025,1250,1100,425,1625,0
378,,,58.0,24.0,62.0,78.0,1538,172,1203,83,335,89,866,312,680,225,186,87,28,9,2700,1325,1250,1100,425,2575,0
7,,,13.0,13.0,15.0,15.0,293,293,293,293,0,0,35,35,35,35,0,0,12,12,0,0,0,0,0,0,0
14,,,14.0,14.0,15.0,15.0,643,643,643,643,0,0,65,65,65,65,0,0,13,13,0,0,0,0,0,0,0
21,,,14.0,14.0,15.0,15.0,671,699,671,699,0,0,35,35,35,35,0,0,13,13,0,0,0,0,0,0,0
29,,,15.0,15.0,15.0,15.0,699,699,699,699,0,0,85,75,85,75,0,0,14,14,0,0,0,0,0,0,0
36,,,16.0,15.0,23.0,15.0,755,643,755,643,0,0,45,100,45,100,0,0,15,14,0,0,0,0,0,0,0
43,,,16.0,16.0,23.0,23.0,839,727,839,727,0,0,95,40,95,40,0,0,15,15,0,0,0,0,0,0,0
50,,,17.0,16.0,23.0,23.0,867,727,867,727,0,0,45,50,45,50,0,0,16,15,0,0,0,0,0,0,0
57,,,18.0,17.0,23.0,23.0,883,699,839,699,44,0,58,45,50,45,8,0,17,16,0,0,0,0,0,0,0
64,,,19.0,18.0,23.0,23.0,1006,783,895,783,111,0,175,140,155,140,20,0,18,17,0,0,0,0,0,0,0
71,,,19.0,18.0,23.0,23.0,1001,777,867,755,134,22,281,179,245,175,36,4,18,17,0,0,0,0,0,0,0
79,,,20.0,19.0,23.0,23.0,1023,833,867,699,156,134,356,284,300,260,56,24,19,18,0,0,0,0,0,0,0
86,,,20.0,19.0,23.0,23.0,995,967,839,811,156,156,471,404,395,360,76,44,19,18,0,0,0,0,0,0,0
93,,,20.0,20.0,23.0,23.0,1018,939,839,783,179,156,191,309,95,245,96,64,20,19,0,0,0,150,0,0,0
100,,,21.0,20.0,23.0,23.0,1074,967,895,811,179,156,126,424,10,340,116,84,20,19,0,0,150,150,0,0,0
107,,,21.0,20.0,23.0,23.0,1051,962,895,783,156,179,172,144,40,40,132,104,20,19,0,50,150,150,0,0,0
114,,,22.0,20.0,23.0,23.0,1051,962,895,783,156,179,252,154,100,80,152,74,21,19,0,50,150,150,0,0,0
121,,,22.0,21.0,23.0,23.0,1051,855,895,699,156,156,227,100,55,10,172,90,21,19,0,50,150,150,0,0,0
129,,,23.0,22.0,23.0,23.0,1023,995,867,839,156,156,357,180,165,70,192,110,22,20,0,50,150,150,0,0,0
136,,,25.0,22.0,31.0,23.0,1158,1051,867,895,291,156,227,180,95,50,132,130,22,20,0,50,300,150,0,0,0
143,,,26.0,23.0,31.0,31.0,1253,1051,895,895,358,156,327,255,155,105,172,150,23,21,0,50,300,150,0,0,0
150,,,26.0,25.0,31.0,31.0,1258,1051,923,895,335,156,218,195,110,25,108,170,24,21,0,50,300,250,0,0,0
157,,,26.0,26.0,31.0,31.0,1236,1158,923,979,313,179,114,290,70,100,44,190,24,22,175,50,300,250,0,0,0
164,,,28.0,26.0,46.0,31.0,1264,1107,951,951,313,156,174,221,90,15,84,206,24,22,175,150,300,250,0,0,0
171,,,29.0,27.0,46.0,31.0,1376,1107,1063,951,313,156,234,366,110,140,124,226,25,23,175,150,300,250,0,0,0
179,,,30.0,29.0,46.0,46.0,1376,1219,1063,1063,313,156,389,271,225,25,164,246,26,24,175,150,300,350,0,0,0
186,,,30.0,30.0,46.0,46.0,1398,1107,1063,951,335,156,264,346,210,80,54,266,28,24,175,150,550,500,0,0,0
193,,,30.0,32.0,46.0,46.0,1505,1331,1147,1175,358,156,139,341,45,80,94,261,28,24,175,250,550,500,0,0,0
200,,,30.0,33.0,46.0,46.0,1488,1494,1175,1315,313,179,301,361,175,80,126,281,28,25,175,250,550,500,0,0,0
207,,,33.0,36.0,46.0,46.0,1544,1522,1231,1343,313,179,206,376,40,75,166,301,28,26,175,250,800,575,0,0,0
214,,,34.0,38.0,46.0,46.0,1544,1667,1231,1511,313,156,231,407,25,115,206,292,28,26,175,350,800,725,0,0,0
221,,,36.0,40.0,46.0,54.0,1516,1835,1203,1679,313,156,261,322,15,110,246,212,30,28,175,350,800,725,0,0,0
229,,,38.0,46.0,46.0,54.0,1488,1975,1175,1819,313,156,351,202,65,20,286,182,32,29,175,500,800,800,0,0,0
236,,,40.0,48.0,46.0,54.0,1757,2059,1399,1903,358,156,326,287,0,85,326,202,34,30,425,500,950,800,0,0,0
243,,,40.0,49.0,46.0,54.0,1757,2143,1399,1987,358,156,486,182,120,60,366,122,34,31,425,500,1100,800,0,0,0
250,,,42.0,53.0,54.0,54.0,1891,2054,1399,1875,492,179,705,227,275,110,430,117,36,32,425,850,1100,800,0,0,0
257,,,47.0,54.0,54.0,54.0,1936,1802,1287,1623,649,179,245,122,110,10,135,112,37,34,1175,850,1400,800,0,0,0
264,,,48.0,58.0,54.0,62.0,2014,1779,1343,1623,671,156,330,168,115,40,215,128,37,34,1175,900,1400,800,0,0,0
271,,,49.0,55.0,54.0,62.0,2048,1807,1399,1651,649,156,526,388,235,240,291,148,37,36,1175,900,1400,800,0,175,0
279,,,47.0,58.0,62.0,70.0,2132,889,1483,755,649,134,772,289,405,125,367,164,38,36,925,900,1400,800,250,175,0
286,,,49.0,60.0,62.0,70.0,2042,458,1371,391,671,67,912,260,465,88,447,172,39,36,925,1025,1400,800,250,175,0
293,,,56.0,61.0,62.0,70.0,2160,1102,1511,1035,649,67,318,253,170,73,148,180,40,36,1675,1025,1400,825,250,275,0
300,,,61.0,54.0,62.0,70.0,2166,934,1539,867,627,67,209,451,85,163,124,288,41,31,1675,1125,1400,750,250,700,0
307,,,61.0,51.0,62.0,70.0,2188,183,1539,139,649,44,259,355,55,63,204,292,42,28,1675,1225,1400,750,250,950,0
314,,,57.0,51.0,62.0,70.0,2266,77,1595,55,671,22,539,337,255,45,284,292,43,28,1175,1225,1400,850,750,950,0
321,,,57.0,53.0,62.0,70.0,2272,475,1623,475,649,0,720,453,360,61,360,392,43,28,1175,1175,1400,775,750,1075,0
329,,,59.0,52.0,70.0,70.0,2378,895,1707,895,671,0,246,493,185,101,61,392,43,28,1125,1125,1400,775,1175,1283,0
7,0,1,13.0,13.0,15.0,14.0,377,293,377,293,0,0,45,35,45,35,0,0,12,12,0,0,0,0,0,0,0
14,0,1,14.0,13.0,15.0,14.0,643,671,643,671,0,0,65,20,65,20,0,0,13,13,0,0,0,0,0,0,0
21,0,1,14.0,14.0,15.0,14.0,699,755,699,755,0,0,50,50,50,50,0,0,13,13,0,0,0,0,0,0,0
29,0,1,15.0,14.0,15.0,14.0,699,755,699,755,0,0,90,140,90,140,0,0,14,13,0,0,0,0,0,0,0
36,0,1,15.0,14.0,15.0,22.0,755,727,755,727,0,0,135,30,135,30,0,0,14,14,0,0,0,0,0,0,0
43,0,1,16.0,13.0,23.0,22.0,755,671,755,671,0,0,65,30,65,30,0,0,15,12,0,0,0,0,0,0,0
50,0,1,16.0,14.0,23.0,22.0,783,699,783,699,0,0,40,70,40,70,0,0,15,12,0,0,0,0,0,0,0
57,0,1,17.0,14.0,23.0,22.0,727,671,727,671,0,0,30,45,30,45,0,0,16,13,0,0,0,0,0,0,0
64,0,1,18.0,14.0,23.0,22.0,783,693,783,671,0,22,125,134,125,130,0,4,17,14,0,0,0,0,0,0,0
71,0,1,18.0,14.0,23.0,30.0,799,749,755,615,44,134,228,229,220,205,8,24,17,14,0,0,0,0,0,0,0
79,0,1,19.0,14.0,23.0,30.0,911,771,755,615,156,156,348,329,320,285,28,44,18,14,0,0,0,0,0,0,0
86,0,1,19.0,17.0,23.0,30.0,939,771,783,615,156,156,458,219,410,155,48,64,18,14,0,0,0,250,0,0,0
93,0,1,20.0,16.0,23.0,30.0,990,771,811,615,179,156,328,169,310,85,18,84,19,13,0,0,150,250,0,0,0
100,0,1,20.0,16.0,23.0,30.0,1046,766,867,587,179,179,63,184,25,80,38,104,19,12,0,0,150,250,0,0,0
107,0,1,20.0,17.0,23.0,30.0,1079,710,923,531,156,179,184,214,130,90,54,124,19,13,0,50,150,250,0,0,0
114,0,1,21.0,18.0,23.0,30.0,1023,743,867,587,156,156,99,250,25,110,74,140,19,13,0,50,150,250,0,0,0
121,0,1,22.0,19.0,23.0,30.0,995,743,839,587,156,156,169,290,75,130,94,160,19,14,100,200,150,250,0,0,0
129,0,1,23.0,20.0,23.0,30.0,1247,833,1091,587,156,246,84,336,70,140,14,196,20,14,100,200,150,250,0,0,0
136,0,1,23.0,20.0,31.0,30.0,1270,810,1091,475,179,335,99,426,65,190,34,236,20,15,100,250,150,450,0,0,0
143,0,1,24.0,22.0,31.0,30.0,1298,844,1119,531,179,313,144,427,140,155,4,272,21,16,150,250,150,450,0,0,0
150,0,1,25.0,22.0,31.0,30.0,1247,922,1091,587,156,335,235,432,215,120,20,312,22,17,150,250,150,450,0,0,0
157,0,1,25.0,23.0,31.0,30.0,1303,950,1147,615,156,335,385,492,345,140,40,352,22,17,150,250,150,450,0,0,0
164,0,1,26.0,24.0,31.0,30.0,1342,956,1119,643,223,313,497,553,425,165,72,388,23,18,150,300,150,450,0,0,0
171,0,1,26.0,27.0,46.0,38.0,1460,950,1147,615,313,335,363,513,355,110,8,403,23,19,150,300,400,450,0,0,0
179,0,1,27.0,27.0,46.0,38.0,1488,1006,1175,671,313,335,393,643,345,200,48,443,24,20,150,300,500,450,0,0,0
186,0,1,32.0,27.0,46.0,38.0,1398,984,1063,671,335,313,303,754,215,275,88,479,25,20,150,300,500,450,0,0,0
193,0,1,32.0,27.0,46.0,38.0,1454,1068,1119,755,335,313,303,894,200,375,103,519,25,20,150,400,500,450,0,0,0
200,0,1,34.0,27.0,46.0,38.0,1426,1118,1091,783,335,335,389,1034,250,475,139,559,26,20,150,400,500,450,0,0,0
207,0,1,38.0,27.0,46.0,38.0,1566,1096,1231,783,335,313,294,1165,115,570,179,595,26,20,350,400,825,450,0,0,0
214,0,1,43.0,27.0,54.0,38.0,1768,1118,1455,783,313,335,210,1300,145,665,65,635,28,20,350,400,825,450,0,0,0
221,0,1,43.0,27.0,54.0,38.0,1880,1118,1567,783,313,335,140,1440,135,765,5,675,28,20,350,400,825,450,0,0,0
229,0,1,50.0,27.0,54.0,38.0,2048,1124,1735,811,313,313,140,1571,95,860,45,711,30,20,550,400,825,450,0,0,0
236,0,1,52.0,27.0,54.0,38.0,2042,1124,1707,811,335,313,175,1706,90,955,85,751,32,20,550,400,825,450,0,0,0
243,0,1,52.0,27.0,54.0,38.0,2160,1146,1847,811,313,335,336,1846,215,1055,121,791,32,20,600,400,825,450,0,0,0
250,0,1,54.0,27.0,54.0,38.0,2042,1146,1707,811,335,335,576,1981,415,1150,161,831,34,20,800,400,825,450,0,0,0
257,0,1,54.0,27.0,62.0,38.0,2076,1096,1763,783,313,313,337,2112,140,1245,197,867,34,20,1100,400,825,450,0,0,0
264,0,1,56.0,27.0,62.0,38.0,2160,1146,1847,811,313,335,312,2252,75,1345,237,907,36,20,1100,400,825,450,0,0,0
271,0,1,58.0,27.0,62.0,38.0,2020,1118,1707,783,313,335,262,2387,35,1440,227,947,38,20,1100,400,825,450,0,0,0
279,0,1,58.0,27.0,62.0,38.0,2210,1096,1875,783,335,313,537,2513,270,1530,267,983,38,20,1100,400,825,450,0,0,0
286,0,1,60.0,27.0,62.0,38.0,2126,1096,1791,783,335,313,377,2653,95,1630,282,1023,40,20,1100,400,825,450,0,0,0
293,0,1,61.0,27.0,70.0,38.0,2098,1062,1763,727,335,335,388,2783,70,1720,318,1063,40,20,1100,400,825,450,0,0,0
300,0,1,63.0,27.0,70.0,38.0,2182,1146,1847,811,335,335,523,2923,165,1820,358,1103,42,20,1100,400,825,450,0,0,0
307,0,1,65.0,27.0,70.0,38.0,2244,1096,1931,783,313,313,209,3059,65,1920,144,1139,44,20,1100,400,1400,450,0,0,0
314,0,1,68.0,27.0,78.0,38.0,2328,1146,2015,811,313,335,354,3194,170,2015,184,1179,44,20,1150,400,1550,450,0,0,0
321,0,1,75.0,27.0,78.0,38.0,2462,1124,2127,811,335,313,173,3325,70,2110,103,1215,46,20,1150,400,1550,450,0,0,0
329,0,1,75.0,27.0,93.0,38.0,2810,1040,2295,727,515,313,186,3460,115,2205,71,1255,46,20,1200,400,1550,450,0,0,0
336,0,1,78.0,27.0,93.0,38.0,2843,1146,2239,811,604,335,257,3600,110,2305,147,1295,48,20,1400,400,1550,450,0,0,0
343,0,1,83.0,27.0,93.0,38.0,2832,1174,2183,839,649,335,283,3745,60,2410,223,1335,49,20,1400,400,1550,450,0,0,0
350,0,1,84.0,27.0,93.0,38.0,2972,1124,2323,811,649,313,458,3866,155,2495,303,1371,50,20,1675,400,1550,450,0,0,0
357,0,1,91.0,27.0,101.0,38.0,2950,1202,2323,867,627,335,229,4016,75,2605,154,1411,52,20,1925,400,1550,450,0,0,0
364,0,1,98.0,27.0,101.0,38.0,3112,1090,2463,755,649,335,159,4131,25,2680,134,1451,52,20,1925,400,1550,450,0,0,0
371,0,1,99.0,27.0,101.0,38.0,3353,1180,2659,867,694,313,144,4282,30,2795,114,1487,54,20,1925,400,1550,450,0,0,0
379,0,1,100.0,27.0,109.0,38.0,3358,1096,2687,783,671,313,385,4407,195,2880,190,1527,54,20,2025,400,1550,450,0,0,0
386,0,1,108.0,27.0,117.0,38.0,3280,1146,2631,811,649,335,352,4542,90,2975,262,1567,56,20,2450,400,1550,450,0,0,0
393,0,1,112.0,27.0,125.0,38.0,3504,1090,2855,755,649,335,347,4682,130,3075,217,1607,57,20,2850,400,1550,450,0,0,0
400,0,1,114.0,27.0,133.0,38.0,3314,1096,2687,783,627,313,733,4808,440,3165,293,1643,59,20,3000,400,1550,450,0,0,0
407,0,1,115.0,27.0,133.0,38.0,3476,1090,2827,755,649,335,508,4948,135,3265,373,1683,60,20,3100,400,1550,450,0,0,0
414,0,1,122.0,27.0,133.0,38.0,3532,1118,2883,783,649,335,698,5078,245,3355,453,1723,62,20,3100,400,1550,450,0,0,0
421,0,1,129.0,27.0,133.0,38.0,3974,1096,3303,783,671,313,344,5224,140,3465,204,1759,65,20,3100,400,1800,450,0,0,0
429,0,1,132.0,23.5,149.0,38.0,4002,1124,3331,811,671,313,404,5149,220,3350,184,1799,65,20,3625,25,1800,450,0,375,0
436,0,1,135.0,22.5,149.0,14.0,4036,1118,3387,783,649,335,511,5094,255,3255,256,1839,68,19,3625,25,1800,450,0,725,0
443,0,1,140.0,12.5,149.0,6.0,3980,866,3331,643,649,223,371,5084,210,3225,161,1859,69,10,3625,25,1800,0,0,1775,0
450,0,1,140.0,5.5,149.0,6.0,3762,334,3135,223,627,111,462,4962,400,3095,62,1867,71,0,3625,25,1800,0,0,2275,0
457,0,1,145.0,6.5,157.0,0.0,3991,0,3275,0,716,0,79,4862,25,2995,54,1867,71,0,4550,25,2100,0,0,2900,0
7,2,1,13.0,13.0,15.0,14.0,335,335,335,335,0,0,40,40,40,40,0,0,12,12,0,0,0,0,0,0,1
14,2,1,14.0,13.0,15.0,14.0,671,671,671,671,0,0,70,20,70,20,0,0,13,13,0,0,0,0,0,0,1
21,2,1,14.0,14.0,15.0,14.0,671,671,671,671,0,0,45,45,45,45,0,0,13,13,0,0,0,0,0,0,1
29,2,1,15.0,14.0,15.0,14.0,699,727,699,727,0,0,90,150,90,150,0,0,14,13,0,0,0,0,0,0,1
36,2,1,15.0,16.0,15.0,22.0,755,783,755,783,0,0,135,145,135,145,0,0,14,14,0,0,0,0,0,0,1
43,2,1,16.0,16.0,23.0,22.0,783,811,783,811,0,0,65,235,65,235,0,0,15,16,0,0,0,0,0,0,1
50,2,1,17.0,15.0,23.0,22.0,839,839,839,839,0,0,45,40,45,40,0,0,16,15,0,0,0,0,0,0,1
57,2,1,18.0,17.0,23.0,22.0,811,811,811,811,0,0,95,35,95,35,0,0,17,15,0,0,0,0,0,0,1
64,2,1,18.0,18.0,23.0,22.0,895,895,895,895,0,0,150,90,150,90,0,0,17,16,0,0,0,0,0,0,1
71,2,1,19.0,17.0,23.0,22.0,945,923,923,923,22,0,254,180,250,180,4,0,18,17,0,0,0,0,0,0,1
79,2,1,20.0,17.0,23.0,22.0,1006,951,895,951,111,0,335,35,315,35,20,0,19,16,0,0,0,0,0,0,1
86,2,1,20.0,18.0,23.0,22.0,973,979,839,979,134,0,51,100,15,100,36,0,19,16,0,0,0,0,0,0,1
93,2,1,20.0,19.0,23.0,22.0,1001,895,867,895,134,0,167,145,115,145,52,0,20,18,0,0,150,0,0,0,1
100,2,1,20.0,20.0,23.0,22.0,973,1046,839,979,134,67,133,232,65,220,68,12,20,19,0,0,150,0,0,0,1
107,2,1,21.0,20.0,23.0,22.0,1051,1079,895,923,156,156,143,347,55,315,88,32,20,19,0,0,150,0,0,0,1
114,2,1,22.0,20.0,23.0,22.0,1079,1130,923,951,156,179,223,387,115,335,108,52,21,20,0,0,150,0,0,0,1
121,2,1,22.0,26.0,23.0,28.0,1107,1102,951,923,156,179,198,102,70,30,128,72,21,20,0,0,150,250,0,0,1
129,2,1,23.0,26.0,23.0,36.0,1158,1107,979,951,179,156,287,243,135,155,152,88,22,20,0,0,150,250,0,0,1
136,2,1,25.0,28.0,31.0,36.0,1180,1057,867,923,313,134,302,74,135,70,167,4,22,20,0,0,300,250,0,0,1
143,2,1,26.0,30.0,31.0,36.0,1258,1107,923,1063,335,44,93,98,40,90,53,8,23,20,0,100,300,250,0,0,1
150,2,1,27.0,30.0,31.0,36.0,1208,1186,895,1119,313,67,84,246,45,230,39,16,24,22,0,100,300,250,0,0,1
157,2,1,31.0,29.0,46.0,36.0,1236,1214,923,1147,313,67,64,74,10,50,54,24,25,23,125,400,300,250,0,0,1
164,2,1,32.0,30.0,46.0,36.0,1292,1298,979,1231,313,67,124,182,30,150,94,32,26,23,125,400,300,250,0,0,1
171,2,1,33.0,33.0,46.0,36.0,1376,1326,1063,1259,313,67,194,40,60,0,134,40,27,24,125,400,300,250,0,0,1
179,2,1,35.0,35.0,46.0,36.0,1449,1331,1091,1287,358,44,364,89,190,45,174,44,29,24,125,400,300,250,0,0,1
186,2,1,40.0,36.0,46.0,36.0,1617,1275,1259,1231,358,44,159,197,95,145,64,52,30,25,250,400,600,250,0,0,1
193,2,1,41.0,40.0,46.0,44.0,1600,1410,1287,1343,313,67,161,180,65,120,96,60,31,28,250,400,600,250,0,0,1
200,2,1,42.0,41.0,46.0,44.0,1740,1438,1427,1371,313,67,166,203,30,135,136,68,32,28,250,400,600,250,0,0,1
207,2,1,43.0,44.0,46.0,44.0,1796,1516,1483,1427,313,89,336,190,160,110,176,80,33,30,250,550,600,250,0,0,1
214,2,1,45.0,48.0,54.0,52.0,1824,1667,1511,1511,313,156,511,155,295,55,216,100,35,31,600,650,600,250,0,0,1
221,2,1,46.0,48.0,54.0,44.0,1958,1746,1623,1567,335,179,686,265,430,145,256,120,36,32,600,650,600,250,0,100,1
229,2,1,47.0,47.0,54.0,50.0,1869,1751,1511,1595,358,156,456,391,160,255,296,136,37,33,600,650,600,250,0,100,1
236,2,1,48.0,50.0,54.0,50.0,2042,1751,1707,1595,335,156,507,366,175,210,332,156,38,33,600,550,600,250,0,200,1
243,2,1,49.0,54.0,54.0,58.0,1964,1863,1651,1707,313,156,483,216,115,40,368,176,39,32,600,700,600,250,0,200,1
250,2,1,51.0,57.0,54.0,58.0,1964,1835,1651,1679,313,156,668,276,260,80,408,196,41,37,600,850,750,375,0,200,1
257,2,1,52.0,58.0,62.0,58.0,2160,1919,1847,1763,313,156,143,261,45,45,98,216,42,39,600,850,750,375,0,200,1
264,2,1,53.0,58.0,62.0,58.0,2087,2082,1707,1903,380,179,175,261,25,125,150,136,43,42,600,950,750,500,0,200,1
271,2,1,54.0,57.5,62.0,66.0,2390,2199,1763,2043,627,156,415,522,185,370,230,152,44,42,600,925,750,500,0,225,1
279,2,1,55.0,64.5,62.0,74.0,2451,2395,1735,2239,716,156,645,242,335,70,310,172,45,41,600,1075,750,500,0,225,1
286,2,1,57.0,66.5,62.0,74.0,2462,2311,1791,2155,671,156,827,322,445,130,382,192,47,48,600,1075,750,500,0,225,1
293,2,1,57.0,70.5,62.0,74.0,2418,2283,1791,2127,627,156,1064,252,610,40,454,212,47,49,600,1075,850,500,0,225,1
300,2,1,72.0,73.5,77.0,74.0,2390,2451,1763,2295,627,156,109,387,75,155,34,232,49,53,600,1075,1650,500,0,225,1
307,2,1,73.0,73.0,77.0,74.0,2530,2726,1903,2547,627,179,234,607,120,355,114,252,50,57,600,1050,1650,500,0,250,1
314,2,1,71.0,78.0,77.0,82.0,2670,2670,2043,2491,627,179,279,452,85,180,194,272,52,58,250,1050,1650,500,350,250,1
321,2,1,74.0,78.0,77.0,90.0,2798,2821,2127,2463,671,358,194,569,20,245,174,324,55,55,250,1050,1650,950,350,250,1
329,2,1,74.0,81.0,85.0,98.0,2933,2849,2239,2379,694,470,385,224,135,90,250,134,55,62,250,1050,1650,950,350,250,1
336,2,1,77.0,81.0,85.0,98.0,3022,2983,2351,2491,671,492,636,574,310,380,326,194,58,62,250,1050,1650,950,350,250,1
343,2,1,78.0,81.0,85.0,98.0,2978,3157,2239,2463,739,694,943,656,525,470,418,186,59,66,250,1150,1650,1075,350,250,1
350,2,1,91.0,81.0,93.0,98.0,3185,3420,2267,2435,918,985,54,978,20,730,34,248,61,66,1570,1150,1800,1075,350,250,1
357,2,1,92.0,80.5,93.0,98.0,3235,3566,2295,2603,940,963,260,986,110,830,150,156,62,66,1600,1125,1800,1325,350,275,1
364,2,1,93.0,92.0,93.0,98.0,3375,3594,2435,2631,940,963,231,403,65,335,166,68,64,66,1630,900,1800,1325,350,500,1
371,2,1,93.0,96.0,93.0,98.0,3448,3582,2463,2687,985,895,222,222,40,150,182,72,65,66,1660,900,1800,1325,350,500,1
379,2,1,96.0,104.0,101.0,106.0,3616,3554,2631,2659,985,895,393,168,195,80,198,88,65,66,1690,900,1800,1325,350,500,1
386,2,1,96.0,106.0,117.0,106.0,3510,3571,2547,2631,963,940,445,434,285,280,160,154,65,66,1690,1500,1800,1325,350,500,1
393,2,1,96.0,114.0,117.0,138.0,3638,3678,2631,2715,1007,963,1215,275,785,205,430,70,68,66,1660,1800,1800,1325,380,500,1
400,2,1,102.0,118.0,117.0,138.0,3616,3549,2631,2631,985,918,586,404,290,330,296,74,68,66,2320,2250,1800,1325,380,500,1
407,2,1,108.0,118.0,117.0,138.0,3599,3622,2659,2659,940,963,263,506,105,428,158,78,68,66,3010,2700,2050,1325,380,524,1
414,2,1,108.0,120.5,117.0,138.0,3650,3538,2687,2575,963,963,428,328,150,238,278,90,68,65,3055,3425,2050,1325,380,549,1
421,2,1,108.0,124.5,117.0,146.0,3638,3498,2631,2603,1007,895,863,357,465,263,398,94,68,65,3070,3725,2050,1325,380,549,1
429,2,1,108.0,128.5,117.0,146.0,3672,3465,2687,2547,985,918,1104,473,590,363,514,110,68,65,3100,3725,2500,1325,380,549,1
436,2,1,109.0,134.0,117.0,154.0,3644,3594,2659,2631,985,963,1491,469,865,393,626,76,68,65,3130,4000,2600,1325,380,574,1
443,2,1,103.0,128.0,117.0,154.0,3644,3599,2659,2659,985,940,1902,901,1160,713,742,188,69,65,2365,3850,2700,1325,1145,1024,1
450,2,1,108.0,142.0,117.0,154.0,3622,3622,2659,2659,963,963,1463,168,955,118,508,50,69,65,2710,3850,2850,1325,1460,1324,1
457,2,1,113.0,146.0,117.0,154.0,3655,3510,2715,2547,940,963,1549,275,925,113,624,162,69,65,3415,4300,3000,1325,1460,1324,1
464,2,1,107.0,150.0,117.0,154.0,3706,3017,2743,2099,963,918,1829,209,1085,43,744,166,69,65,2830,4300,3000,1325,2120,1324,1
471,2,1,107.0,153.0,117.0,154.0,3728,2826,2743,1931,985,895,1950,236,1090,58,860,178,69,65,2890,5400,3000,1325,2120,1374,1
479,2,1,101.0,151.0,133.0,162.0,3599,3292,2659,2374,940,918,2347,326,1375,182,972,144,69,65,2275,5100,3000,1325,2780,1674,1
486,2,1,115.0,157.0,133.0,168.0,3616,3337,2631,2374,985,963,877,234,510,124,367,110,69,65,3155,5100,3100,1325,2795,1674,1
493,2,1,113.0,151.0,133.0,168.0,3588,3415,2603,2452,985,963,1168,662,685,440,483,222,69,65,3305,5300,3200,1325,2960,2074,1
500,2,1,112.0,152.5,133.0,168.0,3403,3756,2463,2771,940,985,1040,208,620,174,420,34,68,65,2960,4975,3350,1325,3370,2849,1
507,2,1,113.0,144.5,133.0,168.0,3017,3689,2099,2816,918,873,1042,657,510,527,532,130,68,62,2930,5075,3300,1325,3595,3349,1
514,2,1,114.0,151.5,133.0,168.0,2530,3521,1791,2760,739,761,712,466,275,244,437,222,70,59,2900,4925,3450,1325,3820,3649,1
521,2,1,118.0,150.5,125.0,168.0,2278,3370,1651,2609,627,761,843,569,330,351,513,218,68,59,3370,4575,3400,1325,4295,3999,1
529,2,1,123.0,147.5,125.0,168.0,2462,2927,1791,2144,671,783,1003,151,410,91,593,60,69,57,3840,5325,3400,1325,4295,4849,1
536,2,1,121.0,135.0,133.0,168.0,2317,2815,1735,2032,582,783,1153,491,500,335,653,156,68,55,3870,4550,3650,1325,4445,5724,1
543,2,1,121.0,135.0,125.0,168.0,1600,2849,1175,2066,425,783,1021,537,320,293,701,244,68,51,3855,4700,3650,1325,4575,6074,1
550,2,1,123.0,133.0,133.0,168.0,1578,3151,1175,2368,403,783,914,629,165,389,749,240,68,51,3795,4450,3650,1325,4730,6474,1
557,2,1,113.0,125.0,141.0,168.0,1499,3107,1119,2346,380,761,1197,585,200,457,997,128,69,56,3340,4550,3350,1325,5530,6974,1
564,2,1,98.0,127.0,149.0,168.0,1561,3179,1203,2396,358,783,1351,522,310,448,1041,74,63,56,3230,4250,3350,1325,6510,7274,1
571,2,1,79.0,120.5,157.0,168.0,1432,3118,1119,2357,313,761,1461,545,380,383,1081,162,51,56,2490,3725,3450,1325,7880,8099,1
579,2,1,86.0,118.0,157.0,168.0,1505,3152,1147,2234,358,918,1041,773,95,495,946,278,51,56,2505,3450,3300,1325,8045,8374,1
586,2,1,88.0,127.0,157.0,168.0,1510,3398,1175,2435,335,963,1167,628,185,234,982,394,53,60,2475,3750,3300,1325,8075,8524,1
593,2,1,85.0,126.0,142.0,168.0,1432,3493,1119,2486,313,1007,1353,890,335,380,1018,510,52,60,2505,3450,3300,1325,8575,8824,1
600,2,1,85.0,127.0,142.0,168.0,1236,3526,923,2519,313,1007,1468,1045,410,415,1058,630,53,58,2535,3800,3600,1325,8575,8824,1
607,2,1,86.0,128.0,142.0,168.0,1348,3370,1035,2407,313,963,1128,1287,255,549,873,738,53,61,2565,4000,3300,1325,8875,8974,1
614,2,1,85.0,126.0,126.0,168.0,1684,3426,1371,2463,313,963,1318,1699,405,841,913,858,52,62,2595,4000,2800,1325,9625,9124,1
621,2,1,85.0,125.0,118.0,168.0,1925,3561,1590,2598,335,963,1512,1776,559,802,953,974,52,65,2610,3400,2800,1325,9740,9724,1
629,2,1,86.0,121.0,118.0,168.0,1584,3370,1226,2385,358,985,1246,1859,253,765,993,1094,52,65,2595,3100,2800,1775,9755,10024,1
636,2,1,83.0,127.0,110.0,168.0,1975,3438,1640,2363,335,1075,1516,839,487,213,1029,626,50,64,2625,3050,2550,1775,10605,10224,1
643,2,1,77.0,122.5,86.0,168.0,1768,3606,1455,2307,313,1299,1661,1277,596,491,1065,786,44,64,2655,3075,2550,1775,11205,10549,1
650,2,1,75.0,125.5,86.0,168.0,1404,3605,1091,2284,313,1321,1771,714,666,172,1105,542,41,64,2685,2725,2500,1775,11780,10899,1
657,2,1,80.0,124.0,86.0,168.0,1466,3594,1153,2295,313,1299,1232,909,387,315,845,594,42,64,2700,2500,2350,1775,12005,11124,1
664,2,1,79.0,128.0,86.0,168.0,2071,3645,1758,2391,313,1254,1760,704,725,158,1035,546,41,64,2715,3550,2350,1775,12055,11324,1
671,2,1,80.0,131.5,86.0,168.0,2239,3672,1881,2351,358,1321,1859,628,784,122,1075,506,42,64,3375,3525,2350,1775,12055,11349,1
679,2,1,80.0,134.5,86.0,168.0,2294,3678,1959,2379,335,1299,2008,689,897,127,1111,562,42,67,3390,4375,2350,1775,12055,11499,1
686,2,1,81.0,141.5,86.0,168.0,2048,3655,1735,2379,313,1276,2239,779,1092,65,1147,714,43,70,3390,4625,2350,1775,12055,11499,1
693,2,1,86.0,141.0,94.0,168.0,2289,3880,1976,2559,313,1321,1823,1225,936,351,887,874,44,70,3405,5100,2350,1775,12055,11524,1
700,2,1,90.0,142.0,94.0,168.0,2272,3942,1959,2643,313,1299,1819,1193,892,371,927,822,44,77,3770,5450,2350,1775,12055,11674,1
707,2,1,90.0,141.0,86.0,174.0,2154,4199,1819,2900,335,1299,1887,695,916,113,971,582,45,77,3785,5250,2350,1775,12155,12124,1
714,2,1,91.0,139.0,117.0,174.0,2362,4282,1959,3006,403,1276,1482,1196,763,462,719,734,45,77,3785,5150,2350,1775,12155,12224,1
721,2,1,79.0,131.0,117.0,174.0,2429,4434,2004,3113,425,1321,1763,1724,996,830,767,894,45,77,2345,4550,2350,1775,13595,12824,1
7,1,2,13.0,13.0,14.0,15.0,251,293,251,293,0,0,30,35,30,35,0,0,12,12,0,0,0,0,0,0,1
14,1,2,13.0,14.0,14.0,15.0,671,643,671,643,0,0,20,65,20,65,0,0,13,13,0,0,0,0,0,0,1
21,1,2,14.0,14.0,14.0,15.0,727,671,727,671,0,0,40,35,40,35,0,0,13,13,0,0,0,0,0,0,1
29,1,2,14.0,15.0,14.0,15.0,755,699,755,699,0,0,140,30,140,30,0,0,13,14,0,0,0,0,0,0,1
36,1,2,16.0,15.0,22.0,15.0,727,755,727,755,0,0,120,115,120,115,0,0,14,14,0,0,0,0,0,0,1
43,1,2,16.0,16.0,22.0,23.0,783,839,783,839,0,0,210,60,210,60,0,0,14,15,0,0,0,0,0,0,1
50,1,2,15.0,17.0,22.0,23.0,783,811,783,811,0,0,5,20,5,20,0,0,15,16,0,0,0,0,0,0,1
57,1,2,17.0,18.0,22.0,23.0,839,867,839,867,0,0,10,35,10,35,0,0,15,17,0,0,0,0,0,0,1
64,1,2,18.0,19.0,22.0,23.0,867,867,867,867,0,0,60,80,60,80,0,0,15,18,0,0,0,0,0,0,1
71,1,2,17.0,19.0,22.0,23.0,839,923,839,923,0,0,135,195,135,195,0,0,16,18,0,0,0,0,0,0,1
79,1,2,16.0,20.0,22.0,23.0,867,911,867,867,0,44,45,303,45,295,0,8,16,19,0,0,0,0,0,0,1
86,1,2,18.0,20.0,22.0,23.0,895,962,895,895,0,67,50,26,50,10,0,16,16,19,0,0,0,0,0,0,1
93,1,2,19.0,20.0,22.0,23.0,811,984,811,895,0,89,95,143,95,115,0,28,17,20,0,0,0,150,0,0,1
100,1,2,20.0,21.0,22.0,23.0,990,1006,923,895,67,111,177,65,165,25,12,40,18,20,0,0,0,150,0,0,1
107,1,2,20.0,21.0,22.0,23.0,1029,1001,895,867,134,134,293,61,265,5,28,56,19,20,0,0,0,150,0,0,1
114,1,2,20.0,22.0,22.0,23.0,995,1023,839,867,156,156,304,186,260,110,44,76,20,21,0,0,0,150,0,0,1
121,1,2,20.0,22.0,28.0,23.0,1023,1074,867,895,156,179,444,161,380,65,64,96,20,21,0,0,0,150,0,0,1
129,1,2,26.0,23.0,36.0,23.0,1057,1079,923,923,134,156,160,287,80,175,80,112,20,22,0,0,250,150,0,0,1
136,1,2,28.0,26.0,36.0,31.0,1046,1141,979,895,67,246,193,258,105,135,88,123,20,23,0,0,250,300,0,0,1
143,1,2,29.0,26.0,36.0,31.0,1130,1208,1063,895,67,313,271,48,175,35,96,13,22,23,0,0,250,300,0,0,1
150,1,2,30.0,27.0,36.0,31.0,1242,1264,1175,951,67,313,179,194,175,145,4,49,23,24,50,0,250,300,0,0,1
157,1,2,30.0,29.0,36.0,46.0,1219,1258,1175,923,44,335,323,169,315,105,8,64,24,24,50,125,250,300,0,0,1
164,1,2,30.0,31.0,36.0,46.0,1270,1292,1203,979,67,313,121,115,105,65,16,50,23,25,400,125,250,300,0,0,1
171,1,2,32.0,33.0,36.0,46.0,1270,1292,1203,979,67,313,34,175,10,85,24,90,24,27,400,125,250,300,0,0,1
179,1,2,35.0,36.0,36.0,46.0,1326,1426,1259,1091,67,335,37,125,5,20,32,105,24,28,400,250,250,300,0,0,1
186,1,2,36.0,38.0,36.0,46.0,1354,1482,1287,1147,67,335,165,250,125,105,40,145,24,30,400,250,250,600,0,0,1
193,1,2,37.0,41.0,44.0,46.0,1359,1544,1315,1231,44,313,164,131,120,100,44,31,25,30,450,250,250,600,0,0,1
200,1,2,40.0,43.0,44.0,46.0,1359,1656,1315,1343,44,313,187,137,135,70,52,67,25,32,550,250,250,600,0,0,1
207,1,2,37.0,43.0,52.0,46.0,1186,1712,1119,1399,67,313,165,202,105,95,60,107,25,32,700,375,250,600,50,0,1
214,1,2,40.5,43.0,52.0,54.0,990,1846,923,1511,67,335,182,252,114,130,68,122,26,34,675,125,250,600,175,250,1
221,1,2,41.5,45.0,52.0,54.0,1158,1846,1091,1511,67,335,110,307,34,145,76,162,27,36,675,425,250,600,175,250,1
229,1,2,44.5,48.0,52.0,54.0,1494,1846,1427,1511,67,335,148,78,64,30,84,48,29,36,675,425,250,600,175,250,1
236,1,2,45.5,50.0,58.0,54.0,1527,1852,1483,1539,44,313,192,304,104,220,88,84,30,38,675,425,250,600,175,250,1
243,1,2,46.0,50.0,58.0,54.0,1606,1992,1539,1679,67,313,335,494,239,370,96,124,33,38,650,550,375,600,200,250,1
250,1,2,50.5,51.0,58.0,62.0,1690,2076,1623,1763,67,313,133,639,29,475,104,164,33,39,575,850,375,600,275,300,1
257,1,2,51.0,54.0,58.0,62.0,1746,2048,1679,1735,67,313,201,494,89,440,112,54,33,40,700,850,375,600,300,300,1
264,1,2,51.5,55.0,58.0,62.0,1774,2154,1707,1819,67,335,184,539,64,445,120,94,38,40,625,850,375,600,375,350,1
271,1,2,55.5,57.0,58.0,62.0,1779,2149,1735,1791,44,358,208,264,84,155,124,109,38,41,625,975,500,750,375,350,1
279,1,2,58.5,61.0,66.0,62.0,1835,2065,1791,1707,44,358,176,279,44,155,132,124,41,42,725,1100,500,750,375,350,1
286,1,2,63.5,62.0,66.0,70.0,1914,2098,1847,1539,67,559,169,190,29,90,140,100,43,43,875,1400,625,750,375,350,1
293,1,2,65.5,65.0,66.0,70.0,2194,2216,2127,1567,67,649,337,191,189,115,148,76,47,44,875,1400,625,750,375,350,1
300,1,2,67.5,67.0,74.0,70.0,2345,2278,2211,1651,134,627,177,217,109,65,68,152,50,46,875,1550,625,750,375,350,1
307,1,2,64.5,67.0,74.0,78.0,2423,2311,2267,1707,156,604,332,353,244,125,88,228,47,46,975,1550,625,750,525,350,1
314,1,2,68.5,67.0,82.0,78.0,2171,2468,2015,1819,156,649,192,413,84,205,108,208,46,48,925,1300,625,750,725,600,1
321,1,2,71.0,66.0,82.0,78.0,2306,2418,2127,1791,179,627,197,244,69,60,128,184,47,49,900,1325,625,750,750,725,1
329,1,2,74.0,69.0,82.0,78.0,2586,2418,2407,1791,179,627,252,340,104,180,148,160,51,50,1050,1325,750,1150,750,725,1
336,1,2,78.0,72.0,90.0,78.0,2591,2334,2435,1707,156,627,238,281,74,220,164,61,56,52,1050,1475,750,1150,750,725,1
343,1,2,78.0,75.0,90.0,93.0,2647,2440,2491,1791,156,649,218,427,134,290,84,137,55,53,1050,1475,750,1150,750,725,1
350,1,2,79.0,77.0,98.0,93.0,2843,2602,2687,1931,156,671,378,547,274,330,104,217,59,54,1000,1575,750,1150,800,725,1
357,1,2,83.0,83.0,98.0,93.0,2894,2675,2715,2071,179,604,222,221,94,40,128,181,60,56,1000,1675,1000,1150,800,775,1
364,1,2,88.0,85.0,98.0,93.0,2972,2810,2659,2183,313,627,321,221,149,60,172,161,62,58,1150,1675,1000,1400,800,775,1
371,1,2,84.0,87.0,106.0,93.0,3078,2978,2519,2351,559,627,147,382,99,145,48,237,63,60,1150,1675,1000,1550,800,775,1
379,1,2,85.0,89.0,106.0,101.0,3140,3039,2491,2435,649,604,132,538,54,225,78,313,65,62,1150,1675,1000,1550,850,775,1
386,1,2,85.0,92.0,106.0,101.0,3218,3151,2547,2547,671,604,413,275,259,90,154,185,65,65,1150,1675,1000,1550,850,775,1
393,1,2,84.0,93.0,114.0,101.0,3224,3185,2463,2491,761,694,584,614,434,345,150,269,67,66,1250,1675,1000,1550,850,775,1
400,1,2,84.0,97.0,114.0,101.0,3347,3386,2407,2491,940,895,896,337,634,60,262,277,67,68,1250,2050,1000,1550,850,775,1
407,1,2,93.0,97.0,122.0,101.0,3482,3526,2519,2631,963,895,763,616,389,235,374,381,67,69,1250,2050,1000,1550,850,775,1
414,1,2,93.0,97.0,130.0,101.0,3459,3538,2519,2687,940,851,989,636,499,155,490,481,67,69,1250,2050,1200,1550,850,775,1
421,1,2,93.0,101.0,130.0,101.0,3622,3599,2659,2659,963,940,1124,881,614,280,510,601,76,69,1250,2250,1200,1700,850,775,1
429,1,2,93.0,101.0,146.0,101.0,3594,3543,2631,2603,963,940,1565,947,939,330,626,617,76,69,1250,2250,1450,2350,850,775,1
436,1,2,115.0,103.0,154.0,109.0,3700,3773,2715,2743,985,1030,900,1272,429,535,471,737,76,69,1250,2250,1450,2350,850,775,1
443,1,2,124.0,109.0,168.0,109.0,3750,3599,2743,2547,1007,1052,1146,572,509,240,637,332,77,69,1250,3225,1450,2500,850,775,1
450,1,2,130.0,112.0,168.0,117.0,3862,3532,2855,2547,1007,985,1252,686,649,400,603,286,77,69,2350,2825,1450,2650,850,775,1
457,1,2,157.0,114.0,168.0,117.0,3958,3482,2995,2519,963,963,149,472,109,320,40,152,77,69,2750,2875,1450,2950,850,775,1
464,1,2,160.0,120.0,176.0,133.0,4070,3655,3107,2715,963,940,355,623,274,355,81,268,77,69,2750,4075,1450,3250,850,775,1
471,1,2,166.0,120.0,176.0,133.0,3650,3571,2799,2631,851,940,370,653,214,265,156,388,75,69,2750,4175,1450,3550,950,775,1
479,1,2,166.0,126.0,168.0,133.0,3694,3627,2799,2687,895,940,722,643,454,135,268,508,77,69,2900,4625,1450,3550,1150,775,1
486,1,2,166.0,129.0,176.0,141.0,3980,3689,2995,2659,985,1030,932,648,569,170,363,478,79,69,4475,4625,1450,3550,1150,775,1
493,1,2,175.0,129.0,176.0,141.0,3924,3666,2939,2659,985,1007,783,810,404,320,379,490,78,72,4750,4625,1450,3550,1150,775,1
500,1,2,176.5,137.0,184.0,141.0,3896,3543,2911,2603,985,940,640,844,474,250,166,594,78,72,4600,5025,1450,3550,1400,775,1
507,1,2,185.0,137.0,192.0,141.0,3874,3650,2911,2687,963,963,611,884,454,170,157,714,78,72,4925,5275,1450,3550,1475,775,1
514,1,2,199.0,137.0,200.0,141.0,3840,3437,2855,2519,985,918,81,1086,29,260,52,826,78,72,5325,5275,1575,3550,1475,775,1
521,1,2,198.0,137.0,200.0,141.0,3924,3403,2715,2463,1209,940,576,1206,364,260,212,946,78,72,5875,5275,1575,3550,1525,775,1
529,1,2,190.0,141.0,200.0,141.0,3952,3504,2631,2519,1321,985,1032,1332,664,270,368,1062,78,72,5625,5125,1575,3550,1925,925,1
536,1,2,197.0,144.0,200.0,157.0,4098,3493,2799,2463,1299,1030,934,644,539,220,395,424,78,72,6125,4850,1575,4100,2125,1650,1
543,1,2,196.5,139.0,200.0,172.0,4176,3594,2855,2631,1321,963,1130,772,654,390,476,382,78,72,5700,4100,1575,4350,2550,2400,1
550,1,2,197.5,145.0,200.0,172.0,4204,3566,2883,2603,1321,963,1336,603,754,405,582,198,78,72,5550,5100,1575,4650,2700,2500,1
557,1,2,197.5,143.0,208.0,172.0,4210,3594,2911,2631,1299,963,1648,738,1064,420,584,318,78,72,5950,5150,1575,4650,2800,2900,1
564,1,2,199.5,146.0,208.0,172.0,4182,3599,2883,2659,1299,940,1939,574,1349,440,590,134,78,72,6450,5750,1575,4650,2800,2900,1
571,1,2,198.5,161.0,216.0,172.0,3902,3622,2603,2659,1299,963,2105,414,1359,160,746,254,77,72,6850,6050,1575,4650,2800,2900,1
579,1,2,188.5,153.0,216.0,172.0,3874,3661,2575,2631,1299,1030,2576,539,1674,315,902,224,77,72,6300,6250,1575,4650,3350,3300,1
586,1,2,198.5,159.0,216.0,172.0,3986,3661,2687,2631,1299,1030,2242,265,1384,75,858,190,77,72,6000,6150,1575,4650,3650,3400,1
593,1,2,180.5,145.0,216.0,172.0,4198,3588,2855,2603,1343,985,2393,693,1529,395,864,298,77,72,4900,5850,1575,4650,4750,4100,1
600,1,2,199.5,139.0,216.0,172.0,4288,3566,2967,2603,1321,963,1719,1119,999,705,720,414,77,72,4600,5850,1575,4650,5050,4700,1
607,1,2,199.5,155.0,216.0,172.0,4299,3459,3023,2519,1276,940,1942,655,1174,225,768,430,77,72,5400,6950,1575,4650,5050,4700,1
614,1,2,195.5,159.0,216.0,172.0,4210,3370,2911,2407,1299,963,2132,630,1204,80,928,550,74,72,5200,6550,1575,4650,5250,4700,1
621,1,2,193.5,162.0,216.0,172.0,4120,3504,2799,2519,1321,985,2613,895,1529,225,1084,670,76,75,6300,7000,1575,4650,5350,4700,1
629,1,2,192.5,171.0,216.0,172.0,4036,3694,2715,2687,1321,1007,1634,941,544,155,1090,786,76,76,4800,7000,1575,4650,6850,4700,1
636,1,2,190.5,171.0,216.0,172.0,4215,3902,2939,2939,1276,963,1751,1009,709,115,1042,894,76,80,4700,7200,1700,4650,6950,4900,1
643,1,2,195.5,171.0,222.0,172.0,4176,3874,2855,2911,1321,963,1417,925,619,115,798,810,74,80,4700,7200,1700,4750,6950,4900,1
650,1,2,195.5,172.0,222.0,172.0,4131,3846,2855,2883,1276,963,1924,1230,974,300,950,930,74,84,6350,7575,2000,4750,6950,4900,1
657,1,2,199.5,177.0,222.0,188.0,4075,3795,2799,2855,1276,940,1800,791,1094,245,706,546,77,84,6750,7575,2000,4750,6950,4900,1
664,1,2,199.5,185.0,222.0,188.0,4238,4098,2939,3135,1299,963,2306,531,1444,65,862,466,77,85,7150,7575,2350,4750,6950,4900,1
671,1,2,199.5,185.0,222.0,188.0,3958,4310,2659,3191,1299,1119,2747,802,1729,200,1018,602,77,86,7150,8025,2350,4750,6950,4900,1
679,1,2,198.5,187.0,222.0,188.0,3851,4501,2575,3247,1276,1254,3219,930,2049,330,1170,600,76,86,7150,8225,2700,4900,7000,4900,1
686,1,2,197.0,185.0,222.0,188.0,3521,4394,2379,3163,1142,1231,3382,1350,2159,610,1223,740,73,86,7125,8125,2900,4900,7175,5000,1
693,1,2,197.5,181.0,222.0,196.0,3874,4467,2687,3191,1187,1276,2769,1291,2019,545,750,746,73,86,7000,8000,2900,4900,7300,5400,1
700,1,2,196.0,197.0,222.0,220.0,3935,4574,2659,3275,1276,1299,3087,832,2264,230,823,602,74,86,7275,8450,3050,5550,7325,5400,1
707,1,2,196.0,197.0,222.0,220.0,4126,4585,2827,3331,1299,1254,3583,1075,2604,475,979,600,74,86,7275,9425,3050,5550,7325,5400,1
714,1,2,196.0,191.0,222.0,220.0,4159,4064,2883,2855,1276,1209,4096,1545,2969,793,1127,752,74,86,7275,9475,3200,5550,7325,5837,1
721,1,2,196.0,188.0,222.0,220.0,4131,3633,2855,2491,1276,1142,3268,1758,2639,878,629,880,74,85,7275,9375,3200,5550,7325,6187,1
729,1,2,196.0,194.0,222.0,220.0,4142,4053,2911,3023,1231,1030,3631,1462,2929,808,702,654,74,87,7275,9375,3200,5550,7325,6187,1
736,1,2,199.5,200.0,222.0,220.0,4137,4338,2883,3331,1254,1007,3933,1681,3079,903,854,778,74,87,8550,9675,3050,5550,7400,6187,1
743,1,2,197.5,200.0,222.0,220.0,4154,4462,2855,3387,1299,1075,4023,2124,3159,1218,864,906,74,87,8450,9575,3050,5550,7500,6287,1
750,1,2,188.0,200.0,222.0,220.0,4014,4333,2715,3303,1299,1030,2900,2624,2034,1598,866,1026,74,87,6125,9675,3050,5850,10025,6287,1
757,1,2,200.0,188.0,230.0,220.0,4120,4445,2799,3415,1321,1030,2715,2554,1689,1658,1026,896,74,87,6025,8600,3050,5850,10125,7362,1
764,1,2,196.5,186.0,230.0,220.0,4058,4299,2715,3247,1343,1052,2877,3057,1849,2033,1028,1024,71,87,6000,8500,3050,5850,10300,7462,1
771,1,2,197.0,188.0,230.0,220.0,3986,4215,2687,3163,1299,1052,3024,2641,1919,1493,1105,1148,71,87,8025,8860,3500,5850,10475,7762,1
779,1,2,200.0,194.0,230.0,220.0,3879,3974,2603,2967,1276,1007,2531,1311,1674,793,857,518,75,87,8125,9260,3500,5850,10475,7762,1
786,1,2,200.0,200.0,222.0,220.0,3958,3997,2659,2967,1299,1030,1471,1474,1229,828,242,646,75,87,7925,9575,3500,5850,10750,7762,1
793,1,2,197.0,200.0,222.0,220.0,3980,4019,2659,2967,1321,1052,1907,1943,1509,1173,398,770,76,87,8425,9590,3500,5850,10900,7762,1
800,1,2,199.5,200.0,222.0,228.0,4176,3773,2855,2743,1321,1030,1998,2178,1444,1288,554,890,76,87,9500,9230,3650,5850,11250,8137,1
807,1,2,199.0,200.0,222.0,228.0,4126,3739,2827,2687,1299,1052,2330,2166,1699,1148,631,1018,76,87,9475,9445,3650,5850,11275,8137,1
814,1,2,194.0,191.0,222.0,228.0,4260,3986,2939,2799,1321,1187,2851,3230,2064,1818,787,1412,84,86,9075,9705,3650,5850,11450,8587,1
821,1,2,197.0,199.0,222.0,228.0,4243,3174,2967,1987,1276,1187,2748,3164,2209,1608,539,1556,84,86,8725,9720,3650,5700,11875,8737,1
829,1,2,199.0,195.0,222.0,221.0,4462,3218,3163,2211,1299,1007,2654,3451,2234,1783,420,1668,84,86,8425,9835,3650,5700,12175,9437,1
836,1,2,196.0,189.0,222.0,221.0,4411,3185,3135,2155,1276,1030,3165,3430,2589,1638,576,1792,83,86,8125,9635,3650,5950,12375,9737,1
843,1,2,200.0,199.0,222.0,221.0,4439,3437,3163,2407,1276,1030,2852,2880,2474,1593,378,1287,83,86,8125,10210,3650,6050,12375,9837,1
850,1,2,199.0,199.0,222.0,236.0,4546,3510,3247,2547,1299,963,3392,2808,2854,1563,538,1245,82,86,8725,10690,3650,6050,12375,9837,1
857,1,2,185.5,199.0,222.0,236.0,4411,3532,3023,2547,1388,985,3915,2917,3209,1548,706,1369,82,86,8050,10905,3650,6050,13750,9837,1
864,1,2,196.5,199.0,222.0,236.0,4406,3655,2771,2715,1635,940,3651,2910,2749,1733,902,1177,82,86,7400,10705,3650,6050,14400,10052,1
871,1,2,196.5,199.0,222.0,221.0,4467,3661,2855,2743,1612,918,3369,3333,2579,2048,790,1285,82,86,7400,11135,3500,5950,14511,10552,1
879,1,2,192.0,199.0,214.0,205.0,4355,2709,2743,2015,1612,694,3576,3238,2819,1873,757,1365,75,86,8175,11135,3500,5950,14961,11202,1
886,1,2,195.5,198.0,208.0,197.0,4221,2737,2743,2043,1478,694,2553,3942,2262,2493,291,1449,72,85,9075,11105,3350,5950,15745,11382,1
893,1,2,198.0,194.0,192.0,197.0,3756,3017,2435,2323,1321,694,2907,3706,2348,2173,559,1533,70,85,8925,10920,3475,5950,16638,11597,1
900,1,2,197.0,192.0,184.0,197.0,3851,2854,2463,2183,1388,671,2975,3726,2248,2263,727,1463,69,85,9175,10835,2825,5950,17438,11697,1
907,1,2,193.0,196.0,184.0,212.0,3678,2726,2379,1987,1299,739,3212,3675,2333,2228,879,1447,65,85,9675,11845,2475,5950,18063,11697,1
914,1,2,190.5,174.0,216.0,220.0,3599,3039,2323,2323,1276,716,1148,3889,1113,2358,35,1531,65,85,7650,9485,2775,5950,20088,14072,1
921,1,2,188.5,168.0,232.0,228.0,3711,3179,2435,2463,1276,716,644,3338,578,1723,66,1615,65,85,6000,7820,2775,5950,21363,16652,1
929,1,2,195.5,176.0,224.0,228.0,3728,2849,2407,2211,1321,638,589,2933,488,1548,101,1385,65,85,6000,7450,2625,5950,21613,16652,1
936,1,2,197.5,180.0,216.0,228.0,3790,2989,2491,2407,1299,582,736,3099,583,1638,153,1461,65,85,6350,8130,2625,5950,21763,16652,1
943,1,2,192.5,194.0,216.0,228.0,3728,2966,2407,2295,1321,671,662,2558,553,1013,109,1545,65,85,8475,7930,2425,5950,22488,16852,1
950,1,2,172.5,196.0,216.0,228.0,3627,3095,2351,2379,1276,716,1385,2412,978,983,407,1429,59,85,8000,8480,2300,5950,23738,17102,1
957,1,2,177.5,180.0,216.0,228.0,3392,3034,2295,2295,1097,739,1324,2076,793,863,531,1213,57,85,8450,6860,2300,5950,23913,18722,1
964,1,2,174.5,196.0,216.0,228.0,3202,3045,2239,2351,963,694,1445,796,798,53,647,743,57,85,8150,7350,2300,5950,24463,19282,1
971,1,2,168.5,176.0,216.0,228.0,3118,2966,2155,2295,963,671,1685,1161,918,338,767,823,57,85,8350,6420,2300,5950,25213,21077,1
979,1,2,167.5,172.0,216.0,243.0,3168,2944,2183,2351,985,593,1615,811,728,168,887,643,56,85,7550,6050,2300,5950,26263,21897,1
986,1,2,167.0,166.0,216.0,243.0,3062,2474,2099,1959,963,515,1137,1099,488,388,649,711,56,85,7375,6100,2300,5950,26438,22197,1
993,1,2,171.0,170.0,216.0,243.0,3246,2770,2239,2211,1007,559,1282,1452,513,673,769,779,56,85,7625,6800,2300,5950,26488,22197,1
1000,1,2,139.5,176.0,216.0,243.0,3162,3627,2155,3023,1007,604,1258,1224,573,373,685,851,55,85,6250,6100,2300,5950,28788,22897,1
1007,1,2,142.0,174.0,216.0,243.0,3179,3745,2239,3163,940,582,1236,1658,443,743,793,915,55,85,6325,7200,2300,5950,29113,22997,1
1014,1,2,148.0,182.0,216.0,243.0,3067,3913,2127,3331,940,582,801,1476,213,643,588,833,55,85,6425,7200,2500,5950,29113,23097,1
1021,1,2,154.5,184.0,216.0,243.0,3028,3750,2043,3191,985,559,551,1044,143,393,408,651,55,85,6350,6750,2500,5950,29338,23747,1
1029,1,2,142.0,174.0,216.0,243.0,3022,3829,2015,3247,1007,582,816,986,313,413,503,573,55,85,6075,5725,2500,5950,30513,24772,1
1036,1,2,137.5,163.0,216.0,228.0,2446,3314,1651,2799,795,515,510,1356,33,723,477,633,50,85,5400,5600,2500,5950,31438,26172,1
1043,1,2,126.0,145.0,216.0,228.0,1718,3230,1203,2715,515,515,715,1370,178,673,537,697,48,85,4875,4475,2500,5950,32363,27822,1
1050,1,2,131.0,158.0,216.0,228.0,1673,3168,1203,2631,470,537,397,509,183,348,214,161,48,85,5275,5475,2500,5950,32363,28122,1
1057,1,2,132.5,158.0,216.0,228.0,1376,2972,951,2435,425,537,245,884,208,663,37,221,48,85,5550,5275,2500,5950,32438,28122,1
1064,1,2,132.5,158.0,216.0,228.0,1930,3146,1483,2631,447,515,506,723,413,588,93,135,48,85,6250,5750,2500,5950,32438,28622,1
1071,1,2,131.5,166.0,216.0,228.0,2126,3028,1567,2379,559,649,777,716,608,493,169,223,48,85,6200,6200,2500,5950,32488,28622,1
1079,1,2,128.5,158.0,216.0,228.0,2177,3442,1595,2771,582,671,984,1016,743,713,241,303,48,85,5950,6100,2500,5850,32663,29222,1
1086,1,2,142.5,158.0,216.0,228.0,2138,3213,1511,2519,627,694,540,1069,223,678,317,391,48,85,5950,6200,2500,5850,32663,29522,1
1093,1,2,150.5,162.0,216.0,228.0,2328,3241,1679,2547,649,694,281,968,63,793,218,175,48,85,5950,6400,2500,5850,32663,29522,1
1100,1,2,147.0,160.0,216.0,228.0,2216,3286,1567,2547,649,739,532,1328,238,1073,294,255,48,85,6475,6100,2500,5850,32888,29622,1
1107,1,2,124.0,164.0,208.0,228.0,2261,2916,1567,2155,694,761,706,635,353,588,353,47,48,85,4825,5925,2500,5850,34488,30247,1
1114,1,2,131.5,164.0,208.0,251.0,2339,3073,1511,2491,828,582,591,995,238,888,353,107,48,85,5100,6975,2500,5850,34513,30247,1
1121,1,2,139.0,164.0,208.0,251.0,2395,2882,1567,2435,828,447,472,955,123,788,349,167,48,85,5325,6975,2500,5850,34538,30247,1
1129,1,2,144.0,156.0,208.0,251.0,2406,3274,1623,2603,783,671,264,1354,198,1103,66,251,48,85,5825,6275,2500,5850,34538,30447,1
1136,1,2,142.0,176.0,208.0,251.0,2076,3627,1315,2911,761,716,187,703,33,368,154,335,46,85,6325,7000,2500,5850,34638,30622,1
1143,1,2,135.0,170.0,202.0,251.0,1488,3610,951,2939,537,671,163,729,103,318,60,411,39,85,6625,6750,2500,5850,35513,31072,1
1150,1,2,134.5,173.0,202.0,251.0,1415,3689,1035,2995,380,694,317,302,213,53,104,249,39,85,6800,6350,2500,6250,35538,31472,1
1157,1,2,142.5,173.0,202.0,251.0,1225,3627,867,2911,358,716,56,735,8,398,48,337,39,85,6800,7225,2500,6250,35538,31472,1
1164,1,2,140.0,175.0,202.0,251.0,1219,3739,839,3023,380,716,214,489,118,368,96,121,38,85,6725,7025,2500,6250,35613,31672,1
1171,1,2,130.5,175.0,202.0,251.0,1219,3678,839,2939,380,739,362,527,218,318,144,209,38,85,6250,6800,2500,6250,36088,32297,1
1179,1,2,130.5,167.0,202.0,259.0,1270,3594,867,2855,403,739,525,246,333,153,192,93,38,85,6650,5775,2500,6250,36088,33322,1
1186,1,2,125.5,155.0,202.0,259.0,1258,3543,867,2827,391,716,662,370,428,343,234,27,38,85,6250,5550,2500,6250,36488,34247,1
1193,1,2,130.5,154.0,202.0,259.0,1018,3521,783,2827,235,694,387,790,383,683,4,107,38,85,6250,5700,2500,6250,36488,34697,1
1200,1,2,138.5,172.0,202.0,259.0,956,3207,755,2491,201,716,105,263,73,68,32,195,38,85,6550,6400,2500,6250,36488,34697,1
1207,1,2,132.5,172.0,202.0,259.0,1029,3073,783,2379,246,694,242,622,178,343,64,279,38,85,6200,6600,2500,6250,36838,34697,1
1214,1,2,126.5,175.0,202.0,259.0,1124,2899,811,2183,313,716,377,170,273,103,104,67,38,85,6350,6250,2500,6250,37038,35047,1
1221,1,2,123.5,172.0,202.0,259.0,1124,3006,811,2267,313,739,517,533,373,378,144,155,38,85,6225,6150,2500,6250,37213,35347,1
1229,1,2,131.5,183.0,202.0,274.0,1169,3090,811,2351,358,739,147,267,88,178,59,89,38,85,5975,6975,2500,6250,37538,35347,1
1236,1,2,131.5,183.0,208.0,274.0,1202,3017,867,2323,335,694,198,527,128,358,70,169,37,84,5925,7075,2500,6250,37638,35497,1
1243,1,2,125.0,179.0,208.0,274.0,1499,3190,1231,2519,268,671,381,382,283,283,98,99,36,84,6100,6950,2500,6250,38013,36147,1
1250,1,2,128.0,171.0,208.0,274.0,1622,3442,1399,2771,223,671,109,802,83,623,26,179,36,84,5900,6775,2350,6250,38463,36622,1
1257,1,2,127.0,177.0,208.0,274.0,1180,3414,979,2743,201,671,228,673,178,568,50,105,35,84,5900,7300,2200,6250,38663,36622,1
1264,1,2,127.0,176.0,208.0,274.0,911,3442,867,2771,44,671,353,567,303,528,50,39,35,84,5950,7100,2200,6250,38663,37122,1
1271,1,2,131.0,186.0,208.0,274.0,1393,3325,1371,2631,22,694,167,457,113,338,54,119,34,84,6100,8125,2200,6250,38913,37122,1
1279,1,2,134.5,184.0,208.0,274.0,1835,3274,1679,2603,156,671,101,837,48,638,53,199,34,84,5825,8025,2200,6250,39188,37222,1
1286,1,2,127.0,176.0,208.0,274.0,1807,3162,1651,2491,156,671,252,1202,183,923,69,279,34,84,5650,7325,2200,6250,39713,37922,1
1293,1,2,112.5,185.0,208.0,274.0,1863,3241,1707,2547,156,694,387,436,373,373,14,63,34,84,4925,6925,2200,6250,40638,38322,1
7,1,1,13.0,13.0,14.0,14.0,293,293,293,293,0,0,35,35,35,35,0,0,12,12,0,0,0,0,0,0,1
14,1,1,13.0,13.0,14.0,14.0,671,671,671,671,0,0,20,20,20,20,0,0,13,13,0,0,0,0,0,0,1
21,1,1,14.0,14.0,14.0,14.0,727,727,727,727,0,0,50,50,50,50,0,0,13,13,0,0,0,0,0,0,1
29,1,1,14.0,14.0,14.0,14.0,755,811,755,811,0,0,145,155,145,155,0,0,13,13,0,0,0,0,0,0,1
36,1,1,16.0,16.0,22.0,22.0,783,839,783,839,0,0,145,155,145,155,0,0,14,14,0,0,0,0,0,0,1
43,1,1,16.0,16.0,22.0,22.0,811,839,811,839,0,0,235,240,235,240,0,0,14,16,0,0,0,0,0,0,1
50,1,1,15.0,15.0,22.0,22.0,783,867,783,867,0,0,30,45,30,45,0,0,15,15,0,0,0,0,0,0,1
57,1,1,17.0,17.0,22.0,22.0,867,867,867,867,0,0,45,45,45,45,0,0,15,15,0,0,0,0,0,0,1
64,1,1,18.0,18.0,22.0,22.0,895,979,895,979,0,0,90,105,90,105,0,0,16,16,0,0,0,0,0,0,1
71,1,1,17.0,17.0,22.0,22.0,811,895,811,895,0,0,165,185,165,185,0,0,17,17,0,0,0,0,0,0,1
79,1,1,17.0,17.0,22.0,22.0,895,951,895,951,0,0,30,45,30,45,0,0,16,16,0,0,0,0,0,0,1
86,1,1,18.0,18.0,22.0,22.0,923,923,923,923,0,0,95,110,95,110,0,0,16,16,0,0,0,0,0,0,1
93,1,1,19.0,19.0,22.0,22.0,979,973,979,951,0,22,150,169,150,165,0,4,18,18,0,0,0,0,0,0,1
100,1,1,20.0,20.0,22.0,22.0,934,978,867,867,67,111,222,245,210,225,12,20,18,19,0,0,0,0,0,0,1
107,1,1,20.0,20.0,22.0,22.0,1023,1051,867,895,156,156,342,370,310,330,32,40,19,19,0,0,0,0,0,0,1
114,1,1,21.0,21.0,22.0,22.0,1079,1107,923,951,156,156,432,465,380,405,52,60,20,20,0,0,0,0,0,0,1
121,1,1,25.0,26.0,28.0,28.0,1074,1023,895,867,179,156,157,130,85,50,72,80,20,21,0,0,250,250,0,0,1
129,1,1,26.0,26.0,28.0,28.0,1135,1158,979,979,156,179,243,80,155,80,88,0,21,21,0,0,250,250,0,0,1
136,1,1,28.0,28.0,28.0,28.0,1141,1107,1007,951,134,156,84,116,80,100,4,16,21,21,0,0,250,250,0,0,1
143,1,1,30.0,30.0,36.0,36.0,1146,1174,1035,1063,111,111,130,163,110,135,20,28,21,22,50,50,250,250,0,0,1
150,1,1,30.0,30.0,36.0,36.0,1258,1174,1147,1063,111,111,282,310,250,270,32,40,23,23,50,50,250,250,0,0,1
157,1,1,30.0,31.0,36.0,36.0,1230,1230,1119,1119,111,111,84,62,40,10,44,52,24,24,350,350,250,250,0,0,1
164,1,1,30.0,31.0,36.0,36.0,1370,1342,1259,1231,111,111,91,38,85,20,6,18,24,23,350,350,250,250,0,0,1
171,1,1,31.0,31.0,36.0,36.0,1320,1314,1231,1203,89,111,148,85,130,55,18,30,23,24,350,400,250,250,0,0,1
179,1,1,33.0,33.0,36.0,36.0,1370,1342,1259,1231,111,111,109,162,75,120,34,42,25,25,400,400,250,250,0,0,1
186,1,1,32.5,35.0,36.0,36.0,1426,1477,1315,1343,111,134,276,227,230,165,46,62,25,27,375,400,250,250,25,0,1
193,1,1,35.5,41.0,44.0,44.0,1499,1499,1343,1343,156,156,201,107,135,25,66,82,27,27,375,400,250,250,25,0,1
200,1,1,40.5,42.0,44.0,44.0,1583,1611,1427,1455,156,156,126,157,40,55,86,102,29,27,375,400,250,250,25,0,1
207,1,1,41.5,42.0,44.0,44.0,1583,1606,1427,1427,156,179,196,242,90,170,106,72,32,27,375,650,250,450,25,0,1
214,1,1,42.5,44.0,52.0,44.0,1611,1578,1455,1399,156,179,277,317,155,225,122,92,32,27,375,800,450,450,25,0,1
221,1,1,44.5,51.0,52.0,52.0,1779,1583,1623,1427,156,156,347,163,230,55,117,108,32,27,525,950,450,450,25,50,1
229,1,1,50.5,53.0,58.0,58.0,1807,1611,1651,1455,156,156,212,248,75,120,137,128,34,28,525,1000,450,450,25,50,1
236,1,1,49.5,55.0,58.0,58.0,1891,1667,1735,1511,156,156,172,298,140,150,32,148,35,35,575,1000,575,450,50,50,1
243,1,1,48.0,54.0,52.0,58.0,2003,1667,1847,1511,156,156,408,418,360,250,48,168,35,35,650,1050,575,450,425,50,1
250,1,1,51.0,56.0,52.0,58.0,2087,1863,1931,1707,156,156,298,278,230,90,68,188,35,33,800,1050,575,450,425,50,1
257,1,1,51.0,58.0,60.0,58.0,2003,1942,1847,1763,156,179,233,313,145,155,88,158,35,34,850,1050,575,450,425,50,1
264,1,1,53.0,58.0,60.0,58.0,2003,1942,1735,1763,268,179,123,243,95,65,28,178,35,37,850,1050,575,450,425,50,1
271,1,1,51.5,57.5,76.0,58.0,2037,2059,1679,1903,358,156,348,289,280,195,68,94,34,39,925,1275,575,575,425,75,1
279,1,1,52.5,57.5,76.0,74.0,1958,2115,1623,1959,335,156,419,449,315,335,104,114,34,39,925,1275,575,575,425,75,1
286,1,1,54.5,59.0,76.0,82.0,1908,2227,1595,2071,313,156,330,289,190,255,140,34,34,39,975,1200,575,775,475,75,1
293,1,1,58.5,68.0,76.0,90.0,1908,2177,1595,1931,313,246,230,145,50,75,180,70,32,38,1025,1200,575,775,475,75,1
300,1,1,59.0,66.0,84.0,98.0,1818,2238,1483,1903,335,335,390,310,170,200,220,110,35,40,1000,1100,575,775,475,175,1
307,1,1,60.5,71.0,92.0,106.0,1824,2322,1511,1987,313,335,466,291,210,220,256,71,35,42,925,950,575,775,550,250,1
314,1,1,60.0,76.5,92.0,114.0,1880,2440,1567,2127,313,313,546,272,325,240,221,32,36,42,1050,1325,575,775,575,275,1
321,1,1,62.0,80.5,92.0,114.0,1986,2390,1539,1987,447,403,126,308,95,295,31,13,35,42,1200,1625,825,775,575,275,1
329,1,1,64.0,84.5,92.0,114.0,1914,2535,1399,2043,515,492,247,413,160,390,87,23,35,42,1500,1925,825,775,600,275,1
336,1,1,66.0,84.5,92.0,114.0,2031,2367,1539,1875,492,492,363,673,220,590,143,83,39,42,1600,2175,825,775,350,300,1
343,1,1,64.0,93.5,92.0,114.0,1986,2166,1427,1651,559,515,495,483,280,340,215,143,36,42,1650,2175,825,775,400,300,1
350,1,1,64.0,93.5,92.0,114.0,2054,2255,1427,1763,627,492,490,710,195,540,295,170,37,42,1550,2375,825,775,500,300,1
357,1,1,68.0,105.0,92.0,114.0,2082,2395,1455,1903,627,492,430,390,55,160,375,230,38,42,1450,2750,825,775,600,375,1
364,1,1,66.0,105.5,92.0,114.0,2132,2373,1483,1903,649,470,516,61,65,50,451,11,39,42,1400,2725,825,775,650,475,1
371,1,1,63.5,107.0,92.0,114.0,2020,2429,1371,1959,649,470,737,156,210,85,527,71,38,42,1475,3300,825,775,725,500,1
379,1,1,64.5,108.5,92.0,114.0,2104,2401,1455,1931,649,470,683,336,105,205,578,131,38,42,1475,3825,1275,775,925,600,1
386,1,1,65.0,104.5,92.0,114.0,2132,2502,1483,1987,649,515,677,376,54,235,623,141,38,42,1325,3125,1125,775,1387,1150,1
393,1,1,56.5,104.5,92.0,122.0,2210,2451,1539,1959,671,492,827,157,124,10,703,147,38,42,900,2775,1700,775,2037,1525,1
400,1,1,48.0,99.5,92.0,122.0,2104,2479,1455,1987,649,492,483,298,4,95,479,203,38,42,125,2525,1850,775,2812,1875,1
407,1,1,39.5,91.5,84.0,122.0,1516,2451,1091,1959,425,492,428,233,9,70,419,163,32,42,150,2425,1700,775,3487,2375,1
414,1,1,39.5,89.0,84.0,122.0,1258,2401,923,1931,335,470,421,409,43,190,378,219,32,42,125,2250,1350,775,3924,2575,1
420,1,1,41.0,90.0,84.0,122.0,1309,2373,951,1903,358,470,457,192,90,75,367,117,31,42,125,2300,1075,775,4285,2675,1
7,1,2,13.0,13.0,14.0,15.0,293,251,293,251,0,0,35,30,35,30,0,0,12,12,0,0,0,0,0,0,0
14,1,2,13.0,14.0,14.0,15.0,671,643,671,643,0,0,20,65,20,65,0,0,13,13,0,0,0,0,0,0,0
21,1,2,14.0,14.0,14.0,15.0,699,615,699,615,0,0,50,30,50,30,0,0,13,13,0,0,0,0,0,0,0
29,1,2,14.0,15.0,14.0,15.0,783,615,783,615,0,0,150,60,150,60,0,0,13,14,0,0,0,0,0,0,0
36,1,2,16.0,15.0,22.0,15.0,755,699,755,699,0,0,145,105,145,105,0,0,14,14,0,0,0,0,0,0,0
43,1,2,16.0,16.0,22.0,23.0,811,699,811,699,0,0,235,30,235,30,0,0,16,15,0,0,0,0,0,0,0
50,1,2,17.0,17.0,22.0,23.0,783,755,783,755,0,0,280,75,280,75,0,0,16,16,0,0,0,0,0,0,0
57,1,2,17.0,18.0,22.0,23.0,839,755,839,755,0,0,30,50,30,50,0,0,16,17,0,0,0,0,0,0,0
64,1,2,18.0,18.0,22.0,23.0,895,839,895,839,0,0,90,105,90,105,0,0,16,17,0,0,0,0,0,0,0
71,1,2,17.0,19.0,22.0,23.0,895,923,895,923,0,0,170,160,170,160,0,0,17,18,0,0,0,0,0,0,0
79,1,2,17.0,20.0,22.0,23.0,895,945,895,923,0,22,30,274,30,270,0,4,16,19,0,0,0,0,0,0,0
86,1,2,18.0,20.0,22.0,23.0,895,990,895,923,0,67,90,397,90,385,0,12,16,19,0,0,0,0,0,0,0
93,1,2,19.0,21.0,22.0,23.0,923,1068,923,979,0,89,140,64,140,40,0,24,18,20,0,0,0,150,0,0,0
100,1,2,20.0,21.0,22.0,23.0,1018,1062,951,951,67,111,217,186,205,150,12,36,19,20,0,0,0,150,0,0,0
107,1,2,20.0,22.0,22.0,23.0,1079,1113,923,979,156,134,347,117,315,65,32,52,19,21,0,0,0,150,0,0,0
114,1,2,20.0,22.0,22.0,23.0,1130,1107,951,951,179,156,382,167,330,95,52,72,20,21,0,0,0,150,0,0,0
121,1,2,22.0,23.0,22.0,23.0,1135,1107,979,951,156,156,358,147,290,55,68,92,20,22,0,0,250,150,0,0,0
129,1,2,26.0,23.0,36.0,23.0,1135,1130,979,951,156,179,243,232,155,120,88,112,20,22,0,0,250,150,0,0,0
136,1,2,28.0,24.0,36.0,31.0,1062,1085,951,839,111,246,65,309,65,165,0,144,20,23,0,0,250,150,0,0,0
143,1,2,28.0,27.0,36.0,31.0,1007,1230,1007,895,0,335,185,185,185,80,0,105,22,24,50,0,250,300,0,0,0
150,1,2,30.0,28.0,36.0,31.0,1147,1180,1147,867,0,313,230,86,230,45,0,41,23,25,50,0,250,300,0,0,0
157,1,2,30.0,28.0,36.0,31.0,1315,1214,1315,923,0,291,380,177,380,100,0,77,24,25,200,0,250,300,0,0,0
164,1,2,31.0,32.0,36.0,46.0,1259,1264,1259,951,0,313,80,117,80,50,0,67,24,26,350,125,250,300,0,0,0
171,1,2,33.0,33.0,36.0,46.0,1343,1320,1343,1007,0,313,40,237,40,130,0,107,24,27,350,125,250,300,0,0,0
179,1,2,34.0,34.0,36.0,46.0,1343,1415,1343,1147,0,268,155,99,155,60,0,39,24,28,350,125,250,300,0,0,0
186,1,2,36.0,35.0,44.0,46.0,1371,1555,1371,1287,0,268,220,191,220,120,0,71,26,29,400,125,250,550,0,0,0
193,1,2,41.0,36.0,44.0,46.0,1399,1538,1399,1315,0,223,90,170,90,75,0,95,26,30,400,300,250,550,0,0,0
200,1,2,43.0,39.0,44.0,46.0,1505,1678,1483,1455,22,223,74,42,70,40,4,2,29,31,550,300,250,550,0,0,0
207,1,2,43.0,40.0,44.0,46.0,1628,1813,1539,1567,89,246,171,165,155,135,16,30,31,32,550,300,250,550,0,0,0
214,1,2,44.0,41.0,52.0,46.0,1813,1852,1679,1651,134,201,352,79,320,25,32,54,33,33,550,300,250,550,0,0,0
221,1,2,48.0,40.0,60.0,46.0,1869,1824,1735,1623,134,201,168,242,120,160,48,82,34,34,550,300,250,800,0,0,0
229,1,2,51.0,44.0,60.0,46.0,1841,1874,1707,1651,134,223,179,121,115,15,64,106,34,34,700,425,250,800,0,0,0
236,1,2,54.0,44.0,66.0,46.0,1835,1953,1679,1707,156,246,254,253,170,115,84,138,35,34,700,425,250,800,0,0,0
243,1,2,56.0,46.0,66.0,54.0,1914,1958,1735,1735,179,223,229,292,125,130,104,162,41,36,700,425,250,950,0,0,0
250,1,2,56.0,50.0,66.0,54.0,1998,1964,1819,1763,179,201,369,171,245,110,124,61,41,36,700,675,250,950,0,0,0
257,1,2,63.0,52.0,66.0,62.0,2199,1981,2043,1735,156,246,185,258,45,165,140,93,41,38,1000,925,250,1100,0,0,0
264,1,2,68.5,53.0,74.0,70.0,2283,1953,2127,1707,156,246,160,371,75,250,85,121,41,38,975,925,450,1250,25,0,0
271,1,2,70.5,61.0,74.0,70.0,2311,2093,2155,1847,156,246,245,128,165,75,80,53,41,39,1075,925,450,1250,25,0,0
279,1,2,73.5,62.0,82.0,70.0,2311,2098,2155,1875,156,223,365,227,290,150,75,77,41,40,1325,1525,600,1250,25,0,0
286,1,2,79.5,61.0,90.0,70.0,2339,2205,2183,1959,156,246,250,444,230,335,20,109,41,40,1625,1400,600,1350,25,125,0
293,1,2,75.5,59.0,90.0,78.0,2418,2149,2239,1903,179,246,535,692,495,555,40,137,41,42,1675,1275,600,1350,225,250,0
300,1,2,83.0,66.0,98.0,78.0,2334,2171,2155,1903,179,268,105,339,45,270,60,69,41,42,1500,1150,600,1350,400,375,0
307,1,2,80.5,71.0,98.0,78.0,2339,2138,2183,1847,156,291,326,165,250,160,76,5,39,43,1725,1650,600,1350,475,375,0
314,1,2,83.5,71.0,98.0,78.0,2199,2014,2043,1679,156,335,441,300,345,255,96,45,39,44,2275,1525,600,1350,475,500,0
321,1,2,87.5,71.0,98.0,78.0,2255,2143,2099,1763,156,380,501,563,435,470,66,93,39,44,2275,1525,600,1350,475,500,0
329,1,2,87.5,72.0,98.0,78.0,2199,2177,2043,1819,156,358,666,432,580,295,86,137,39,46,2425,1525,850,1350,475,500,0
336,1,2,92.5,74.0,98.0,78.0,2255,2294,2099,1735,156,559,586,357,480,240,106,117,38,47,2475,1900,850,1350,475,500,0
343,1,2,93.5,78.0,106.0,86.0,2166,2446,1987,1819,179,627,646,278,520,185,126,93,43,47,2675,2050,850,1350,475,500,0
350,1,2,93.5,78.0,106.0,94.0,2222,2490,2043,1819,179,671,476,483,430,310,46,173,44,47,2675,2050,850,1350,475,500,0
357,1,2,96.5,78.0,114.0,102.0,2339,2625,2183,1931,156,694,612,783,550,530,62,253,45,47,2675,2050,850,1350,475,500,0
364,1,2,100.5,78.0,122.0,102.0,2390,2552,2211,1903,179,649,596,771,560,550,36,221,46,47,2675,2050,850,1600,475,500,0
371,1,2,100.0,77.0,122.0,110.0,2306,2608,2015,1959,291,649,746,1096,670,795,76,301,47,46,2650,2425,850,1600,500,550,0
379,1,2,108.0,81.0,122.0,110.0,2334,2502,1931,1875,403,627,637,912,505,635,132,277,47,46,2850,2425,850,1600,500,550,0
386,1,2,107.5,89.0,130.0,118.0,2563,2502,1959,1875,604,627,957,512,745,355,212,157,56,46,2825,3125,850,1600,525,550,0
393,1,2,107.0,89.0,130.0,110.0,2714,2418,2043,1791,671,627,872,812,580,575,292,237,56,46,2800,3125,975,1600,550,650,0
400,1,2,120.0,89.0,130.0,118.0,2972,2541,2323,1847,649,694,443,607,275,290,168,317,56,46,2650,3125,975,1600,700,650,0
407,1,2,119.5,89.0,130.0,118.0,3196,2518,2547,1847,649,671,679,428,435,135,244,293,56,46,2625,3125,1225,1600,725,650,0
414,1,2,123.5,97.0,162.0,118.0,3022,2552,2351,1903,671,649,529,420,430,255,99,165,55,46,3425,3800,1225,1600,725,650,0
421,1,2,130.0,97.0,162.0,126.0,3084,2440,2435,1791,649,649,455,260,330,165,125,95,55,46,3700,3800,1225,1600,750,650,0
429,1,2,132.0,97.0,178.0,134.0,3034,2474,2407,1847,627,627,311,406,210,235,101,171,53,46,3800,3800,1225,1600,750,650,0
436,1,2,137.0,103.0,178.0,134.0,2938,2474,2267,1847,671,627,305,186,270,85,35,101,60,46,3900,3800,1225,1600,750,650,0
443,1,2,137.0,101.0,178.0,134.0,3213,2546,2407,1875,806,671,715,646,580,415,135,231,67,46,3900,4525,1225,1600,750,475,0
450,1,2,141.5,103.0,178.0,134.0,3291,2485,2463,1791,828,694,846,596,615,285,231,311,67,46,4075,4525,1225,1600,775,475,0
457,1,2,142.0,103.0,178.0,134.0,3538,2406,2687,1735,851,671,822,878,695,495,127,383,67,46,4050,4525,1350,1600,800,475,0
464,1,2,154.5,111.0,178.0,134.0,3594,2468,2743,1819,851,649,747,679,670,320,77,359,67,48,4225,4525,1350,1600,875,475,0
471,1,2,151.5,107.0,178.0,157.0,3582,2306,2687,1679,895,627,825,900,740,465,85,435,67,47,4075,4775,1350,2050,1075,775,0
479,1,2,157.0,106.0,178.0,149.0,3689,2390,2771,1763,918,627,867,1100,770,585,97,515,67,46,4650,4650,1350,2200,1200,1050,0
486,1,2,156.0,105.0,186.0,149.0,3711,2418,2771,1791,940,627,1218,1110,1030,565,188,545,67,46,4700,4550,1350,2200,1350,1450,0
493,1,2,160.5,104.0,186.0,149.0,3711,2485,2771,1791,940,694,950,850,825,325,125,525,67,48,4375,4400,1350,2200,1825,2100,0
500,1,2,153.5,97.0,186.0,149.0,3790,2485,2827,1791,963,694,1402,1090,1165,485,237,605,67,49,4325,3850,1350,2350,2175,2525,0
507,1,2,156.0,85.0,186.0,149.0,3706,2356,2743,1707,963,649,724,1373,575,700,149,673,66,51,3800,2875,1350,2350,2800,3500,0
514,1,2,154.0,86.0,186.0,149.0,3689,2580,2771,1931,918,649,947,738,740,185,207,553,66,51,4200,2075,1350,2350,3100,4300,0
521,1,2,160.5,86.0,186.0,149.0,3465,2418,2547,1791,918,627,839,1019,645,390,194,629,66,51,4175,2775,1350,2350,3125,4300,0
529,1,2,161.5,90.0,186.0,149.0,3325,2530,2407,1903,918,627,641,814,535,255,106,559,66,54,4975,2600,1350,2350,3325,4475,0
536,1,2,151.5,84.0,186.0,149.0,3230,2580,2267,1931,963,649,917,1124,695,485,222,639,65,54,4675,2650,1350,2350,3825,4950,0
543,1,2,133.5,82.0,186.0,149.0,3179,2793,2239,2099,940,694,1304,749,970,230,334,519,70,54,3875,1875,1350,2350,4925,5825,0
550,1,2,139.5,80.0,186.0,149.0,3202,2742,2239,2071,963,671,1201,576,880,185,321,391,69,54,3675,1875,1350,2350,5125,6525,0
557,1,2,146.0,82.0,186.0,149.0,3263,2720,2323,2071,940,649,1079,497,775,180,304,317,68,52,3550,1950,1350,2350,5250,6800,0
564,1,2,155.5,69.0,186.0,149.0,3414,2306,2519,1679,895,627,707,753,495,360,212,393,68,45,3725,1575,1350,2250,5575,7775,0
571,1,2,149.5,73.0,186.0,149.0,3437,2166,2519,1539,918,627,993,373,690,200,303,173,68,45,3725,1850,1350,2250,5975,8150,0
579,1,2,155.0,75.0,192.0,126.0,3465,2138,2547,1511,918,627,1135,273,795,120,340,153,68,45,3900,1900,1350,2250,6000,8775,0
586,1,2,159.0,69.0,192.0,126.0,3739,2205,2799,1511,940,694,1172,548,820,315,352,233,68,43,4400,1775,1350,2250,6200,9175,0
593,1,2,159.0,69.0,192.0,126.0,3818,2177,2855,1483,963,694,1323,393,1005,80,318,313,68,43,4500,1775,1350,2250,6200,9175,0
600,1,2,165.0,72.0,192.0,126.0,3756,2160,2771,1511,985,649,1470,351,1040,120,430,231,68,43,4800,2275,1350,2250,6200,9175,0
607,1,2,169.0,76.0,192.0,126.0,3806,2076,2687,1427,1119,649,1555,201,1060,90,495,111,74,43,5200,2575,1800,2250,6200,9175,0
614,1,2,181.0,78.0,192.0,126.0,3834,1886,2603,1259,1231,627,808,317,765,130,43,187,74,43,5300,2575,1800,2250,6200,9175,0
621,1,2,183.0,78.0,200.0,126.0,3969,1858,2715,1231,1254,627,980,242,935,125,45,117,74,45,5450,2575,1800,2250,6200,9175,0
7,2,1,13.0,13.0,15.0,14.0,293,335,293,335,0,0,35,40,35,40,0,0,12,12,0,0,0,0,0,0,0
14,2,1,14.0,13.0,15.0,14.0,643,643,643,643,0,0,65,15,65,15,0,0,13,13,0,0,0,0,0,0,0
21,2,1,14.0,14.0,15.0,14.0,643,699,643,699,0,0,35,50,35,50,0,0,13,13,0,0,0,0,0,0,0
29,2,1,15.0,14.0,15.0,14.0,615,755,615,755,0,0,60,145,60,145,0,0,14,13,0,0,0,0,0,0,0
36,2,1,15.0,16.0,15.0,22.0,615,755,615,755,0,0,95,135,95,135,0,0,14,14,0,0,0,0,0,0,0
43,2,1,16.0,16.0,23.0,22.0,727,783,727,783,0,0,40,225,40,225,0,0,15,14,0,0,0,0,0,0,0
50,2,1,17.0,17.0,23.0,22.0,783,811,783,811,0,0,75,275,75,275,0,0,16,16,0,0,0,0,0,0,0
57,2,1,18.0,17.0,23.0,22.0,811,839,811,839,0,0,45,25,45,25,0,0,17,16,0,0,0,0,0,0,0
64,2,1,18.0,18.0,23.0,22.0,867,923,867,923,0,0,105,85,105,85,0,0,17,16,0,0,0,0,0,0,0
71,2,1,19.0,17.0,23.0,22.0,951,951,951,951,0,0,170,170,170,170,0,0,18,16,0,0,0,0,0,0,0
79,2,1,19.0,17.0,23.0,22.0,973,951,951,951,22,0,279,30,275,30,4,0,18,16,0,0,0,0,0,0,0
86,2,1,20.0,18.0,23.0,22.0,1012,923,923,923,89,0,396,95,380,95,16,0,19,16,0,0,0,0,0,0,0
93,2,1,20.0,19.0,23.0,22.0,1001,923,867,923,134,0,117,150,85,150,32,0,20,18,0,0,150,0,0,0,0
100,2,1,20.0,19.0,23.0,22.0,1057,962,923,895,134,67,83,272,35,260,48,12,20,19,0,0,150,0,0,0,0
107,2,1,21.0,20.0,23.0,22.0,1062,1079,951,923,111,156,80,357,20,325,60,32,20,19,0,0,150,0,0,0,0
114,2,1,22.0,20.0,23.0,22.0,1057,1102,923,923,134,179,155,387,75,335,80,52,21,20,0,0,150,0,0,0,0
121,2,1,22.0,20.0,23.0,22.0,1107,1051,951,895,156,156,186,508,90,440,96,68,21,20,0,0,150,250,0,0,0
129,2,1,23.0,26.0,23.0,28.0,1079,1051,923,895,156,156,261,228,145,140,116,88,22,20,0,0,150,250,0,0,0
136,2,1,25.0,28.0,31.0,36.0,1141,1034,895,923,246,111,228,50,105,50,123,0,22,20,0,0,300,250,0,0,0
143,2,1,26.0,29.0,31.0,36.0,1158,1063,867,1063,291,0,69,135,60,135,9,0,23,21,0,50,300,250,0,0,0
150,2,1,26.0,30.0,31.0,36.0,1208,1035,895,1035,313,0,170,200,125,200,45,0,23,22,0,100,300,250,0,0,0
157,2,1,29.0,30.0,31.0,36.0,1225,1147,867,1147,358,0,90,35,80,35,10,0,24,23,125,100,300,250,0,0,0
164,2,1,31.0,31.0,46.0,36.0,1286,1203,951,1203,335,0,146,95,100,95,46,0,25,23,125,400,300,250,0,0,0
171,2,1,33.0,32.0,46.0,36.0,1236,1343,923,1343,313,0,147,105,65,105,82,0,27,23,125,400,300,250,0,0,0
179,2,1,34.0,35.0,46.0,36.0,1376,1427,1063,1427,313,0,222,60,100,60,122,0,28,25,125,400,300,250,0,0,0
186,2,1,35.0,36.0,46.0,36.0,1516,1455,1203,1455,313,0,367,190,205,190,162,0,29,26,125,400,600,250,0,0,0
193,2,1,41.0,34.0,46.0,44.0,1628,1119,1315,1119,313,0,217,220,165,220,52,0,31,26,250,400,600,250,0,50,0
200,2,1,42.0,39.0,46.0,44.0,1785,799,1427,755,358,44,277,78,185,70,92,8,32,26,250,400,600,250,0,50,0
207,2,1,43.0,42.0,46.0,44.0,1818,1242,1483,1175,335,67,233,183,105,167,128,16,33,27,250,400,600,250,0,50,0
214,2,1,44.0,44.0,46.0,44.0,1824,1522,1511,1455,313,67,404,111,240,87,164,24,34,33,250,550,600,250,0,50,0
221,2,1,48.0,44.0,54.0,44.0,1880,1572,1567,1483,313,89,269,213,215,177,54,36,35,34,600,550,600,250,0,50,0
229,2,1,50.0,44.0,54.0,44.0,2020,1790,1707,1679,313,111,369,334,275,282,94,52,37,34,600,550,600,250,0,150,0
236,2,1,50.0,50.0,54.0,50.0,1992,1841,1679,1707,313,134,199,200,65,132,134,68,38,34,600,550,600,250,0,150,0
243,2,1,51.0,56.0,62.0,66.0,2070,1953,1735,1819,335,134,389,126,215,42,174,84,39,34,600,550,600,250,0,150,0
250,2,1,56.0,56.0,62.0,66.0,2177,1667,1819,1511,358,156,159,181,95,77,64,104,40,37,900,700,600,250,0,150,0
257,2,1,57.0,58.0,62.0,66.0,2210,1807,1875,1651,335,156,210,281,110,157,100,124,41,43,900,700,750,250,0,150,0
264,2,1,58.0,62.0,62.0,66.0,2188,2059,1875,1903,313,156,56,221,20,77,36,144,42,44,900,700,750,250,0,150,0
271,2,1,59.0,63.0,70.0,66.0,2110,2311,1819,2155,291,156,222,331,150,167,72,164,43,44,900,850,750,375,0,150,0
279,2,1,60.0,65.0,70.0,74.0,1964,2278,1651,2099,313,179,342,331,230,147,112,184,44,47,900,850,750,375,0,200,0
286,2,1,66.0,70.0,78.0,74.0,2216,2474,1679,2295,537,179,168,233,30,29,138,204,46,46,1200,850,750,375,0,250,0
293,2,1,67.0,69.0,78.0,74.0,2328,2535,1679,2379,649,156,363,489,145,269,218,220,47,49,1450,1000,750,500,0,250,0
300,2,1,72.0,74.0,78.0,74.0,2468,2647,1819,2491,649,156,319,209,175,69,144,140,48,54,1450,950,750,500,0,300,0
307,2,1,73.0,74.0,93.0,74.0,2608,2759,1959,2603,649,156,315,339,95,179,220,160,49,54,1450,950,750,500,0,300,0
314,2,1,76.0,74.0,93.0,74.0,2530,2927,1903,2771,627,156,372,439,155,259,217,180,50,59,1450,950,1100,500,0,300,0
321,2,1,79.0,74.0,93.0,74.0,2619,3006,2015,2827,604,179,289,649,150,449,139,200,53,58,1450,1000,1100,500,0,300,0
329,2,1,81.0,74.0,93.0,98.0,2815,2972,2211,2771,604,201,620,733,405,509,215,224,55,56,1450,1000,1100,700,0,450,0
336,2,1,81.0,80.0,101.0,98.0,2972,2446,2323,2267,649,179,875,459,580,219,295,240,57,52,1775,1000,1100,700,125,700,0
343,2,1,84.0,78.0,101.0,106.0,3034,2283,2407,2127,627,156,496,664,275,404,221,260,58,49,1650,1150,1250,825,250,850,0
350,2,1,86.0,79.0,101.0,114.0,3039,2591,2435,2435,604,156,522,739,375,559,147,180,60,60,1650,1150,1250,825,250,850,0
357,2,1,92.0,84.0,101.0,114.0,3252,2854,2603,2519,649,335,202,531,125,299,77,232,62,60,1650,1150,1250,1075,250,850,0
364,2,1,94.0,85.0,109.0,114.0,3146,3062,2519,2435,627,627,274,406,125,194,149,212,64,61,1900,1150,1550,1075,250,850,0
371,2,1,99.0,84.0,109.0,114.0,3213,3291,2407,2575,806,716,373,241,270,199,103,42,66,63,2250,1150,1550,1075,250,850,0
379,2,1,99.0,83.5,117.0,122.0,3582,3375,2575,2659,1007,716,663,641,440,519,223,122,67,66,2250,1125,1550,1075,250,875,0
386,2,1,104.0,98.5,125.0,122.0,3678,3286,2715,2547,963,739,590,270,405,214,185,56,69,67,2250,1225,1650,1075,250,875,0
393,2,1,108.0,98.5,125.0,122.0,3711,3308,2771,2435,940,873,277,672,130,504,147,168,69,67,2250,1225,1950,1075,250,875,0
400,2,1,108.0,108.0,125.0,114.0,3711,3560,2771,2575,940,985,618,402,355,189,263,213,70,67,2250,1150,1950,1075,250,1100,0
407,2,1,111.0,112.0,133.0,114.0,3762,3700,2799,2715,963,985,423,647,340,314,83,333,70,67,2550,1750,2100,1075,250,1100,0
414,2,1,113.0,113.0,141.0,122.0,3806,3706,2799,2743,1007,963,513,519,360,74,153,445,70,70,2550,2050,2100,1075,250,1100,0
421,2,1,118.0,111.0,141.0,122.0,3862,3549,2855,2519,1007,1030,565,734,450,169,115,565,70,68,3250,2050,2100,1075,250,1150,0
427,2,1,118.0,108.0,141.0,122.0,3862,2910,2855,2015,1007,895,565,766,450,129,115,637,70,63,3250,2050,2100,1075,250,1500,0
7,1,1,13.0,13.0,14.0,14.0,251,335,251,335,0,0,30,40,30,40,0,0,12,12,0,0,0,0,0,0,1
14,1,1,13.0,13.0,14.0,14.0,671,643,671,643,0,0,20,15,20,15,0,0,13,13,0,0,0,0,0,0,1
21,1,1,14.0,14.0,14.0,14.0,727,727,727,727,0,0,50,55,50,55,0,0,13,13,0,0,0,0,0,0,1
29,1,1,14.0,14.0,14.0,14.0,755,727,755,727,0,0,140,145,140,145,0,0,13,13,0,0,0,0,0,0,1
36,1,1,16.0,16.0,22.0,22.0,839,783,839,783,0,0,150,140,150,140,0,0,14,14,0,0,0,0,0,0,1
43,1,1,16.0,16.0,22.0,22.0,839,811,839,811,0,0,235,235,235,235,0,0,14,15,0,0,0,0,0,0,1
50,1,1,15.0,15.0,22.0,22.0,867,811,867,811,0,0,40,30,40,30,0,0,15,15,0,0,0,0,0,0,1
57,1,1,17.0,17.0,22.0,22.0,895,867,895,867,0,0,40,35,40,35,0,0,15,15,0,0,0,0,0,0,1
64,1,1,18.0,18.0,22.0,22.0,951,895,951,895,0,0,105,90,105,90,0,0,16,16,0,0,0,0,0,0,1
71,1,1,17.0,17.0,22.0,22.0,923,951,923,951,0,0,175,175,175,175,0,0,17,17,0,0,0,0,0,0,1
79,1,1,17.0,17.0,22.0,22.0,951,923,951,923,0,0,40,35,40,35,0,0,16,16,0,0,0,0,0,0,1
86,1,1,18.0,18.0,22.0,22.0,979,923,979,923,0,0,110,100,110,100,0,0,16,16,0,0,0,0,0,0,1
93,1,1,19.0,19.0,22.0,22.0,1001,973,979,951,22,22,164,164,160,160,4,4,18,18,0,0,0,0,0,0,1
100,1,1,20.0,20.0,22.0,22.0,1018,978,951,867,67,111,237,235,225,215,12,20,18,19,0,0,0,0,0,0,1
107,1,1,20.0,20.0,22.0,22.0,1062,1107,951,951,111,156,363,370,335,330,28,40,19,19,0,0,0,0,0,0,1
114,1,1,21.0,21.0,22.0,22.0,1113,1079,979,923,134,156,374,450,330,390,44,60,20,20,0,0,0,0,0,0,1
121,1,1,25.0,26.0,28.0,28.0,1051,1158,895,979,156,179,144,130,80,50,64,80,19,20,0,0,250,250,0,0,1
129,1,1,26.0,26.0,28.0,28.0,1107,1158,951,979,156,179,229,70,145,70,84,0,20,21,0,0,250,250,0,0,1
136,1,1,27.0,28.0,28.0,28.0,1051,1191,895,1035,156,156,214,111,110,95,104,16,22,21,0,0,250,250,0,0,1
143,1,1,27.0,30.0,28.0,36.0,1242,1258,1063,1147,179,111,159,163,135,135,24,28,22,22,0,50,375,250,0,0,1
150,1,1,28.0,30.0,36.0,36.0,1275,1230,1119,1119,156,111,260,304,220,260,40,44,23,23,0,50,375,250,0,0,1
157,1,1,33.0,29.0,36.0,36.0,1359,1309,1203,1175,156,134,125,170,65,110,60,60,23,24,300,350,375,250,0,0,1
164,1,1,34.0,32.0,36.0,36.0,1359,1314,1203,1203,156,111,235,72,155,0,80,72,25,24,350,350,375,250,0,0,1
171,1,1,34.0,31.5,36.0,36.0,1382,1449,1203,1315,179,134,315,248,215,160,100,88,26,24,350,325,375,250,0,25,1
179,1,1,35.0,33.0,36.0,44.0,1438,1421,1259,1287,179,134,140,324,120,220,20,104,26,24,350,350,375,250,0,50,1
186,1,1,35.0,34.0,36.0,44.0,1443,1398,1287,1287,156,111,201,306,165,190,36,116,26,23,350,450,375,250,0,50,1
193,1,1,36.0,40.0,36.0,44.0,1527,1370,1371,1259,156,111,141,177,85,45,56,132,27,23,500,550,375,250,0,50,1
200,1,1,40.0,40.0,44.0,44.0,1499,1449,1343,1315,156,134,121,233,45,85,76,148,27,23,500,550,500,250,0,50,1
207,1,1,42.0,41.0,44.0,44.0,1583,1370,1427,1259,156,111,206,350,110,190,96,160,29,23,500,800,500,250,0,50,1
214,1,1,41.0,43.0,44.0,44.0,1662,1370,1483,1259,179,111,81,106,65,80,16,26,32,23,500,950,500,375,0,50,1
221,1,1,40.0,46.0,44.0,52.0,1639,1365,1483,1231,156,134,97,72,65,30,32,42,32,23,450,950,500,375,50,100,1
229,1,1,40.0,47.5,44.0,58.0,1695,1393,1539,1259,156,134,122,88,70,30,52,58,31,25,450,875,700,375,50,175,1
236,1,1,43.0,47.5,44.0,58.0,1835,1454,1679,1343,156,111,192,115,120,45,72,70,32,30,450,725,1075,375,50,325,1
243,1,1,41.0,46.0,44.0,58.0,1723,1561,1567,1427,156,134,317,296,225,210,92,86,36,32,300,650,1075,375,200,400,1
250,1,1,43.0,46.0,44.0,58.0,1830,1734,1651,1623,179,111,182,198,120,100,62,98,35,34,300,600,1200,375,200,450,1
257,1,1,43.0,48.5,44.0,58.0,1751,1818,1595,1707,156,111,493,204,315,90,178,114,35,33,300,575,1125,375,400,475,1
264,1,1,44.0,51.0,44.0,58.0,1751,1897,1483,1763,268,134,158,180,90,50,68,130,35,35,300,550,1125,375,400,500,1
271,1,1,44.0,52.5,44.0,58.0,1958,1925,1511,1791,447,134,299,316,175,170,124,146,35,37,500,525,1125,375,525,525,1
279,1,1,44.0,54.0,68.0,58.0,1981,1930,1511,1819,470,111,339,203,155,145,184,58,36,40,500,500,1125,375,525,550,1
286,1,1,42.0,54.0,68.0,66.0,1432,2132,1119,1931,313,201,482,326,270,240,212,86,34,40,500,600,1125,375,625,700,1
293,1,1,52.0,60.0,92.0,66.0,1242,2222,1063,1931,179,291,142,152,35,30,107,122,34,40,500,650,1325,575,625,750,1
300,1,1,56.0,62.0,92.0,66.0,1813,2339,1455,2071,358,268,179,339,70,185,109,154,34,48,500,650,1325,575,625,750,1
307,1,1,60.0,63.0,92.0,66.0,1925,2362,1455,2071,470,291,214,470,95,280,119,190,34,48,800,650,1325,575,625,750,1
314,1,1,64.0,65.0,92.0,74.0,1975,2552,1483,2239,492,313,34,576,5,350,29,226,34,48,1000,850,1325,575,625,750,1
321,1,1,68.0,73.0,92.0,82.0,1970,2535,1455,2267,515,268,84,274,45,220,39,54,34,48,1300,900,1200,575,625,750,1
329,1,1,70.0,70.5,92.0,90.0,1925,2815,1455,2547,470,268,211,460,145,370,66,90,34,46,1400,975,1200,575,625,775,1
336,1,1,74.0,81.5,92.0,90.0,1919,2670,1427,2379,492,291,231,111,155,85,76,26,34,46,1600,975,1200,825,625,775,1
343,1,1,78.0,81.5,92.0,90.0,1807,2647,1315,2379,492,268,256,433,170,375,86,58,34,49,1800,1375,1200,825,625,775,1
350,1,1,84.0,89.5,92.0,98.0,1813,2474,1343,2183,470,291,82,219,15,175,67,44,34,49,2100,1375,1200,825,625,775,1
357,1,1,88.0,89.5,92.0,106.0,1970,2608,1455,2071,515,537,117,255,40,235,77,20,34,49,2300,1775,1200,825,625,775,1
364,1,1,90.0,94.0,92.0,114.0,1925,2698,1455,2071,470,627,144,167,40,150,104,17,34,52,2600,1750,1200,825,625,800,1
371,1,1,92.0,100.0,100.0,122.0,1964,2709,1539,2127,425,582,282,200,155,190,127,10,34,52,2600,1950,1200,825,625,800,1
379,1,1,96.0,106.0,100.0,122.0,1992,2754,1567,2127,425,627,328,141,195,130,133,11,34,52,2800,2050,1200,825,625,800,1
386,1,1,99.0,106.5,108.0,122.0,1958,2905,1511,2323,447,582,256,294,117,240,139,54,33,51,3000,2225,1200,825,518,825,1
393,1,1,105.0,114.5,108.0,130.0,1925,2955,1455,2351,470,604,187,255,67,225,120,30,33,51,3200,2625,1200,825,518,825,1
400,1,1,108.0,116.5,108.0,130.0,1874,2922,1427,2295,447,627,205,401,137,345,68,56,33,51,3200,2725,1200,975,518,925,1
407,1,1,104.0,121.0,108.0,130.0,1902,2972,1455,2323,447,649,242,457,122,400,120,57,33,51,3300,2950,1200,975,718,1000,1
414,1,1,104.0,124.5,108.0,130.0,1880,2899,1455,2295,425,604,154,500,57,450,97,50,33,51,3400,3025,1325,975,1018,1125,1
421,1,1,90.0,114.0,124.0,130.0,1846,2894,1399,2267,447,627,90,447,12,425,78,22,33,51,2400,2550,1325,1125,2018,2100,1
427,1,1,80.0,110.5,124.0,130.0,1925,2922,1455,2295,470,627,184,382,87,350,97,32,33,51,1800,2075,1325,1125,2618,2575,1
7,0,2,13.0,13.0,15.0,15.0,251,293,251,293,0,0,30,35,30,35,0,0,12,12,0,0,0,0,0,0,0
14,0,2,14.0,14.0,15.0,15.0,671,671,671,671,0,0,70,70,70,70,0,0,13,13,0,0,0,0,0,0,0
21,0,2,14.0,14.0,15.0,15.0,727,727,727,727,0,0,50,50,50,50,0,0,13,13,0,0,0,0,0,0,0
29,0,2,15.0,15.0,15.0,15.0,699,699,699,699,0,0,85,85,85,85,0,0,14,14,0,0,0,0,0,0,0
36,0,2,15.0,15.0,15.0,15.0,727,839,727,839,0,0,130,145,130,145,0,0,14,14,0,0,0,0,0,0,0
43,0,2,16.0,16.0,23.0,23.0,839,755,839,755,0,0,80,25,80,25,0,0,15,15,0,0,0,0,0,0,0
50,0,2,16.0,17.0,23.0,23.0,755,783,755,783,0,0,40,45,40,45,0,0,15,16,0,0,0,0,0,0,0
57,0,2,17.0,18.0,23.0,23.0,783,811,783,811,0,0,130,105,130,105,0,0,16,17,0,0,0,0,0,0,0
64,0,2,18.0,19.0,23.0,23.0,811,895,811,895,0,0,185,150,185,150,0,0,17,18,0,0,0,0,0,0,0
71,0,2,18.0,19.0,23.0,23.0,822,895,755,895,67,0,272,215,260,215,12,0,17,18,0,0,0,0,0,0,0
79,0,2,19.0,20.0,23.0,23.0,855,900,699,811,156,89,322,326,290,310,32,16,18,19,0,0,0,0,0,0,0
86,0,2,19.0,20.0,23.0,23.0,799,950,643,839,156,111,427,443,375,415,52,28,18,19,0,0,0,150,0,0,0
93,0,2,19.0,20.0,23.0,23.0,906,922,727,811,179,111,287,155,265,115,22,40,19,20,0,0,150,150,0,0,0
100,0,2,19.0,21.0,23.0,23.0,878,1029,699,895,179,134,392,86,350,30,42,56,19,20,0,0,150,150,0,0,0
107,0,2,19.0,21.0,23.0,23.0,911,1029,755,895,156,134,103,127,45,55,58,72,19,20,0,0,150,150,0,0,0
114,0,2,19.0,22.0,23.0,23.0,967,1079,811,923,156,156,123,208,45,120,78,88,19,21,0,0,150,150,0,0,0
121,0,2,20.0,22.0,23.0,23.0,911,1051,755,895,156,156,173,233,75,125,98,108,19,21,0,0,150,150,0,0,0
129,0,2,23.0,23.0,23.0,23.0,1079,1074,923,895,156,179,173,317,55,185,118,132,20,22,0,0,250,150,0,0,0
136,0,2,23.0,23.0,23.0,23.0,1079,1191,923,923,156,268,313,183,175,90,138,93,20,23,0,0,250,300,0,0,0
143,0,2,26.0,26.0,31.0,31.0,1158,1292,979,979,179,313,303,339,145,210,158,129,21,23,100,0,250,300,0,0,0
150,0,2,26.0,27.0,31.0,31.0,1158,1258,979,923,179,335,198,179,120,110,78,69,21,24,100,0,250,300,0,0,0
157,0,2,27.0,29.0,31.0,31.0,1135,1236,979,923,156,313,139,95,45,40,94,55,22,24,100,125,250,300,0,0,0
164,0,2,27.0,31.0,31.0,46.0,1331,1236,1175,923,156,313,194,195,80,100,114,95,22,25,200,125,250,300,0,0,0
171,0,2,30.0,31.0,31.0,46.0,1331,1398,1175,1063,156,335,244,275,110,140,134,135,23,25,200,125,250,300,0,0,0
179,0,2,30.0,33.0,46.0,46.0,1387,1398,1231,1063,156,335,204,240,50,65,154,175,23,27,200,125,250,300,0,0,0
186,0,2,31.0,35.0,46.0,46.0,1314,1404,1091,1091,223,313,300,351,118,140,182,211,24,29,250,125,250,300,37,0,0
193,0,2,33.0,35.0,46.0,46.0,1426,1538,1091,1203,335,335,375,451,153,200,222,251,25,29,300,300,500,300,37,0,0
200,0,2,34.0,37.0,46.0,46.0,1376,1572,1063,1259,313,313,496,537,238,250,258,287,25,31,300,300,650,550,37,0,0
207,0,2,34.0,38.0,46.0,46.0,1482,1684,1147,1371,335,313,541,352,293,250,248,102,25,31,400,300,650,550,37,0,0
214,0,2,36.0,42.0,46.0,46.0,1432,1712,1119,1399,313,313,507,182,223,90,284,92,26,33,400,300,650,550,37,0,0
221,0,2,39.0,43.0,46.0,46.0,1600,1818,1287,1483,313,335,422,402,98,270,324,132,27,34,400,300,800,550,37,0,0
229,0,2,44.0,42.0,46.0,46.0,1768,1846,1455,1511,313,335,332,622,93,400,239,222,28,35,400,400,800,700,37,0,0
236,0,2,46.0,45.0,54.0,54.0,1930,2014,1595,1679,335,335,217,693,38,510,179,183,30,37,400,400,800,700,37,0,0
243,0,2,47.0,45.0,54.0,54.0,2065,1986,1707,1651,358,335,417,818,198,595,219,223,30,37,550,400,800,700,37,0,0
250,0,2,50.0,47.0,54.0,54.0,1986,2104,1651,1791,335,313,223,569,93,310,130,259,32,39,550,400,800,700,37,0,0
257,0,2,54.0,51.0,54.0,54.0,2104,1964,1791,1651,313,313,239,444,73,245,166,199,32,39,875,850,800,1000,37,0,0
264,0,2,56.0,51.0,62.0,54.0,2272,2070,1959,1735,313,335,519,199,313,160,206,39,33,41,875,850,800,1000,37,0,0
271,0,2,57.0,53.0,62.0,54.0,2328,2126,2015,1679,313,447,389,254,243,155,146,99,35,41,975,850,800,1000,37,0,0
279,0,2,59.0,59.0,62.0,62.0,2132,2289,1819,1819,313,470,294,525,108,370,186,155,35,41,1025,850,800,1000,37,0,0
286,0,2,64.0,61.0,70.0,62.0,2154,2367,1819,1875,335,492,319,715,93,500,226,215,37,43,1075,850,800,1000,37,0,0
293,0,2,67.0,61.0,70.0,70.0,2434,2339,2099,1847,335,492,305,890,168,615,137,275,37,43,1350,850,800,1000,37,0,0
300,0,2,69.0,61.0,70.0,70.0,2373,2289,2015,1707,358,582,404,507,223,260,181,247,39,45,1350,850,800,1000,37,0,0
307,0,2,72.0,63.0,78.0,70.0,2300,2328,1875,1679,425,649,241,402,58,225,183,177,39,45,1500,850,1050,1000,37,0,0
314,0,2,74.0,63.0,78.0,78.0,2322,2378,1875,1707,447,671,211,683,68,430,143,253,41,45,1500,850,1050,1000,37,0,0
321,0,2,74.0,73.0,78.0,86.0,2429,2552,1959,1903,470,649,416,219,263,140,153,79,41,47,1775,1350,1200,1000,37,0,0
329,0,2,77.0,74.0,86.0,101.0,2787,2496,2295,1847,492,649,246,260,133,105,113,155,43,47,1925,1525,1325,1000,37,0,0
336,0,2,80.0,76.0,86.0,101.0,2866,2552,2351,1903,515,649,301,275,253,140,48,135,43,49,1925,1525,1325,1250,37,0,0
343,0,2,82.0,80.0,86.0,101.0,2782,2496,2267,1847,515,649,192,246,88,85,104,161,43,51,2025,1700,1325,1250,37,0,0
350,0,2,85.0,83.0,102.0,101.0,2681,2630,2211,1959,470,671,299,301,243,110,56,191,43,52,2075,1700,1325,1550,37,0,0
357,0,2,87.0,85.0,102.0,109.0,2597,2608,2127,1959,470,649,199,372,183,105,16,267,43,55,2075,1875,1425,1550,37,0,0
364,0,2,92.0,91.0,102.0,109.0,2513,2832,2043,2183,470,649,134,223,58,80,76,143,43,55,2500,2375,1425,1650,37,0,0
371,0,2,95.0,97.0,102.0,117.0,2429,2950,1959,2323,470,627,159,124,148,5,11,119,43,57,2500,2375,1425,1650,37,0,0
379,0,2,99.0,98.0,102.0,117.0,2530,3056,2015,2407,515,649,184,339,113,140,71,199,43,57,2700,2725,1425,1650,37,0,0
386,0,2,102.0,100.0,118.0,117.0,2356,3084,1819,2435,537,649,274,504,243,225,31,279,43,60,3150,2725,1425,1650,37,0,0
393,0,2,103.0,104.0,118.0,117.0,2311,3084,1819,2435,492,649,456,535,373,280,83,255,43,60,3150,3075,1575,1800,37,0,0
400,0,2,108.0,107.0,118.0,133.0,2317,3274,1847,2603,470,671,542,275,403,140,139,135,43,62,3400,3075,1725,1800,37,0,0
407,0,2,111.0,108.0,126.0,133.0,2457,3386,1987,2715,470,671,377,291,303,80,74,211,43,63,3675,3575,1725,1800,37,0,0
414,0,2,119.0,114.0,134.0,133.0,2289,3392,1819,2743,470,649,157,402,123,115,34,287,43,65,3975,3575,1725,1800,37,0,0
421,0,2,120.0,116.0,134.0,133.0,2401,3482,1931,2855,470,627,232,618,138,255,94,363,43,68,4175,3775,1725,1800,37,0,0
429,0,2,122.0,116.0,142.0,133.0,2334,3392,1819,2743,515,649,512,808,358,465,154,343,43,68,4275,3775,1725,1800,37,0,0
436,0,2,125.0,120.0,150.0,133.0,2334,3482,1819,2855,515,627,438,529,228,110,210,419,43,70,4425,3775,1725,1800,87,0,0
443,0,2,125.0,120.0,150.0,133.0,2311,3392,1819,2743,492,649,354,934,88,435,266,499,43,70,4900,3975,1725,2150,137,0,0
450,0,2,126.0,120.0,150.0,125.0,2317,3504,1847,2855,470,649,640,1150,318,575,322,575,43,70,4950,3975,1725,2150,237,300,0
457,0,2,125.0,114.0,150.0,141.0,2233,3526,1763,2855,470,671,905,1375,523,720,382,655,43,70,4900,3375,1725,2450,487,900,0
464,0,2,134.0,124.0,150.0,141.0,2317,3616,1847,2967,470,649,210,1101,43,570,167,531,43,70,5000,3575,1725,2350,487,1000,0
471,0,2,138.0,122.0,150.0,141.0,2283,3420,1791,2771,492,649,490,1512,263,905,227,607,43,68,5200,3775,1725,2350,487,1100,0
479,0,2,139.0,121.0,150.0,133.0,2440,2552,1903,1903,537,649,300,1792,138,1105,162,687,43,67,5250,3775,1725,2350,487,1325,0
486,0,2,142.0,129.0,150.0,133.0,2283,2356,1791,1707,492,649,412,1678,198,915,214,763,43,67,5400,4175,1725,2350,487,1325,0
493,0,2,146.0,127.0,150.0,118.0,2345,2378,1875,1707,470,671,288,1963,18,1120,270,843,43,67,5600,4075,1725,2350,487,1825,0
500,0,2,150.0,127.0,150.0,110.0,2261,2882,1791,2211,470,671,473,2039,143,1120,330,919,43,67,6425,4075,1725,2350,487,1925,0
507,0,2,150.0,127.0,150.0,125.0,2261,2552,1791,1903,470,649,738,1715,348,720,390,995,43,67,6625,4075,1725,2350,487,2000,0
514,0,2,149.0,118.0,150.0,125.0,2289,3034,1819,2407,470,627,1033,1611,583,540,450,1071,43,67,6375,2925,1725,2350,837,3150,0
521,0,2,150.0,126.0,166.0,149.0,2306,3336,1791,2687,515,649,898,1421,388,470,510,951,43,67,6375,4025,1725,2350,837,3150,0
529,0,2,144.0,106.0,166.0,149.0,2390,3308,1875,2659,515,649,684,1806,318,775,366,1031,43,67,6100,2725,1725,2350,1337,4450,0
536,0,2,147.0,98.0,166.0,165.0,2367,3280,1875,2631,492,649,960,1897,538,790,422,1107,43,67,6250,2100,1725,2350,1387,5075,0
543,0,2,148.0,110.0,166.0,165.0,2289,3414,1819,2743,470,671,1126,1607,648,420,478,1187,43,67,6300,2700,1725,2350,1387,5075,0
550,0,2,137.0,86.0,166.0,165.0,2149,3364,1679,2715,470,649,1061,1989,648,730,413,1259,43,67,5900,1100,1725,2350,2087,6675,0
7,2,0,13.0,13.0,15.0,15.0,251,293,251,293,0,0,30,35,30,35,0,0,12,12,0,0,0,0,0,0,0
14,2,0,14.0,14.0,15.0,15.0,643,671,643,671,0,0,65,70,65,70,0,0,13,13,0,0,0,0,0,0,0
21,2,0,14.0,14.0,15.0,15.0,699,699,699,699,0,0,50,50,50,50,0,0,13,13,0,0,0,0,0,0,0
29,2,0,15.0,15.0,15.0,15.0,727,671,727,671,0,0,90,80,90,80,0,0,14,14,0,0,0,0,0,0,0
36,2,0,15.0,15.0,15.0,15.0,783,727,783,727,0,0,140,130,140,130,0,0,14,14,0,0,0,0,0,0,0
43,2,0,16.0,16.0,23.0,23.0,811,783,811,783,0,0,40,70,40,70,0,0,15,15,0,0,0,0,0,0,0
50,2,0,17.0,16.0,23.0,23.0,839,783,839,783,0,0,15,35,15,35,0,0,16,15,0,0,0,0,0,0,0
57,2,0,18.0,17.0,23.0,23.0,839,755,839,755,0,0,65,130,65,130,0,0,17,16,0,0,0,0,0,0,0
64,2,0,19.0,18.0,23.0,23.0,923,839,923,839,0,0,130,180,130,180,0,0,18,17,0,0,0,0,0,0,0
71,2,0,19.0,18.0,23.0,23.0,973,878,951,811,22,67,249,282,245,270,4,12,18,17,0,0,0,0,0,0,0
79,2,0,20.0,19.0,23.0,23.0,995,911,951,755,44,156,358,338,350,310,8,28,19,18,0,0,0,0,0,0,0
86,2,0,20.0,19.0,23.0,23.0,911,911,867,755,44,156,76,453,60,405,16,48,19,18,0,0,150,0,0,0,0
93,2,0,20.0,20.0,23.0,23.0,1046,883,979,727,67,156,54,358,30,290,24,68,20,19,0,0,150,150,0,0,0
100,2,0,21.0,20.0,23.0,23.0,1034,990,923,811,111,179,50,478,10,390,40,88,20,19,0,0,150,150,0,0,0
107,2,0,22.0,20.0,23.0,23.0,1079,1018,923,839,156,179,125,193,65,85,60,108,21,19,0,50,150,150,0,0,0
114,2,0,22.0,20.0,23.0,23.0,1051,995,895,839,156,156,110,109,30,35,80,74,21,19,0,50,150,150,0,0,0
121,2,0,23.0,21.0,23.0,23.0,1079,939,923,783,156,156,230,174,130,80,100,94,22,19,0,50,150,150,0,0,0
129,2,0,25.0,22.0,31.0,23.0,1135,1135,867,979,268,156,201,269,90,155,111,114,22,20,0,50,300,150,0,0,0
136,2,0,26.0,22.0,31.0,31.0,1169,1135,811,979,358,156,236,319,135,185,101,134,23,20,0,50,300,150,0,0,0
143,2,0,26.0,23.0,31.0,31.0,1174,1191,839,1035,335,156,72,419,35,265,37,154,23,21,0,50,300,150,0,0,0
150,2,0,29.0,25.0,31.0,31.0,1208,1270,895,1091,313,179,43,334,20,260,23,74,24,21,125,50,300,250,0,0,0
157,2,0,31.0,26.0,46.0,31.0,1292,1387,979,1231,313,156,103,505,40,415,63,90,25,22,125,50,300,250,0,0,0
164,2,0,32.0,27.0,46.0,31.0,1342,1415,1007,1259,335,156,163,215,60,105,103,110,26,23,125,50,300,250,0,0,0
171,2,0,36.0,27.0,46.0,31.0,1376,1387,1063,1231,313,156,104,370,15,240,89,130,28,23,300,50,300,350,0,0,0
179,2,0,34.0,27.0,46.0,46.0,1488,1415,1175,1259,313,156,114,225,85,75,29,150,28,24,300,250,550,350,0,0,0
186,2,0,38.0,30.0,46.0,46.0,1622,1359,1287,1203,335,156,74,225,55,55,19,170,30,24,300,250,550,350,0,0,0
193,2,0,39.0,30.0,46.0,46.0,1600,1466,1287,1287,313,179,65,270,10,80,55,190,31,24,300,250,550,350,0,0,0
200,2,0,40.0,33.0,46.0,46.0,1768,1522,1455,1343,313,179,121,290,30,80,91,210,32,25,300,350,550,350,0,0,0
207,2,0,42.0,34.0,46.0,46.0,1740,1583,1427,1427,313,156,226,371,95,145,131,226,34,25,300,350,550,350,0,0,0
214,2,0,42.0,35.0,54.0,46.0,1908,1527,1595,1371,313,156,121,316,50,170,71,146,34,26,475,350,550,350,0,0,0
221,2,0,44.0,39.0,54.0,46.0,1992,1723,1679,1567,313,156,292,116,185,50,107,66,36,28,475,450,550,625,0,0,0
229,2,0,45.0,39.0,54.0,46.0,2070,1667,1735,1511,335,156,487,76,340,15,147,61,37,29,475,450,550,625,0,0,0
236,2,0,46.0,41.0,54.0,61.0,2154,1863,1819,1707,335,156,322,206,135,125,187,81,38,30,475,550,550,625,0,0,0
243,2,0,49.0,44.0,54.0,61.0,2160,1942,1847,1763,313,179,254,131,85,30,169,101,40,31,650,550,550,625,0,0,0
250,2,0,50.0,45.0,54.0,61.0,2188,1880,1875,1679,313,201,359,70,150,45,209,25,40,32,650,550,700,800,0,0,0
257,2,0,54.0,47.0,62.0,61.0,2216,1830,1903,1539,313,291,334,211,135,150,199,61,42,33,650,550,700,1050,0,0,0
264,2,0,57.0,50.0,62.0,61.0,2154,1958,1819,1623,335,335,194,361,80,260,114,101,42,34,1000,650,950,1050,0,0,0
271,2,0,59.0,53.0,70.0,61.0,2294,2048,1959,1735,335,313,189,187,35,150,154,37,44,35,1000,700,950,1050,0,0,0
279,2,0,60.0,55.0,70.0,61.0,2322,1936,1987,1623,335,313,455,127,265,100,190,27,45,37,1000,800,950,1050,0,0,0
286,2,0,63.0,58.0,70.0,61.0,2272,1986,1959,1651,313,335,441,92,265,25,176,67,46,38,1275,800,950,1050,0,0,0
293,2,0,67.0,61.0,78.0,61.0,2322,2182,1875,1847,447,335,455,187,265,80,190,107,48,41,1275,850,950,1050,0,0,0
300,2,0,67.0,61.0,78.0,69.0,2563,2468,1959,2155,604,313,397,248,335,130,62,118,48,42,1450,750,950,1050,0,100,0
307,2,0,69.0,66.0,93.0,69.0,2384,2714,1847,2379,537,335,276,313,150,155,126,158,50,43,1450,850,950,1300,0,100,0
314,2,0,71.0,66.0,93.0,69.0,2328,2681,1791,2323,537,358,449,547,255,370,194,177,51,45,1450,850,950,1400,0,100,0
321,2,0,71.0,68.0,93.0,69.0,2619,2860,2015,2435,604,425,666,354,400,350,266,4,53,46,1325,975,950,1400,125,100,0
329,2,0,72.0,75.0,101.0,85.0,2815,2989,2211,2519,604,470,404,379,70,315,334,64,54,45,1325,1025,950,1400,125,200,0
336,2,0,73.0,73.0,101.0,85.0,2910,3067,2351,2575,559,492,698,720,300,600,398,120,56,47,1225,875,1450,1625,225,350,0
343,2,0,75.0,75.0,101.0,85.0,3045,3118,2463,2603,582,515,201,585,35,455,166,130,58,48,1225,875,1450,1625,225,350,0
350,2,0,79.0,79.0,101.0,85.0,3050,2871,2491,2379,559,492,109,561,25,400,84,161,60,48,1425,1300,1450,1625,225,350,0
357,2,0,80.0,82.0,101.0,85.0,3151,2950,2547,2323,604,627,341,511,185,395,156,116,62,50,1425,1500,1450,1625,225,350,0
364,2,0,81.0,85.0,101.0,85.0,3263,2759,2659,2155,604,604,669,524,445,440,224,84,63,50,1425,1550,1450,1525,225,500,0
371,2,0,81.0,85.0,109.0,93.0,3375,3034,2771,2407,604,627,1076,644,780,505,296,139,64,50,1425,1475,1450,1525,225,700,0
379,2,0,83.0,89.0,109.0,93.0,3358,2826,2799,2155,559,671,965,269,705,150,260,119,65,52,1525,1525,1750,1525,225,700,0
386,2,0,89.0,91.0,109.0,93.0,3375,2793,2659,2099,716,694,599,254,485,155,114,99,65,53,1525,1625,2050,1625,225,700,0
393,2,0,97.0,92.0,117.0,93.0,3431,2552,2491,1903,940,649,250,211,170,165,80,46,65,54,1925,2150,2200,1925,225,700,0
400,2,0,98.0,93.0,117.0,93.0,3442,2720,2547,2071,895,649,614,142,430,70,184,72,65,56,2225,2275,2200,1925,225,700,0
407,2,0,100.0,105.0,125.0,109.0,3644,3168,2659,2519,985,649,490,482,340,330,150,152,65,57,2225,2325,2200,2050,225,700,0
414,2,0,106.0,107.0,125.0,109.0,3554,3566,2547,2939,1007,627,305,88,135,35,170,53,66,58,2800,2325,2500,2050,225,700,0
421,2,0,112.0,109.0,125.0,109.0,3571,3342,2631,2715,940,627,519,203,245,120,274,83,66,59,3050,2375,2650,2125,225,700,0
429,2,0,112.0,109.0,133.0,109.0,3650,3470,2687,2799,963,671,869,233,475,145,394,88,66,61,3350,2875,2650,2475,225,700,0
436,2,0,116.0,109.0,141.0,109.0,3560,3353,2575,2659,985,694,874,418,660,275,214,143,66,61,3550,2875,2650,2475,225,700,0
443,2,0,122.0,124.0,141.0,125.0,3543,3442,2603,2771,940,671,307,229,135,85,172,144,66,61,3350,2875,2650,2475,225,700,0
450,2,0,122.0,125.0,141.0,125.0,3577,3521,2659,2715,918,806,494,323,310,150,184,173,66,64,4350,3100,2650,2475,225,700,0
457,2,0,126.0,125.0,149.0,125.0,3734,3487,2771,2547,963,940,139,59,85,45,54,14,66,64,4350,3200,2650,2475,225,700,0
464,2,0,126.0,132.0,149.0,133.0,3616,3487,2631,2547,985,940,454,449,280,315,174,134,66,64,4700,3775,2800,2575,225,750,0
471,2,0,126.0,132.0,149.0,133.0,3588,3599,2603,2659,985,940,891,500,605,300,286,200,66,64,4700,3775,2800,2775,225,750,0
479,2,0,131.0,133.0,149.0,133.0,3633,3857,2603,2827,1030,1030,761,385,505,315,256,70,66,64,4900,3875,2800,2775,225,750,0
486,2,0,139.0,133.0,149.0,133.0,3728,4008,2743,3023,985,985,818,312,450,130,368,182,69,63,4900,3875,2800,2775,225,800,0
493,2,0,143.0,140.0,149.0,141.0,3515,3902,2575,2939,940,963,315,554,185,285,130,269,69,63,5200,4275,3450,2775,325,850,0
500,2,0,149.0,145.0,165.0,157.0,3728,3902,2743,2939,985,963,275,534,225,220,50,314,69,64,5200,4425,3600,2775,325,850,0
507,2,0,157.0,144.0,173.0,157.0,3566,3930,2603,2967,963,963,72,655,60,400,12,255,69,65,5300,4425,3600,2775,325,900,0
514,2,0,157.0,146.0,188.0,157.0,3683,3991,2743,3051,940,940,533,871,405,550,128,321,69,65,5825,4650,3600,2775,325,1000,0
521,2,0,153.0,147.0,188.0,165.0,3358,4092,2351,3107,1007,985,903,1136,655,820,248,316,69,65,5475,4875,3600,2775,675,1100,0
529,2,0,149.0,149.0,188.0,165.0,3386,3997,2379,2967,1007,1030,569,341,405,180,164,161,69,65,5275,5375,3600,2875,875,1100,0
536,2,0,155.0,155.0,188.0,165.0,3482,3784,2519,2799,963,985,491,359,415,265,76,94,69,66,5775,5500,3600,2875,875,1100,0
543,2,0,165.0,157.0,188.0,165.0,3874,3846,2911,2883,963,963,157,601,65,395,92,206,69,66,6275,5625,3600,2875,875,1100,0
550,2,0,174.0,162.0,196.0,165.0,3840,3790,2855,2827,985,963,113,616,5,440,108,176,69,66,6275,5625,3600,2975,875,1100,0
557,2,0,181.0,165.0,196.0,165.0,3846,3739,2883,2799,963,940,529,782,305,515,224,267,69,67,7125,5900,3750,2975,875,1100,0
564,2,0,179.0,171.0,204.0,188.0,3846,3739,2883,2799,963,940,690,517,350,280,340,237,73,67,7025,6725,3750,2975,975,1100,0
571,2,0,179.0,170.0,204.0,196.0,3885,3521,2855,2491,1030,1030,1155,867,695,510,460,357,73,66,7525,6925,3750,2975,975,1300,0
579,2,0,194.0,171.0,204.0,196.0,3874,3577,2911,2547,963,1030,278,698,135,450,143,248,73,67,8400,7050,3750,3425,975,1350,0
586,2,0,194.0,172.0,204.0,204.0,3991,3375,3051,2435,940,940,494,747,285,545,209,202,73,68,8825,7050,3750,3425,1075,1350,0
593,2,0,188.0,177.0,204.0,212.0,3958,3706,2995,2743,963,963,964,637,635,490,329,147,73,69,8625,7050,3750,3425,1375,1350,0
600,2,0,189.0,177.0,204.0,212.0,3952,3711,2967,2771,985,940,1329,1083,955,820,374,263,73,69,8625,7500,3750,3575,1375,1350,0
607,2,0,187.0,180.0,204.0,212.0,3986,3599,3023,2659,963,940,1811,1074,1325,845,486,229,73,70,9025,7300,3750,3675,1475,1825,0
614,2,0,186.0,181.0,212.0,212.0,3980,3700,2995,2715,985,985,1672,1339,1370,1015,302,324,73,70,8825,7325,4050,3775,1675,1925,0
621,2,0,167.0,169.0,212.0,212.0,3974,3829,2967,2799,1007,1030,2147,1569,1725,1150,422,419,73,70,7475,6500,4050,3775,3125,3025,0
629,2,0,183.0,179.0,212.0,212.0,3935,3812,2995,2827,940,985,1805,411,1275,280,530,131,73,70,7575,6750,4050,3775,3125,3125,0
636,2,0,187.0,181.0,212.0,212.0,3874,3756,2911,2771,963,985,911,598,265,355,646,243,73,70,8275,7150,4050,3775,3125,3125,0
643,2,0,188.0,186.0,212.0,212.0,3924,3482,2939,2519,985,963,776,119,310,85,466,34,77,73,8275,7275,4050,3775,3125,3225,0
650,2,0,191.0,187.0,220.0,212.0,3986,3543,3023,2603,963,940,243,370,165,245,78,125,77,74,8575,7375,4050,3775,3125,3225,0
657,2,0,178.0,191.0,220.0,212.0,3930,3627,2967,2687,963,940,709,700,515,480,194,220,78,75,8075,8375,4050,3875,3925,3225,0
664,2,0,178.0,196.0,220.0,212.0,3974,3834,2967,2827,1007,1007,974,370,660,305,314,65,78,76,7725,8750,4200,3875,4275,3225,0
671,2,0,178.0,195.0,220.0,212.0,4002,3829,2883,2799,1119,1030,1159,571,855,390,304,181,82,76,7725,8700,4500,3875,4275,3275,0
679,2,0,175.0,187.0,220.0,212.0,4187,3767,2911,2827,1276,940,1661,1030,1205,745,456,285,82,77,7500,8600,4500,3875,4800,3725,0
686,2,0,178.0,186.0,220.0,212.0,4070,3790,2771,2827,1299,963,1842,1205,1380,825,462,380,82,77,7800,8375,4500,3875,4800,4075,0
693,2,0,150.0,184.0,220.0,220.0,4154,3874,2855,2911,1299,963,2363,1675,1745,1175,618,500,82,78,5500,8275,4500,3875,7100,4175,0
700,2,0,143.0,190.0,220.0,220.0,4075,4070,2799,2995,1276,1075,939,1546,715,1135,224,411,82,78,3050,8250,4500,3875,9550,4300,0
707,2,0,134.0,187.0,235.0,235.0,4120,4103,2799,3051,1321,1052,1135,1439,905,1000,230,439,82,78,3950,7525,4500,3875,10550,5150,0
714,2,0,140.0,186.0,235.0,235.0,4170,4047,2827,2883,1343,1164,1076,1755,840,1180,236,575,82,78,4150,7275,4500,3875,10650,5400,0
721,2,0,140.0,190.0,235.0,235.0,4075,4182,2799,2995,1276,1187,1269,1285,1035,770,234,515,82,78,4150,7500,4500,3875,10650,5400,0
729,2,0,155.0,195.0,235.0,235.0,4243,4036,2967,2827,1276,1209,235,1474,95,840,140,634,87,80,3550,8150,4800,3875,11250,5400,0
736,2,0,145.0,189.0,235.0,235.0,4238,4137,2939,2883,1299,1254,451,1791,305,1055,146,736,87,80,4050,7675,4800,3875,11750,6375,0
743,2,0,128.0,168.0,235.0,235.0,4327,3963,3051,2799,1276,1164,968,2242,670,1370,298,872,88,80,3050,5825,4800,3875,13050,8350,0
750,2,0,128.0,150.0,235.0,235.0,4417,4019,3163,2855,1254,1164,1209,1354,905,830,304,524,88,80,3050,3150,4800,3875,13350,11300,0
757,2,0,145.0,160.0,235.0,235.0,4546,4081,3247,2827,1299,1254,440,1211,280,710,160,501,88,80,4100,3350,4800,3875,13350,11300,0
764,2,0,142.0,160.0,235.0,235.0,4506,3952,3163,2631,1343,1321,1135,1108,815,730,320,378,88,80,4200,3450,4800,3875,13350,11300,0
771,2,0,145.0,164.0,235.0,235.0,4361,3829,3107,2575,1254,1254,794,1138,480,720,314,418,88,80,4500,3900,4800,3875,13350,11300,0
779,2,0,147.0,176.0,235.0,235.0,4316,3834,2995,2603,1321,1231,974,827,650,365,324,462,88,80,4500,4775,4800,3875,13350,11300,0
786,2,0,163.0,178.0,235.0,235.0,4562,3857,3219,2603,1343,1254,419,888,185,420,234,468,88,80,4725,4775,4800,3875,13625,11400,0
793,2,0,163.0,178.0,235.0,235.0,4579,3812,3303,2603,1276,1209,962,661,580,320,382,341,88,80,5825,4925,4800,4300,13625,11400,0
800,2,0,166.0,190.0,235.0,235.0,4406,3694,3107,2463,1299,1231,968,557,430,135,538,422,88,80,6125,6300,5100,4300,13625,11400,0
807,2,0,164.0,190.0,235.0,250.0,4529,4064,3051,2743,1478,1321,1512,1044,790,470,722,574,88,80,6025,6425,5350,4300,13725,11400,0
814,2,0,177.0,190.0,235.0,250.0,4585,4086,2995,2743,1590,1343,800,1215,515,635,285,580,88,80,7575,6700,5350,4300,13725,11400,0
821,2,0,177.0,192.0,235.0,250.0,4691,3941,3079,2687,1612,1254,1357,1186,880,620,477,566,88,80,7575,7175,5350,4300,13725,11600,0
829,2,0,185.0,192.0,243.0,250.0,4770,4310,3135,3079,1635,1231,782,1703,605,985,177,718,88,80,8875,7175,5350,4300,13725,11600,0
836,2,0,185.0,196.0,243.0,250.0,4809,4389,3219,3135,1590,1254,900,2010,685,1165,215,845,88,81,8875,7225,5350,4550,13725,11600,0
843,2,0,183.0,196.0,243.0,250.0,4803,4316,3191,3107,1612,1209,1062,2533,705,1540,357,993,87,81,8575,7350,5350,4850,14225,11600,0
850,2,0,177.0,176.0,243.0,250.0,4142,4305,2575,3051,1567,1254,972,3049,585,1900,387,1149,83,81,8850,6350,5100,4850,15400,12875,0
857,2,0,177.0,177.0,243.0,250.0,3370,4422,1847,3079,1523,1343,997,1920,530,1165,467,755,81,81,9025,5050,5100,4850,15675,14400,0
864,2,0,181.0,178.0,243.0,250.0,3263,4406,1875,3107,1388,1299,909,1613,440,1110,469,503,81,81,9025,5050,5100,4850,15675,14400,0
871,2,0,181.0,188.0,243.0,250.0,3862,4473,2519,3219,1343,1254,1369,993,740,575,629,418,82,81,9025,5350,5500,4850,15675,14400,0
879,2,0,193.0,195.0,258.0,250.0,4109,4282,2743,3051,1366,1231,627,950,230,630,397,320,85,83,10075,5725,5500,4850,15675,14400,0
886,2,0,193.0,200.0,258.0,250.0,4075,4282,2575,3051,1500,1231,880,1175,295,756,585,419,85,84,10075,6050,5500,4850,15675,14400,0
893,2,0,193.0,197.0,258.0,250.0,4338,4450,2771,3219,1567,1231,1408,1695,635,1122,773,573,85,84,10075,6300,5500,4950,15675,14550,0
900,2,0,187.0,193.0,258.0,235.0,4294,4344,2659,3079,1635,1265,1933,1764,960,1198,973,566,85,77,9775,7100,5500,4950,15975,15650,0
907,2,0,199.0,200.0,266.0,235.0,4288,3941,2631,2743,1657,1198,929,361,510,115,419,246,85,75,9775,7675,5500,4950,15975,15750,0
914,2,0,197.0,200.0,266.0,235.0,4187,3610,2575,2491,1612,1119,331,1074,220,700,111,374,85,75,11100,7675,5800,4850,16150,15950,0
921,2,0,188.0,180.0,266.0,235.0,4243,3420,2519,2323,1724,1097,838,1462,515,960,323,502,85,70,10275,6975,5800,4750,16625,17125,0
929,2,0,175.0,185.0,266.0,235.0,4288,3314,2519,2239,1769,1075,746,1279,515,720,231,559,85,70,8575,6950,5800,4750,18325,17425,0
936,2,0,178.0,192.0,266.0,235.0,4618,3162,2827,2043,1791,1119,911,1167,460,495,451,672,85,70,8500,6950,5800,4750,18800,17425,0
943,2,0,188.0,192.0,266.0,235.0,4865,3230,3051,2043,1814,1187,664,1548,155,731,509,817,85,70,8500,7150,5800,4750,18800,17425,0
950,2,0,174.0,188.0,266.0,220.0,4786,3414,2995,2183,1791,1231,950,1924,375,971,575,953,85,71,7625,8375,5350,4750,20625,18356,0
957,2,0,166.0,154.0,266.0,220.0,4775,2754,3051,1567,1724,1187,800,1759,175,752,625,1007,85,50,7150,7275,5850,4750,21400,20781,0
964,2,0,172.0,154.0,266.0,220.0,4764,2653,2995,1511,1769,1142,837,1385,150,427,687,958,85,49,7550,6800,6450,4650,21775,21556,0
971,2,0,146.0,154.0,258.0,220.0,4663,2636,2995,1539,1668,1097,1395,1685,510,598,885,1087,85,49,5025,6900,6450,4550,24750,21656,0
979,2,0,154.0,163.0,258.0,220.0,4518,2591,2939,1539,1579,1052,1047,917,230,129,817,788,85,49,5725,7400,6450,4550,24925,21656,0
986,2,0,152.0,169.0,258.0,220.0,4327,2563,2827,1511,1500,1052,1262,886,415,140,847,746,85,49,5550,7650,6450,4550,25100,21656,0
993,2,0,166.0,172.0,258.0,220.0,4394,2266,2827,1259,1567,1007,740,992,305,128,435,864,85,49,6150,8025,6450,4550,25100,21656,0
1000,2,0,168.0,177.0,258.0,220.0,4338,2289,2771,1259,1567,1030,968,981,495,22,473,959,85,50,6950,8150,6450,4550,25100,21656,0
1007,2,0,172.0,179.0,258.0,220.0,4389,2244,2799,1259,1590,985,291,1115,155,54,136,1061,85,52,7150,8425,6450,4550,25100,21656,0
1014,2,0,172.0,182.0,266.0,220.0,4523,2440,2911,1455,1612,985,734,1219,485,71,249,1148,85,52,7500,8475,6450,4550,25100,21656,0
1021,2,0,174.0,180.0,266.0,220.0,4714,2490,3079,1483,1635,1007,901,1483,560,221,341,1262,85,55,7250,8900,6600,4550,25350,21756,0
1029,2,0,177.0,174.0,274.0,220.0,4590,2490,3023,1595,1567,895,1335,1789,810,419,525,1370,85,55,8150,9150,6600,4550,25350,22106,0
1036,2,0,182.0,176.0,266.0,220.0,4596,2642,3051,1679,1545,963,1389,1382,680,134,709,1248,82,55,7950,8900,6600,4550,25800,22481,0
1043,2,0,174.0,169.0,258.0,220.0,4473,2776,2995,1791,1478,985,1935,1113,1050,49,885,1064,82,55,8050,8125,6600,4550,26375,23256,0
1050,2,0,168.0,171.0,243.0,220.0,4411,2849,3023,1819,1388,1030,2450,1253,1405,169,1045,1084,76,55,8150,8175,6600,4550,27075,23256,0
1057,2,0,180.0,171.0,235.0,220.0,3924,2933,2603,1903,1321,1030,1702,1600,505,404,1197,1196,72,55,8150,8400,6350,4550,27700,23256,0
1064,2,0,160.0,165.0,235.0,220.0,3762,2787,2463,1847,1299,940,2144,1643,795,464,1349,1179,72,55,7350,8300,6350,4550,29200,23831,0
1071,2,0,160.0,171.0,235.0,220.0,3801,2916,2547,1931,1254,985,2248,1432,855,254,1393,1178,72,55,7050,8125,6350,4550,29500,24006,0
1079,2,0,172.0,171.0,235.0,220.0,3694,2759,2463,1819,1231,940,1525,1773,280,479,1245,1294,72,55,7400,8325,6350,4550,29500,24006,0
1086,2,0,168.0,163.0,235.0,220.0,3823,2916,2547,1931,1276,985,1992,1567,595,249,1397,1318,72,58,8050,7200,6350,4550,29500,25831,0
1093,2,0,166.0,161.0,235.0,220.0,3689,2899,2435,1847,1254,1052,1919,1638,620,229,1299,1409,72,58,8175,7125,6350,4550,29975,26306,0
1100,2,0,166.0,154.0,235.0,220.0,3750,2978,2519,2015,1231,963,1982,1196,535,79,1447,1117,72,59,8175,6000,6350,4550,29975,27631,0
1107,2,0,171.0,155.0,235.0,220.0,3840,3078,2519,2071,1321,1007,1738,1511,635,274,1103,1237,71,61,8925,6300,6350,4550,29975,27631,0
1114,2,0,163.0,152.0,227.0,220.0,3812,2843,2491,1903,1321,940,2170,1563,915,239,1255,1324,71,53,8225,6525,6350,4550,30775,27981,0
1121,2,0,167.0,154.0,227.0,205.0,3510,2664,2379,1679,1131,985,2232,1517,955,194,1277,1323,71,51,8575,6525,6350,4550,30775,28631,0
1129,2,0,171.0,155.0,227.0,205.0,3476,2418,2435,1455,1041,963,2242,1738,835,299,1407,1439,71,51,8300,7675,6350,4450,31050,28731,0
1136,2,0,177.0,157.0,227.0,197.0,3202,2345,2295,1427,907,918,1661,1651,450,229,1211,1422,67,49,8700,7775,6350,4225,31250,29156,0
1143,2,0,173.0,161.0,227.0,197.0,2916,2384,2155,1455,761,929,1962,1682,655,204,1307,1478,66,50,9050,7900,6350,4225,31650,29156,0
1150,2,0,173.0,159.0,227.0,189.0,2910,2160,2127,1455,783,705,2299,1683,900,179,1399,1504,66,50,9050,7975,6350,4225,31650,29556,0
1157,2,0,173.0,158.0,227.0,189.0,2871,2222,2043,1483,828,739,2550,1730,1055,159,1495,1571,67,50,9050,7675,6350,4225,31650,29856,0
1164,2,0,191.0,162.0,227.0,189.0,2726,2171,1987,1455,739,716,1265,1715,140,239,1125,1476,67,50,9300,8200,6350,4225,31650,29856,0
1171,2,0,193.0,166.0,242.0,189.0,2692,2098,1931,1427,761,671,1396,1704,325,194,1071,1510,67,50,11075,8325,6350,4225,31650,29856,0
1179,2,0,193.0,168.0,250.0,189.0,2720,1930,1959,1203,761,727,1253,1809,90,234,1163,1575,67,50,11075,8425,6350,4225,31650,29856,0
1186,2,0,193.0,171.0,250.0,189.0,2972,1858,2211,1287,761,571,1619,1724,360,239,1259,1485,67,50,11075,8550,6350,4225,31650,29856,0
1193,2,0,193.0,171.0,250.0,189.0,3146,1863,2407,1259,739,604,1977,1936,630,379,1347,1557,67,50,11075,9200,6350,4225,31650,29856,0
1200,2,0,199.0,164.0,242.0,181.0,2978,1835,2239,1343,739,492,1806,1949,525,394,1281,1555,67,42,11600,9025,6200,4225,31900,30656,0
1207,2,0,197.0,157.0,227.0,157.0,2905,1538,2211,1203,694,335,2156,1889,795,319,1361,1570,67,35,11500,9025,6100,4225,32500,31306,0
1214,2,0,199.0,157.0,227.0,149.0,2938,1505,2267,1147,671,358,2161,2069,770,459,1391,1610,67,35,11675,9025,6100,4125,32500,31581,0
1221,2,0,195.0,150.0,227.0,141.0,2961,1326,2267,1035,694,291,2525,2210,1050,564,1475,1646,67,35,11475,8800,6100,4125,32700,32106,0
1229,2,0,185.0,133.0,227.0,126.0,2877,1225,2183,867,694,358,2853,2353,1290,659,1563,1694,67,35,10675,7825,6100,4125,33500,33931,0
1236,2,0,200.0,133.0,227.0,118.0,3123,1068,2407,755,716,313,2047,1700,700,49,1347,1651,67,35,10675,7825,6100,4125,33500,34106,0
1243,2,0,200.0,133.0,227.0,118.0,3101,1062,2407,727,694,335,2301,1774,870,79,1431,1695,67,35,11275,7825,6100,4125,33500,34106,0
1250,2,0,187.0,119.0,227.0,118.0,2871,1113,2155,755,716,358,2626,1905,1115,174,1511,1731,67,35,10100,6600,6100,4125,34675,35331,0
1255,2,0,187.0,94.0,227.0,134.0,2871,1046,2155,755,716,291,2626,1998,1115,239,1511,1759,67,35,10100,3300,6100,4125,34675,38581,0
7,2,1,13.0,13.0,15.0,14.0,335,419,335,419,0,0,40,50,40,50,0,0,12,12,0,0,0,0,0,0,1
14,2,1,14.0,13.0,15.0,14.0,643,671,643,671,0,0,65,20,65,20,0,0,13,13,0,0,0,0,0,0,1
21,2,1,14.0,14.0,15.0,14.0,699,755,699,755,0,0,50,60,50,60,0,0,13,13,0,0,0,0,0,0,1
29,2,1,15.0,14.0,15.0,14.0,727,783,727,783,0,0,40,160,40,160,0,0,14,13,0,0,0,0,0,0,1
36,2,1,15.0,16.0,15.0,22.0,811,811,811,811,0,0,135,150,135,150,0,0,14,14,0,0,0,0,0,0,1
43,2,1,16.0,16.0,23.0,22.0,839,867,839,867,0,0,30,240,30,240,0,0,15,16,0,0,0,0,0,0,1
50,2,1,17.0,15.0,23.0,22.0,895,839,895,839,0,0,60,40,60,40,0,0,16,15,0,0,0,0,0,0,1
57,2,1,18.0,17.0,23.0,22.0,895,895,895,895,0,0,10,45,10,45,0,0,17,15,0,0,0,0,0,0,1
64,2,1,19.0,18.0,23.0,22.0,951,895,951,895,0,0,120,90,120,90,0,0,18,16,0,0,0,0,0,0,1
71,2,1,19.0,17.0,23.0,22.0,1001,895,979,895,22,0,239,175,235,175,4,0,18,17,0,0,0,0,0,0,1
79,2,1,20.0,17.0,23.0,22.0,1040,923,951,923,89,0,351,35,335,35,16,0,19,16,0,0,0,0,0,0,1
86,2,1,20.0,18.0,23.0,22.0,1006,923,895,923,111,0,68,95,40,95,28,0,19,16,0,0,0,0,0,0,1
93,2,1,21.0,19.0,23.0,22.0,1029,895,895,895,134,0,138,150,90,150,48,0,20,18,0,0,150,0,0,0,1
100,2,1,21.0,20.0,23.0,22.0,1079,990,923,923,156,67,119,222,55,210,64,12,21,19,0,0,150,0,0,0,1
107,2,1,22.0,20.0,23.0,22.0,1051,1057,895,923,156,134,119,357,35,325,84,32,21,19,0,0,150,0,0,0,1
114,2,1,22.0,20.0,23.0,22.0,1107,1135,951,979,156,156,154,383,50,335,104,48,21,20,0,0,150,0,0,0,1
121,2,1,23.0,26.0,23.0,28.0,1051,1107,895,951,156,156,229,108,105,40,124,68,22,20,0,0,150,250,0,0,1
129,2,1,23.0,26.0,23.0,36.0,1146,1107,923,951,223,156,317,248,165,160,152,88,22,20,0,0,150,250,0,0,1
136,2,1,26.0,28.0,31.0,36.0,1258,1118,923,1007,335,111,47,80,30,80,17,0,23,20,0,0,300,250,0,0,1
143,2,1,27.0,30.0,31.0,36.0,1258,1035,923,1035,335,0,33,90,30,90,3,0,24,22,0,100,300,250,0,0,1
150,2,1,28.0,30.0,31.0,36.0,1309,1203,951,1203,358,0,143,145,100,45,43,100,25,22,0,100,300,250,0,0,1
157,2,1,30.0,31.0,46.0,36.0,1292,1203,979,1203,313,0,140,185,65,85,75,100,26,23,0,400,300,250,0,0,1
164,2,1,33.0,31.0,46.0,36.0,1348,1287,1035,1287,313,0,125,130,35,130,90,0,27,23,125,400,300,250,0,0,1
171,2,1,34.0,34.0,46.0,36.0,1404,1371,1091,1371,313,0,250,0,120,0,130,0,28,25,125,400,300,250,0,0,1
179,2,1,35.0,36.0,46.0,36.0,1572,1399,1259,1399,313,0,340,70,170,70,170,0,29,25,125,400,300,250,0,0,1
186,2,1,39.0,36.0,46.0,36.0,1678,1455,1343,1455,335,0,235,140,125,140,110,0,31,26,125,400,600,250,0,0,1
193,2,1,40.0,40.0,46.0,44.0,1729,1427,1371,1427,358,0,330,115,180,115,150,0,32,28,125,400,600,250,0,0,1
200,2,1,44.0,42.0,46.0,44.0,1818,1539,1483,1539,335,0,51,60,15,60,36,0,33,28,500,400,600,250,0,0,1
207,2,1,46.0,46.0,46.0,52.0,1796,1695,1483,1651,313,44,157,18,85,10,72,8,35,33,500,550,600,250,0,0,1
214,2,1,46.0,46.0,54.0,52.0,1908,1835,1595,1679,313,156,277,138,165,110,112,28,35,34,500,550,600,250,0,0,1
221,2,1,48.0,50.0,54.0,44.0,1852,1998,1539,1819,313,179,452,168,300,120,152,48,37,34,500,550,600,250,0,100,1
229,2,1,51.0,51.0,54.0,58.0,2026,1947,1735,1791,291,156,253,94,215,30,38,64,37,32,800,550,600,250,0,100,1
236,2,1,53.0,51.0,54.0,66.0,2048,1947,1735,1791,313,156,488,319,410,235,78,84,39,36,800,550,600,250,0,100,1
243,2,1,55.0,57.0,62.0,66.0,2070,1919,1735,1763,335,156,238,194,120,90,118,104,41,39,800,850,600,250,0,100,1
250,2,1,55.0,57.0,62.0,66.0,2132,2031,1819,1875,313,156,249,224,95,200,154,24,41,39,800,850,750,500,0,100,1
257,2,1,57.0,62.0,62.0,66.0,2042,1914,1707,1735,335,179,234,199,140,155,94,44,43,43,1100,850,750,500,0,100,1
264,2,1,57.0,65.0,62.0,66.0,2138,2166,1847,1987,291,179,246,214,120,150,126,64,43,46,1100,850,750,500,0,100,1
271,2,1,59.0,66.0,62.0,66.0,2194,2367,1903,2211,291,156,327,230,165,150,162,80,45,48,1100,950,750,500,0,100,1
279,2,1,60.0,66.0,62.0,66.0,2261,2423,1791,2267,470,156,545,45,315,45,230,0,46,48,1100,1100,750,500,0,100,1
286,2,1,65.0,68.0,70.0,82.0,2446,2535,1819,2379,627,156,187,220,85,200,102,20,47,49,1100,1100,750,500,0,100,1
293,2,1,67.0,72.0,70.0,90.0,2457,2535,1875,2379,582,156,369,260,195,220,174,40,49,49,1400,1100,1150,625,0,250,1
300,2,1,69.0,74.0,70.0,90.0,2507,2563,1903,2407,604,156,35,320,35,260,0,60,51,49,1400,1100,1150,625,0,250,1
307,2,1,70.0,73.0,70.0,90.0,2474,2530,1847,2351,627,179,130,340,50,260,80,80,53,56,1400,1150,1150,625,0,300,1
314,2,1,72.0,77.0,85.0,90.0,2630,2630,1959,2407,671,223,345,128,185,20,160,108,53,52,1400,1150,1150,625,0,300,1
321,2,1,73.0,76.0,93.0,90.0,2714,2356,2043,2043,671,313,616,239,380,95,236,144,54,49,1400,1100,1150,625,0,500,1
329,2,1,80.0,81.0,101.0,90.0,2916,2462,2267,2127,649,335,417,99,205,15,212,84,57,58,1400,1100,1150,625,0,500,1
336,2,1,80.0,81.0,101.0,90.0,2944,2619,2295,2127,649,492,658,317,370,165,288,152,57,63,1750,1100,1450,1000,0,500,1
343,2,1,83.0,83.5,101.0,90.0,3084,3006,2435,2155,649,851,923,472,555,200,368,272,60,65,1750,1075,1450,1000,0,525,1
350,2,1,85.0,85.5,101.0,90.0,3118,3319,2491,2379,627,940,599,298,155,110,444,188,62,67,1750,1075,1450,1000,0,525,1
357,2,1,86.0,86.5,101.0,98.0,3224,3666,2575,2659,649,1007,684,498,160,190,524,308,63,67,1750,1075,1450,1000,0,525,1
364,2,1,88.0,88.5,101.0,106.0,3269,3638,2575,2631,694,1007,983,805,375,385,608,420,65,70,1750,1075,1450,1000,0,525,1
371,2,1,97.0,94.5,117.0,114.0,3409,3538,2491,2575,918,963,624,712,100,180,524,532,66,71,2450,1075,1450,1000,0,525,1
379,2,1,100.0,97.5,117.0,122.0,3482,3459,2519,2519,963,940,597,883,165,235,432,648,69,73,2450,1075,1450,1000,0,525,1
386,2,1,101.0,98.5,117.0,128.0,3459,3678,2519,2715,940,963,704,1238,160,470,544,768,70,73,2450,1325,1450,1000,50,575,1
393,2,1,102.0,103.0,117.0,136.0,3515,3683,2575,2743,940,940,880,1119,220,335,660,784,71,72,2450,1450,1450,1000,50,700,1
400,2,1,104.0,102.0,117.0,144.0,3515,3756,2575,2771,940,985,855,1794,75,790,780,1004,73,71,2450,1450,1450,1000,50,700,1
407,2,1,105.0,102.0,117.0,144.0,3622,3862,2659,2855,963,1007,1205,2259,305,1135,900,1124,74,72,2450,1550,1700,1000,50,700,1
414,2,1,108.0,102.0,117.0,144.0,3689,3717,2659,2687,1030,1030,1545,2700,525,1460,1020,1240,77,72,2450,1800,1700,1000,50,700,1
421,2,1,117.0,128.0,132.0,144.0,3812,3773,2827,2631,985,1142,458,565,280,485,178,80,79,72,2150,1800,2050,1450,350,700,1
429,2,1,119.0,130.0,132.0,144.0,3767,3935,2827,2659,940,1276,505,542,215,510,290,32,80,72,3150,1800,2050,1450,350,700,1
436,2,1,120.0,138.0,132.0,144.0,4098,4075,3135,2799,963,1276,1025,632,615,440,410,192,83,72,3150,1800,2200,1450,350,700,1
443,2,1,120.0,142.0,132.0,144.0,4176,3997,3191,2743,985,1254,709,613,325,465,384,148,84,72,3150,4400,2350,1450,350,700,1
450,2,1,120.0,146.0,132.0,152.0,4383,4064,3219,2743,1164,1321,1152,698,620,590,532,108,85,72,3150,4800,2650,1450,350,700,1
457,2,1,122.0,152.0,132.0,152.0,4630,4193,3331,2827,1299,1366,1513,584,975,470,538,114,85,72,3150,5000,2800,1450,350,700,1
464,2,1,122.0,151.5,132.0,160.0,4742,4030,3443,2687,1299,1343,1825,951,1235,685,590,266,85,72,3350,5375,2950,1450,350,725,1
471,2,1,136.0,155.5,148.0,160.0,4669,4025,3415,2771,1254,1254,733,825,445,715,288,110,85,72,4400,5975,3200,1450,525,825,1
479,2,1,124.0,153.5,148.0,168.0,4260,3963,3051,2687,1209,1276,1228,880,800,810,428,70,81,72,3700,5575,3350,1450,1425,1225,1
486,2,1,112.0,164.5,148.0,168.0,3291,3986,2239,2687,1052,1299,1450,410,998,380,452,30,73,72,3350,5375,3350,1450,2175,1425,1
493,2,1,100.0,160.0,148.0,168.0,2451,4019,1623,2743,828,1276,1735,897,1183,715,552,182,61,72,3400,5650,3350,1450,2975,1750,1
500,2,1,111.0,152.0,148.0,168.0,2524,3952,1763,2631,761,1321,357,747,213,705,144,42,61,72,3300,4800,3350,1450,3350,3150,1
507,2,1,111.0,160.0,148.0,168.0,2625,3806,1819,2463,806,1343,318,799,178,605,140,194,59,72,4375,5200,3350,1450,3450,3150,1
514,2,1,115.0,165.0,148.0,168.0,2709,3476,1903,2155,806,1321,500,560,268,435,232,125,60,72,4625,5550,3600,1450,3450,3200,1
521,2,1,119.0,168.0,148.0,168.0,2580,3487,1819,2211,761,1276,208,733,38,560,170,173,64,80,4625,5950,3600,1450,3450,3200,1
529,2,1,120.0,167.0,148.0,168.0,3218,3627,2211,2351,1007,1276,371,579,73,350,298,229,65,79,4625,6350,3600,1450,3450,3200,1
536,2,1,127.0,167.0,148.0,168.0,3319,3997,2155,2743,1164,1254,319,1085,173,700,146,385,68,79,4875,6550,3600,1450,3450,3200,1
543,2,1,129.0,183.0,148.0,200.0,3566,4182,2379,2883,1187,1299,515,595,233,50,282,545,69,78,4875,6800,3600,1450,3450,3200,1
550,2,1,131.0,182.0,148.0,200.0,3773,4389,2519,3023,1254,1366,818,920,463,265,355,655,70,77,5575,6750,3700,1450,3450,3250,1
557,2,1,143.0,182.0,148.0,200.0,3918,4277,2687,2911,1231,1366,316,1427,113,620,203,807,72,81,5575,6750,3950,1450,3450,3250,1
564,2,1,143.0,176.0,148.0,200.0,3834,4327,2603,3051,1231,1276,515,1946,268,995,247,951,73,82,6125,6800,3950,1700,3700,3850,1
571,2,1,144.0,170.0,148.0,200.0,3638,4327,2519,3051,1119,1276,757,2467,378,1360,379,1107,72,82,6050,6400,3950,1700,3962,4250,1
579,2,1,147.0,154.0,148.0,200.0,3655,4439,2715,3163,940,1276,624,2667,208,1550,416,1117,72,82,5450,5400,3850,1700,4812,5250,1
586,2,1,140.0,162.5,148.0,200.0,3991,4417,3051,3163,940,1254,940,2198,408,1175,532,1023,73,82,5200,4425,4000,1900,5662,6225,1
593,2,1,138.0,156.0,148.0,200.0,3885,4562,2967,3219,918,1343,1163,2738,623,1555,540,1183,73,82,4950,3800,4000,2100,6012,6850,1
600,2,1,144.0,170.0,148.0,200.0,3795,4562,2855,3219,940,1343,1020,2376,818,1320,202,1056,75,82,5650,3800,4000,2100,6012,6850,1
607,2,1,145.0,168.5,148.0,200.0,3756,4624,2771,3303,985,1321,951,2252,633,1190,318,1062,75,81,5400,4775,4000,2100,6412,6875,1
614,2,1,147.0,178.5,148.0,200.0,3627,4389,2687,3135,940,1254,1139,2215,813,1130,326,1085,75,80,5650,4775,4000,2100,6412,6875,1
621,2,1,148.0,178.5,148.0,200.0,3437,4439,2519,3163,918,1276,1161,2745,723,1500,438,1245,76,81,5650,5475,4000,2100,6412,6875,1
629,2,1,148.0,181.5,148.0,200.0,3398,4327,2211,3051,1187,1276,713,2776,348,1700,365,1076,77,81,5650,5475,4000,2100,6412,6875,1
636,2,1,148.0,181.5,148.0,200.0,3370,4350,2183,3051,1187,1299,728,3292,423,2060,305,1232,77,81,5650,5975,4150,2225,6412,6875,1
643,2,1,148.0,181.0,148.0,200.0,3644,4372,2435,3051,1209,1321,1186,3767,733,2400,453,1367,77,81,5900,6250,4250,2225,6412,6900,1
650,2,1,156.0,188.0,172.0,200.0,4053,4450,2799,3107,1254,1343,772,3709,463,2340,309,1369,77,81,6000,6250,4250,2575,6412,6900,1
657,2,1,156.0,188.0,180.0,200.0,4215,4355,2939,3079,1276,1276,1120,3802,663,2485,457,1317,79,81,6000,6250,4500,2575,6412,6900,1
664,2,1,158.0,192.0,180.0,200.0,4198,4210,2967,2911,1231,1299,1353,3323,848,2250,505,1073,79,83,6450,6250,4500,2575,6412,6900,1
671,2,1,169.0,187.0,180.0,192.0,4142,4327,2911,3051,1231,1276,636,3864,283,2635,353,1229,75,83,7500,6550,4500,2575,6612,7400,1
679,2,1,165.0,185.0,180.0,198.0,3935,4333,2659,3079,1276,1254,987,4395,553,3010,434,1385,70,83,7750,6350,4500,2575,6862,7600,1
686,2,1,171.0,193.0,180.0,198.0,3879,4462,2603,3163,1276,1299,949,3095,663,2325,286,770,73,83,8150,6150,4650,2575,6862,8000,1
693,2,1,178.0,184.0,180.0,198.0,4019,4417,2743,3051,1276,1366,777,3540,568,2610,209,930,74,82,7750,5350,4650,2575,6862,8800,1
700,2,1,178.0,182.5,180.0,198.0,3907,4333,2631,2967,1276,1366,1220,3312,863,2455,357,857,77,82,8200,5475,4650,2575,6862,9025,1
707,2,1,180.0,182.0,180.0,198.0,3907,4557,2631,3303,1276,1254,1392,3875,983,2859,409,1016,77,82,8750,5475,4650,2575,6862,9037,1
714,2,1,180.0,179.0,180.0,222.0,3840,4719,2631,3443,1209,1276,1861,3880,1308,2704,553,1176,77,82,8750,6525,4650,2700,6862,9962,1
721,2,1,180.0,191.0,195.0,222.0,3963,4719,2687,3443,1276,1276,2332,2040,1623,1904,709,136,77,82,9000,6525,4650,2950,6862,9962,1
729,2,1,188.0,193.0,195.0,222.0,3734,4630,2435,3331,1299,1299,1193,2091,678,1999,515,92,67,82,10225,6475,4650,2950,7362,10262,1
736,2,1,189.0,200.0,195.0,214.0,3498,4814,2267,3471,1231,1343,1158,2256,503,2004,655,252,67,82,10225,7325,4650,2950,7362,10687,1
743,2,1,182.0,192.0,195.0,214.0,3442,4562,2211,3219,1231,1343,1430,2379,623,1979,807,400,72,82,9625,8425,4650,2950,7962,10937,1
750,2,1,182.0,188.0,195.0,214.0,3711,4568,2435,3247,1276,1321,1762,2910,803,2354,959,556,72,78,9625,8425,4650,2950,7962,10937,1
757,2,1,194.0,190.0,195.0,214.0,3689,4299,2435,3023,1254,1276,1219,1813,708,1734,511,79,77,76,9825,9325,4650,2950,7962,10937,1
764,2,1,192.0,190.0,195.0,214.0,4002,4215,2771,2939,1231,1276,1697,2248,1038,2009,659,239,77,76,9575,9325,4650,2950,8212,10937,1
771,2,1,188.0,183.5,203.0,214.0,4098,4103,2799,2827,1299,1276,1433,2669,718,2274,715,395,77,74,10025,9100,4650,2950,8612,11162,1
779,2,1,182.0,182.5,203.0,214.0,4103,4098,2827,2799,1276,1299,1926,3165,1063,2614,863,551,77,73,9650,9100,5100,2950,8987,11162,1
786,2,1,182.0,190.5,203.0,214.0,4019,4165,2743,2799,1276,1366,2394,3265,1383,2554,1011,711,77,73,9650,9700,5100,3550,8987,11162,1
793,2,1,200.0,190.5,203.0,214.0,4053,3885,2799,2407,1254,1478,1437,2891,478,2404,959,487,77,73,10850,9700,5100,3800,8987,11162,1
800,2,1,200.0,190.5,211.0,214.0,3946,3577,2715,1987,1231,1590,801,2959,198,2459,603,500,77,73,10850,10100,5100,3800,8987,11162,1
807,2,1,200.0,189.5,211.0,214.0,3773,3739,2631,2127,1142,1612,1237,3430,498,2734,739,696,77,73,10850,10050,5100,3800,8987,11212,1
814,2,1,198.0,184.0,211.0,214.0,4014,3829,2827,2239,1187,1590,1731,3881,848,2989,883,892,77,73,10675,10025,5100,3800,9162,11587,1
821,2,1,180.0,186.0,211.0,214.0,4120,3890,2911,2323,1209,1567,1824,3507,693,2419,1131,1088,77,73,8150,8275,5550,3800,11787,12962,1
829,2,1,179.0,192.5,211.0,214.0,4131,3879,2967,2267,1164,1612,2265,3114,998,1909,1267,1205,77,70,8575,7900,5650,3675,11962,13612,1
836,2,1,173.0,196.5,211.0,214.0,4142,3862,2911,2295,1231,1567,2752,2770,1333,1564,1419,1206,77,70,8275,8450,5650,3675,12262,13912,1
843,2,1,171.0,196.0,211.0,214.0,4243,3823,2967,2323,1276,1500,2400,3208,1083,1834,1317,1374,78,70,8050,9225,6150,3675,13312,13962,1
850,2,1,165.0,191.5,203.0,214.0,4176,3470,2967,2127,1209,1343,2355,3310,1048,1784,1307,1526,78,70,7300,8950,6650,3675,14787,15037,1
857,2,1,165.0,198.0,203.0,214.0,4075,3414,2911,2071,1164,1343,1890,3237,443,1589,1447,1648,77,69,6950,9275,6650,3675,15187,15112,1
864,2,1,166.0,197.0,203.0,214.0,3974,3336,2743,2015,1231,1321,1323,3312,128,1654,1195,1658,78,69,6950,9225,6650,3675,15187,15262,1
871,2,1,173.0,198.0,211.0,214.0,4014,3218,2827,1875,1187,1343,1207,3156,318,1534,889,1622,82,76,7550,9225,6650,3675,15187,15262,1
879,2,1,178.0,197.0,219.0,214.0,4098,3454,2911,2043,1187,1411,1311,3125,278,1564,1033,1561,84,76,7550,9475,6650,3675,15187,15312,1
886,2,1,189.0,196.5,227.0,214.0,4137,3493,2883,2127,1254,1366,243,3522,108,1809,135,1713,87,76,7100,9450,6650,3675,15637,15337,1
893,2,1,173.0,199.0,227.0,216.0,4114,3442,2883,2099,1231,1343,738,3793,463,1924,275,1869,89,76,6175,9425,6650,3675,16712,15712,1
900,2,1,170.0,195.5,227.0,216.0,4238,3515,3051,2239,1187,1276,893,3614,478,1739,415,1875,92,76,6950,9500,6800,3925,17437,15887,1
907,2,1,158.0,188.5,227.0,216.0,4266,3582,3079,2239,1187,1343,1417,3751,858,1854,559,1897,94,75,5875,9150,6800,3925,18512,16237,1
914,2,1,149.0,183.0,219.0,216.0,4271,3543,2995,2267,1276,1276,1867,4177,1148,2124,719,2053,95,75,5225,8825,6800,3925,19262,16487,1
921,2,1,147.0,184.5,219.0,216.0,4512,3493,3079,2127,1433,1366,1528,2940,1233,1619,295,1321,96,74,5125,8200,6800,3925,19962,17037,1
929,2,1,161.0,182.0,219.0,222.0,4501,3756,3023,2323,1478,1433,837,3183,708,1694,129,1489,96,74,5550,8125,6800,3925,19962,17412,1
936,2,1,165.0,182.0,219.0,222.0,4562,3773,2995,2295,1567,1478,531,3266,318,1784,213,1482,96,74,6000,8125,6800,3925,19962,17412,1
943,2,1,165.0,183.0,219.0,222.0,4546,3930,3023,2407,1523,1523,1467,3495,1078,1979,389,1516,96,74,6800,8425,6800,3925,19962,17462,1
950,2,1,171.0,183.0,219.0,222.0,4428,4019,2995,2407,1433,1612,1185,3966,628,2254,557,1712,96,74,6800,8775,6800,3925,19962,17537,1
957,2,1,183.0,184.5,227.0,222.0,4562,3907,2995,2295,1567,1612,533,4182,388,2274,145,1908,96,74,7450,9500,6800,3925,20212,17837,1
964,2,1,183.0,183.5,235.0,222.0,4540,3986,2995,2351,1545,1635,1077,4503,748,2474,329,2029,96,74,7150,9450,6800,3925,20212,17887,1
971,2,1,173.0,172.0,235.0,222.0,4394,3963,2939,2351,1455,1612,1590,4415,1093,2194,497,2221,96,71,7150,8725,6800,3925,21062,19012,1
979,2,1,173.0,168.5,243.0,228.0,4473,3958,2995,2435,1478,1523,1524,4572,918,2179,606,2393,96,69,6900,8600,6800,3925,21812,19412,1
986,2,1,169.0,160.5,243.0,228.0,4540,3722,2995,2155,1545,1567,2059,4951,1273,2374,786,2577,96,69,6600,8150,6800,3925,22112,19862,1
993,2,1,181.0,170.0,243.0,228.0,4501,3834,3023,2267,1478,1567,1360,3207,748,1404,612,1803,96,70,6500,8875,6800,3925,22212,19987,1
1000,2,1,181.0,169.5,243.0,228.0,3991,3582,2491,2071,1500,1511,1416,3619,628,1634,788,1985,96,70,7825,8850,6800,3925,22212,20012,1
1007,2,1,183.0,169.5,243.0,228.0,3885,3487,2351,2099,1534,1388,1378,3906,408,1749,970,2157,96,70,7425,9150,6800,3925,23012,20012,1
1014,2,1,183.0,167.5,243.0,228.0,3683,3538,2351,2127,1332,1411,1495,4347,473,2014,1022,2333,96,68,7425,10050,6800,3925,23012,20012,1
1021,2,1,195.0,173.5,258.0,228.0,3946,3678,2603,2155,1343,1523,840,3572,133,1809,707,1763,96,68,7425,10050,6800,3925,23012,20012,1
1029,2,1,200.0,173.5,258.0,228.0,4506,3706,3163,2183,1343,1523,1005,4019,213,2084,792,1935,96,68,7825,10050,6800,3925,23012,20012,1
1036,2,1,196.0,169.5,258.0,228.0,4473,3526,3107,2071,1366,1455,1545,4418,593,2319,952,2099,96,68,8025,10400,6950,4175,23412,20562,1
1043,2,1,184.0,169.5,258.0,228.0,4708,3694,3275,2239,1433,1455,2106,4874,978,2599,1128,2275,96,68,7075,10400,7200,4175,24462,20562,1
1050,2,1,190.0,171.0,258.0,228.0,4725,3616,3247,2183,1478,1433,1111,5055,253,2704,858,2351,96,68,6025,10375,7200,4175,25512,20587,1
1057,2,1,194.0,178.0,258.0,220.0,4831,3728,3331,2295,1500,1433,1170,5176,278,2649,892,2527,96,68,7675,10175,7200,4175,25612,20787,1
1064,2,1,174.0,155.0,258.0,220.0,4702,3728,3247,2295,1455,1433,1737,5622,673,2919,1064,2703,96,68,6525,8275,7200,4175,27062,22237,1
1071,2,1,163.0,136.5,258.0,220.0,4803,3902,3303,2379,1500,1523,1421,6068,173,3189,1248,2879,96,68,4250,6750,7200,4175,29287,24112,1
1079,2,1,155.0,158.0,258.0,220.0,4820,3818,3275,2295,1545,1523,1996,3779,568,2024,1428,1755,96,68,4600,6725,7200,4050,29837,24512,1
1086,2,1,153.0,155.0,258.0,220.0,4803,3616,3303,2183,1500,1433,2576,4773,968,2404,1608,2369,96,68,4500,6725,7200,4050,29937,24512,1
1093,2,1,153.0,162.0,258.0,220.0,4758,3319,3303,1931,1455,1388,3138,4217,1358,1984,1780,2233,96,68,4500,6725,7200,4050,29937,24662,1
1100,2,1,177.0,167.0,258.0,220.0,4798,2854,3331,1735,1467,1119,1598,4094,248,1879,1350,2215,96,68,6600,7475,7200,3925,29937,24862,1
1107,2,1,155.0,165.5,258.0,220.0,4518,3162,3163,2043,1355,1119,2035,4019,523,1664,1512,2355,96,72,5050,6950,7200,3925,31487,26137,1
1114,2,1,151.0,162.5,258.0,220.0,4523,3381,3135,2239,1388,1142,2579,4409,903,1914,1676,2495,96,75,4700,7150,7200,3925,31837,26437,1
1121,2,1,167.0,166.5,258.0,220.0,4630,3706,3219,2519,1411,1187,530,4305,328,1774,202,2531,96,74,4400,8200,7200,3925,32137,26437,1
1129,2,1,169.0,171.5,258.0,220.0,4714,3577,3303,2435,1411,1142,794,3608,578,1449,216,2159,96,73,4400,8700,7200,3925,32137,26437,1
1136,2,1,169.0,170.5,266.0,220.0,4579,3498,3191,2379,1388,1119,1332,3395,948,1404,384,1991,96,75,7100,8700,7200,3925,32137,26437,1
1143,2,1,173.0,176.5,266.0,228.0,4658,3482,3247,2351,1411,1131,1520,2357,1068,949,452,1408,96,75,7100,8800,7200,4050,32137,26437,1
1150,2,1,167.0,178.0,274.0,228.0,4769,3493,3314,2407,1455,1086,2088,2483,1460,1089,628,1394,96,75,6550,9925,7200,3575,32637,27062,1
1157,2,1,191.0,182.0,274.0,228.0,4646,3526,3258,2407,1388,1119,1442,2459,650,929,792,1530,96,74,6550,9675,7200,3575,32637,27462,1
1164,2,1,194.0,192.0,274.0,228.0,4770,3543,3359,2547,1411,996,1620,1921,885,689,735,1232,96,73,7750,10575,7200,3575,32637,27512,1
1171,2,1,189.0,180.5,274.0,228.0,4674,2994,3219,2547,1455,447,2157,2241,1250,979,907,1262,96,68,7750,10400,7200,3575,33012,28462,1
1179,2,1,177.0,177.0,274.0,222.0,4736,2546,3303,2323,1433,223,2440,1790,1515,954,925,836,96,61,6925,11375,7200,3575,33837,29437,1
1186,2,1,159.0,177.0,274.0,222.0,4972,2614,3606,2435,1366,179,3038,2120,1949,1264,1089,856,96,61,5550,11375,7200,3575,33962,29437,1
1193,2,1,175.0,183.0,289.0,222.0,4999,2563,3566,2407,1433,156,1317,1661,1056,889,261,772,96,61,6850,11375,7200,3575,34862,29437,1
1200,2,1,175.0,181.0,289.0,222.0,4921,2614,3488,2435,1433,179,1902,1890,1469,1094,433,796,96,59,7150,11375,7200,3575,34862,29437,1
1207,2,1,175.0,181.0,289.0,222.0,5296,2586,3908,2295,1388,291,2531,2215,1934,1379,597,836,98,59,7150,11375,7200,3575,34862,29437,1
1214,2,1,190.0,185.0,289.0,222.0,5313,2770,3902,2435,1411,335,2220,2040,1451,1464,769,576,98,59,7050,12325,7200,3450,34962,29562,1
1221,2,1,191.0,185.0,289.0,222.0,5509,2798,4054,2463,1455,335,2759,2385,1893,1769,866,616,98,59,7850,12575,7200,3450,34962,29562,1
1229,2,1,198.0,185.0,289.0,222.0,5442,2798,4009,2463,1433,335,3008,2711,1974,2059,1034,652,98,59,7750,12575,7200,3450,35062,29562,1
1236,2,1,188.0,177.5,289.0,222.0,5425,2720,3992,2407,1433,313,3643,2772,2445,2084,1198,688,98,59,7500,11850,7200,3450,35712,30437,1
1243,2,1,194.0,172.5,289.0,222.0,5487,2513,4054,2267,1433,246,3500,3060,2130,2344,1370,716,98,56,7500,11750,7350,3200,36212,30937,1
1250,2,1,190.0,171.5,289.0,222.0,5318,1690,3986,1623,1332,67,3920,3108,2396,2384,1524,724,98,56,7500,12050,7350,3075,36612,31262,1
1257,2,1,198.0,178.5,289.0,222.0,5241,1718,3942,1651,1299,67,3758,2911,2328,2179,1430,732,98,56,7725,12250,7350,3075,36787,31312,1
1264,2,1,194.0,182.0,289.0,222.0,5229,2250,3930,2183,1299,67,3444,3119,2329,2379,1115,740,98,61,7375,12225,7350,3075,37137,31112,1
1271,2,1,192.0,184.5,289.0,222.0,5201,2115,3914,2071,1287,44,4065,2608,2804,2114,1261,494,98,54,7200,12500,7350,3075,37312,31487,1
1279,2,1,198.0,181.5,289.0,222.0,4966,2177,3970,2043,996,134,3467,2893,2598,2379,869,514,98,52,6600,12450,7350,2825,37912,31887,1
1286,2,1,192.0,173.0,289.0,222.0,4524,2266,3774,2043,750,223,3104,3156,2149,2614,955,542,98,52,5250,11875,7350,2825,39262,32462,1
1293,2,1,188.0,176.5,289.0,222.0,4395,2356,3746,2043,649,313,3624,2411,2589,2329,1035,82,98,51,5950,12600,7350,2825,39462,32487,1
1300,2,1,188.0,179.5,289.0,222.0,4378,2350,3729,2015,649,335,3843,1942,2882,1824,961,118,98,46,5950,12900,7350,2825,39462,32487,1
1307,2,1,196.0,175.0,289.0,214.0,4333,2322,3662,1987,671,335,3438,2207,2647,2049,791,158,98,46,6635,12125,7350,2825,39737,33262,1
1314,2,1,190.0,183.0,289.0,214.0,4199,2132,3550,1819,649,313,3007,2068,2390,1874,617,194,98,46,6350,13275,7350,2825,40337,33262,1
1321,2,1,200.0,181.0,289.0,214.0,4143,2182,3494,1735,649,447,2774,2312,2368,2054,406,258,98,45,7585,13225,7350,2825,40324,33312,1
1329,2,1,190.0,189.0,289.0,214.0,3952,2294,3303,1623,649,671,3025,1333,2539,1199,486,134,98,47,6900,12925,7350,2825,41024,33612,1
1336,2,1,198.0,184.5,289.0,214.0,4109,2182,3460,1511,649,671,2997,1598,2435,1384,562,214,98,47,6970,12850,7350,2975,41199,34287,1
1343,2,1,188.0,179.5,289.0,208.0,3863,1690,3236,1175,627,515,3315,839,2677,769,638,70,98,45,7000,12600,7200,2825,41949,35137,1
1350,2,1,173.0,176.5,281.0,208.0,3599,1544,2950,1119,649,425,3194,767,2476,749,718,18,87,45,6105,12200,7200,2825,43924,35537,1
1357,2,1,177.0,173.0,266.0,208.0,2910,1510,2239,1063,671,447,2324,499,2026,429,298,70,85,45,6795,12525,7200,2825,44424,35712,1
1364,2,1,183.0,182.0,266.0,214.0,2860,1550,2211,1147,649,403,2061,250,1941,124,120,126,85,44,6795,13125,7500,2825,44424,35712,1
1371,2,1,193.0,182.0,266.0,214.0,2664,1645,2015,1063,649,582,1971,287,1871,89,100,198,85,44,7470,13625,7500,2825,44424,35712,1
1379,2,1,193.0,182.0,266.0,214.0,2692,1863,2043,1259,649,604,1522,520,1346,254,176,266,85,44,8145,13875,7500,2825,44424,35712,1
1386,2,1,195.0,187.0,266.0,214.0,2468,1768,1819,1007,649,761,1567,172,1461,114,106,58,85,44,8190,13875,7500,2825,44424,35712,1
1393,2,1,195.0,186.0,266.0,214.0,2306,1947,1679,1231,627,716,1818,407,1636,269,182,138,85,43,8435,13875,7500,2825,44424,35712,1
1400,2,1,197.0,192.0,266.0,214.0,2294,1824,1623,1063,671,761,1523,227,1261,89,262,138,85,41,8825,14625,7500,2825,44424,35712,1
1407,2,1,197.0,191.0,266.0,206.0,2244,1830,1595,1091,649,739,1584,446,1246,224,338,222,85,40,8855,14625,7500,2825,44424,35812,1
1414,2,1,197.0,191.0,274.0,206.0,2334,1830,1685,1091,649,739,1846,664,1432,354,414,310,85,40,9530,15175,7500,2950,44424,35812,1
1421,2,1,197.0,195.0,274.0,206.0,2961,1790,2312,1007,649,783,2125,376,1706,174,419,202,85,40,9695,15175,7500,3200,44524,35812,1
1429,2,1,193.0,195.0,274.0,206.0,2547,1841,1898,1091,649,750,2359,602,1864,314,495,288,85,40,10170,15425,7500,3325,44724,35812,1
1436,2,1,199.0,198.5,282.0,212.0,2160,1678,1511,1063,649,615,2014,295,1689,139,325,156,85,40,10830,15850,7650,3325,44724,35837,1
1443,2,1,199.0,198.5,282.0,212.0,2155,1718,1506,1091,649,627,2219,507,1818,279,401,228,85,40,10975,15850,8000,3325,44724,35837,1
1450,2,1,199.0,198.5,282.0,212.0,2787,1880,2116,1119,671,761,2850,592,2119,264,731,328,85,40,11020,16350,8000,3325,44724,35837,1
1457,2,1,195.0,194.5,282.0,206.0,2653,1863,1937,1147,716,716,3117,817,2298,409,819,408,85,38,11150,16250,8000,3075,44999,36537,1
1464,2,1,183.0,178.5,297.0,206.0,2805,1550,2066,1091,739,459,3449,502,2550,244,899,258,85,32,10550,15400,8000,3075,45614,38337,1
1471,2,1,175.0,164.0,297.0,206.0,3236,1471,2497,1091,739,380,3795,672,2808,374,987,298,85,30,9720,14275,8000,3075,46409,39562,1
1479,2,1,185.0,159.0,297.0,206.0,3622,1398,2816,1063,806,335,2917,847,2359,509,558,338,85,30,9290,13875,8000,3325,46884,39962,1
1486,2,1,167.0,166.0,297.0,206.0,3218,1398,2435,1063,783,335,3253,553,2599,179,654,374,85,30,7515,13625,8000,3325,48639,40212,1
1493,2,1,176.0,164.0,297.0,206.0,3431,1398,2603,1063,828,335,2296,728,2192,314,104,414,85,30,7560,13875,8000,3325,48639,40462,1
1500,2,1,173.0,170.0,297.0,206.0,2273,1488,1534,1175,739,313,2515,164,2327,14,188,150,82,30,7990,14325,8000,3325,48789,40462,1
1507,2,1,173.0,170.0,281.0,206.0,2048,1404,1399,1091,649,313,2747,334,2487,144,260,190,82,30,8005,14325,8000,3325,48989,40462,1
1514,2,1,198.0,169.0,281.0,206.0,1908,1113,1259,867,649,246,1982,52,1642,34,340,18,82,29,10280,14325,8000,3325,49064,40512,1
1521,2,1,198.0,169.0,266.0,200.0,2020,514,1371,447,649,67,2213,111,1797,89,416,22,82,29,10705,14325,7850,3325,49614,40862,1
1529,2,1,197.0,168.0,266.0,200.0,1908,525,1259,503,649,22,2453,176,1957,154,496,22,81,29,10705,15425,7700,3325,49814,40912,1
1536,2,1,194.0,165.0,266.0,200.0,2172,553,1523,531,649,22,2286,250,1889,224,397,26,81,29,10305,15125,7700,3325,50214,41212,1
1543,2,1,198.0,164.0,266.0,200.0,1930,503,1259,503,671,0,1291,310,1164,284,127,26,81,29,10005,15075,7700,3325,50514,41262,1
1550,2,1,198.0,162.5,266.0,200.0,1908,687,1259,643,649,44,1502,108,1299,74,203,34,81,28,10430,15050,7700,3325,50514,41287,1
1557,2,1,196.0,162.5,266.0,200.0,1964,866,1315,755,649,111,1758,214,1479,164,279,50,81,28,10330,15050,7700,3325,50614,41287,1
1564,2,1,200.0,162.5,266.0,200.0,1908,827,1259,783,649,44,1573,298,1514,244,59,54,81,28,10730,15050,7700,3325,51014,41287,1
1571,2,1,200.0,162.5,258.0,200.0,1964,659,1315,615,649,44,1829,391,1694,329,135,62,81,28,10730,15050,7700,3325,51114,41287,1
1579,2,1,200.0,162.5,258.0,200.0,1886,894,1259,783,627,111,1725,202,1664,124,61,78,81,28,11140,15050,7700,2825,51129,41787,1
1586,2,1,200.0,162.5,258.0,200.0,1992,922,1343,811,649,111,1985,600,1844,514,141,86,81,28,11990,15050,7700,2825,51129,41787,1
1593,2,1,200.0,161.5,258.0,200.0,1930,743,1259,699,671,44,1900,679,1829,589,71,90,81,27,11705,15050,7700,2825,51429,41837,1
1600,2,1,200.0,165.5,258.0,200.0,1998,833,1371,699,627,134,1642,184,1499,74,143,110,81,27,11705,15050,7700,2825,51429,41837,1
1607,2,1,200.0,165.5,258.0,200.0,1880,838,1231,727,649,111,1862,273,1639,159,223,114,81,27,11705,15050,7700,2825,51429,41837,1
1614,2,1,200.0,166.5,258.0,200.0,2076,799,1427,755,649,44,2018,207,1719,89,299,118,81,26,11705,15050,7700,2825,51429,41837,1
1621,2,1,200.0,166.5,266.0,206.0,1908,760,1259,671,649,89,2533,304,2154,174,379,130,81,26,11705,15050,7700,2825,51129,41837,1
1629,2,1,200.0,168.5,266.0,206.0,2110,1029,1483,895,627,134,2189,289,1734,139,455,150,81,26,12005,15050,7700,2825,51129,41837,1
1636,2,1,200.0,168.5,274.0,206.0,1930,1068,1259,867,671,201,2404,412,1869,234,535,178,81,26,12005,15350,7700,2825,51129,41837,1
1643,2,1,200.0,168.0,274.0,206.0,2048,1208,1399,895,649,313,2345,572,1734,354,611,218,81,26,12005,15325,7700,2825,51129,41862,1
1650,2,1,200.0,169.0,274.0,206.0,1908,1314,1259,979,649,335,2571,442,1884,384,687,58,81,26,12005,15225,7700,2825,51129,42112,1
1657,2,1,196.0,169.0,274.0,206.0,1880,1398,1231,1063,649,335,2766,158,1999,64,767,94,81,26,11790,14425,7700,2825,51344,42912,1
1664,2,1,194.0,169.0,282.0,206.0,1516,1454,867,1119,649,335,2942,343,2099,209,843,134,81,26,11705,14575,7900,2700,51444,43037,1
1671,2,1,194.0,167.0,282.0,206.0,1488,1376,839,1063,649,313,3112,499,2189,329,923,170,81,26,11705,14325,8100,2700,51444,43287,1
1679,2,1,192.0,161.0,282.0,206.0,1348,1348,699,1035,649,313,3263,654,2264,444,999,210,81,26,10990,14350,8100,2700,51784,43937,1
1686,2,1,184.0,149.0,282.0,212.0,1398,1376,727,1063,671,313,3393,819,2314,569,1079,250,81,26,10235,12510,8100,2700,52794,45537,1
1693,2,1,172.0,141.0,282.0,212.0,1348,1426,699,1091,649,335,3534,999,2379,709,1155,290,81,26,9050,11775,8100,2700,54514,46587,1
1700,2,1,172.0,152.0,282.0,212.0,1376,1376,727,1063,649,313,3290,360,2059,34,1231,326,81,26,9050,11775,8100,2700,54514,46587,1
1707,2,1,172.0,150.0,282.0,212.0,1236,1202,587,867,649,335,3411,495,2104,129,1307,366,81,26,9080,11525,8100,2700,54514,46837,1
1714,2,1,172.0,146.0,282.0,212.0,1376,1118,727,783,649,335,3561,625,2174,219,1387,406,81,29,9110,11225,8100,2700,54514,47137,1
1721,2,1,191.0,148.0,282.0,212.0,1354,794,727,503,627,291,2712,502,1324,64,1388,438,81,27,10025,11225,8100,2700,54514,47137,1
1729,2,1,175.0,144.5,282.0,212.0,1398,469,727,335,671,134,2857,554,1389,104,1468,450,81,27,9240,10800,8100,2700,55314,47487,1
1736,2,1,183.0,139.5,282.0,212.0,1807,637,1091,503,716,134,2290,614,1134,144,1156,470,81,26,9255,11050,8100,2700,55314,48037,1
1743,2,1,185.0,139.5,282.0,212.0,2126,978,1511,755,615,223,2211,742,1139,244,1072,498,81,26,9355,11050,8100,2700,55314,48037,1
1750,2,1,185.0,139.5,282.0,212.0,1090,1202,587,755,503,447,2341,892,1209,334,1132,558,81,26,9570,11050,8100,2700,55314,48037,1
1757,2,1,185.0,139.5,282.0,212.0,1057,1152,587,615,470,537,2467,1039,1279,409,1188,630,81,26,9570,11050,8100,2700,55314,48037,1
1764,2,1,185.0,139.5,290.0,212.0,1170,1320,655,671,515,649,2542,1204,1286,494,1256,710,81,26,9570,11050,8100,2700,55314,48037,1
1771,2,1,189.0,142.5,290.0,212.0,1785,1342,1293,671,492,671,2236,1060,1220,474,1016,586,81,26,9570,11050,8100,2700,55314,48037,1
1779,2,1,187.0,152.5,305.0,212.0,2087,1421,1528,727,559,694,2334,475,1250,59,1084,416,81,26,9870,11050,8100,2700,55414,48037,1
1786,2,1,185.0,150.5,305.0,212.0,2485,1376,1892,727,593,649,2626,792,1476,254,1150,538,81,26,9620,11050,8100,2700,55664,48037,1
1793,2,1,183.0,154.5,305.0,212.0,2693,1410,2234,783,459,627,2945,453,1747,39,1198,414,81,26,9520,11050,8100,2700,55764,48037,1
1800,2,1,191.0,154.5,305.0,212.0,2329,1354,1814,727,515,627,2329,623,1359,129,970,494,81,26,9520,11950,8100,2700,55764,48037,1
1807,2,1,199.0,155.5,305.0,212.0,2367,1404,1763,755,604,649,1609,643,967,169,642,474,81,26,9520,11950,8400,2700,55764,48037,1
1814,2,1,199.0,158.5,305.0,212.0,2189,1348,1562,699,627,649,1270,353,848,99,422,254,81,26,9520,11950,8400,2700,55764,48037,1
1821,2,1,199.0,158.0,305.0,212.0,2284,1510,1635,839,649,671,1541,429,1047,149,494,280,81,26,9520,12425,8400,2700,55764,48062,1
1829,2,1,191.0,161.0,305.0,212.0,2121,1460,1450,811,671,649,1081,301,957,149,124,152,65,26,10320,13025,8400,2700,56564,48062,1
1836,2,1,185.0,161.0,313.0,212.0,2060,1410,1433,783,627,627,915,452,719,224,196,228,59,26,12620,13125,8400,2700,56864,48062,1
1843,2,1,199.0,165.0,313.0,212.0,2010,1359,1383,811,627,548,455,133,179,39,276,94,59,26,12620,13125,8400,2700,56864,48062,1
1850,2,1,192.0,165.0,313.0,212.0,1959,1275,1355,783,604,492,686,283,334,129,352,154,52,26,13320,13125,8400,2700,57289,48062,1
1857,2,1,188.0,165.0,313.0,212.0,1763,1275,1226,783,537,492,892,433,480,219,412,214,52,26,12920,13425,8100,2700,57989,48062,1
1864,2,1,188.0,165.0,313.0,212.0,1125,1298,711,783,414,515,978,589,520,319,458,270,52,26,12920,13425,8300,2700,57989,48062,1
1871,2,1,188.0,169.0,313.0,212.0,446,1326,167,811,279,515,922,259,440,129,482,130,52,26,12920,13925,8500,2700,57989,48062,1
1879,2,1,188.0,169.0,313.0,212.0,940,1281,649,811,291,470,1068,396,546,214,522,182,52,26,12920,13925,8500,2700,57989,48062,1
1886,2,1,186.0,171.5,305.0,212.0,1500,1281,1187,811,313,470,1250,61,692,19,558,42,52,26,12720,13850,8300,2700,58589,48137,1
1893,2,1,182.0,167.0,305.0,204.0,1432,1309,1119,839,313,470,1417,126,819,74,598,52,52,26,12320,13425,8100,2700,58789,48562,1
1900,2,1,182.0,169.0,305.0,204.0,1561,1443,1226,951,335,492,1510,201,872,89,638,112,52,26,12320,13925,8100,2700,58789,48562,1
1907,2,1,182.0,171.0,305.0,204.0,1398,1499,1063,1007,335,492,1592,131,914,59,678,72,52,26,12320,14025,8100,2700,58789,48562,1
1914,2,1,182.0,171.0,305.0,204.0,1376,1522,1063,1007,313,515,1755,307,1041,179,714,128,52,26,12320,14625,8100,2700,58789,48562,1
1921,2,1,176.0,171.0,313.0,204.0,1258,1443,923,951,335,492,1906,463,1152,279,754,184,48,26,12120,14625,8100,2700,59189,48562,1
1929,2,1,176.0,167.5,313.0,204.0,1225,1421,867,951,358,470,2053,644,1255,404,798,240,48,26,12120,14300,8100,2700,59189,48887,1
1936,2,1,166.0,164.0,313.0,198.0,1141,1303,750,923,391,380,2189,288,1345,204,844,84,48,23,11620,14325,8100,2700,59689,49687,1
1943,2,1,159.0,164.0,313.0,198.0,984,1124,671,811,313,313,2300,418,1420,294,880,124,43,23,11520,14325,8100,2700,60039,49687,1
1950,2,1,157.0,158.0,313.0,190.0,614,1040,391,727,223,313,1355,543,1205,379,150,164,31,23,11520,13525,8100,2700,60639,50487,1
1957,2,1,157.0,163.0,313.0,190.0,492,973,313,615,179,358,1417,303,1247,149,170,154,31,23,11720,13525,8100,2700,60639,50487,1
1964,2,1,157.0,163.0,313.0,190.0,436,1029,235,671,201,358,1455,333,1261,189,194,144,31,23,12620,14025,8100,2700,60639,50487,1
1971,2,1,157.0,165.0,313.0,190.0,744,1068,431,755,313,313,1565,215,1331,139,234,76,31,23,12620,14375,8100,2700,60639,50487,1
1979,2,1,157.0,165.0,313.0,190.0,940,1068,627,755,313,313,1675,340,1401,224,274,116,31,23,12620,14475,8100,2700,60639,50487,1
1986,2,1,155.0,165.0,305.0,190.0,900,984,587,671,313,313,1792,465,1478,309,314,156,31,23,12520,14475,8100,2700,60839,50487,1
1993,2,1,159.0,167.0,305.0,190.0,805,1096,470,783,335,313,1474,355,1420,259,54,96,31,23,12520,14475,8100,2700,60839,50487,1
2000,2,1,167.0,167.0,305.0,190.0,726,1040,391,727,335,313,1170,480,1076,344,94,136,31,23,12520,14725,8100,2700,60839,50487,1
2007,2,1,151.0,170.0,305.0,190.0,883,1029,548,671,335,358,1276,455,1146,279,130,176,15,23,13370,14725,8100,2700,61639,50487,1
2014,2,1,145.0,170.0,305.0,190.0,839,1113,548,755,291,358,1378,590,1216,374,162,216,9,23,13370,14725,8100,2700,62014,50487,1
2021,2,1,142.0,170.0,305.0,190.0,492,1096,313,783,179,313,1126,712,1094,464,32,248,6,23,13070,14975,8100,2700,62464,50487,1
2029,2,1,142.0,170.0,290.0,190.0,145,1068,78,755,67,313,1137,842,1101,554,36,288,6,23,13070,15125,8100,2700,62864,50487,1
2036,2,1,140.0,170.0,290.0,190.0,0,984,0,671,0,313,1137,952,1101,624,36,328,6,23,12970,15125,8100,2700,62964,50487,1
2043,2,1,140.0,172.0,290.0,190.0,184,1040,117,727,67,313,1170,742,1122,474,48,268,6,22,12970,15125,8100,2700,62964,50487,1
2050,2,1,140.0,174.0,290.0,190.0,78,1034,78,699,0,335,1170,537,1122,379,48,158,6,22,12970,15125,8100,2700,62964,50487,1
2057,2,1,140.0,174.0,290.0,190.0,0,973,0,615,0,358,695,642,647,444,48,198,6,22,13270,15275,8100,2700,62964,50487,1
2064,2,1,140.0,173.0,290.0,190.0,0,956,0,643,0,313,695,759,647,529,48,230,6,21,13270,15275,8100,2700,62964,50487,1
2071,2,1,140.0,173.0,290.0,190.0,106,900,39,587,67,313,714,869,654,599,60,270,6,21,13270,15275,8100,2700,62964,50487,1
2079,2,1,140.0,173.0,290.0,190.0,100,984,78,671,22,313,721,994,661,684,60,310,6,21,13270,15575,8100,2950,62964,50487,1
2086,2,1,139.0,173.0,290.0,190.0,39,956,39,643,0,313,728,1119,668,769,60,350,6,21,13170,15575,8100,2950,63064,50487,1
2093,2,1,138.0,177.0,290.0,190.0,0,928,0,615,0,313,1028,729,968,639,60,90,6,21,13070,15575,8100,2950,62939,50487,1
2100,2,1,152.0,177.0,290.0,190.0,67,1057,0,699,67,358,325,854,253,724,72,130,6,21,13055,15575,8100,2700,62954,50737,1
2107,2,1,152.0,172.0,290.0,184.0,122,514,78,335,44,179,324,882,252,744,72,138,6,19,13740,15275,8000,2700,63084,51487,1
2114,2,1,149.0,161.0,290.0,184.0,39,368,39,279,0,89,264,948,192,794,72,154,6,19,13450,14125,8000,2700,63314,52637,1
2121,2,1,138.0,155.0,290.0,176.0,39,301,39,279,0,22,226,977,154,819,72,158,5,19,12450,13275,8000,2700,64359,53487,1
2129,2,1,133.0,149.0,290.0,176.0,44,284,0,195,44,89,144,1014,64,844,80,170,2,19,12350,13125,8000,2700,64669,54137,1
2136,2,1,133.0,151.0,282.0,176.0,22,368,0,279,22,89,84,811,4,779,80,32,2,19,12425,13125,7900,2700,64869,54137,1
2143,2,1,133.0,162.5,282.0,176.0,0,346,0,279,0,67,84,146,4,114,80,32,2,19,12500,13100,7900,2700,64869,54162,1
2150,2,1,133.0,162.5,282.0,176.0,0,368,0,279,0,89,84,187,4,139,80,48,2,19,12500,13100,7900,2700,64869,54162,1
2157,2,1,133.0,165.5,282.0,176.0,44,323,0,279,44,44,92,67,4,19,88,48,2,19,12500,13500,7900,2700,64869,54162,1
2164,2,1,133.0,161.5,282.0,176.0,44,334,0,223,44,111,92,102,4,34,88,68,2,19,12440,13200,7900,2700,64929,54462,1
2171,2,1,127.0,149.5,282.0,176.0,0,334,0,223,0,111,92,145,4,69,88,76,2,19,11645,11950,7900,2700,65724,55962,1
2179,2,1,113.0,137.5,282.0,176.0,0,228,0,139,0,89,92,167,4,79,88,88,2,19,10625,11000,7900,2700,66744,57362,1
2186,2,1,101.0,131.0,282.0,176.0,44,273,0,139,44,134,100,212,4,104,96,108,2,19,9345,10225,7900,2700,68024,58137,1
2193,2,1,79.0,121.0,282.0,176.0,44,362,0,251,44,111,100,249,4,129,96,120,2,19,7250,9425,7900,2700,70019,58937,1
2200,2,1,78.0,117.0,282.0,176.0,0,172,0,83,0,89,100,275,4,139,96,136,1,19,7250,9025,7900,2700,70069,59337,1
2207,2,1,77.0,109.0,266.0,176.0,0,413,0,279,0,134,100,327,4,179,96,148,0,19,7250,8175,7700,2700,70594,60187,1
2214,2,1,77.0,107.0,258.0,176.0,0,301,0,167,0,134,100,352,4,184,96,168,0,19,7250,8025,7500,2700,70894,60337,1
2221,2,1,77.0,109.0,258.0,176.0,0,256,0,167,0,89,100,135,4,59,96,76,0,19,7250,8025,7500,2700,70894,60337,1
2229,2,1,77.0,109.0,258.0,176.0,0,329,0,195,0,134,100,175,4,79,96,96,0,19,7250,8025,7500,2700,70894,60337,1
2236,2,1,77.0,105.0,258.0,176.0,0,267,0,111,0,156,100,215,4,99,96,116,0,19,7250,7725,7500,2700,70894,60637,1
2243,2,1,77.0,99.0,258.0,176.0,0,329,0,195,0,134,100,244,4,124,96,120,0,19,7250,6975,7500,2700,70894,61387,1
2250,2,1,60.0,97.0,258.0,176.0,0,284,0,195,0,89,100,285,4,149,96,136,0,19,5625,6975,7500,2700,72519,61637,1
2257,2,1,60.0,91.0,258.0,176.0,0,301,0,167,0,134,100,317,4,169,96,148,0,19,5625,6425,7500,2700,72519,62187,1
2264,2,1,60.0,91.0,258.0,176.0,0,334,0,223,0,111,100,359,4,199,96,160,0,19,5625,6425,7500,2700,72519,62187,1
2271,2,1,60.0,87.0,258.0,176.0,0,284,0,195,0,89,100,146,4,74,96,72,0,19,5625,5975,7500,2700,72519,62637,1
2279,2,1,60.0,85.0,258.0,176.0,0,385,0,251,0,134,100,188,4,104,96,84,0,19,5625,5825,7500,2700,72519,62787,1
2286,2,1,60.0,84.5,258.0,176.0,0,256,0,167,0,89,100,210,4,114,96,96,0,19,5625,5800,7500,2700,72519,62812,1
2293,2,1,60.0,80.5,250.0,176.0,0,290,0,223,0,67,100,249,4,149,96,100,0,18,5625,5600,7100,2700,73019,63062,1
2300,2,1,55.0,76.5,234.0,176.0,0,284,0,195,0,89,100,290,4,174,96,116,0,18,5200,5450,7100,2700,73719,63462,1
2307,2,1,55.0,72.5,219.0,176.0,0,284,0,195,0,89,100,323,4,199,96,124,0,18,5200,5050,7100,2700,74194,63862,1
2314,2,1,55.0,70.0,219.0,160.0,0,290,0,223,0,67,100,105,4,69,96,36,0,16,5200,4725,6800,2700,74494,64387,1
2321,2,1,55.0,66.0,203.0,144.0,0,155,0,111,0,44,100,119,4,79,96,40,0,12,5200,4725,6650,2700,74844,64787,1
2329,2,1,55.0,66.0,188.0,128.0,0,77,0,55,0,22,100,133,4,89,96,44,0,12,5200,4725,6650,2700,75394,64987,1
2336,2,1,55.0,65.0,188.0,120.0,0,49,0,27,0,22,100,137,4,89,96,48,0,11,5200,4725,6500,2700,75544,65137,1
2343,2,1,55.0,63.5,180.0,120.0,0,22,0,0,0,22,100,137,4,89,96,48,0,10,5200,4950,6350,2700,75794,65212,1
2350,2,1,55.0,63.0,180.0,120.0,0,27,0,27,0,0,100,142,4,94,96,48,0,10,5200,4925,6200,2700,75944,65237,1
2357,2,1,55.0,62.5,165.0,120.0,0,0,0,0,0,0,100,142,4,94,96,48,0,10,5200,4900,6200,2450,76344,65512,1
2364,2,1,55.0,60.0,157.0,120.0,0,0,0,0,0,0,100,142,4,94,96,48,0,9,5200,4825,5800,2450,76844,65637,1
2371,2,1,55.0,58.0,157.0,120.0,0,105,0,83,0,22,100,161,4,109,96,52,0,9,5200,4725,5800,2450,76844,65737,1
2379,2,1,55.0,58.0,157.0,120.0,0,105,0,83,0,22,100,161,4,109,96,52,0,9,5200,4725,5800,2450,76844,65737,1
2386,2,1,55.0,58.0,149.0,120.0,0,55,0,55,0,0,100,171,4,119,96,52,0,9,5200,4725,5650,2450,77094,65737,1
2393,2,1,55.0,56.0,149.0,120.0,0,223,0,223,0,0,100,201,4,149,96,52,0,9,5200,4475,5350,2450,77469,65987,1
2400,2,1,55.0,56.0,149.0,120.0,0,111,0,111,0,0,100,206,4,154,96,52,0,9,5200,4475,5350,2450,77469,65987,1
2407,2,1,45.0,54.0,149.0,120.0,0,55,0,55,0,0,100,216,4,164,96,52,0,9,4350,4225,5200,2450,78469,66237,1
2414,2,1,45.0,54.0,134.0,120.0,0,139,0,139,0,0,100,236,4,184,96,52,0,9,4350,4225,5200,2450,78869,66237,1
2421,2,1,42.0,54.0,134.0,120.0,0,111,0,111,0,0,100,256,4,204,96,52,0,9,4050,4225,5200,2450,79169,66237,1
2429,2,1,42.0,50.0,134.0,120.0,0,111,0,111,0,0,100,266,4,214,96,52,0,9,4050,3675,4800,2450,79569,66787,1
2436,2,1,42.0,50.0,134.0,120.0,0,111,0,111,0,0,100,281,4,229,96,52,0,9,4050,3675,4650,2450,79794,66787,1
2443,2,1,42.0,49.5,134.0,120.0,0,167,0,167,0,0,100,306,4,254,96,52,0,9,4050,3650,4650,2450,79794,66812,1
2450,2,1,42.0,49.5,134.0,114.0,0,111,0,111,0,0,100,316,4,264,96,52,0,9,4050,3650,4500,2450,79944,67162,1
2457,2,1,42.0,49.5,126.0,114.0,0,55,0,55,0,0,100,321,4,269,96,52,0,9,4050,3650,4200,2450,80344,67162,1
2464,2,1,42.0,49.5,126.0,114.0,0,167,0,167,0,0,100,351,4,299,96,52,0,9,4050,3650,4050,2450,80494,67162,1
2471,2,1,42.0,48.5,126.0,114.0,0,111,0,111,0,0,100,361,4,309,96,52,0,8,4050,3650,4050,2450,80494,67212,1
2479,2,1,42.0,48.5,126.0,114.0,0,55,0,55,0,0,100,371,4,319,96,52,0,8,4050,3650,3950,2450,80594,67287,1
2486,2,1,42.0,48.5,126.0,114.0,0,195,0,195,0,0,100,396,4,344,96,52,0,8,4050,3650,3950,2450,80669,67287,1
2493,2,1,42.0,48.5,126.0,114.0,0,139,0,139,0,0,100,401,4,349,96,52,0,8,4050,3650,3450,2450,81056,67287,1
2500,2,1,42.0,48.5,110.0,114.0,0,55,0,55,0,0,100,411,4,359,96,52,0,8,4050,3650,3450,2450,81256,67287,1
2507,2,1,42.0,48.5,102.0,106.0,0,139,0,139,0,0,100,431,4,379,96,52,0,8,4050,3650,3450,2450,81356,67387,1
2514,2,1,42.0,48.5,102.0,98.0,0,111,0,111,0,0,100,441,4,389,96,52,0,8,4050,3650,2950,2450,81856,67487,1
2521,2,1,37.0,48.5,102.0,98.0,0,83,0,83,0,0,100,451,4,399,96,52,0,8,3625,3650,2950,2450,82281,67487,1
2529,2,1,37.0,48.5,102.0,98.0,0,83,0,83,0,0,100,461,4,409,96,52,0,8,3625,3650,2950,2450,82281,67487,1
2534,2,1,32.0,48.5,71.0,98.0,0,111,0,111,0,0,100,476,4,424,96,52,0,8,3200,3650,2950,2450,83381,67487,1
7,0,2,13.0,13.0,15.0,15.0,377,335,377,335,0,0,45,40,45,40,0,0,12,12,0,0,0,0,0,0,0
14,0,2,14.0,14.0,15.0,15.0,643,671,643,671,0,0,65,70,65,70,0,0,13,13,0,0,0,0,0,0,0
21,0,2,14.0,14.0,15.0,15.0,671,671,671,671,0,0,45,45,45,45,0,0,13,13,0,0,0,0,0,0,0
29,0,2,15.0,15.0,15.0,15.0,671,671,671,671,0,0,85,85,85,85,0,0,14,14,0,0,0,0,0,0,0
36,0,2,15.0,15.0,15.0,23.0,727,783,727,783,0,0,125,145,125,145,0,0,14,14,0,0,0,0,0,0,0
43,0,2,16.0,16.0,23.0,23.0,755,811,755,811,0,0,60,35,60,35,0,0,15,15,0,0,0,0,0,0,0
50,0,2,16.0,17.0,23.0,23.0,811,867,811,867,0,0,40,10,40,10,0,0,15,16,0,0,0,0,0,0,0
57,0,2,17.0,18.0,23.0,23.0,727,811,727,811,0,0,80,65,80,65,0,0,16,17,0,0,0,0,0,0,0
64,0,2,18.0,19.0,23.0,23.0,811,951,811,951,0,0,70,175,70,175,0,0,17,18,0,0,0,0,0,0,0
71,0,2,18.0,19.0,23.0,23.0,771,945,727,923,44,22,163,234,155,230,8,4,17,18,0,0,0,0,0,0,0
79,0,2,19.0,20.0,23.0,23.0,939,967,783,923,156,44,218,353,190,345,28,8,18,19,0,0,0,0,0,0,0
86,0,2,19.0,20.0,23.0,23.0,967,990,811,923,156,67,338,326,290,310,48,16,18,19,0,0,0,150,0,0,0
93,0,2,20.0,20.0,23.0,23.0,990,984,811,895,179,89,203,433,185,405,18,28,19,20,0,0,150,150,0,0,0
100,0,2,20.0,21.0,23.0,23.0,1018,1029,839,895,179,134,323,104,285,60,38,44,19,20,0,0,150,150,0,0,0
107,0,2,20.0,21.0,23.0,23.0,995,978,839,867,156,111,434,71,380,15,54,56,19,20,0,0,150,150,0,0,0
114,0,2,20.0,22.0,31.0,23.0,1023,1001,867,867,156,134,164,112,90,40,74,72,19,21,0,0,150,150,0,0,0
121,0,2,22.0,23.0,31.0,23.0,995,1079,839,923,156,156,169,187,75,95,94,92,19,22,100,0,150,300,0,0,0
129,0,2,22.0,25.0,31.0,31.0,1135,1079,979,923,156,156,64,47,50,10,14,37,20,22,100,0,150,300,0,0,0
136,0,2,23.0,26.0,31.0,31.0,1130,1158,951,979,179,179,89,177,55,120,34,57,20,23,100,0,150,300,0,0,0
143,0,2,23.0,29.0,31.0,31.0,1102,1225,923,979,179,246,219,99,165,60,54,39,21,24,150,125,150,300,0,0,0
150,0,2,24.0,30.0,31.0,31.0,1219,1163,1063,895,156,268,85,186,65,115,20,71,21,25,150,125,150,300,0,0,0
157,0,2,24.0,30.0,31.0,31.0,1219,1270,1063,979,156,291,180,191,140,80,40,111,21,25,150,125,150,300,0,0,0
164,0,2,25.0,31.0,31.0,31.0,1230,1202,1007,867,223,335,117,281,45,130,72,151,22,26,150,125,150,300,0,0,0
171,0,2,26.0,32.0,31.0,46.0,1286,1258,951,923,335,335,267,341,155,150,112,191,23,26,150,125,400,300,0,50,0
179,0,2,26.0,33.0,31.0,46.0,1320,1040,1007,727,313,313,412,402,260,175,152,227,23,27,150,300,400,300,0,50,0
186,0,2,29.0,34.0,46.0,46.0,1197,1286,839,951,358,335,312,267,145,100,167,167,24,28,150,300,500,400,0,50,0
193,0,2,29.0,36.0,46.0,46.0,1342,1516,1007,1203,335,313,333,308,130,105,203,203,24,30,150,300,500,400,0,50,0
200,0,2,33.0,37.0,46.0,46.0,1516,1566,1203,1231,313,335,104,244,15,105,89,139,25,31,150,300,725,400,0,50,0
207,0,2,35.0,38.0,46.0,46.0,1516,1611,1203,1343,313,268,169,186,40,15,129,171,25,32,250,300,725,400,0,50,0
214,0,2,35.0,40.0,46.0,46.0,1460,1667,1147,1399,313,268,269,397,125,190,144,207,26,34,250,300,875,400,0,50,0
221,0,2,36.0,41.0,46.0,46.0,1432,1740,1119,1427,313,313,184,107,100,10,84,97,26,35,250,300,950,650,0,50,0
229,0,2,39.0,42.0,46.0,46.0,1734,1718,1399,1427,335,291,174,159,50,30,124,129,26,36,350,300,1025,650,0,50,0
236,0,2,39.0,43.0,46.0,46.0,1757,1802,1399,1511,358,291,389,290,225,125,164,165,26,37,625,300,1025,650,0,50,0
243,0,2,42.0,44.0,46.0,46.0,1740,1914,1427,1623,313,291,321,432,250,235,71,197,27,38,775,300,1025,650,0,50,0
250,0,2,46.0,48.0,46.0,54.0,1824,1998,1511,1707,313,291,186,288,125,180,61,108,27,39,675,300,1025,900,100,50,0
257,0,2,49.0,49.0,54.0,54.0,1824,2003,1511,1735,313,268,216,330,115,190,101,140,27,40,675,475,1025,1050,100,50,0
264,0,2,49.0,53.0,54.0,54.0,1992,2054,1679,1763,313,291,141,351,100,225,41,126,27,42,675,475,1025,1050,100,50,0
271,0,2,54.0,55.0,54.0,62.0,1992,2037,1679,1791,313,246,116,294,85,215,31,79,29,43,1300,750,1025,1200,100,50,0
279,0,2,57.0,60.0,62.0,62.0,2093,1947,1735,1679,358,268,151,171,80,160,71,11,29,44,1300,750,1025,1200,100,50,0
286,0,2,58.0,60.0,62.0,62.0,1986,2110,1651,1707,335,403,287,337,180,270,107,67,29,45,1350,1200,1025,1200,100,50,0
293,0,2,62.0,63.0,62.0,70.0,2104,2199,1791,1595,313,604,93,414,75,350,18,64,31,46,1600,1200,1025,1200,100,50,0
300,0,2,66.0,63.0,70.0,70.0,2188,2373,1875,1791,313,582,163,496,130,360,33,136,31,46,1650,1200,1025,1200,100,50,0
307,0,2,69.0,64.0,70.0,78.0,2188,2272,1875,1623,313,649,183,321,135,255,48,66,32,47,1700,1300,1025,1200,100,100,0
314,0,2,71.0,68.0,78.0,78.0,2048,2434,1735,1763,313,671,58,267,20,225,38,42,33,48,1700,1300,1025,1200,100,100,0
321,0,2,74.0,68.0,78.0,86.0,1930,2350,1595,1679,335,671,173,443,95,325,78,118,35,49,2150,1650,1025,1200,100,100,0
329,0,2,76.0,70.0,78.0,86.0,1841,2474,1483,1847,358,627,283,545,165,355,118,190,35,49,2275,1750,1025,1200,100,100,0
336,0,2,77.0,70.0,78.0,86.0,1874,2401,1539,1819,335,582,504,527,350,265,154,262,35,49,2325,1750,1025,1200,150,100,0
343,0,2,76.0,74.0,86.0,94.0,1852,2423,1539,1819,313,604,730,443,540,205,190,238,35,49,2525,1750,1025,1350,200,100,0
350,0,2,78.0,78.0,86.0,102.0,1600,2451,1287,1847,313,604,476,525,296,215,180,310,33,49,2525,1950,1025,1350,351,100,0
357,0,2,79.0,69.0,86.0,94.0,1628,2474,1315,1847,313,627,373,313,203,135,170,178,33,46,2575,1650,1025,1650,351,650,0
364,0,2,76.0,59.0,86.0,94.0,1656,1914,1343,1399,313,515,177,224,17,40,160,184,31,38,2300,1300,1025,1950,732,1575,0
371,0,2,76.0,39.0,86.0,94.0,1701,1253,1343,895,358,358,382,374,182,150,200,224,28,26,2500,600,1025,1950,1038,2875,0
379,0,2,74.0,43.0,86.0,94.0,1505,1275,1147,895,358,380,312,352,123,130,189,222,30,26,2400,1025,1125,1750,1138,3300,0
386,0,2,73.0,45.0,86.0,94.0,1544,1309,1231,951,313,358,171,331,56,115,115,216,30,26,2325,1200,1125,1500,1263,3550,0
393,0,2,80.0,47.0,86.0,94.0,1544,1331,1231,951,313,380,206,399,58,135,148,264,30,26,2625,1200,1125,1500,1263,3550,0
400,0,2,83.0,47.0,86.0,94.0,1712,1309,1399,951,313,358,132,549,75,245,57,304,32,27,2625,1200,1125,1400,1263,3725,0
407,0,2,83.0,49.0,86.0,79.0,1740,1365,1427,1007,313,358,332,364,242,120,90,244,32,28,2625,1025,1125,1400,1263,4300,0
414,0,2,85.0,49.0,86.0,79.0,1902,1258,1567,923,335,335,568,505,442,225,126,280,32,28,2975,1375,1125,1400,1263,4300,0
7,1,1,13.0,13.0,14.0,14.0,377,335,377,335,0,0,45,40,45,40,0,0,12,12,0,0,0,0,0,0,1
14,1,1,13.0,13.0,14.0,14.0,671,643,671,643,0,0,20,15,20,15,0,0,13,13,0,0,0,0,0,0,1
21,1,1,14.0,14.0,14.0,14.0,727,727,727,727,0,0,50,50,50,50,0,0,13,13,0,0,0,0,0,0,1
29,1,1,14.0,14.0,14.0,14.0,727,699,727,699,0,0,145,140,145,140,0,0,13,13,0,0,0,0,0,0,1
36,1,1,16.0,16.0,22.0,22.0,783,811,783,811,0,0,145,150,145,150,0,0,14,14,0,0,0,0,0,0,1
43,1,1,16.0,16.0,22.0,22.0,811,839,811,839,0,0,240,240,240,240,0,0,14,14,0,0,0,0,0,0,1
50,1,1,15.0,15.0,22.0,22.0,811,839,811,839,0,0,30,40,30,40,0,0,15,15,0,0,0,0,0,0,1
57,1,1,17.0,17.0,22.0,22.0,783,839,783,839,0,0,30,40,30,40,0,0,15,15,0,0,0,0,0,0,1
64,1,1,18.0,18.0,22.0,22.0,923,923,923,923,0,0,90,100,90,100,0,0,16,16,0,0,0,0,0,0,1
71,1,1,17.0,17.0,22.0,22.0,923,951,923,951,0,0,170,180,170,180,0,0,17,17,0,0,0,0,0,0,1
79,1,1,17.0,17.0,22.0,22.0,951,979,951,979,0,0,25,45,25,45,0,0,16,16,0,0,0,0,0,0,1
86,1,1,18.0,18.0,22.0,22.0,979,979,979,979,0,0,95,110,95,110,0,0,16,16,0,0,0,0,0,0,1
93,1,1,19.0,19.0,22.0,22.0,911,979,867,979,44,0,143,165,135,165,8,0,18,18,0,0,0,0,0,0,1
100,1,1,19.0,20.0,22.0,22.0,1023,1034,867,923,156,111,273,240,245,220,28,20,18,18,0,0,0,0,0,0,1
107,1,1,20.0,20.0,22.0,22.0,1074,1051,895,895,179,156,343,360,295,320,48,40,19,19,0,0,0,0,0,0,1
114,1,1,21.0,21.0,22.0,22.0,1107,1107,951,951,156,156,429,445,365,385,64,60,20,20,0,0,0,0,0,0,1
121,1,1,26.0,26.0,28.0,28.0,1079,1135,923,979,156,156,104,230,20,150,84,80,20,20,0,0,250,250,0,0,1
129,1,1,26.0,26.0,28.0,28.0,1163,1186,1007,1007,156,179,49,70,45,70,4,0,21,21,0,0,250,250,0,0,1
136,1,1,28.0,28.0,28.0,28.0,1068,1141,979,1007,89,134,77,102,65,90,12,12,21,21,0,0,250,250,0,0,1
143,1,1,28.0,30.0,36.0,36.0,1186,1197,1119,1063,67,134,215,153,195,125,20,28,21,21,50,50,250,250,0,0,1
150,1,1,30.0,30.0,36.0,36.0,1191,1230,1147,1119,44,111,259,300,235,260,24,40,23,23,50,50,250,250,0,0,1
157,1,1,30.0,30.0,36.0,36.0,1247,1230,1203,1119,44,111,57,96,25,40,32,56,23,24,350,350,250,250,0,0,1
164,1,1,32.0,32.0,36.0,36.0,1326,1337,1259,1203,67,134,115,162,75,90,40,72,23,24,400,350,250,250,0,0,1
171,1,1,33.0,31.0,36.0,36.0,1303,1393,1259,1259,44,134,214,178,170,140,44,38,24,23,400,350,250,250,0,0,1
179,1,1,34.0,33.0,36.0,36.0,1438,1398,1371,1287,67,111,237,145,185,95,52,50,25,25,400,400,250,250,0,0,1
186,1,1,35.0,33.0,36.0,36.0,1443,1426,1399,1315,44,111,346,321,290,255,56,66,25,25,500,400,250,250,0,0,1
193,1,1,36.0,38.0,36.0,44.0,1471,1533,1427,1399,44,134,474,152,410,70,64,82,25,27,500,400,250,250,0,0,1
200,1,1,41.0,40.0,44.0,44.0,1522,1538,1455,1427,67,111,202,224,180,130,22,94,24,29,550,400,250,250,0,0,1
207,1,1,41.0,42.0,44.0,44.0,1466,1723,1399,1567,67,156,360,329,330,215,30,114,24,29,600,400,250,250,0,0,1
214,1,1,42.0,44.0,44.0,52.0,1426,1746,1315,1567,111,179,382,429,340,295,42,134,24,29,950,650,250,450,0,0,1
221,1,1,43.5,51.0,44.0,52.0,1398,1751,1287,1595,111,156,444,120,390,20,54,100,25,29,925,750,250,450,25,0,1
229,1,1,52.5,51.0,58.0,58.0,1348,1695,1259,1539,89,156,101,220,35,150,66,70,26,29,925,850,250,450,25,0,1
236,1,1,52.5,51.0,58.0,58.0,1454,1527,1343,1371,111,156,287,300,205,210,82,90,27,29,925,950,250,450,25,50,1
243,1,1,55.5,55.0,58.0,58.0,1566,1443,1455,1287,111,156,329,225,235,115,94,110,34,28,925,1300,450,450,25,150,1
250,1,1,57.5,57.0,58.0,66.0,1706,1606,1595,1427,111,179,286,230,180,100,106,130,37,28,925,1300,450,450,25,150,1
257,1,1,57.5,58.0,58.0,66.0,1841,1634,1707,1455,134,179,307,155,235,55,72,100,36,35,925,1450,450,450,25,150,1
264,1,1,56.5,60.5,58.0,66.0,1925,1779,1791,1623,134,156,392,197,300,43,92,154,37,35,1075,1425,450,450,25,199,1
271,1,1,56.5,62.0,58.0,74.0,2026,1891,1847,1735,179,156,492,337,405,163,87,174,37,36,1175,1400,450,450,50,224,1
279,1,1,57.5,62.0,58.0,82.0,2311,2003,2155,1847,156,156,508,477,405,283,103,194,38,39,1175,1400,450,450,50,224,1
286,1,1,56.0,63.5,74.0,90.0,2160,2115,1959,1959,201,156,341,237,210,123,131,114,39,41,1150,1325,450,450,150,299,1
293,1,1,56.0,68.5,82.0,90.0,2244,2171,1819,2015,425,156,526,192,335,58,191,134,39,42,1150,1325,650,450,150,299,1
300,1,1,65.5,70.5,98.0,98.0,2205,2250,1735,2071,470,179,272,227,150,73,122,154,39,42,1125,1325,650,450,175,299,1
307,1,1,69.0,73.5,122.0,98.0,2255,2250,1763,2071,492,179,347,282,215,108,132,174,39,46,1050,1275,650,450,175,349,1
314,1,1,79.0,73.5,130.0,98.0,2227,2507,1735,2351,492,156,103,508,40,318,63,190,39,51,1450,1275,650,450,175,349,1
321,1,1,82.0,71.0,130.0,98.0,2289,2563,1819,2407,470,156,224,613,105,403,119,210,39,53,1750,1200,650,450,175,424,1
329,1,1,84.0,87.5,130.0,106.0,2205,2742,1735,2519,470,223,84,138,55,46,29,92,39,52,2050,1175,650,650,175,511,1
336,1,1,84.5,89.0,130.0,114.0,2255,2826,1763,2379,492,447,309,283,220,181,89,102,39,52,2225,950,650,650,250,586,1
343,1,1,89.0,98.5,130.0,114.0,2171,3034,1679,2519,492,515,320,148,175,111,145,37,39,52,2650,875,650,650,400,661,1
350,1,1,93.0,99.0,130.0,114.0,2255,2899,1763,2407,492,492,186,194,85,176,101,18,39,52,2300,1500,650,650,650,936,1
357,1,1,91.5,94.0,130.0,114.0,2149,2843,1679,2351,470,492,97,165,15,141,82,24,39,52,1825,1100,650,800,975,1536,1
364,1,1,85.5,93.0,130.0,114.0,2233,2647,1763,2155,470,492,353,345,154,336,199,9,39,51,1825,1400,650,800,1249,1936,1
371,1,1,86.0,92.0,130.0,114.0,2227,2765,1735,2295,492,470,313,276,54,211,259,65,39,51,2050,1250,650,800,1524,2386,1
379,1,1,77.5,94.0,130.0,114.0,2149,2457,1679,1987,470,470,269,166,54,116,215,50,42,51,1825,1250,650,800,1999,2586,1
386,1,1,80.5,98.0,130.0,114.0,2278,2703,1763,2211,515,492,399,301,124,241,275,60,45,51,1825,1900,650,800,1999,2586,1
393,1,1,84.5,106.0,130.0,114.0,2339,2922,1847,2407,492,515,485,251,204,231,281,20,46,51,1825,2000,650,800,1999,2586,1
400,1,1,90.5,106.0,130.0,106.0,2513,2927,2043,2435,470,492,391,557,154,481,237,76,49,51,1725,2000,650,800,2099,2736,1
407,1,1,99.0,106.0,130.0,106.0,2653,2927,2183,2435,470,492,212,693,44,561,168,132,49,51,1700,2350,650,800,2124,2736,1
414,1,1,101.0,104.5,130.0,98.0,2737,2877,2267,2407,470,470,247,839,119,751,128,88,49,51,2150,2825,650,800,2274,2911,1
421,1,1,102.0,104.5,130.0,106.0,2675,2821,2183,2351,492,470,357,1194,219,1046,138,148,48,51,2550,2875,650,800,2424,2911,1
429,1,1,101.0,104.0,130.0,114.0,2647,2871,2155,2379,492,492,458,1034,314,826,144,208,48,51,2500,2450,650,800,2674,3536,1
436,1,1,85.0,98.0,130.0,114.0,2726,2843,2211,2351,515,492,688,1129,509,961,179,168,48,51,1800,2050,900,800,3574,3936,1
443,1,1,89.0,108.0,130.0,114.0,2681,2871,2211,2379,470,492,685,785,504,736,181,49,47,61,1850,1850,900,800,3624,4136,1
450,1,1,88.0,113.0,130.0,114.0,2569,2983,2099,2491,470,492,430,516,389,511,41,5,44,58,2150,1850,900,800,3624,4136,1
457,1,1,89.0,112.0,130.0,114.0,2339,3067,1847,2575,492,492,655,761,554,696,101,65,46,57,2350,2350,900,800,3624,4136,1
464,1,1,92.0,113.0,130.0,114.0,2513,3185,2043,2715,470,470,821,952,664,906,157,46,48,57,2350,2550,900,800,3624,4136,1
471,1,1,93.0,114.0,130.0,122.0,2496,3039,1959,2547,537,492,1059,1211,834,1176,225,35,49,57,2350,2950,900,800,3624,4136,1
479,1,1,96.0,121.0,130.0,138.0,2614,3090,1763,2351,851,739,726,1186,389,1126,337,60,52,57,2350,3050,900,925,3624,4136,1
486,1,1,95.0,128.0,130.0,138.0,2759,3011,1819,2071,940,940,1077,992,624,916,453,76,51,63,2400,3250,900,925,3624,4136,1
493,1,1,98.0,128.0,138.0,138.0,2759,3224,1819,2239,940,985,1249,994,684,806,565,188,51,63,2550,3250,900,1175,3624,4136,1
500,1,1,98.0,133.0,146.0,138.0,2782,3308,1819,2323,963,985,1590,980,909,751,681,229,51,62,2550,3600,900,1175,3624,4136,1
507,1,1,97.5,137.0,146.0,146.0,2787,3314,1847,2351,940,963,1916,781,1119,586,797,195,51,62,2675,3600,900,1175,3649,4136,1
514,1,1,97.5,153.0,146.0,154.0,2916,3398,1931,2435,985,963,2291,397,1374,286,917,111,51,62,2675,3600,900,1175,3649,4136,1
521,1,1,97.5,153.0,138.0,154.0,2754,3532,1791,2547,963,985,2598,807,1569,576,1029,231,51,62,2675,4100,1350,1175,3749,4136,1
529,1,1,123.5,159.0,130.0,170.0,2485,3504,1679,2519,806,985,572,933,459,661,113,272,51,62,2675,4100,1350,1175,3849,4136,1
536,1,1,121.5,165.0,124.0,170.0,2233,3476,1539,2491,694,985,683,874,494,486,189,388,49,62,2675,4900,1350,1175,4199,4136,1
543,1,1,113.5,165.0,124.0,170.0,2334,3414,1707,2407,627,1007,1214,1185,849,681,365,504,49,62,2625,4900,1350,1175,4499,4136,1
550,1,1,111.5,165.0,124.0,170.0,2384,3448,1735,2463,649,985,843,1391,694,871,149,520,48,62,3825,5200,1350,1175,4949,4136,1
557,1,1,111.0,153.0,138.0,178.0,2468,3319,1819,2379,649,940,733,1768,704,1136,29,632,48,61,3600,4500,1350,1175,5174,4836,1
564,1,1,101.5,167.0,138.0,178.0,2378,3314,1707,2351,671,963,918,873,809,446,109,427,47,61,3225,3900,1350,1175,5799,5436,1
571,1,1,92.5,159.0,138.0,184.0,2266,3358,1595,2351,671,1007,1070,1273,889,726,181,547,47,61,3225,3950,1350,1175,6449,5836,1
579,1,1,74.5,159.0,138.0,184.0,1914,3202,1287,2239,627,963,587,945,534,461,53,484,29,58,2775,3350,1150,1175,7999,6586,1
7,1,2,13.0,13.0,14.0,15.0,293,293,293,293,0,0,35,35,35,35,0,0,12,12,0,0,0,0,0,0,0
14,1,2,13.0,13.0,14.0,15.0,671,643,671,643,0,0,20,15,20,15,0,0,13,13,0,0,0,0,0,0,0
21,1,2,14.0,14.0,14.0,15.0,727,671,727,671,0,0,55,45,55,45,0,0,13,13,0,0,0,0,0,0,0
29,1,2,14.0,15.0,14.0,15.0,727,755,727,755,0,0,150,75,150,75,0,0,13,14,0,0,0,0,0,0,0
36,1,2,16.0,16.0,22.0,23.0,811,699,811,699,0,0,155,120,155,120,0,0,14,15,0,0,0,0,0,0,0
43,1,2,16.0,16.0,22.0,23.0,783,783,783,783,0,0,240,10,240,10,0,0,14,15,0,0,0,0,0,0,0
50,1,2,17.0,17.0,22.0,23.0,811,755,811,755,0,0,290,20,290,20,0,0,16,16,0,0,0,0,0,0,0
57,1,2,17.0,18.0,22.0,23.0,839,811,839,811,0,0,50,75,50,75,0,0,16,17,0,0,0,0,0,0,0
64,1,2,18.0,18.0,22.0,23.0,895,895,895,895,0,0,100,135,100,135,0,0,16,17,0,0,0,0,0,0,0
71,1,2,17.0,19.0,22.0,23.0,951,923,951,923,0,0,190,245,190,245,0,0,17,18,0,0,0,0,0,0,0
79,1,2,18.0,19.0,22.0,23.0,1007,956,1007,867,0,89,0,366,0,350,0,16,16,18,0,0,0,0,0,0,0
86,1,2,18.0,20.0,22.0,23.0,923,866,923,755,0,111,105,418,105,390,0,28,16,19,0,0,0,150,0,0,0
93,1,2,19.0,20.0,22.0,23.0,979,945,979,811,0,134,165,394,165,350,0,44,18,20,0,0,0,150,0,0,0
100,1,2,20.0,21.0,22.0,23.0,1068,945,979,811,89,134,246,65,230,5,16,60,19,20,0,0,0,150,0,0,0
107,1,2,20.0,21.0,22.0,23.0,1057,995,923,839,134,156,362,90,330,10,32,80,19,20,0,0,0,150,0,0,0
114,1,2,20.0,22.0,22.0,23.0,1102,1051,923,895,179,156,392,180,340,80,52,100,20,21,0,0,0,150,0,0,0
121,1,2,22.0,22.0,22.0,23.0,1051,1079,895,923,156,156,358,185,290,65,68,120,20,21,0,0,250,150,0,0,0
129,1,2,26.0,25.0,36.0,31.0,1023,1158,867,979,156,179,228,90,140,25,88,65,20,22,0,0,250,300,0,0,0
136,1,2,27.0,25.0,36.0,31.0,1090,1102,979,923,111,179,115,170,115,85,0,85,20,22,0,0,250,300,0,0,0
143,1,2,28.0,26.0,36.0,31.0,979,1202,979,979,0,223,185,263,185,150,0,113,20,23,100,0,250,300,0,0,0
150,1,2,28.0,29.0,36.0,31.0,1007,1292,1007,979,0,313,305,33,305,5,0,28,22,24,100,125,250,300,0,0,0
157,1,2,29.0,29.0,36.0,31.0,1175,1270,1175,979,0,291,60,184,60,120,0,64,21,24,250,125,250,300,0,0,0
164,1,2,30.0,30.0,36.0,31.0,1231,1320,1231,1007,0,313,155,69,155,40,0,29,21,25,400,125,250,300,0,0,0
171,1,2,32.0,33.0,36.0,46.0,1231,1370,1231,1035,0,335,50,169,50,100,0,69,22,25,450,250,250,300,0,0,0
179,1,2,35.0,35.0,36.0,46.0,1259,1370,1259,1035,0,335,50,275,50,170,0,105,22,27,500,250,250,300,0,0,0
186,1,2,36.0,36.0,36.0,46.0,1371,1482,1371,1147,0,335,170,410,170,265,0,145,22,28,500,250,250,300,0,0,0
193,1,2,39.0,41.0,44.0,46.0,1399,1432,1399,1119,0,313,165,166,165,135,0,31,24,29,550,250,250,600,0,0,0
200,1,2,42.0,41.0,44.0,46.0,1315,1404,1315,1091,0,313,115,341,115,270,0,71,23,31,600,375,250,600,50,0,0
207,1,2,42.5,37.0,44.0,46.0,1147,1398,1147,1063,0,335,95,451,95,340,0,111,27,30,725,125,250,600,75,300,0
214,1,2,43.5,39.0,44.0,46.0,1371,1510,1371,1175,0,335,65,511,65,385,0,126,30,30,775,125,250,600,75,300,0
221,1,2,42.5,41.0,44.0,46.0,1567,1650,1567,1315,0,335,140,497,140,335,0,162,31,31,725,475,250,600,125,300,0
229,1,2,48.5,41.0,58.0,46.0,1679,1650,1679,1315,0,335,155,697,155,495,0,202,31,33,725,475,250,600,125,300,0
236,1,2,52.0,43.0,66.0,46.0,1763,1684,1763,1371,0,313,105,813,105,575,0,238,35,33,700,475,250,600,150,300,0
243,1,2,55.0,45.0,66.0,54.0,1863,1712,1819,1399,44,313,63,513,55,235,8,278,36,35,650,600,250,600,200,300,0
250,1,2,54.5,42.0,66.0,54.0,1891,1460,1735,1147,156,313,63,528,35,210,28,318,35,32,575,600,250,600,275,450,0
257,1,2,53.0,47.0,66.0,54.0,2003,1152,1847,839,156,313,163,374,115,170,48,204,35,34,650,600,250,600,400,450,0
264,1,2,56.0,47.0,66.0,54.0,2059,1746,1903,1455,156,291,108,346,40,110,68,236,38,34,800,600,250,600,400,450,0
271,1,2,60.0,49.0,74.0,54.0,2138,1802,1959,1511,179,291,163,218,75,50,88,168,39,36,950,600,500,600,400,450,0
279,1,2,65.0,49.0,74.0,62.0,2222,1970,2043,1679,179,291,178,149,70,95,108,54,40,36,950,600,500,600,400,450,0
286,1,2,66.0,51.0,82.0,62.0,1919,1841,1763,1595,156,246,54,162,30,80,24,82,41,38,1050,900,500,600,450,450,0
293,1,2,66.5,45.0,82.0,70.0,1807,1606,1651,1203,156,403,139,122,95,5,44,117,42,32,1125,775,500,600,575,875,0
7,0,1,13.0,13.0,15.0,14.0,293,167,293,167,0,0,35,20,35,20,0,0,12,12,0,0,0,0,0,0,0
14,0,1,14.0,13.0,15.0,14.0,643,643,643,643,0,0,65,15,65,15,0,0,13,13,0,0,0,0,0,0,0
21,0,1,14.0,14.0,15.0,14.0,699,699,699,699,0,0,45,35,45,35,0,0,13,13,0,0,0,0,0,0,0
29,0,1,15.0,14.0,15.0,14.0,643,755,643,755,0,0,75,125,75,125,0,0,14,13,0,0,0,0,0,0,0
36,0,1,15.0,14.0,15.0,22.0,727,755,727,755,0,0,125,15,125,15,0,0,14,14,0,0,0,0,0,0,0
43,0,1,16.0,13.0,23.0,22.0,755,755,755,755,0,0,65,25,65,25,0,0,15,12,0,0,0,0,0,0,0
50,0,1,16.0,14.0,23.0,22.0,755,643,755,643,0,0,70,45,70,45,0,0,15,12,0,0,0,0,0,0,0
57,0,1,17.0,14.0,23.0,22.0,755,699,755,699,0,0,125,40,125,40,0,0,16,13,0,0,0,0,0,0,0
64,0,1,18.0,14.0,23.0,22.0,755,721,755,699,0,22,165,119,165,115,0,4,17,14,0,0,0,0,0,0,0
71,0,1,18.0,14.0,23.0,22.0,777,754,755,643,22,111,159,205,155,185,4,20,17,14,0,0,0,0,0,0,0
79,0,1,19.0,14.0,23.0,30.0,833,771,699,615,134,156,264,305,240,265,24,40,18,14,0,0,0,0,0,0,0
86,0,1,19.0,17.0,23.0,30.0,911,827,755,671,156,156,434,200,390,140,44,60,18,14,0,0,0,250,0,0,0
93,0,1,20.0,17.0,23.0,30.0,939,799,783,643,156,156,304,140,290,60,14,80,19,14,0,0,150,250,0,0,0
100,0,1,20.0,17.0,23.0,30.0,939,771,783,615,156,156,409,155,375,55,34,100,19,13,0,0,150,250,0,0,0
107,0,1,20.0,18.0,23.0,30.0,962,710,783,531,179,179,129,140,75,20,54,120,19,12,0,50,150,250,0,0,0
114,0,1,21.0,18.0,23.0,30.0,934,710,755,531,179,179,89,220,15,80,74,140,19,13,0,50,150,250,0,0,0
121,0,1,22.0,20.0,23.0,30.0,939,687,783,531,156,156,145,196,55,40,90,156,19,14,100,250,150,250,0,0,0
129,0,1,23.0,21.0,23.0,30.0,995,732,839,531,156,201,225,239,115,55,110,184,20,14,100,250,150,250,0,0,0
136,0,1,23.0,21.0,31.0,30.0,1191,760,1035,447,156,313,140,339,110,115,30,224,20,15,100,250,150,450,0,0,0
143,0,1,24.0,22.0,31.0,30.0,1219,894,1063,559,156,335,135,399,135,135,0,264,21,16,150,300,150,450,0,0,0
150,0,1,25.0,23.0,31.0,30.0,1247,844,1091,531,156,313,220,435,200,135,20,300,22,16,150,300,150,450,0,0,0
157,0,1,25.0,24.0,31.0,30.0,1298,922,1119,587,179,335,370,400,330,60,40,340,22,17,150,300,150,450,0,0,0
164,0,1,25.0,25.0,31.0,30.0,1326,894,1147,559,179,335,125,460,65,80,60,380,23,18,150,300,150,450,0,0,0
171,0,1,26.0,25.0,31.0,38.0,1303,984,1147,671,156,313,206,581,130,165,76,416,23,19,150,300,150,450,0,0,0
179,0,1,26.0,25.0,46.0,38.0,1303,928,1147,615,156,313,161,681,65,225,96,456,23,20,150,300,500,450,0,0,0
186,0,1,27.0,25.0,46.0,38.0,1247,1090,1091,755,156,335,151,826,35,330,116,496,24,20,150,300,500,450,0,0,0
193,0,1,27.0,25.0,46.0,38.0,1247,1062,1091,727,156,335,301,941,165,405,136,536,24,20,150,300,500,450,0,0,0
200,0,1,32.0,25.0,46.0,38.0,1499,1118,1343,783,156,335,181,1077,50,505,131,572,25,20,150,300,500,450,0,0,0
207,0,1,34.0,25.0,46.0,38.0,1578,1090,1399,755,179,335,246,1207,95,595,151,612,26,20,150,300,500,450,0,0,0
214,0,1,35.0,25.0,46.0,38.0,1779,1068,1623,755,156,313,332,1333,165,685,167,648,27,20,150,300,500,450,0,0,0
221,0,1,39.0,25.0,46.0,38.0,1779,1062,1623,727,156,335,137,1458,50,770,87,688,28,20,350,300,575,450,0,0,0
229,0,1,42.0,25.0,46.0,38.0,1779,1096,1623,783,156,313,197,1594,90,870,107,724,29,20,350,300,575,450,0,0,0
236,0,1,42.0,25.0,61.0,38.0,1779,1068,1623,755,156,313,262,1724,135,960,127,764,29,20,350,300,725,450,0,0,0
243,0,1,42.0,25.0,61.0,38.0,1824,1096,1623,783,201,313,485,1854,330,1050,155,804,31,20,550,300,725,450,0,0,0
250,0,1,45.0,25.0,61.0,38.0,1958,1062,1623,727,335,335,320,1989,225,1145,95,844,31,20,600,300,725,450,0,0,0
257,0,1,49.0,25.0,61.0,38.0,2070,1118,1735,783,335,335,265,2119,180,1235,85,884,33,20,600,300,725,450,0,0,0
264,0,1,50.0,25.0,61.0,38.0,2188,1090,1875,755,313,335,271,2250,150,1330,121,920,33,20,600,300,725,450,0,0,0
271,0,1,55.0,25.0,61.0,38.0,2020,1146,1707,811,313,335,356,2390,195,1430,161,960,35,20,750,300,725,450,0,0,0
279,0,1,55.0,25.0,61.0,38.0,2070,1096,1735,783,335,313,361,2516,160,1520,201,996,36,20,750,300,725,450,0,0,0
286,0,1,58.0,25.0,69.0,38.0,2154,1068,1819,755,335,313,401,2641,160,1605,241,1036,38,20,800,300,975,450,0,0,0
293,0,1,60.0,25.0,69.0,38.0,2384,1068,2071,755,313,313,737,2781,460,1705,277,1076,38,20,900,300,1075,450,0,0,0
300,0,1,64.0,25.0,69.0,38.0,2462,1118,2127,783,335,335,362,2906,270,1790,92,1116,40,20,900,300,1075,450,0,0,0
307,0,1,69.0,25.0,69.0,38.0,2518,1146,2183,811,335,335,222,3051,90,1895,132,1156,40,20,1050,300,1200,450,0,0,0
314,0,1,69.0,25.0,69.0,38.0,2440,1090,2127,755,313,335,513,3172,345,1980,168,1192,42,20,1050,300,1325,450,0,0,0
321,0,1,69.0,25.0,69.0,38.0,2490,1096,2155,783,335,313,273,3303,265,2075,8,1228,43,20,1100,300,1400,450,0,0,0
329,0,1,73.0,25.0,85.0,38.0,2574,1068,2239,755,335,313,233,3438,185,2170,48,1268,43,20,1150,300,1400,450,0,0,0
336,0,1,76.0,25.0,85.0,38.0,2619,1068,2127,755,492,313,556,3568,440,2260,116,1308,46,20,1550,300,1400,450,0,0,0
343,0,1,82.0,25.0,85.0,38.0,3078,1118,2407,783,671,335,201,3698,130,2350,71,1348,46,20,1600,300,1400,450,0,0,0
350,0,1,85.0,26.0,93.0,38.0,3314,1118,2687,783,627,335,463,3543,320,2255,143,1288,49,20,1600,300,1400,450,0,0,0
357,0,1,85.0,27.0,101.0,38.0,3314,1118,2687,783,627,335,369,3614,300,2290,69,1324,49,20,1700,300,1400,450,0,0,0
364,0,1,91.0,28.0,101.0,38.0,3426,1090,2799,755,627,335,324,3694,175,2330,149,1364,52,21,1750,300,1400,450,0,0,0
371,0,1,91.0,29.0,101.0,38.0,3414,1124,2743,811,671,313,494,3690,265,2290,229,1400,55,22,1750,300,1400,450,0,0,0
379,0,1,97.0,28.5,109.0,38.0,3280,1180,2631,867,649,313,420,3730,240,2290,180,1440,55,23,2025,175,1400,450,0,125,0
386,0,1,100.0,28.0,109.0,38.0,3308,1186,2659,895,649,291,406,3866,250,2390,156,1476,55,24,2175,150,1550,450,0,150,0
393,0,1,103.0,28.0,109.0,46.0,3414,1236,2743,923,671,313,246,4026,110,2510,136,1516,58,25,2175,200,1550,450,0,150,0
400,0,1,107.0,29.0,125.0,46.0,3532,1208,2883,895,649,313,148,4121,140,2565,8,1556,58,25,2175,200,1550,450,0,150,0
407,0,1,112.0,29.0,125.0,46.0,3510,1281,2883,923,627,358,299,3866,215,2370,84,1496,61,24,2325,50,1550,700,0,350,0
414,0,1,115.0,29.0,125.0,46.0,3560,1230,2911,895,649,335,564,3562,400,2230,164,1332,61,23,2600,50,1850,700,0,350,0
421,0,1,115.0,30.0,133.0,46.0,3868,1124,3107,811,761,313,930,3638,670,2270,260,1368,61,24,2800,300,1850,700,0,350,0
429,0,1,126.0,30.0,133.0,46.0,3862,1146,2967,811,895,335,302,3778,155,2370,147,1408,64,25,2850,300,1850,700,0,350,0
436,0,1,130.0,30.0,133.0,46.0,3868,1174,2883,839,985,335,362,3923,295,2475,67,1448,64,25,3250,300,2100,700,0,350,0
443,0,1,130.0,30.0,141.0,46.0,4002,1286,2995,951,1007,335,348,4079,190,2595,158,1484,67,25,3500,500,2350,700,0,350,0
450,0,1,135.0,32.0,141.0,46.0,3818,1258,2855,923,963,335,206,4129,115,2630,91,1499,67,25,3500,500,2350,700,0,350,0
457,0,1,135.0,31.0,157.0,46.0,3795,1236,2855,923,940,313,347,3970,315,2435,32,1535,67,24,3775,500,2350,700,0,350,0
464,0,1,138.0,31.0,157.0,46.0,3566,1208,2603,895,963,313,517,4125,490,2550,27,1575,67,24,4375,500,2625,700,0,350,0
471,0,1,148.0,31.0,157.0,46.0,3678,1236,2715,923,963,313,473,4275,330,2660,143,1615,67,24,4425,600,2625,700,0,350,0
479,0,1,150.0,31.0,157.0,46.0,3644,1258,2659,923,985,335,819,4435,560,2780,259,1655,67,24,4425,600,2625,700,0,350,0
486,0,1,157.0,33.0,157.0,46.0,3750,1258,2743,923,1007,335,224,4380,95,2785,129,1595,70,24,4875,600,2625,1150,0,350,0
493,0,1,162.0,33.0,165.0,46.0,3700,1286,2715,951,985,335,426,4536,185,2905,241,1631,70,24,4875,600,2625,1150,0,350,0
500,0,1,165.0,33.0,165.0,46.0,3930,1208,2967,895,963,313,613,4677,260,3010,353,1667,70,24,5150,600,2625,1150,0,350,0
507,0,1,176.0,33.0,189.0,46.0,3935,1264,2995,951,940,313,529,4837,260,3130,269,1707,73,24,5450,800,2625,1150,0,350,0
514,0,1,176.0,33.0,204.0,46.0,3902,1180,2939,867,963,313,799,4967,410,3220,389,1747,73,24,5600,800,2625,1150,0,350,0
521,0,1,185.0,33.0,220.0,46.0,3874,1152,2911,839,963,313,685,5112,305,3325,380,1787,73,24,5925,800,2625,1150,0,350,0
529,0,1,185.0,34.0,220.0,44.0,3924,1046,2939,755,985,291,1031,5054,585,3285,446,1769,73,24,6075,600,2625,1150,0,550,0
536,0,1,185.0,33.0,236.0,44.0,4193,844,3163,531,1030,313,1091,5084,525,3275,566,1809,73,23,7000,600,2625,1150,0,550,0
543,0,1,199.0,34.0,236.0,44.0,4148,1062,3163,727,985,335,259,5170,35,3325,224,1845,73,23,7050,700,2625,1150,0,550,0
550,0,1,200.0,35.0,236.0,44.0,4047,1258,3107,923,940,335,401,5275,215,3390,186,1885,73,24,7050,700,2625,1150,0,550,0
557,0,1,200.0,36.0,236.0,44.0,4182,1326,3219,1035,963,291,796,5392,565,3475,231,1917,73,25,7475,700,2625,1150,0,550,0
564,0,1,200.0,37.0,236.0,44.0,4378,1135,3415,867,963,268,1346,5358,995,3405,351,1953,73,26,7725,700,2625,1150,0,550,0
571,0,1,200.0,38.0,236.0,44.0,4288,1258,3303,811,985,447,1308,5487,845,3470,463,2017,73,27,8400,700,2625,1150,0,550,0
579,0,1,200.0,39.0,236.0,44.0,4198,1443,3191,839,1007,604,1593,5612,1060,3515,533,2097,73,28,8400,700,2625,1150,0,550,0
586,0,1,200.0,40.0,236.0,52.0,4036,1622,3051,951,985,671,1180,5757,735,3580,445,2177,73,29,8400,700,2775,1150,0,550,0
593,0,1,200.0,41.0,236.0,52.0,3790,1578,2827,951,963,627,1612,5899,1055,3650,557,2249,73,30,8400,700,3075,1150,0,550,0
600,0,1,200.0,42.0,236.0,52.0,3504,1740,2519,1091,985,649,811,6059,705,3730,106,2329,73,31,8400,700,3075,1150,0,550,0
607,0,1,200.0,43.0,236.0,52.0,3616,1684,2519,1035,1097,649,1252,6200,1010,3795,242,2405,73,32,8400,700,3275,1150,0,550,0
614,0,1,200.0,44.0,236.0,52.0,3644,1718,2547,1091,1097,627,903,6347,525,3870,378,2477,73,33,8400,700,3275,1150,0,550,0
621,0,1,200.0,45.0,236.0,52.0,3638,1639,2519,1035,1119,604,1336,6408,830,3855,506,2553,73,34,8400,700,3500,1150,0,550,0
629,0,1,200.0,46.0,236.0,52.0,3750,1802,2631,1175,1119,627,1783,6574,1145,3945,638,2629,73,35,8400,700,4000,1150,0,550,0
636,0,1,200.0,48.0,236.0,44.0,3706,1807,2631,1203,1075,604,2232,6585,1470,3930,762,2655,73,36,8400,500,4000,1150,0,750,0
643,0,1,200.0,43.0,236.0,46.0,3745,1348,2715,923,1030,425,2682,6569,1800,3870,882,2699,73,31,8400,500,4000,1150,0,1400,0
650,0,1,200.0,41.0,251.0,46.0,3661,1191,2631,811,1030,380,2929,6312,2015,3765,914,2547,73,30,8400,650,4000,1150,0,1575,0
657,0,1,200.0,36.0,266.0,54.0,3711,1040,2659,727,1052,313,1627,6069,585,3590,1042,2479,73,27,8400,550,4000,1150,0,1900,0
664,0,1,200.0,34.5,266.0,54.0,3493,934,2463,643,1030,291,2031,6025,865,3535,1166,2490,73,25,8400,425,4000,1150,0,2225,0
671,0,1,200.0,35.5,266.0,54.0,3515,872,2463,559,1052,313,1845,6071,830,3545,1015,2526,73,26,8400,425,4000,1150,0,2225,0
679,0,1,200.0,36.5,266.0,62.0,3409,872,2379,559,1030,313,1951,5831,970,3265,981,2566,73,27,8400,525,4000,1150,0,2225,0
686,0,1,200.0,38.5,266.0,62.0,3431,872,2379,559,1052,313,2339,5791,1230,3260,1109,2531,73,28,8400,525,4200,1400,0,2225,0
693,0,1,200.0,40.5,281.0,62.0,3330,850,2323,559,1007,291,2749,5672,1520,3155,1229,2517,73,28,8400,625,4200,1400,0,2225,0
700,0,1,200.0,39.0,296.0,62.0,3319,872,2267,559,1052,313,2851,5707,1490,3150,1361,2557,73,28,8400,550,4200,1400,0,2300,0
707,0,1,200.0,35.0,296.0,46.0,3409,894,2379,559,1030,335,3105,5517,1620,2995,1485,2522,73,29,8400,100,4200,1400,0,2900,0
714,0,1,200.0,37.0,296.0,46.0,3073,894,2043,559,1030,335,3440,5377,1835,2890,1605,2487,73,29,8400,300,4200,1400,0,3325,0
721,0,1,200.0,33.0,296.0,30.0,2888,894,1679,559,1209,335,3787,5483,2030,2960,1757,2523,73,30,8400,100,4450,1400,0,3925,0
729,0,1,200.0,6.0,311.0,22.0,3241,620,1987,419,1254,201,4196,5144,2295,2655,1901,2489,73,1,8400,50,4450,700,0,6500,0
736,0,1,199.0,2.0,356.0,16.0,3582,77,2351,55,1231,22,4635,5244,2590,2755,2045,2489,73,0,8350,50,4450,0,0,7825,0
743,0,1,199.0,0.0,356.0,16.0,3756,0,2547,0,1209,0,4943,5444,2750,2955,2193,2489,73,0,8350,100,4450,0,0,7825,0
7,2,1,13.0,13.0,15.0,14.0,251,251,251,251,0,0,30,30,30,30,0,0,12,12,0,0,0,0,0,0,0
14,2,1,14.0,13.0,15.0,14.0,671,671,671,671,0,0,70,20,70,20,0,0,13,12,0,0,0,0,0,0,0
21,2,1,14.0,14.0,15.0,14.0,699,755,699,755,0,0,40,50,40,50,0,0,13,13,0,0,0,0,0,0,0
29,2,1,15.0,14.0,15.0,14.0,727,783,727,783,0,0,90,140,90,140,0,0,14,13,0,0,0,0,0,0,0
36,2,1,15.0,16.0,15.0,22.0,727,839,727,839,0,0,120,145,120,145,0,0,14,14,0,0,0,0,0,0,0
43,2,1,16.0,16.0,23.0,22.0,755,811,755,811,0,0,60,230,60,230,0,0,15,14,0,0,0,0,0,0,0
50,2,1,17.0,16.0,23.0,22.0,839,811,839,811,0,0,120,20,120,20,0,0,16,16,0,0,0,0,0,0,0
57,2,1,18.0,17.0,23.0,22.0,811,895,811,895,0,0,40,35,40,35,0,0,17,15,0,0,0,0,0,0,0
64,2,1,19.0,18.0,23.0,22.0,923,923,923,923,0,0,150,85,150,85,0,0,18,16,0,0,0,0,0,0,0
71,2,1,19.0,17.0,23.0,22.0,923,923,923,923,0,0,260,165,260,165,0,0,18,17,0,0,0,0,0,0,0
79,2,1,20.0,17.0,23.0,22.0,951,951,951,951,0,0,325,30,325,30,0,0,19,16,0,0,0,0,0,0,0
86,2,1,20.0,18.0,23.0,22.0,973,923,951,923,22,0,44,90,40,90,4,0,19,16,0,0,0,0,0,0,0
93,2,1,20.0,19.0,23.0,22.0,1040,923,951,923,89,0,161,145,145,145,16,0,20,18,0,0,150,0,0,0,0
100,2,1,21.0,20.0,23.0,22.0,1051,962,895,895,156,67,86,217,50,205,36,12,20,18,0,0,150,0,0,0,0
107,2,1,21.0,20.0,23.0,22.0,1079,1085,923,951,156,134,76,348,20,320,56,28,20,19,0,0,150,0,0,0,0
114,2,1,22.0,20.0,23.0,22.0,1046,1079,867,923,179,156,111,378,35,330,76,48,21,20,0,0,150,0,0,0,0
121,2,1,23.0,20.0,23.0,22.0,1135,1135,979,979,156,156,192,508,100,440,92,68,22,20,0,0,150,250,0,0,0
129,2,1,23.0,26.0,23.0,36.0,1130,1158,951,979,179,179,326,243,210,155,116,88,22,20,0,0,150,250,0,0,0
136,2,1,26.0,28.0,31.0,36.0,1130,1068,839,979,291,89,136,262,80,170,56,92,23,20,0,0,300,250,0,0,0
143,2,1,26.0,28.0,31.0,36.0,1230,1074,895,1007,335,67,236,395,140,295,96,100,23,20,0,100,300,250,0,0,0
150,2,1,27.0,29.0,31.0,36.0,1208,1130,895,1063,313,67,132,128,100,20,32,108,24,21,0,100,300,250,0,0,0
157,2,1,29.0,29.0,46.0,36.0,1258,1186,923,1119,335,67,112,71,65,55,47,16,24,21,175,100,300,250,0,0,0
164,2,1,31.0,31.0,46.0,36.0,1286,1270,951,1203,335,67,172,124,85,100,87,24,25,23,175,400,300,250,0,0,0
171,2,1,32.0,33.0,46.0,36.0,1292,1247,979,1203,313,44,228,118,105,90,123,28,26,23,175,400,300,250,0,0,0
179,2,1,33.0,36.0,46.0,36.0,1376,1359,1063,1315,313,44,353,86,190,50,163,36,27,25,300,350,300,250,0,50,0
186,2,1,35.0,36.0,46.0,36.0,1432,1354,1119,1287,313,67,274,254,175,210,99,44,29,27,300,350,550,250,0,50,0
193,2,1,35.0,36.0,46.0,36.0,1449,1522,1203,1455,246,67,207,337,180,285,27,52,29,29,300,350,550,250,0,50,0
200,2,1,38.0,36.0,46.0,36.0,1594,1522,1371,1455,223,67,131,410,105,350,26,60,31,29,300,350,550,250,0,50,0
207,2,1,40.0,42.0,46.0,44.0,1729,1662,1483,1595,246,67,178,278,120,210,58,68,32,29,300,500,550,250,0,50,0
214,2,1,41.0,41.5,46.0,44.0,1729,1611,1483,1567,246,44,321,187,235,115,86,72,33,27,300,475,550,250,0,75,0
221,2,1,42.0,44.0,46.0,58.0,1729,1600,1483,1511,246,89,183,179,65,95,118,84,34,32,300,450,550,250,0,100,0
229,2,1,43.0,49.0,46.0,58.0,1880,1667,1567,1511,313,156,398,134,240,30,158,104,35,33,425,450,800,250,0,100,0
236,2,1,46.0,52.0,46.0,58.0,1992,1891,1679,1735,313,156,243,214,45,90,198,124,36,36,425,450,800,250,0,100,0
243,2,1,46.0,52.0,46.0,58.0,2082,1953,1791,1707,291,246,389,250,155,90,234,160,37,40,425,600,800,250,0,100,0
250,2,1,46.0,58.0,46.0,58.0,2126,2126,1791,1791,335,335,329,186,55,65,274,121,38,42,425,600,950,450,0,100,0
257,2,1,52.0,58.0,54.0,66.0,2126,2294,1791,1959,335,335,325,471,65,310,260,161,38,42,675,750,950,450,0,100,0
264,2,1,53.0,67.0,62.0,74.0,2076,2440,1763,2127,313,313,346,182,125,85,221,97,38,41,925,750,950,450,0,100,0
271,2,1,54.0,69.0,70.0,74.0,2098,2356,1763,2043,335,313,516,227,255,90,261,137,40,40,925,1050,1250,450,0,100,0
279,2,1,62.0,74.0,70.0,74.0,2154,2266,1819,1931,335,335,281,252,80,75,201,177,41,40,925,1550,1350,450,0,100,0
286,2,1,64.0,74.0,70.0,74.0,2048,2322,1735,1987,313,335,377,537,140,320,237,217,41,41,1525,1600,1350,575,0,100,0
293,2,1,64.0,74.0,70.0,74.0,2076,2272,1651,1959,425,313,348,603,205,350,143,253,41,41,1525,1800,1350,700,0,100,0
300,2,1,61.0,70.5,70.0,74.0,2311,2266,1707,1931,604,335,620,688,405,395,215,293,43,41,1275,1575,1350,700,250,425,0
307,2,1,65.0,73.0,70.0,90.0,2384,2238,1735,1903,649,335,410,608,215,275,195,333,44,40,1525,1400,1350,700,500,650,0
314,2,1,65.0,72.0,70.0,90.0,2362,2104,1735,1791,627,313,696,764,425,395,271,369,44,39,1525,1400,1350,700,500,800,0
321,2,1,67.0,72.0,70.0,98.0,2468,2132,1819,1819,649,313,621,824,370,415,251,409,44,35,1400,1650,1350,700,625,1000,0
329,2,1,63.0,75.0,70.0,98.0,2546,1908,1875,1595,671,313,641,510,310,165,331,345,44,37,1025,1750,1350,700,1000,1100,0
336,2,1,69.0,81.0,70.0,98.0,2502,1975,1875,1707,627,268,539,447,215,70,324,377,44,41,1025,1750,1350,700,1000,1100,0
343,2,1,69.0,83.0,70.0,98.0,2423,2143,1819,1875,604,268,831,599,435,190,396,409,46,43,1400,1750,1650,700,1000,1100,0
350,2,1,70.0,84.0,86.0,98.0,2474,2222,1847,1931,627,291,1081,670,605,225,476,445,46,49,1400,1750,1650,700,1000,1150,0
357,2,1,63.0,86.0,86.0,98.0,2552,1863,1903,1595,649,268,1331,723,775,250,556,473,46,48,900,1750,1650,700,1500,1200,0
364,2,1,67.0,84.5,86.0,106.0,2524,1292,1875,1091,649,201,1132,773,600,280,532,493,48,50,1525,1775,1650,700,1750,1375,0
371,2,1,70.0,82.0,86.0,106.0,2580,1208,1931,1007,649,201,552,656,190,135,362,521,48,49,1525,1750,1650,700,1750,1550,0
379,2,1,70.0,79.0,86.0,106.0,2552,1790,1903,1567,649,223,743,759,305,210,438,549,48,49,1525,1750,1650,700,1750,1550,0
386,2,1,70.0,81.0,86.0,106.0,2524,2311,1875,2043,649,268,949,845,435,260,514,585,48,47,1400,1750,1650,950,1875,1650,0
393,2,1,82.0,90.0,94.0,122.0,2502,2574,1875,2239,627,335,410,205,70,130,340,75,50,47,2200,1750,1650,950,1875,1650,0
400,2,1,83.0,94.0,94.0,122.0,2524,2574,1875,2239,649,335,620,300,200,185,420,115,50,51,2200,2350,1650,950,1875,1650,0
407,2,1,84.0,99.0,94.0,122.0,2530,2563,1903,2071,627,492,926,259,430,80,496,179,52,55,2200,2350,1650,1075,1875,1750,0
414,2,1,81.0,96.0,94.0,122.0,2664,2266,2015,1707,649,559,1156,213,580,70,576,143,52,51,1950,2350,1650,1075,2125,2000,0
421,2,1,78.0,94.5,94.0,122.0,2742,2065,2071,1483,671,582,1376,364,720,145,656,219,53,56,2000,2325,1650,1075,2375,2175,0
429,2,1,88.0,101.5,94.0,122.0,2714,2373,2043,1791,671,582,942,266,310,50,632,216,55,58,2500,2325,1650,1075,2375,2175,0
436,2,1,94.0,107.5,94.0,122.0,2720,2905,2071,2323,649,582,413,318,55,105,358,213,56,59,2500,2425,1650,1075,2375,2175,0
443,2,1,97.0,113.5,109.0,122.0,2496,3034,1847,2407,649,627,539,389,105,175,434,214,57,59,2500,2675,1650,1075,2375,2175,0
450,2,1,97.0,116.0,117.0,122.0,2552,3224,1903,2575,649,649,859,591,345,330,514,261,57,59,2500,2650,1650,1075,2375,2250,0
457,2,1,98.0,113.5,117.0,122.0,2922,3207,2295,2603,627,604,1170,209,580,80,590,129,60,57,2500,2725,1650,1075,2375,2675,0
464,2,1,107.0,106.5,125.0,122.0,3280,3073,2631,2491,649,582,510,427,190,230,320,197,60,58,3200,2325,1750,1075,2375,3275,0
471,2,1,109.0,108.5,125.0,122.0,3224,3039,2575,2435,649,604,631,408,235,135,396,273,61,64,3200,2325,1750,1075,2375,3275,0
479,2,1,116.0,108.0,125.0,122.0,3246,2989,2575,2407,671,582,481,725,205,380,276,345,63,67,3700,2250,1750,1075,2375,3350,0
486,2,1,122.0,110.0,125.0,122.0,2944,3252,2295,2603,649,649,292,921,90,550,202,371,65,69,3700,2200,1750,1075,2375,3400,0
493,2,1,122.0,120.5,125.0,122.0,3157,3280,2463,2631,694,649,336,512,50,265,286,247,65,69,4225,1925,1750,1075,2375,3675,0
500,2,1,122.0,117.5,125.0,122.0,3246,3409,2351,2603,895,806,737,837,335,515,402,322,65,69,4225,1675,1750,1075,2375,3925,0
507,2,1,124.0,116.5,125.0,122.0,3510,3627,2547,2687,963,940,539,1064,75,680,464,384,65,69,4225,1775,1750,1075,2375,4225,0
514,2,1,124.0,116.5,133.0,122.0,3431,3650,2491,2687,940,963,956,1409,380,905,576,504,65,69,4400,2475,1750,1075,2375,4225,0
521,2,1,124.0,116.5,141.0,122.0,3426,3566,2463,2603,963,963,1157,1339,465,715,692,624,65,69,4400,2575,1750,1075,2375,4225,0
529,2,1,130.0,118.5,141.0,130.0,3403,3532,2463,2547,940,985,704,1610,150,870,554,740,65,69,5425,2675,1900,1075,2375,4225,0
536,2,1,130.0,115.5,157.0,170.0,3454,3610,2491,2603,963,1007,1111,740,445,480,666,260,65,70,5425,1875,1900,1525,2375,5025,0
543,2,1,130.0,119.5,157.0,170.0,3454,3582,2491,2575,963,1007,1518,562,740,490,778,72,65,69,5425,1875,1900,1525,2375,5025,0
550,2,1,138.0,128.5,157.0,170.0,3459,3336,2519,2351,940,985,1234,508,540,320,694,188,65,69,5425,1875,1900,1525,2375,5025,0
557,2,1,144.0,136.5,157.0,184.0,3314,3207,2351,2267,963,940,639,140,25,140,614,0,65,77,6125,3075,2500,1525,2375,5025,0
564,2,1,144.0,142.5,157.0,184.0,3224,3202,2239,2239,985,963,859,225,125,180,734,45,65,78,6125,3075,2500,1525,2375,5025,0
571,2,1,144.0,152.5,157.0,184.0,3330,3386,2323,2267,1007,1119,951,149,105,85,846,64,65,78,6125,3675,2500,1525,2375,5025,0
579,2,1,147.0,157.5,157.0,176.0,3286,3022,2323,1903,963,1119,984,87,130,20,854,67,64,78,6125,4075,2500,1525,2425,5125,0
586,2,1,153.0,156.5,157.0,176.0,3370,2927,2407,1875,963,1052,990,246,220,105,770,141,62,77,7175,4225,2500,1525,2375,5475,0
593,2,1,151.0,163.5,165.0,176.0,3274,3381,2379,2351,895,1030,1125,168,305,40,820,128,57,76,7350,4775,2650,1525,2475,5725,0
600,2,1,151.0,167.5,165.0,170.0,2899,3442,2071,2435,828,1007,1365,178,445,130,920,48,55,76,7850,4875,2800,1525,2575,6175,0
607,2,1,154.0,165.5,165.0,170.0,2748,3459,1875,2519,873,940,823,691,45,510,778,181,51,76,7750,4975,2950,1400,2975,6375,0
614,2,1,154.0,169.5,165.0,170.0,2502,3403,1651,2463,851,940,1117,906,235,655,882,251,52,76,8625,5575,2950,1400,2975,6450,0
621,2,1,144.0,156.5,165.0,170.0,2686,3510,1791,2547,895,963,1436,1331,450,960,986,371,52,76,7825,5075,2950,1550,3775,7250,0
629,2,1,139.0,166.5,165.0,170.0,2798,3526,1903,2519,895,1007,1431,1151,445,810,986,341,51,76,7575,5175,2950,1550,4425,7350,0
636,2,1,148.0,168.5,165.0,170.0,2748,3554,1875,2547,873,1007,966,568,130,140,836,428,50,76,7575,5175,2950,1550,4475,7350,0
643,2,1,150.0,168.5,165.0,170.0,2647,3442,1819,2435,828,1007,1116,964,230,420,886,544,52,76,7925,5775,2950,1550,4475,7350,0
650,2,1,150.0,167.5,165.0,170.0,2619,3538,1791,2575,828,963,1120,1041,280,535,840,506,52,75,7925,5775,2950,1550,4475,7350,0
657,2,1,156.0,170.5,157.0,218.0,2552,3347,1679,2407,873,940,893,347,95,300,798,47,52,74,7925,5275,2950,1550,4575,7950,0
664,2,1,156.0,180.5,157.0,218.0,2782,3398,1931,2435,851,963,1239,247,345,205,894,42,52,74,8450,5875,2950,1550,4575,7950,0
671,2,1,152.0,148.0,157.0,218.0,2838,3392,1987,2407,851,985,1577,672,575,510,1002,162,52,74,8100,4450,2950,1550,4925,9675,0
679,2,1,140.0,139.0,157.0,218.0,2916,3392,2043,2407,873,985,1212,78,310,50,902,28,52,74,6325,2700,2950,1550,6700,11725,0
685,2,1,140.0,110.0,157.0,218.0,2916,3448,2043,2463,873,985,1212,323,310,220,902,103,52,74,6325,900,2950,1400,6700,14075,0
7,0,0,13.0,13.0,15.0,15.0,293,293,293,293,0,0,35,35,35,35,0,0,12,12,0,0,0,0,0,0,0
14,0,0,14.0,14.0,15.0,15.0,643,671,643,671,0,0,65,70,65,70,0,0,13,13,0,0,0,0,0,0,0
21,0,0,14.0,14.0,15.0,15.0,699,699,699,699,0,0,40,40,40,40,0,0,13,13,0,0,0,0,0,0,0
29,0,0,15.0,15.0,15.0,15.0,699,671,699,671,0,0,35,75,35,75,0,0,14,14,0,0,0,0,0,0,0
36,0,0,15.0,15.0,15.0,15.0,727,727,727,727,0,0,115,115,115,115,0,0,14,14,0,0,0,0,0,0,0
43,0,0,16.0,16.0,23.0,23.0,783,727,783,727,0,0,55,120,55,120,0,0,15,15,0,0,0,0,0,0,0
50,0,0,16.0,16.0,23.0,23.0,755,727,755,727,0,0,20,50,20,50,0,0,15,15,0,0,0,0,0,0,0
57,0,0,17.0,17.0,23.0,23.0,699,727,699,727,0,0,30,50,30,50,0,0,16,16,0,0,0,0,0,0,0
64,0,0,18.0,18.0,23.0,23.0,727,715,727,671,0,44,65,133,65,125,0,8,17,17,0,0,0,0,0,0,0
71,0,0,18.0,18.0,23.0,23.0,805,827,783,671,22,156,169,183,165,155,4,28,17,17,0,0,0,0,0,0,0
79,0,0,19.0,19.0,23.0,23.0,833,799,699,643,134,156,214,279,190,235,24,44,18,18,0,0,0,0,0,0,0
86,0,0,19.0,19.0,23.0,23.0,917,855,671,699,246,156,330,389,270,325,60,64,18,18,0,0,0,0,0,0,0
93,0,0,20.0,19.0,23.0,23.0,928,883,615,727,313,156,100,494,50,410,50,84,19,19,0,0,150,150,0,0,0
100,0,0,20.0,20.0,23.0,23.0,1034,883,699,727,335,156,215,354,125,300,90,54,19,19,0,0,150,150,0,0,0
107,0,0,20.0,20.0,23.0,23.0,956,934,643,755,313,179,67,469,45,395,22,74,19,19,0,0,150,150,0,0,0
114,0,0,20.0,20.0,31.0,23.0,889,962,643,783,246,179,190,179,140,85,50,94,19,19,0,0,150,150,0,0,0
121,0,0,22.0,21.0,31.0,23.0,917,939,671,783,246,156,152,135,120,25,32,110,19,19,100,0,150,150,0,0,0
129,0,0,23.0,22.0,31.0,23.0,1169,995,923,839,246,156,255,215,195,85,60,130,20,19,100,100,150,150,0,0,0
136,0,0,23.0,22.0,31.0,23.0,1191,1191,923,1035,268,156,407,105,315,55,92,50,20,20,100,100,150,150,0,0,0
143,0,0,24.0,23.0,31.0,31.0,1118,1191,895,1035,223,156,496,120,380,50,116,70,21,20,100,150,150,150,0,0,0
150,0,0,24.0,25.0,31.0,31.0,1219,1163,951,1007,268,156,263,90,115,50,148,40,21,21,100,150,400,150,0,0,0
157,0,0,27.0,25.0,31.0,31.0,1281,1158,1035,979,246,179,271,70,95,10,176,60,22,21,200,150,400,150,0,0,0
164,0,0,28.0,26.0,31.0,31.0,1449,1214,1203,1035,246,179,204,155,50,75,154,80,23,22,200,150,400,150,0,0,0
171,0,0,28.0,26.0,31.0,31.0,1438,1286,1147,1063,291,223,269,298,100,190,169,108,23,22,200,150,400,150,0,0,0
179,0,0,31.0,29.0,31.0,31.0,1426,1370,1091,1035,335,335,279,253,70,155,209,98,24,23,300,250,400,400,0,0,0
186,0,0,31.0,29.0,39.0,46.0,1292,1398,979,1063,313,335,260,163,115,125,145,38,24,24,300,250,400,500,0,0,0
193,0,0,32.0,30.0,39.0,46.0,1432,1230,1119,895,313,335,400,123,215,45,185,78,25,24,300,250,400,500,0,0,0
200,0,0,34.0,30.0,39.0,46.0,1538,1376,1203,1063,335,313,405,214,205,100,200,114,25,24,400,350,500,500,0,0,0
207,0,0,35.0,33.0,39.0,46.0,1510,1482,1175,1147,335,335,525,259,285,105,240,154,26,25,400,350,500,500,0,0,0
214,0,0,37.0,36.0,39.0,46.0,1510,1516,1175,1203,335,313,586,245,310,55,276,190,26,25,500,350,500,600,0,0,0
221,0,0,41.0,37.0,54.0,46.0,1566,1544,1231,1231,335,313,251,290,60,85,191,205,27,26,500,350,825,850,0,0,0
229,0,0,41.0,39.0,54.0,46.0,1628,1796,1315,1371,313,425,442,291,215,55,227,236,27,28,500,450,825,850,0,0,0
236,0,0,42.0,41.0,54.0,46.0,1628,1863,1315,1371,313,492,572,361,305,65,267,296,28,28,600,550,900,850,0,0,0
243,0,0,44.0,45.0,54.0,46.0,1594,2037,1259,1567,335,470,177,217,70,65,107,152,28,30,600,550,900,1000,0,0,0
250,0,0,48.0,49.0,54.0,54.0,1594,2115,1259,1623,335,492,212,152,65,40,147,112,29,31,850,600,900,1000,0,0,0
257,0,0,52.0,52.0,54.0,54.0,1712,2250,1399,1735,313,515,93,302,35,130,58,172,30,32,850,650,900,1000,0,0,0
264,0,0,53.0,52.0,54.0,54.0,1930,2311,1595,1819,335,492,283,263,185,35,98,228,31,32,950,650,900,1000,0,0,0
271,0,0,54.0,54.0,54.0,54.0,2166,2289,1763,1819,403,470,355,459,205,175,150,284,33,34,950,750,900,1000,0,0,0
279,0,0,54.0,54.0,54.0,54.0,2255,2311,1763,1819,492,492,601,504,395,160,206,344,33,35,950,750,900,1000,0,0,0
286,0,0,54.0,61.0,54.0,70.0,2205,2255,1735,1763,470,492,242,194,30,115,212,79,33,35,1250,1350,900,1000,0,0,0
293,0,0,54.0,62.0,54.0,70.0,2115,2261,1623,1791,492,470,457,295,185,160,272,135,33,35,1575,1350,1050,1000,0,0,0
300,0,0,59.0,64.0,62.0,70.0,2115,2390,1623,1875,492,515,357,580,125,385,232,195,33,37,1575,1350,1050,1000,0,0,0
307,0,0,62.0,66.0,62.0,78.0,2143,2390,1651,1875,492,515,233,290,70,35,163,255,35,39,1575,1400,1050,1000,0,0,0
314,0,0,62.0,68.0,62.0,78.0,2003,2401,1511,1931,492,470,318,382,95,75,223,307,35,39,1725,1400,1050,1000,0,0,0
321,0,0,67.0,73.0,70.0,78.0,1751,2373,1259,1903,492,470,429,87,150,45,279,42,35,41,1725,1675,1050,1000,0,0,0
329,0,0,69.0,75.0,70.0,78.0,1807,2507,1315,2015,492,492,139,197,0,95,139,102,35,41,1725,1975,1050,1000,0,0,0
336,0,0,70.0,78.0,70.0,78.0,1925,2434,1455,1875,470,559,280,354,85,180,195,174,37,43,2000,2075,1050,1000,0,0,0
343,0,0,76.0,78.0,78.0,78.0,2087,2658,1595,1987,492,671,395,394,140,140,255,254,37,45,2150,2075,1050,900,0,25,0
350,0,0,81.0,81.0,86.0,94.0,2367,2350,1875,1679,492,671,310,530,120,200,190,330,39,45,2150,2025,1050,900,0,125,0
357,0,0,82.0,85.0,101.0,94.0,2367,2524,1875,1875,492,649,336,511,90,230,246,281,39,47,2200,2300,1050,900,100,125,0
364,0,0,84.0,87.0,101.0,94.0,2479,2502,1987,1875,492,627,541,522,235,165,306,357,41,47,2400,2350,1050,900,100,125,0
371,0,0,89.0,87.0,101.0,94.0,2479,2496,1987,1847,492,649,332,797,170,360,162,437,41,48,2600,2700,1050,900,100,125,0
379,0,0,90.0,88.0,101.0,109.0,2591,2580,2099,1931,492,649,647,877,425,360,222,517,42,49,3025,2700,1050,900,100,125,0
386,0,0,95.0,94.0,101.0,109.0,2451,2580,1959,1931,492,649,538,648,260,205,278,443,44,51,3025,2700,1050,1150,100,125,0
393,0,0,98.0,95.0,101.0,109.0,2507,2608,2015,1959,492,649,378,759,165,290,213,469,44,51,3025,2975,1050,1450,100,125,0
400,0,0,100.0,98.0,101.0,109.0,2289,2602,1819,1931,470,671,359,439,190,165,169,274,46,53,3575,2875,1050,1450,100,225,0
407,0,0,104.0,99.0,109.0,109.0,2395,2642,1903,2015,492,627,104,256,75,60,29,196,46,54,3575,2875,1050,1450,100,225,0
414,0,0,108.0,100.0,117.0,109.0,2412,2558,1875,1931,537,627,203,416,110,140,93,276,48,55,3575,2925,1050,1450,100,225,0
421,0,0,108.0,106.0,125.0,109.0,2524,2468,1875,1819,649,649,253,266,80,110,173,156,50,57,3575,3375,1050,1450,375,225,0
429,0,0,108.0,106.0,125.0,109.0,2530,2490,1903,1819,627,671,564,341,315,205,249,136,51,57,3575,3650,1050,1550,375,225,0
436,0,0,115.0,108.0,133.0,109.0,2664,2496,2015,1847,649,649,419,507,215,295,204,212,52,59,3675,3550,1050,1750,375,325,0
443,0,0,118.0,110.0,133.0,117.0,2938,2826,2267,2155,671,671,654,328,370,115,284,213,54,61,4125,3550,1050,1750,375,325,0
450,0,0,119.0,108.0,133.0,117.0,3162,2944,2491,2295,671,649,980,544,620,255,360,289,55,60,4125,3700,1050,1975,375,725,0
457,0,0,111.0,106.0,133.0,117.0,3336,2496,2687,2071,649,425,1001,824,565,495,436,329,57,59,3375,3700,1050,1975,1225,925,0
464,0,0,107.0,110.0,133.0,133.0,3084,2216,2435,1903,649,313,1072,739,560,495,512,244,58,59,3400,3750,1050,1975,1475,925,0
471,0,0,111.0,115.0,133.0,133.0,3056,2524,2407,2211,649,313,1192,354,725,70,467,284,60,60,3500,3750,1200,1975,1525,975,0
479,0,0,119.0,116.0,133.0,133.0,3140,2714,2491,2379,649,335,458,454,165,130,293,324,62,62,3500,3975,1200,1975,1525,975,0
486,0,0,121.0,120.0,133.0,133.0,3112,3286,2463,2883,649,403,618,486,245,210,373,276,63,62,3500,3975,1450,1975,1525,975,0
493,0,0,123.0,126.0,133.0,133.0,3308,3930,2659,3303,649,627,969,817,520,465,449,352,65,64,3600,4225,1450,1975,1525,975,0
500,0,0,121.0,119.0,133.0,133.0,3582,3151,2911,2659,671,492,1389,415,860,215,529,200,67,60,3625,4300,1450,1975,1825,1475,0
507,0,0,118.0,110.0,141.0,133.0,3420,2686,2771,2239,649,447,1225,425,820,165,405,260,68,57,3025,3600,1450,1875,2425,2775,0
514,0,0,122.0,87.0,141.0,133.0,3633,2490,2939,2043,694,447,869,481,605,265,264,216,68,56,3225,1950,1550,1775,2625,4900,0
521,0,0,116.0,76.0,141.0,125.0,3577,2502,2883,1987,694,515,1283,215,935,60,348,155,71,54,2650,850,1550,1775,3300,6200,0
529,0,0,113.0,72.0,141.0,125.0,3549,2009,2855,1539,694,470,1142,292,910,85,232,207,72,50,2125,875,1850,1775,3875,6725,0
536,0,0,115.0,66.0,141.0,125.0,3538,1354,2799,951,739,403,495,406,300,155,195,251,72,47,1925,725,1850,1775,4075,7075,0
543,0,0,118.0,68.0,141.0,125.0,3493,1802,2687,1399,806,403,206,494,15,345,191,149,74,46,2175,1075,1850,1550,4125,7350,0
550,0,0,119.0,68.0,141.0,125.0,3353,1589,2547,1231,806,358,363,114,180,50,183,64,74,44,2425,1125,1850,1550,4400,7525,0
557,0,0,122.0,75.0,141.0,125.0,3409,1947,2603,1567,806,380,609,72,330,60,279,12,74,46,2725,1600,1850,1550,4400,7600,0
564,0,0,122.0,77.0,141.0,125.0,3644,2166,2771,1763,873,403,806,199,515,135,291,64,74,46,2725,1700,1850,1550,4400,7600,0
571,0,0,126.0,80.0,141.0,125.0,3571,2227,2631,1735,940,492,982,379,575,255,407,124,74,48,3075,1750,1850,1700,4400,7600,0
579,0,0,130.0,83.0,141.0,125.0,3622,2334,2659,1819,963,515,787,224,385,90,402,134,74,49,3400,1850,1850,1950,4400,7600,0
586,0,0,131.0,86.0,141.0,125.0,3554,2384,2547,1735,1007,649,963,219,445,55,518,164,74,50,3400,2375,2050,1950,4400,7600,0
593,0,0,139.0,88.0,141.0,125.0,3689,2608,2659,1959,1030,649,1053,411,415,175,638,236,74,52,3650,2375,2750,1950,4400,7600,0
600,0,0,139.0,88.0,141.0,125.0,3538,2502,2575,1987,963,515,1461,597,715,305,746,292,74,49,3650,2475,2750,2350,4400,7800,0
606,0,0,139.0,77.0,141.0,125.0,3538,2227,2575,1847,963,380,1461,386,715,50,746,336,74,52,3650,1475,2750,2350,4400,8850,0
7,0,1,13.0,13.0,15.0,14.0,293,251,293,251,0,0,35,30,35,30,0,0,12,12,0,0,0,0,0,0,0
14,0,1,14.0,13.0,15.0,14.0,615,671,615,671,0,0,60,20,60,20,0,0,13,13,0,0,0,0,0,0,0
21,0,1,14.0,14.0,15.0,14.0,699,755,699,755,0,0,45,50,45,50,0,0,13,13,0,0,0,0,0,0,0
29,0,1,15.0,14.0,15.0,14.0,671,755,671,755,0,0,75,140,75,140,0,0,14,13,0,0,0,0,0,0,0
36,0,1,15.0,14.0,15.0,22.0,783,783,783,783,0,0,130,235,130,235,0,0,14,14,0,0,0,0,0,0,0
43,0,1,16.0,13.0,23.0,22.0,811,699,811,699,0,0,65,10,65,10,0,0,15,13,0,0,0,0,0,0,0
50,0,1,16.0,14.0,23.0,22.0,839,783,839,783,0,0,40,55,40,55,0,0,15,13,0,0,0,0,0,0,0
57,0,1,17.0,14.0,23.0,22.0,811,671,811,671,0,0,135,140,135,140,0,0,16,13,0,0,0,0,0,0,0
64,0,1,18.0,13.0,23.0,22.0,839,783,839,783,0,0,180,35,180,35,0,0,17,13,0,0,0,0,0,0,0
71,0,1,18.0,13.0,23.0,22.0,883,755,839,755,44,0,278,50,270,50,8,0,17,12,0,0,0,0,0,0,0
79,0,1,19.0,14.0,23.0,22.0,967,699,811,699,156,0,348,75,320,75,28,0,18,13,0,0,0,0,0,0,0
86,0,1,19.0,14.0,23.0,22.0,990,643,811,643,179,0,458,60,410,60,48,0,18,14,0,0,0,0,0,0,0
93,0,1,20.0,14.0,23.0,22.0,995,699,839,699,156,0,329,150,315,150,14,0,19,14,0,0,150,0,0,0,0
100,0,1,20.0,14.0,23.0,30.0,967,810,811,699,156,111,49,250,15,230,34,20,19,14,0,0,150,0,0,0,0
107,0,1,20.0,14.0,23.0,30.0,939,771,783,615,156,156,154,341,100,305,54,36,19,14,0,0,150,0,0,0,0
114,0,1,21.0,18.0,23.0,36.0,939,771,783,615,156,156,119,181,45,125,74,56,19,14,0,0,150,250,0,0,0
121,0,1,22.0,17.0,23.0,36.0,855,687,699,531,156,156,179,116,85,40,94,76,19,13,100,0,150,250,0,0,0
129,0,1,23.0,17.0,23.0,36.0,1074,659,895,503,179,156,269,112,155,20,114,92,20,12,100,50,150,250,0,0,0
136,0,1,23.0,18.0,31.0,36.0,1275,749,1119,615,156,134,135,163,105,55,30,108,20,13,100,100,150,250,0,0,0
143,0,1,24.0,20.0,31.0,36.0,1275,642,1119,531,156,111,275,130,225,10,50,120,21,13,150,100,150,250,0,0,0
150,0,1,25.0,21.0,31.0,36.0,1275,721,1119,587,156,134,275,180,255,40,20,140,22,14,150,250,150,250,0,0,0
157,0,1,25.0,22.0,31.0,36.0,1303,715,1147,559,156,156,420,210,380,50,40,160,22,15,150,300,150,450,0,0,0
164,0,1,26.0,23.0,31.0,36.0,1331,827,1175,671,156,156,130,270,70,90,60,180,23,16,150,300,150,450,0,0,0
171,0,1,26.0,24.0,31.0,36.0,1410,788,1231,587,179,201,235,323,155,115,80,208,23,17,150,300,150,450,0,0,0
179,0,1,27.0,25.0,46.0,36.0,1438,995,1259,727,179,268,245,399,145,155,100,244,24,18,150,300,400,450,0,0,0
186,0,1,27.0,28.0,46.0,36.0,1443,1018,1287,727,156,291,406,366,290,115,116,251,24,19,150,300,500,450,0,0,0
193,0,1,32.0,28.0,46.0,36.0,1583,1046,1427,755,156,291,191,397,55,110,136,287,25,20,150,300,500,450,0,0,0
200,0,1,33.0,29.0,46.0,36.0,1555,990,1399,699,156,291,201,463,70,140,131,323,25,21,150,300,500,450,0,0,0
207,0,1,34.0,30.0,46.0,36.0,1723,1096,1567,783,156,313,271,558,120,195,151,363,26,22,150,400,500,450,0,0,0
214,0,1,37.0,31.0,46.0,44.0,1835,1124,1679,811,156,313,186,644,115,245,71,399,28,23,350,400,575,450,0,0,0
221,0,1,41.0,32.0,46.0,44.0,1970,1202,1791,867,179,335,206,734,115,295,91,439,28,24,350,400,575,450,0,0,0
229,0,1,43.0,33.0,46.0,44.0,1942,1292,1763,979,179,313,316,745,205,270,111,475,30,25,350,400,575,450,0,0,0
236,0,1,44.0,36.0,61.0,44.0,1914,1320,1623,1007,291,313,361,510,210,120,151,390,31,26,400,400,725,450,0,0,0
243,0,1,46.0,37.0,61.0,44.0,2048,1510,1735,1175,313,335,411,645,220,215,191,430,32,27,600,400,725,450,0,0,0
250,0,1,51.0,38.0,61.0,52.0,2048,1482,1735,1147,313,335,496,765,265,295,231,470,34,28,650,400,725,450,0,0,0
257,0,1,51.0,39.0,61.0,52.0,2272,1628,1959,1315,313,313,321,906,200,400,121,506,34,28,650,500,725,450,0,0,0
264,0,1,55.0,40.0,61.0,52.0,2378,1622,2043,1287,335,335,361,1041,200,495,161,546,36,29,750,500,725,450,0,0,0
271,0,1,56.0,41.0,61.0,52.0,2317,1684,1959,1371,358,313,516,1097,315,515,201,582,36,30,800,500,725,450,0,0,0
279,0,1,58.0,42.0,61.0,52.0,2406,1600,2071,1287,335,313,312,1237,75,615,237,622,38,31,800,500,725,450,0,0,0
286,0,1,63.0,45.0,69.0,52.0,2272,1790,1959,1455,313,335,338,1302,65,665,273,637,40,32,950,500,725,450,0,0,0
293,0,1,64.0,46.0,69.0,60.0,2384,1762,2071,1427,313,335,588,1462,275,785,313,677,40,33,950,500,1075,700,0,0,0
300,0,1,69.0,46.0,69.0,60.0,2266,1824,1931,1511,335,313,337,1408,180,795,157,613,43,33,1050,500,1075,700,0,0,0
307,0,1,69.0,46.0,69.0,60.0,2474,1874,1959,1539,515,335,134,1558,105,905,29,653,43,33,1100,800,1325,700,0,0,0
314,0,1,74.0,47.0,77.0,60.0,2754,1790,2127,1455,627,335,296,1718,195,1025,101,693,43,34,1100,800,1325,700,0,0,0
321,0,1,77.0,48.0,77.0,60.0,2714,1908,2043,1595,671,313,256,1899,100,1170,156,729,46,35,1150,800,1325,700,0,0,0
329,0,1,77.0,49.0,77.0,60.0,2698,1774,2071,1371,627,403,408,2065,280,1280,128,785,46,36,1650,800,1325,700,0,0,0
336,0,1,85.0,52.0,85.0,60.0,3028,1925,2379,1343,649,582,138,2146,105,1310,33,836,48,37,1700,800,1400,700,0,0,0
343,0,1,85.0,53.0,93.0,60.0,3174,2042,2547,1371,627,671,304,2351,195,1435,109,916,48,38,1700,800,1400,700,0,0,0
350,0,1,89.0,53.0,93.0,60.0,3252,2076,2603,1427,649,649,384,2602,195,1610,189,992,51,39,1700,900,1400,700,0,0,0
357,0,1,92.0,53.0,93.0,60.0,3252,2182,2603,1511,649,671,364,2867,95,1795,269,1072,52,40,1800,900,1400,700,0,0,0
364,0,1,94.0,53.0,109.0,60.0,3330,2238,2659,1567,671,671,545,3128,200,1980,345,1148,54,40,1800,900,1400,700,0,0,0
371,0,1,97.0,53.0,109.0,60.0,3308,2244,2659,1595,649,649,551,3394,255,2170,296,1224,56,40,2225,900,1400,700,0,0,0
379,0,1,107.0,53.0,109.0,60.0,3252,2272,2603,1623,649,649,222,3655,50,2355,172,1300,57,40,2225,900,1400,700,0,0,0
386,0,1,107.0,53.0,109.0,60.0,3504,2272,2855,1623,649,649,627,3920,375,2540,252,1380,59,40,2225,900,1550,700,0,0,0
393,0,1,110.0,53.0,125.0,60.0,3454,2194,2827,1567,627,627,678,4176,350,2720,328,1456,60,40,2225,900,1550,700,0,0,0
400,0,1,115.0,53.0,133.0,60.0,3084,2294,2435,1623,649,671,678,4451,370,2915,308,1536,60,40,2375,900,1550,700,0,0,0
407,0,1,118.0,53.0,133.0,60.0,3470,2244,2799,1595,671,649,253,4707,90,3095,163,1612,63,40,3050,900,1850,700,0,0,0
414,0,1,122.0,53.0,133.0,60.0,3722,2216,3051,1567,671,649,409,4968,170,3280,239,1688,63,40,3300,900,1850,700,0,0,0
421,0,1,128.0,53.0,133.0,60.0,3706,2166,3079,1539,627,627,181,5224,70,3460,111,1764,63,40,3300,900,1850,700,0,0,0
429,0,1,133.0,51.0,133.0,60.0,3784,2272,3135,1623,649,649,276,5454,185,3610,91,1844,66,40,3350,750,1850,700,0,150,0
436,0,1,132.0,43.0,133.0,60.0,4030,2132,3359,1483,671,649,590,5604,415,3680,175,1924,66,40,3575,350,1850,700,50,550,0
443,0,1,133.0,43.0,133.0,60.0,3812,2244,3051,1595,761,649,727,5875,460,3875,267,2000,69,40,3775,350,2050,700,50,550,0
450,0,1,133.0,43.0,133.0,68.0,3857,2126,2939,1455,918,671,483,6135,450,4055,33,2080,69,40,3775,400,2300,700,50,550,0
457,0,1,133.0,45.0,133.0,68.0,4019,2210,3079,1539,940,671,536,6291,395,4160,141,2131,70,40,4175,400,2300,700,50,550,0
464,0,1,149.0,45.0,149.0,68.0,3874,2160,2911,1511,963,649,127,6557,70,4350,57,2207,70,40,4175,400,2550,700,50,550,0
471,0,1,149.0,45.0,173.0,68.0,3689,2138,2771,1511,918,627,380,6813,315,4530,65,2283,72,40,4175,400,2550,700,50,550,0
479,0,1,156.0,45.0,173.0,68.0,3599,2076,2659,1427,940,649,731,7073,575,4710,156,2363,73,40,4575,500,2550,700,50,550,0
486,0,1,157.0,46.0,188.0,68.0,3560,2160,2575,1511,985,649,462,7273,190,4830,272,2443,73,40,4575,500,2550,700,50,550,0
493,0,1,163.0,46.0,188.0,68.0,3470,2076,2463,1427,1007,649,227,7524,135,5005,92,2519,73,40,4975,500,2625,700,50,550,0
500,0,1,173.0,46.0,188.0,68.0,3560,2154,2575,1483,985,671,349,7789,245,5190,104,2599,73,40,5375,500,2625,700,50,550,0
507,0,1,178.0,46.0,220.0,68.0,3532,2160,2547,1511,985,649,420,8051,300,5380,120,2671,73,40,5425,550,2625,700,50,550,0
514,0,1,184.0,48.0,220.0,68.0,3706,2194,2743,1567,963,627,166,8207,55,5485,111,2722,73,40,5675,550,2625,700,50,550,0
521,0,1,187.0,48.0,220.0,68.0,3958,2188,2995,1539,963,649,337,8477,260,5675,77,2802,76,40,5825,550,2625,700,50,550,0
529,0,1,193.0,48.0,220.0,68.0,4226,2160,3219,1511,1007,649,427,8732,380,5850,47,2882,76,40,6375,550,2625,700,50,550,0
536,0,1,200.0,48.0,220.0,68.0,4226,2244,3219,1595,1007,649,698,9003,510,6045,188,2958,76,40,7225,650,2625,700,50,550,0
543,0,1,200.0,48.0,220.0,68.0,4770,2238,3807,1567,963,671,1280,9258,980,6220,300,3038,76,40,7225,650,2625,700,50,550,0
550,0,1,200.0,48.0,220.0,68.0,4904,2154,3919,1483,985,671,856,9504,440,6390,416,3114,76,40,7525,650,2625,700,50,550,0
557,0,1,200.0,48.0,220.0,60.0,4624,2216,3639,1567,985,649,1401,9665,865,6525,536,3140,76,40,7850,450,2625,700,50,750,0
564,0,1,200.0,50.0,220.0,60.0,4411,2222,3471,1595,940,627,1458,9821,810,6630,648,3191,76,40,8125,450,2625,700,50,750,0
571,0,1,200.0,50.0,220.0,60.0,4366,2244,3359,1595,1007,649,1461,10081,885,6810,576,3271,76,40,8125,550,2625,700,50,750,0
579,0,1,200.0,50.0,220.0,60.0,4109,2272,2967,1623,1142,649,1952,10356,1240,7005,712,3351,76,40,8125,550,2625,700,50,750,0
586,0,1,200.0,50.0,220.0,60.0,4277,2244,3023,1595,1254,649,2469,10617,1605,7190,864,3427,76,40,8125,650,2625,700,50,750,0
593,0,1,200.0,50.0,220.0,60.0,4411,2266,3135,1595,1276,671,1657,10882,1320,7375,337,3507,76,40,8125,650,2625,700,50,750,0
600,0,1,200.0,50.0,220.0,60.0,4383,2238,3107,1567,1276,671,2159,11148,1670,7565,489,3583,76,40,8125,650,2625,700,50,750,0
607,0,1,200.0,50.0,220.0,60.0,4002,2244,2771,1595,1231,649,2617,11409,1980,7750,637,3659,76,40,8125,650,2625,700,50,750,0
614,0,1,128.0,52.0,220.0,60.0,3879,2194,2603,1567,1276,627,2879,11575,2140,7865,739,3710,76,40,4525,650,3275,700,50,750,0
621,0,1,148.0,52.0,250.0,60.0,3913,2272,2659,1623,1254,649,1451,11245,1210,7655,241,3590,76,40,4525,650,3575,700,50,750,0
629,0,1,148.0,52.0,250.0,60.0,3885,2250,2631,1623,1254,627,1914,11516,1525,7850,389,3666,76,40,4525,750,3575,700,50,750,0
636,0,1,148.0,51.0,250.0,76.0,4249,2182,2995,1511,1254,671,2432,11316,1895,7770,537,3546,76,38,4525,850,3800,700,50,750,0
643,0,1,148.0,52.0,250.0,76.0,4193,2104,2939,1455,1254,649,2919,11517,2230,7895,689,3622,76,38,5050,850,3800,700,50,750,0
650,0,1,164.0,52.0,250.0,76.0,4109,1992,2855,1343,1254,649,1351,11754,1260,8060,91,3694,76,39,5050,850,4000,700,50,750,0
657,0,1,170.0,52.0,250.0,76.0,4025,2026,2771,1399,1254,627,1814,12000,1575,8230,239,3770,76,40,6000,850,4200,700,50,750,0
664,0,1,168.0,52.0,226.0,76.0,4215,2110,2939,1483,1276,627,2020,12270,1775,8420,245,3850,76,40,5900,850,4200,950,350,750,0
671,0,1,184.0,46.0,226.0,68.0,4260,2076,2939,1427,1321,649,1711,12360,1310,8480,401,3880,76,40,6300,250,4200,1200,350,1350,0
679,0,1,184.0,46.0,226.0,68.0,4148,2126,2827,1455,1321,671,1982,12470,1525,8585,457,3885,76,40,7400,250,4200,1200,350,1350,0
686,0,1,184.0,47.0,226.0,68.0,4047,2154,2771,1483,1276,671,2464,12681,1855,8720,609,3961,76,40,8300,350,4200,1200,350,1350,0
693,0,1,184.0,47.0,226.0,68.0,4092,2182,2771,1511,1321,671,2650,12937,2035,8900,615,4037,76,40,8750,500,4200,1200,350,1350,0
700,0,1,184.0,47.0,226.0,68.0,3896,2160,2575,1511,1321,649,3105,13193,2330,9080,775,4113,76,40,8750,500,4200,1200,350,1350,0
707,0,1,184.0,49.0,226.0,68.0,3650,2166,2351,1539,1299,627,3228,13349,2455,9185,773,4164,76,40,8750,550,4200,1200,350,1350,0
714,0,1,184.0,49.0,226.0,68.0,3734,2188,2435,1539,1299,649,3548,13609,2690,9365,858,4244,76,40,8750,550,4200,1200,350,1350,0
721,0,1,184.0,51.0,226.0,68.0,4126,2076,2827,1427,1299,649,4050,13609,3040,9435,1010,4174,76,40,8750,550,4200,1200,350,1350,0
729,0,1,183.0,46.0,226.0,60.0,4372,2098,3051,1427,1321,671,4065,13660,3145,9435,920,4225,76,40,8650,200,4200,1200,450,1900,0
736,0,1,183.0,45.0,226.0,60.0,4266,2037,2967,1343,1299,694,4577,13600,3505,9295,1072,4305,76,39,8650,200,4200,1200,450,1900,0
743,0,1,183.0,35.0,226.0,60.0,4372,1712,3051,1063,1321,649,5098,13683,3870,9310,1228,4373,76,27,8650,200,4200,1200,450,2500,0
750,0,1,183.0,29.0,226.0,60.0,4271,1370,2995,811,1276,559,5610,13787,4230,9350,1380,4437,76,20,8650,200,4200,1200,450,2850,0
757,0,1,183.0,26.0,226.0,60.0,4322,967,3023,587,1299,380,6126,13837,4590,9360,1536,4477,76,17,8650,500,4200,1200,450,3050,0
764,0,1,183.0,26.0,226.0,60.0,4372,816,3051,503,1321,313,6666,13887,4970,9370,1696,4517,76,18,8650,600,4200,1200,450,3100,0
771,0,1,181.0,17.0,226.0,60.0,4266,631,2967,363,1299,268,7168,13859,5320,9335,1848,4524,76,10,8550,500,4200,1200,550,3650,0
779,0,1,181.0,15.0,226.0,60.0,4355,536,3079,223,1276,313,7680,13889,5680,9325,2000,4564,76,10,8550,250,4200,1200,550,3950,0
786,0,1,181.0,9.0,226.0,60.0,4260,435,2939,167,1321,268,8196,13731,6040,9135,2156,4596,76,4,8550,150,4200,1200,550,4450,0
7,0,2,13.0,13.0,15.0,15.0,251,293,251,293,0,0,30,35,30,35,0,0,12,12,0,0,0,0,0,0,1
14,0,2,14.0,14.0,15.0,15.0,671,671,671,671,0,0,70,70,70,70,0,0,13,13,0,0,0,0,0,0,1
21,0,2,14.0,14.0,15.0,15.0,699,699,699,699,0,0,50,0,50,0,0,0,13,13,0,0,0,0,0,0,1
29,0,2,15.0,15.0,15.0,15.0,699,699,699,699,0,0,85,40,85,40,0,0,14,14,0,0,0,0,0,0,1
36,0,2,15.0,15.0,15.0,15.0,727,755,727,755,0,0,130,140,130,140,0,0,14,14,0,0,0,0,0,0,1
43,0,2,16.0,16.0,23.0,23.0,755,783,755,783,0,0,70,35,70,35,0,0,15,15,0,0,0,0,0,0,1
50,0,2,16.0,17.0,23.0,23.0,811,839,811,839,0,0,45,5,45,5,0,0,15,16,0,0,0,0,0,0,1
57,0,2,17.0,18.0,23.0,23.0,727,839,727,839,0,0,130,55,130,55,0,0,16,17,0,0,0,0,0,0,1
64,0,2,18.0,19.0,23.0,23.0,839,923,839,923,0,0,190,175,190,175,0,0,17,18,0,0,0,0,0,0,1
71,0,2,18.0,19.0,23.0,23.0,827,951,783,951,44,0,283,240,275,240,8,0,17,18,0,0,0,0,0,0,1
79,0,2,19.0,20.0,23.0,23.0,889,951,755,951,134,0,344,345,320,345,24,0,18,19,0,0,0,0,0,0,1
86,0,2,19.0,20.0,23.0,23.0,911,1018,755,951,156,67,459,322,415,310,44,12,18,19,0,0,0,150,0,0,1
93,0,2,20.0,20.0,23.0,23.0,939,978,783,867,156,111,374,39,310,15,64,24,19,20,0,0,150,150,0,0,1
100,0,2,20.0,20.0,23.0,23.0,962,1023,783,867,179,156,479,59,395,15,84,44,19,20,0,0,150,150,0,0,1
107,0,2,20.0,21.0,23.0,23.0,1046,1023,867,867,179,156,609,134,505,70,104,64,19,20,50,0,150,150,0,0,1
114,0,2,21.0,22.0,23.0,23.0,995,1074,839,895,156,179,125,139,55,55,70,84,19,21,50,0,150,150,0,0,1
121,0,2,22.0,24.0,23.0,31.0,939,1074,783,895,156,179,175,144,85,65,90,79,19,21,50,0,150,300,0,0,1
129,0,2,23.0,25.0,23.0,31.0,1079,1079,923,923,156,156,265,120,155,25,110,95,20,22,50,0,150,300,0,0,1
136,0,2,23.0,25.0,23.0,31.0,1051,1096,895,895,156,201,155,208,125,85,30,123,20,22,50,0,150,300,0,0,1
143,0,2,24.0,26.0,31.0,39.0,1102,1180,923,867,179,313,135,48,85,35,50,13,21,23,150,125,150,300,0,0,1
150,0,2,24.0,28.0,31.0,39.0,1079,1258,923,923,156,335,41,83,25,55,16,28,21,23,150,125,150,300,0,0,1
157,0,2,25.0,28.0,31.0,39.0,1219,1236,1063,923,156,313,216,29,180,15,36,14,22,23,150,125,150,300,0,50,1
164,0,2,26.0,29.0,31.0,54.0,1247,1314,1091,979,156,335,251,179,195,125,56,54,23,24,150,125,150,300,0,50,1
171,0,2,26.0,30.0,31.0,54.0,1247,1236,1091,923,156,313,396,180,320,90,76,90,23,24,150,125,250,300,0,50,1
179,0,2,29.0,34.0,31.0,54.0,1354,1376,1063,1063,291,313,156,225,140,120,16,105,24,26,150,250,500,300,0,50,1
186,0,2,31.0,35.0,46.0,54.0,1370,1432,1035,1119,335,313,102,300,50,155,52,145,24,27,150,250,600,600,0,50,1
193,0,2,32.0,40.0,46.0,54.0,1376,1594,1063,1259,313,335,128,140,40,105,88,35,25,29,150,250,600,600,0,50,1
200,0,2,32.0,41.0,46.0,54.0,1656,1650,1343,1315,313,335,198,245,95,170,103,75,25,30,250,250,600,600,0,50,1
207,0,2,36.0,42.0,46.0,54.0,1628,1706,1315,1371,313,335,233,431,90,320,143,111,26,31,350,375,600,600,0,50,1
214,0,2,36.0,43.0,46.0,54.0,1678,1678,1343,1343,335,335,428,236,245,85,183,151,27,32,350,675,850,600,0,50,1
221,0,2,43.0,47.0,46.0,54.0,1824,1628,1511,1315,313,313,194,142,75,105,119,37,28,33,450,675,925,600,0,50,1
229,0,2,43.0,49.0,46.0,54.0,1583,1908,1315,1595,268,313,147,282,75,205,72,77,27,35,450,675,925,600,100,50,1
236,0,2,43.0,49.0,46.0,54.0,1158,1880,979,1567,179,313,162,497,66,380,96,117,25,35,500,675,925,600,250,50,1
243,0,2,45.0,49.0,54.0,54.0,1477,2014,1231,1679,246,335,173,242,41,85,132,157,26,37,550,675,925,600,250,50,1
250,0,2,45.0,51.0,54.0,54.0,1510,1936,1175,1623,335,313,323,373,151,180,172,193,26,37,800,975,925,600,300,50,1
257,0,2,50.0,54.0,54.0,54.0,1180,2042,867,1707,313,335,85,213,6,130,79,83,28,39,1075,975,925,900,300,50,1
264,0,2,51.0,58.0,62.0,62.0,1544,2009,1231,1651,313,358,230,193,111,120,119,73,28,37,1125,975,925,900,300,150,1
271,0,2,53.0,61.0,62.0,62.0,1656,1902,1343,1567,313,335,245,179,86,95,159,84,29,38,1125,1225,925,900,300,200,1
279,0,2,56.0,61.0,62.0,62.0,1684,1992,1371,1679,313,313,135,170,11,50,124,120,30,38,1075,1350,925,900,400,200,1
286,0,2,57.0,62.0,62.0,62.0,1986,1992,1651,1679,335,313,310,205,146,45,164,160,31,40,1400,1650,925,900,400,200,1
293,0,2,62.0,62.0,70.0,62.0,2322,2076,1987,1763,335,313,206,405,106,205,100,200,32,41,1400,1650,925,900,400,200,1
300,0,2,64.0,64.0,70.0,70.0,2266,2154,1931,1819,335,335,196,275,56,135,140,140,33,41,1450,1650,925,900,400,200,1
307,0,2,66.0,66.0,70.0,78.0,2272,2182,1959,1847,313,335,422,185,246,105,176,80,34,41,1725,1650,925,900,400,200,1
314,0,2,65.0,66.0,70.0,78.0,2244,2194,1931,1679,313,515,427,448,286,300,141,148,33,43,1725,1525,925,900,600,325,1
321,0,2,66.0,62.0,78.0,93.0,2070,2356,1735,1707,335,649,457,203,276,125,181,78,32,45,1975,900,925,900,650,950,1
329,0,2,72.0,62.0,78.0,93.0,2188,2334,1875,1707,313,627,288,270,196,120,92,150,34,45,2025,1675,925,1050,650,950,1
336,0,2,73.0,65.0,78.0,93.0,1992,2462,1679,1791,313,671,378,325,246,95,132,230,34,45,2075,1675,925,1300,650,950,1
343,0,2,76.0,65.0,78.0,93.0,2098,2446,1763,1819,335,627,588,617,416,315,172,302,36,45,2125,1675,925,1300,650,950,1
350,0,2,79.0,71.0,86.0,85.0,2126,2496,1791,1847,335,649,238,397,126,165,112,232,36,48,2400,2200,925,1300,650,1050,1
357,0,2,77.0,74.0,86.0,85.0,2070,2580,1735,1931,335,649,447,562,302,250,145,312,38,48,2575,2200,925,1400,750,1050,1
364,0,2,75.0,75.0,86.0,85.0,2188,2636,1875,1987,313,649,354,728,302,340,52,388,38,51,2025,2025,925,1600,1364,1225,1
371,0,2,77.0,81.0,86.0,85.0,2082,2726,1791,2099,291,627,420,534,307,220,113,314,38,51,2075,2200,925,1600,1364,1225,1
379,0,2,72.0,82.0,86.0,85.0,1309,2860,1175,2211,134,649,511,670,389,280,122,390,37,54,2025,2375,925,1600,1816,1400,1
386,0,2,65.0,82.0,86.0,85.0,1460,2860,1371,2211,89,649,633,515,499,295,134,220,34,54,1825,2375,925,1600,2216,1400,1
393,0,2,62.0,85.0,86.0,85.0,1634,3062,1455,2435,179,627,372,721,214,425,158,296,35,57,1575,2375,925,1600,2466,1400,1
400,0,2,67.0,85.0,86.0,85.0,2020,3112,1707,2463,313,649,197,436,149,60,48,376,36,58,1875,2375,925,1600,2466,1400,1
407,0,2,69.0,85.0,86.0,85.0,1986,3196,1651,2547,335,649,147,717,59,265,88,452,37,60,1925,2375,925,1600,2466,1400,1
414,0,2,71.0,85.0,86.0,85.0,2014,3090,1679,2463,335,627,298,554,174,130,124,424,39,60,1925,2375,925,1600,2516,1400,1
421,0,2,71.0,94.0,86.0,101.0,2350,3202,2015,2575,335,627,283,295,119,95,164,200,39,60,1975,2825,1000,1600,2516,1400,1
429,0,2,74.0,95.0,101.0,101.0,2216,3252,1903,2603,313,649,272,381,77,105,195,276,41,63,1975,2825,1000,1600,2516,1400,1
436,0,2,75.0,97.0,101.0,101.0,2188,3308,1763,2659,425,649,509,466,259,110,250,356,42,63,2300,2825,1150,1600,2516,1400,1
443,0,2,77.0,98.0,101.0,117.0,2334,3302,1707,2631,627,671,597,857,274,425,323,432,43,64,2300,2825,1300,1700,2516,1400,1
450,0,2,77.0,102.0,101.0,125.0,2558,3370,1931,2743,627,627,789,909,394,505,395,404,41,66,2350,2825,1550,2000,2670,1400,1
457,0,2,80.0,104.0,101.0,125.0,2765,3364,2183,2715,582,649,103,769,44,535,59,234,42,67,2400,3350,1550,2150,2670,1400,1
464,0,2,83.0,109.0,101.0,125.0,3000,3157,2351,2463,649,694,203,447,164,125,39,322,45,67,2450,3350,1550,2400,2670,1400,1
471,0,2,85.0,113.0,101.0,125.0,3230,3442,2603,2547,627,895,405,424,294,90,111,334,46,67,2450,3350,1550,2550,2670,1400,1
479,0,2,83.0,113.0,101.0,125.0,3202,3526,2575,2519,627,1007,430,734,239,280,191,454,47,70,2350,3700,1550,2700,2959,1400,1
486,0,2,89.0,111.0,101.0,125.0,3224,3560,2575,2575,649,985,365,760,119,390,246,370,48,70,2400,3450,1550,2700,2959,1650,1
493,0,2,89.0,109.0,109.0,133.0,3112,3650,2463,2687,649,963,465,1197,164,715,301,482,49,70,2300,3525,1550,3050,3059,1825,1
500,0,2,95.0,125.0,109.0,141.0,2944,3706,2295,2743,649,963,615,433,243,35,372,398,52,70,2400,4325,1650,3050,3059,1825,1
507,0,2,96.0,126.0,109.0,141.0,2658,3700,1987,2715,671,985,474,773,93,330,381,443,49,70,2525,4325,1650,3050,3259,1825,1
514,0,2,97.0,126.0,109.0,141.0,2154,3594,1707,2631,447,963,470,1199,76,640,394,559,48,70,2575,4325,1650,3350,3409,1825,1
521,0,2,105.0,140.0,109.0,141.0,2490,3644,2043,2659,447,985,295,330,41,255,254,75,50,70,2750,5225,1850,3350,3409,1825,1
529,0,2,106.0,140.0,109.0,141.0,2866,3616,2239,2631,627,985,305,361,46,170,259,191,51,70,2950,4725,2150,3350,3409,1825,1
536,0,2,109.0,140.0,109.0,141.0,3000,3622,2351,2659,649,963,420,688,106,385,314,303,54,70,3075,5625,2150,3350,3409,1825,1
543,0,2,109.0,140.0,109.0,157.0,3246,3538,2575,2575,671,963,335,1094,41,675,294,419,54,70,3175,5625,2225,3350,3409,1825,1
550,0,2,109.0,156.0,109.0,157.0,3274,3398,2603,2435,671,963,496,489,151,250,345,239,56,70,3575,6425,2225,3350,3459,1825,1
557,0,2,120.0,157.0,125.0,157.0,3554,3370,2883,2407,671,963,717,740,321,385,396,355,56,70,3575,6225,2225,3350,3459,1825,1
564,0,2,123.0,159.0,133.0,165.0,3622,3274,2995,2267,627,1007,589,1130,196,655,393,475,58,70,3575,6675,2325,3350,3509,1825,1
571,0,2,123.0,152.0,133.0,165.0,3482,3414,2855,2407,627,1007,959,1522,486,935,473,587,59,71,3525,6175,2325,3350,3659,2325,1
579,0,2,98.0,145.0,133.0,165.0,3006,3342,2379,2379,627,963,869,719,391,20,478,699,52,73,2300,5175,2325,3350,5741,4125,1
7,,,13.0,13.0,15.0,14.0,251,293,251,293,0,0,30,35,30,35,0,0,12,12,0,0,0,0,0,0,1
14,,,14.0,13.0,15.0,14.0,643,671,643,671,0,0,65,20,65,20,0,0,13,13,0,0,0,0,0,0,1
21,,,14.0,14.0,15.0,14.0,699,783,699,783,0,0,45,55,45,55,0,0,13,13,0,0,0,0,0,0,1
29,,,15.0,14.0,15.0,14.0,755,783,755,783,0,0,35,140,35,140,0,0,14,13,0,0,0,0,0,0,1
36,,,16.0,14.0,23.0,22.0,811,783,811,783,0,0,130,235,130,235,0,0,15,14,0,0,0,0,0,0,1
43,,,16.0,13.0,23.0,22.0,839,755,839,755,0,0,25,15,25,15,0,0,15,13,0,0,0,0,0,0,1
50,,,17.0,14.0,23.0,22.0,867,755,867,755,0,0,0,50,0,50,0,0,16,13,0,0,0,0,0,0,1
57,,,18.0,14.0,23.0,22.0,867,727,867,727,0,0,5,140,5,140,0,0,17,13,0,0,0,0,0,0,1
64,,,19.0,13.0,23.0,22.0,979,755,979,755,0,0,110,5,110,5,0,0,18,13,0,0,0,0,0,0,1
71,,,19.0,13.0,23.0,22.0,973,699,951,699,22,0,229,35,225,35,4,0,18,12,0,0,0,0,0,0,1
79,,,20.0,14.0,23.0,22.0,995,671,951,671,44,0,343,70,335,70,8,0,19,12,0,0,0,0,0,0,1
86,,,20.0,14.0,23.0,22.0,1018,699,951,699,67,0,71,50,55,50,16,0,19,13,0,0,150,0,0,0,1
93,,,20.0,14.0,23.0,22.0,1018,687,951,643,67,44,44,143,20,135,24,8,20,14,0,0,150,0,0,0,1
100,,,21.0,14.0,23.0,30.0,1040,827,951,671,89,156,111,248,75,220,36,28,20,14,0,0,150,0,0,0,1
107,,,21.0,14.0,23.0,30.0,1006,822,895,643,111,179,112,333,60,285,52,48,20,14,0,0,150,0,0,0,1
114,,,22.0,18.0,23.0,36.0,1051,850,895,671,156,179,92,183,20,115,72,68,21,14,0,0,150,250,0,0,1
121,,,23.0,17.0,23.0,36.0,1107,687,951,531,156,156,172,109,80,25,92,84,22,13,0,0,150,250,0,0,1
129,,,24.0,18.0,31.0,36.0,1090,687,867,531,223,156,255,119,135,15,120,104,23,13,0,50,300,250,0,0,1
136,,,26.0,18.0,31.0,36.0,1202,721,867,587,335,134,275,150,140,30,135,120,23,12,0,100,300,250,0,0,1
143,,,27.0,19.0,31.0,36.0,1214,721,923,587,291,134,127,181,110,45,17,136,24,13,0,100,300,250,0,0,1
150,,,30.0,20.0,31.0,36.0,1242,659,951,503,291,156,47,221,40,65,7,156,25,14,125,250,300,250,0,0,1
157,,,31.0,21.0,46.0,36.0,1292,822,979,643,313,179,62,266,15,90,47,176,25,15,125,300,300,250,0,0,1
164,,,33.0,22.0,46.0,36.0,1320,788,1007,587,313,201,118,305,85,105,33,200,27,16,125,300,300,450,0,0,1
171,,,35.0,23.0,46.0,36.0,1538,900,1203,699,335,201,153,364,80,140,73,224,29,17,125,300,300,450,0,0,1
179,,,35.0,24.0,46.0,36.0,1538,889,1203,643,335,246,228,421,115,165,113,256,29,18,125,300,300,450,0,0,1
186,,,37.0,27.0,46.0,36.0,1600,1018,1287,727,313,291,364,392,215,125,149,267,31,19,300,300,600,450,0,0,1
193,,,42.0,27.5,54.0,36.0,1684,1040,1371,727,313,313,124,477,85,170,39,307,32,20,300,275,600,450,0,25,1
200,,,43.0,28.5,54.0,36.0,1790,1113,1455,755,335,358,224,442,145,95,79,347,33,21,300,275,600,450,0,25,1
207,,,45.0,29.5,54.0,36.0,1796,1169,1483,811,313,358,240,527,125,140,115,387,35,22,300,375,600,450,0,25,1
214,,,46.0,30.5,54.0,36.0,1796,1152,1483,839,313,313,305,614,150,195,155,419,36,23,300,375,600,450,0,25,1
221,,,48.0,31.5,54.0,44.0,1964,1236,1651,923,313,313,151,700,110,245,41,455,38,24,300,375,600,450,0,25,1
229,,,48.0,32.5,54.0,44.0,2042,1292,1707,979,335,313,385,720,300,225,85,495,38,25,650,375,600,450,0,25,1
236,,,54.0,35.5,54.0,44.0,2070,1376,1511,1063,559,313,95,735,80,225,15,510,40,26,650,375,600,450,0,25,1
243,,,54.0,36.5,54.0,44.0,2194,1404,1567,1091,627,313,363,605,280,155,83,450,40,26,650,375,600,450,0,25,1
250,,,54.0,37.5,54.0,52.0,2272,1477,1623,1119,649,358,424,725,265,235,159,490,42,27,650,475,600,450,0,25,1
257,,,56.0,38.5,62.0,52.0,2272,1566,1623,1231,649,335,695,871,460,345,235,526,42,28,650,475,750,450,0,25,1
264,,,60.0,39.5,62.0,52.0,2278,1544,1651,1231,627,313,276,997,265,435,11,562,42,29,1000,475,1050,450,0,25,1
271,,,64.0,40.5,70.0,52.0,2406,1656,1735,1343,671,313,476,1152,385,550,91,602,44,30,1000,475,1050,450,0,25,1
279,,,66.0,43.0,70.0,52.0,2412,1656,1763,1343,649,313,432,1102,390,485,42,617,44,31,1000,450,1050,450,0,50,1
286,,,66.0,44.0,70.0,52.0,2384,1740,1735,1427,649,313,213,1272,95,615,118,657,44,32,1125,450,1050,450,0,50,1
293,,,67.0,45.0,78.0,52.0,2384,1846,1735,1511,649,335,463,1427,265,730,198,697,44,33,1125,450,1050,450,0,50,1
300,,,71.0,46.0,78.0,60.0,2384,1869,1735,1511,649,358,404,1402,280,765,124,637,44,34,1475,550,1050,700,0,50,1
307,,,75.0,46.0,86.0,60.0,2474,1908,1847,1595,627,313,145,1549,95,880,50,669,45,34,1825,650,1050,700,0,50,1
314,,,77.0,46.0,86.0,60.0,2468,1740,1819,1427,649,313,340,1674,210,965,130,709,45,34,1825,750,1050,700,0,50,1
321,,,77.0,49.0,86.0,60.0,2490,1796,1819,1483,671,313,645,1754,435,1030,210,724,45,35,1825,750,1050,700,0,50,1
329,,,79.0,50.0,94.0,60.0,2574,1880,1903,1567,671,313,491,1934,355,1170,136,764,47,36,1825,750,1050,700,0,50,1
336,,,83.0,51.0,94.0,60.0,2418,1852,1791,1427,627,425,124,2099,70,1275,54,824,47,37,2175,750,1150,700,0,50,1
343,,,89.0,52.0,94.0,60.0,2507,1947,1903,1343,604,604,325,2295,195,1395,130,900,49,38,2525,850,1150,700,0,50,1
350,,,90.0,52.0,94.0,60.0,2507,1992,1903,1343,604,649,181,2531,75,1555,106,976,51,39,2525,850,1150,700,0,50,1
357,,,92.0,52.0,109.0,60.0,2485,2082,1903,1455,582,627,113,2778,35,1730,78,1048,51,40,2525,850,1150,700,0,50,1
364,,,93.0,52.0,109.0,60.0,2714,2104,2043,1455,671,649,293,3033,135,1905,158,1128,52,40,2525,850,1150,700,0,50,1
371,,,95.0,52.0,109.0,60.0,2686,2216,2015,1567,671,649,459,3299,225,2095,234,1204,54,40,2525,850,1150,700,0,50,1
379,,,98.0,52.0,109.0,52.0,2860,2194,2211,1567,649,627,710,3450,400,2220,310,1230,57,40,3225,650,1150,700,0,250,1
386,,,101.0,52.0,109.0,52.0,3062,2160,2435,1511,627,649,706,3610,420,2300,286,1310,60,40,3225,650,1600,700,0,250,1
393,,,101.0,51.0,109.0,46.0,3056,1583,2407,1091,649,492,356,3358,90,2000,266,1358,60,39,3225,750,1850,100,0,850,1
400,,,103.0,52.0,109.0,54.0,3224,838,2575,503,649,335,331,3412,210,2010,121,1402,63,39,3225,750,2100,100,0,850,1
407,,,106.0,52.0,109.0,62.0,3179,1051,2575,783,604,268,430,3551,328,2125,102,1426,64,39,3225,750,2100,100,0,850,1
414,,,106.0,52.0,109.0,62.0,3280,1354,2519,1175,761,179,531,3721,333,2275,198,1446,64,40,3225,750,2100,100,0,850,1
421,,,106.0,52.0,109.0,62.0,3414,1337,2519,1203,895,134,540,3877,238,2415,302,1462,67,40,3325,750,2400,100,0,850,1
429,,,106.0,52.0,109.0,62.0,3538,1494,2575,1315,963,179,577,4061,263,2575,314,1486,67,40,3325,750,2550,100,0,850,1
436,,,112.0,52.0,125.0,62.0,3594,1365,2631,1231,963,134,609,4217,183,2715,426,1502,67,40,3325,750,2550,100,0,850,1
443,,,116.0,52.0,133.0,54.0,3571,1359,2631,1203,940,156,91,4027,53,2605,38,1422,69,40,3325,550,2900,100,0,1050,1
450,,,116.0,52.0,133.0,54.0,3678,1494,2715,1315,963,179,406,4216,248,2770,158,1446,69,40,3725,550,3300,100,0,1050,1
457,,,116.0,52.0,133.0,62.0,3846,1382,2883,1203,963,179,858,4371,588,2905,270,1466,69,40,3725,550,3300,100,0,1050,1
464,,,120.0,52.0,133.0,68.0,3806,1410,2799,1231,1007,179,548,4541,158,3055,390,1486,69,40,3725,550,3300,100,0,1050,1
471,,,120.0,52.0,133.0,68.0,3717,1376,2799,1175,918,201,879,4695,393,3185,486,1510,69,40,3925,550,3300,100,0,1050,1
479,,,128.0,52.0,133.0,68.0,3907,1370,2967,1035,940,335,289,4873,83,3315,206,1558,69,40,4700,550,3300,100,0,1050,1
486,,,128.0,52.0,133.0,68.0,3874,1953,2911,1371,963,582,626,5115,308,3485,318,1630,69,40,4700,550,3600,100,0,1050,1
493,,,128.0,52.0,133.0,68.0,3790,2278,2827,1651,963,627,1072,5401,638,3695,434,1706,69,40,4700,550,3900,100,0,1050,1
500,,,128.0,52.0,149.0,68.0,3728,2138,2743,1511,985,627,1118,5547,568,3815,550,1732,69,40,4700,550,4550,350,0,1050,1
507,,,132.0,52.0,157.0,68.0,3722,2222,2715,1595,1007,627,469,5822,353,4010,116,1812,69,40,4700,550,4550,350,0,1050,1
514,,,142.0,52.0,165.0,68.0,3622,2188,2659,1539,963,649,606,6092,378,4200,228,1892,69,40,5375,650,4550,350,0,1050,1
521,,,142.0,52.0,165.0,68.0,3661,2244,2743,1595,918,649,248,6363,108,4395,140,1968,69,40,5825,650,4550,350,0,1050,1
529,,,142.0,52.0,165.0,68.0,3493,2182,2575,1511,918,671,314,6623,58,4575,256,2048,69,40,5825,650,4550,350,0,1050,1
536,,,142.0,52.0,165.0,68.0,3566,2188,2603,1539,963,649,445,6890,223,4770,222,2120,69,40,5825,650,4550,350,0,1050,1
543,,,145.0,52.0,165.0,68.0,3454,2244,2491,1595,963,649,252,7175,68,4975,184,2200,69,40,5825,650,4550,350,0,1050,1
550,,,145.0,52.0,165.0,68.0,3454,2194,2491,1567,963,627,504,7421,208,5145,296,2276,69,40,5825,650,4700,350,0,1050,1
557,,,148.0,52.0,165.0,68.0,3465,2216,2435,1567,1030,649,770,7706,358,5350,412,2356,72,40,6200,650,5200,350,0,1050,1
564,,,154.0,52.0,165.0,68.0,3386,2216,2379,1567,1007,649,461,7976,183,5540,278,2436,72,40,6200,650,5700,350,0,1050,1
571,,,163.0,52.0,165.0,68.0,3291,2322,2351,1651,940,671,259,8247,123,5735,136,2512,75,40,6200,650,5700,350,0,1050,1
579,,,165.0,52.0,180.0,68.0,3291,2210,2351,1539,940,671,499,8497,243,5905,256,2592,78,40,6200,650,6150,350,0,1050,1
586,,,171.0,52.0,180.0,68.0,3566,2188,2603,1539,963,649,199,8769,73,6105,126,2664,78,40,6200,650,6150,350,0,1050,1
593,,,171.0,52.0,180.0,68.0,3734,2188,2771,1539,963,649,540,9039,298,6295,242,2744,80,40,6200,650,6150,350,0,1050,1
600,,,171.0,52.0,180.0,68.0,3924,2306,2939,1679,985,627,666,9300,483,6480,183,2820,80,40,6200,650,6150,350,0,1050,1
607,,,175.0,52.0,188.0,68.0,4114,2222,2995,1595,1119,627,357,8721,288,6225,69,2496,80,39,6200,650,6150,350,0,1050,1
614,,,181.0,52.0,188.0,68.0,4467,2188,3191,1539,1276,649,889,8921,668,6345,221,2576,84,38,7520,650,6150,350,0,1050,1
7,0,2,13.0,13.0,15.0,15.0,377,377,377,377,0,0,45,45,45,45,0,0,12,12,0,0,0,0,0,0,0
14,0,2,14.0,14.0,15.0,15.0,671,699,671,699,0,0,70,75,70,75,0,0,13,13,0,0,0,0,0,0,0
21,0,2,14.0,14.0,15.0,15.0,727,699,727,699,0,0,5,50,5,50,0,0,13,13,0,0,0,0,0,0,0
29,0,2,15.0,15.0,15.0,15.0,755,755,755,755,0,0,45,60,45,60,0,0,14,14,0,0,0,0,0,0,0
36,0,2,15.0,16.0,15.0,23.0,783,839,783,839,0,0,130,155,130,155,0,0,14,15,0,0,0,0,0,0,0
43,0,2,16.0,16.0,23.0,23.0,755,839,755,839,0,0,65,50,65,50,0,0,15,15,0,0,0,0,0,0,0
50,0,2,16.0,17.0,23.0,23.0,783,867,783,867,0,0,45,25,45,25,0,0,15,16,0,0,0,0,0,0,0
57,0,2,17.0,18.0,23.0,23.0,783,867,783,867,0,0,80,135,80,135,0,0,16,17,0,0,0,0,0,0,0
64,0,2,18.0,19.0,23.0,23.0,783,923,783,923,0,0,125,190,125,190,0,0,17,18,0,0,0,0,0,0,0
71,0,2,18.0,19.0,23.0,23.0,771,1001,727,979,44,22,218,304,210,300,8,4,17,18,0,0,0,0,0,0,0
79,0,2,19.0,20.0,23.0,23.0,883,967,727,923,156,44,323,368,295,360,28,8,18,19,0,0,0,0,0,0,0
86,0,2,19.0,20.0,23.0,23.0,911,1068,755,979,156,89,428,49,380,25,48,24,18,19,0,0,0,150,0,0,0
93,0,2,20.0,21.0,23.0,23.0,939,1034,783,923,156,111,293,166,275,130,18,36,19,20,0,0,150,150,0,0,0
100,0,2,20.0,22.0,23.0,23.0,1051,1001,895,867,156,134,418,91,380,35,38,56,19,21,0,0,150,150,0,0,0
107,0,2,20.0,21.0,23.0,23.0,1023,1107,867,951,156,156,133,101,75,25,58,76,19,21,0,0,150,150,0,0,0
114,0,2,21.0,22.0,23.0,23.0,1018,1079,839,923,179,156,98,186,20,90,78,96,19,21,0,0,150,150,0,0,0
121,0,2,22.0,23.0,23.0,23.0,962,1107,783,951,179,156,108,271,10,155,98,116,19,22,100,0,150,150,0,0,0
129,0,2,23.0,23.0,23.0,31.0,1079,1152,923,951,156,201,234,360,120,220,114,140,20,22,100,0,150,150,0,0,0
136,0,2,23.0,26.0,31.0,31.0,1023,1118,867,895,156,223,69,174,35,85,34,89,20,23,100,0,150,300,0,0,0
143,0,2,24.0,26.0,31.0,31.0,1023,1219,867,951,156,268,99,271,95,150,4,121,21,23,150,0,150,300,0,0,0
150,0,2,25.0,27.0,31.0,31.0,1107,1208,951,895,156,313,104,421,80,260,24,161,22,24,150,0,150,300,0,0,0
157,0,2,25.0,29.0,31.0,54.0,1163,1264,1007,951,156,313,129,172,85,125,44,47,22,25,150,125,150,300,0,0,0
164,0,2,26.0,31.0,31.0,54.0,1186,1292,1007,979,179,313,219,112,155,50,64,62,23,25,150,125,150,300,0,0,0
171,0,2,26.0,33.0,31.0,54.0,1219,1370,1063,1035,156,335,375,172,295,70,80,102,23,27,150,125,150,300,0,0,0
179,0,2,29.0,33.0,46.0,54.0,1292,1454,1091,1119,201,335,38,247,30,105,8,142,24,27,150,125,600,300,0,0,0
186,0,2,31.0,37.0,46.0,54.0,1292,1572,979,1259,313,313,88,208,40,55,48,153,24,29,150,250,600,300,0,0,0
193,0,2,32.0,37.0,46.0,54.0,1460,1572,1147,1259,313,313,118,293,30,100,88,193,25,29,150,250,600,300,0,0,0
200,0,2,34.0,39.0,46.0,54.0,1600,1706,1287,1371,313,335,128,443,25,210,103,233,26,31,250,250,600,600,0,0,0
207,0,2,36.0,43.0,46.0,54.0,1561,1690,1203,1399,358,291,168,235,25,70,143,165,26,33,350,250,600,600,0,0,0
214,0,2,38.0,43.0,46.0,54.0,1645,1802,1287,1511,358,291,228,206,45,105,183,101,28,33,350,375,850,600,0,0,0
221,0,2,38.0,47.0,46.0,54.0,1656,1824,1343,1511,313,313,280,361,65,220,215,141,28,35,450,625,925,600,0,0,0
229,0,2,37.0,47.0,46.0,54.0,1740,1925,1427,1567,313,358,575,496,320,315,255,181,30,35,350,625,925,600,100,0,0
236,0,2,43.0,49.0,54.0,54.0,1908,2009,1595,1651,313,358,245,561,125,340,120,221,30,37,250,625,925,600,200,0,0
243,0,2,45.0,52.0,54.0,54.0,1992,1970,1679,1679,313,291,195,334,35,185,160,149,31,38,250,875,925,600,200,0,0
250,0,2,47.0,53.0,54.0,54.0,1902,1914,1567,1623,335,291,205,529,5,340,200,189,33,39,350,875,925,750,200,0,0
257,0,2,49.0,54.0,54.0,54.0,1729,2020,1371,1707,358,313,280,284,40,55,240,229,33,41,350,875,925,750,200,0,0
264,0,2,51.0,54.0,62.0,54.0,1902,2126,1567,1791,335,335,371,179,95,10,276,169,35,41,350,1125,925,750,200,0,0
271,0,2,51.0,60.0,62.0,62.0,1992,2104,1679,1679,313,425,402,225,90,50,312,175,35,42,875,1125,1075,750,200,0,0
279,0,2,53.0,62.0,62.0,62.0,1802,2210,1399,1763,403,447,268,327,25,150,243,177,37,42,925,1475,1200,750,200,0,0
286,0,2,54.0,64.0,62.0,70.0,1981,2294,1511,1847,470,447,314,198,115,65,199,133,37,44,925,1725,1200,900,200,0,0
293,0,2,56.0,67.0,70.0,70.0,2009,2272,1539,1847,470,425,214,171,5,90,209,81,38,46,925,1725,1275,900,200,0,0
300,0,2,59.0,68.0,70.0,70.0,2166,2322,1651,1875,515,447,269,362,75,225,194,137,39,46,1025,1725,1275,900,200,0,0
307,0,2,61.0,70.0,70.0,70.0,2664,2345,2127,1875,537,470,329,243,75,150,254,93,40,48,1025,1975,1275,900,200,0,0
314,0,2,60.0,70.0,78.0,70.0,2591,2384,2099,1959,492,425,536,525,230,380,306,145,40,48,1025,1975,1275,1000,200,0,0
321,0,2,64.0,70.0,78.0,70.0,2317,2530,1847,2015,470,515,467,325,96,220,371,105,41,50,1150,1975,1425,1250,200,0,0
329,0,2,67.0,74.0,78.0,78.0,2250,2233,1735,1763,515,470,376,522,40,365,336,157,42,50,1200,1975,1525,1250,200,0,0
336,0,2,70.0,74.0,78.0,93.0,2283,2406,1679,1959,604,447,278,274,71,165,207,109,43,50,1200,1975,1625,1250,200,0,0
343,0,2,72.0,77.0,78.0,109.0,2362,2653,1735,2183,627,470,329,429,45,260,284,169,41,52,1350,1975,1700,1250,300,0,0
350,0,2,74.0,86.0,78.0,109.0,2317,2793,1623,2323,694,470,304,179,65,150,239,29,41,53,1400,2225,1700,1250,300,0,0
357,0,2,77.0,86.0,78.0,109.0,2686,2843,2015,2351,671,492,461,259,150,170,311,89,43,55,1450,2625,1800,1250,300,0,0
364,0,2,78.0,88.0,78.0,109.0,2524,2899,1875,2407,649,492,502,144,115,95,387,49,44,56,1850,2875,1800,1250,300,0,0
371,0,2,79.0,90.0,86.0,109.0,2558,2894,1931,2379,627,515,763,385,350,280,413,105,44,56,1950,2875,1800,1250,300,0,0
379,0,2,86.0,94.0,86.0,109.0,2698,3067,2071,2575,627,492,538,311,195,250,343,61,44,56,2275,3175,1800,1550,300,0,0
386,0,2,86.0,96.0,86.0,117.0,2866,2989,2239,2519,627,470,613,552,290,435,323,117,44,56,2275,3175,1800,1550,300,0,0
393,0,2,89.0,102.0,94.0,125.0,2854,3045,2183,2575,671,470,403,627,0,450,403,177,45,58,2375,3625,1800,1700,300,0,0
400,0,2,90.0,108.0,94.0,125.0,2737,3017,2043,2547,694,470,643,692,160,455,483,237,45,58,2500,3725,1800,1850,300,0,0
407,0,2,91.0,110.0,102.0,125.0,2608,3067,1959,2575,649,492,596,667,45,470,551,197,45,58,2500,4025,1800,2000,300,0,0
414,0,2,93.0,119.0,102.0,125.0,2524,3034,1875,2519,649,515,786,322,155,165,631,157,45,58,2925,4325,1800,2000,300,0,0
421,0,2,94.0,119.0,102.0,125.0,2558,3146,1931,2631,627,515,747,653,90,440,657,213,47,58,2875,4325,1800,2000,350,0,0
429,0,2,95.0,123.0,102.0,125.0,2334,3011,1707,2519,627,492,887,709,150,440,737,269,47,61,2925,4575,1800,2250,350,0,0
436,0,2,97.0,125.0,102.0,125.0,2412,3084,1763,2547,649,537,1037,772,220,435,817,337,49,61,2975,4575,1800,2250,350,0,0
443,0,2,101.0,125.0,102.0,125.0,2289,2944,1595,2295,694,649,1037,1046,165,625,872,421,49,63,3025,4675,1800,2250,350,0,0
450,0,2,101.0,127.0,110.0,133.0,2485,3067,1791,2351,694,716,1038,1139,240,680,798,459,51,63,3025,4675,2000,2250,400,0,0
457,0,2,105.0,128.0,118.0,149.0,2580,3246,1931,2463,649,783,740,1425,95,945,645,480,52,63,3075,5100,2300,2250,400,0,0
464,0,2,106.0,126.0,118.0,149.0,2586,3302,1959,2519,627,783,626,1807,105,1235,521,572,52,63,3200,4850,2300,2400,450,250,0
471,0,2,106.0,126.0,133.0,157.0,2726,3347,2099,2519,627,828,736,1462,235,1140,501,322,53,63,3200,4950,2300,2400,450,250,0
479,0,2,110.0,142.0,133.0,157.0,2670,3224,2043,2351,627,873,451,461,45,285,406,176,53,63,3200,6125,2300,2400,450,250,0
486,0,2,112.0,142.0,133.0,157.0,2524,3196,1875,2211,649,985,616,746,155,450,461,296,53,63,3475,6125,2300,2400,450,250,0
493,0,2,116.0,146.0,133.0,157.0,2821,3006,2127,2043,694,963,661,608,120,300,541,308,55,63,3750,6125,2300,2400,450,250,0
500,0,2,120.0,146.0,133.0,157.0,3162,3174,2491,2211,671,963,578,909,115,485,463,424,55,63,3875,6125,2700,2400,450,250,0
507,0,2,125.0,146.0,133.0,165.0,3336,3364,2687,2379,649,985,484,925,70,385,414,540,57,63,3875,6125,2700,2600,450,250,0
514,0,2,128.0,148.0,133.0,181.0,3230,3420,2603,2435,627,985,575,876,110,420,465,456,57,63,4150,6125,2700,2600,450,250,0
521,0,2,133.0,160.0,133.0,181.0,3006,3398,2379,2435,627,963,605,182,85,10,520,172,59,63,4425,6500,2700,3150,450,250,0
529,0,2,131.0,160.0,141.0,181.0,3403,3364,2575,2379,828,985,732,588,175,300,557,288,61,63,4600,6750,2700,3150,700,250,0
536,0,2,138.0,160.0,141.0,189.0,3890,3330,2883,2323,1007,1007,428,988,5,580,423,408,62,63,4725,6750,2700,3150,700,250,0
543,0,2,138.0,160.0,149.0,189.0,3885,3291,2855,2351,1030,940,829,226,290,110,539,116,62,63,5225,6750,2700,3150,700,250,0
550,0,2,139.0,160.0,157.0,189.0,3756,3370,2771,2407,985,963,666,536,140,300,526,236,64,63,5225,6750,2700,3150,700,250,0
557,0,2,144.0,169.0,157.0,189.0,3823,3392,2883,2407,940,985,758,286,245,130,513,156,64,63,5450,7250,2700,3150,700,250,0
564,0,2,148.0,175.0,165.0,189.0,3851,3364,2911,2379,940,985,588,477,205,205,383,272,64,63,6000,7750,2700,3150,700,250,0
571,0,2,151.0,180.0,165.0,189.0,3734,3151,2771,2211,963,940,563,439,185,155,378,284,66,66,6000,7750,2700,3150,700,250,0
579,0,2,154.0,181.0,165.0,189.0,3700,3274,2715,2267,985,1007,733,789,235,385,498,404,66,67,6275,7750,2700,3400,700,250,0
586,0,2,152.0,182.0,173.0,204.0,3610,3314,2603,2351,1007,963,809,586,345,220,464,366,67,69,6600,7750,2700,3400,700,250,0
593,0,2,155.0,184.0,173.0,204.0,3386,3426,2379,2463,1007,963,656,887,330,405,326,482,66,71,6875,8000,2700,3550,750,250,0
600,0,2,157.0,184.0,173.0,204.0,3207,3538,2267,2575,940,963,284,822,100,420,184,402,65,73,7075,8000,2825,3550,1050,250,0
607,0,2,159.0,198.0,173.0,204.0,3246,3812,2351,2827,895,985,442,578,175,310,267,268,65,73,7075,9000,2825,3550,1050,250,0
614,0,2,158.0,196.0,173.0,204.0,3162,3734,2267,2771,895,963,313,924,130,615,183,309,65,73,7025,8750,2825,3550,1100,500,0
621,0,2,166.0,196.0,188.0,204.0,3095,3924,2155,2939,940,985,483,1200,180,875,303,325,65,73,7625,8750,3075,3550,1100,500,0
629,0,2,168.0,196.0,188.0,204.0,2966,3946,1959,2939,1007,1007,508,1175,185,930,323,245,68,73,8400,9000,3275,3550,1100,500,0
636,0,2,172.0,194.0,188.0,204.0,3190,4014,2183,3051,1007,963,250,1232,40,875,210,357,68,73,8450,8750,3275,3850,1100,750,0
643,0,2,176.0,200.0,188.0,204.0,3084,3846,2099,2883,985,963,332,1408,35,935,297,473,69,73,8575,9050,3275,3850,1150,750,0
650,0,2,174.0,179.0,188.0,204.0,3179,3868,2239,2883,940,985,559,1863,175,1270,384,593,70,73,8575,8225,3475,4150,1499,2075,0
657,0,2,157.0,147.0,188.0,204.0,3207,3784,2267,2799,940,985,499,2069,95,1460,404,609,70,73,7250,6225,3475,4150,2874,4575,0
664,0,2,141.0,129.0,188.0,204.0,2983,3846,2043,2883,940,963,669,1740,170,1015,499,725,70,73,5975,3475,3475,4150,4867,7325,0
671,0,2,145.0,127.0,188.0,204.0,2944,3840,1959,2855,985,985,631,946,162,605,469,341,70,73,6200,3000,3475,4650,4867,8700,0
679,0,2,144.0,131.0,188.0,204.0,3470,3689,2463,2547,1007,1142,447,1075,112,590,335,485,70,73,6250,3250,3475,4650,4867,8700,0
686,0,2,149.0,133.0,188.0,204.0,3997,3689,2967,2435,1030,1254,516,1018,90,585,426,433,72,73,6425,3450,3475,4650,4867,8700,0
693,0,2,152.0,149.0,188.0,204.0,3846,3795,2883,2519,963,1276,774,488,265,95,509,393,72,73,6700,4400,3475,4650,4867,8700,0
700,0,2,158.0,152.0,188.0,212.0,3991,3683,3051,2407,940,1276,497,564,72,115,425,449,73,73,6800,4950,3475,4650,4867,8800,0
707,0,2,158.0,156.0,188.0,212.0,3890,3638,2771,2295,1119,1343,244,784,19,175,225,609,75,73,6925,4950,3575,4650,4867,8800,0
714,0,2,163.0,158.0,188.0,227.0,4187,3633,2911,2267,1276,1366,430,1125,79,410,351,715,75,73,7025,5650,3575,4650,4867,8800,0
721,0,2,163.0,164.0,188.0,227.0,4142,3672,2799,2351,1343,1321,1147,948,565,335,582,613,77,73,7025,6150,3775,4650,4867,8800,0
729,0,2,171.0,164.0,188.0,227.0,4271,4019,2883,2743,1388,1276,403,625,115,185,288,440,77,73,7525,6150,3775,4650,4867,8800,0
736,0,2,176.0,164.0,188.0,227.0,4422,3823,3079,2547,1343,1276,471,986,85,390,386,596,77,73,7800,6150,3775,4650,4867,8800,0
743,0,2,171.0,164.0,188.0,227.0,4187,3902,2911,2603,1276,1299,624,1461,240,705,384,756,77,73,7600,6150,3775,4650,5117,8800,0
750,0,2,174.0,180.0,188.0,227.0,4081,3930,2827,2631,1254,1299,900,1122,460,210,440,912,77,73,7775,6950,4200,4650,5117,8800,0
757,0,2,177.0,180.0,188.0,227.0,4053,3297,2799,2155,1254,1142,155,1481,30,445,125,1036,77,73,8025,6950,4200,4650,5242,8800,0
764,0,2,182.0,179.0,188.0,227.0,4271,2378,2995,1483,1276,895,420,1756,285,620,135,1136,77,72,8400,6950,4250,4900,5242,8850,0
771,0,2,187.0,173.0,188.0,211.0,4137,2686,2771,1903,1366,783,580,913,310,85,270,828,77,54,8575,7610,4125,5000,5242,10150,0
779,0,2,190.0,173.0,196.0,211.0,4305,3050,2939,2379,1366,671,637,908,365,100,272,808,77,54,8575,8285,4125,5000,5242,10150,0
786,0,2,188.0,172.0,196.0,211.0,4182,3067,2883,2351,1299,716,1021,1246,605,350,416,896,77,56,8600,7975,4125,5000,5492,10650,0
793,0,2,164.0,134.0,196.0,211.0,4249,3090,2995,2351,1254,739,1518,1084,950,100,568,984,77,59,6425,5425,4325,5000,7617,13415,0
800,0,2,139.0,106.0,204.0,211.0,4137,3118,2883,2379,1254,739,1353,1143,750,75,603,1068,77,59,4350,3410,4525,5000,9967,15945,0
807,0,2,134.0,88.0,204.0,211.0,4159,3207,2883,2491,1276,716,1568,1503,880,355,688,1148,77,59,3825,2365,4525,5000,10542,17305,0
814,0,2,140.0,88.0,204.0,211.0,4176,3101,2855,2407,1321,694,548,1502,25,470,523,1032,77,59,4600,2380,4525,5150,10542,17305,0
821,0,2,143.0,77.0,204.0,211.0,4131,3106,2743,2435,1388,671,784,1851,180,735,604,1116,77,48,4650,2395,4325,5150,10542,17855,0
829,0,2,149.0,90.0,204.0,211.0,3941,2591,2575,1875,1366,716,476,834,45,205,431,629,77,48,4975,2410,4325,5150,10542,17855,0
836,0,2,157.0,93.0,204.0,211.0,3795,2563,2519,1847,1276,716,685,532,185,115,500,417,77,48,5550,3070,4325,5150,10542,17855,0
843,0,2,153.0,98.0,204.0,211.0,3885,2642,2631,1903,1254,739,266,581,135,80,131,501,77,48,5550,3100,4325,5150,10542,17855,0
850,0,2,156.0,101.0,204.0,211.0,3913,2703,2659,1987,1254,716,261,875,145,290,116,585,77,48,5775,3230,4325,5150,10542,17855,0
857,0,2,160.0,106.0,204.0,211.0,3907,2289,2631,1595,1276,694,496,495,245,80,251,415,77,52,6400,3260,4325,5250,10542,18155,0
864,0,2,162.0,109.0,204.0,211.0,3918,2423,2575,1707,1343,716,756,503,420,150,336,353,77,52,7000,3575,4625,5250,10542,18155,0
871,0,2,169.0,106.0,204.0,196.0,3913,2490,2547,1819,1366,671,428,793,215,360,213,433,77,52,7050,3290,4625,5100,10542,19005,0
879,0,2,172.0,106.0,204.0,188.0,3952,2524,2631,1875,1321,649,566,498,330,235,236,263,77,52,7225,3590,4625,5000,10542,19205,0
886,0,2,174.0,116.0,204.0,188.0,3745,2681,2491,1875,1254,806,644,618,385,255,259,363,77,52,7500,4250,4625,5000,10542,19205,0
893,0,2,179.0,116.0,219.0,188.0,3577,2720,2323,1847,1254,873,319,903,175,440,144,463,77,52,7775,4925,4725,5000,10567,19205,0
900,0,2,180.0,115.0,219.0,180.0,3409,2182,2211,1511,1198,671,489,1119,220,580,269,539,77,55,8225,5255,4525,5000,10567,19355,0
907,0,2,186.0,121.0,219.0,180.0,3269,2457,2127,1875,1142,582,94,308,35,205,59,103,77,55,8225,5285,4675,5000,10842,19355,0
914,0,2,180.0,112.0,219.0,180.0,3370,2787,2183,2183,1187,604,505,584,310,405,195,179,77,55,8250,5150,4775,5000,11417,20065,0
921,0,2,176.0,111.0,219.0,180.0,3566,2765,2379,2239,1187,526,402,411,175,170,227,241,77,55,7850,4155,4775,5000,12367,21575,0
7,1,0,13.0,13.0,14.0,15.0,419,293,419,293,0,0,50,35,50,35,0,0,12,12,0,0,0,0,0,0,0
14,1,0,13.0,14.0,14.0,15.0,699,671,699,671,0,0,25,70,25,70,0,0,13,13,0,0,0,0,0,0,0
21,1,0,14.0,14.0,14.0,15.0,755,727,755,727,0,0,60,50,60,50,0,0,13,13,0,0,0,0,0,0,0
29,1,0,14.0,15.0,14.0,15.0,755,671,755,671,0,0,155,80,155,80,0,0,13,14,0,0,0,0,0,0,0
36,1,0,16.0,15.0,22.0,15.0,811,783,811,783,0,0,155,135,155,135,0,0,14,14,0,0,0,0,0,0,0
43,1,0,16.0,16.0,22.0,23.0,811,783,811,783,0,0,240,65,240,65,0,0,14,15,0,0,0,0,0,0,0
50,1,0,15.0,16.0,22.0,23.0,839,783,839,783,0,0,40,35,40,35,0,0,15,15,0,0,0,0,0,0,0
57,1,0,17.0,17.0,22.0,23.0,867,699,867,699,0,0,50,125,50,125,0,0,15,16,0,0,0,0,0,0,0
64,1,0,18.0,18.0,22.0,23.0,895,811,895,811,0,0,95,175,95,175,0,0,16,17,0,0,0,0,0,0,0
71,1,0,17.0,18.0,22.0,23.0,923,833,923,811,0,22,180,219,180,215,0,4,17,17,0,0,0,0,0,0,0
79,1,0,17.0,19.0,22.0,23.0,923,889,923,755,0,134,40,329,40,305,0,24,16,18,0,0,0,0,0,0,0
86,1,0,18.0,19.0,22.0,23.0,923,995,923,839,0,156,105,454,105,410,0,44,16,18,0,0,0,0,0,0,0
93,1,0,19.0,20.0,22.0,23.0,945,995,923,839,22,156,164,314,160,300,4,14,18,19,0,0,0,150,0,0,0
100,1,0,20.0,20.0,22.0,23.0,906,1023,839,867,67,156,232,439,220,405,12,34,18,19,0,0,0,150,0,0,0
107,1,0,20.0,20.0,22.0,23.0,1034,962,923,783,111,179,368,149,340,95,28,54,19,19,0,0,0,150,0,0,0
114,1,0,21.0,20.0,22.0,23.0,1023,962,867,783,156,179,443,164,395,90,48,74,20,19,0,0,0,150,0,0,0
121,1,0,27.0,22.0,28.0,23.0,1079,911,923,755,156,156,178,170,110,80,68,90,20,19,0,100,250,150,0,0,0
129,1,0,27.0,23.0,28.0,23.0,1130,1051,951,895,179,156,318,250,230,140,88,110,21,20,0,100,250,150,0,0,0
136,1,0,28.0,23.0,28.0,31.0,1163,1107,1007,951,156,156,299,105,195,75,104,30,21,20,0,100,250,150,0,0,0
143,1,0,27.0,24.0,28.0,31.0,1074,1135,1007,979,67,156,123,140,15,140,108,0,20,21,100,150,250,150,0,0,0
150,1,0,28.0,24.0,28.0,31.0,1107,1303,1063,1147,44,156,206,215,90,195,116,20,21,21,100,150,250,150,0,0,0
157,1,0,31.0,25.0,36.0,31.0,1298,1382,1231,1203,67,179,219,370,95,330,124,40,22,22,400,150,250,150,0,0,0
164,1,0,31.0,25.0,36.0,31.0,1275,1359,1231,1203,44,156,163,166,135,110,28,56,24,23,400,150,250,150,0,0,0
171,1,0,33.0,26.0,36.0,31.0,1331,1387,1287,1231,44,156,66,266,30,190,36,76,25,23,400,150,250,150,0,0,0
179,1,0,36.0,26.0,36.0,46.0,1354,1443,1287,1287,67,156,74,231,30,135,44,96,25,23,400,150,250,500,0,0,0
186,1,0,36.0,31.0,36.0,46.0,1443,1331,1399,1175,44,156,153,171,105,55,48,116,25,24,400,150,250,500,0,0,0
193,1,0,40.0,32.0,44.0,46.0,1471,1527,1427,1371,44,156,131,231,75,120,56,111,28,25,400,150,250,500,0,0,0
200,1,0,43.0,33.0,44.0,46.0,1606,1466,1539,1287,67,179,119,166,55,35,64,131,28,25,400,150,250,500,0,0,0
207,1,0,46.0,36.0,52.0,46.0,1583,1522,1539,1343,44,179,113,251,45,100,68,151,32,26,550,350,250,500,0,0,0
214,1,0,48.0,39.0,58.0,46.0,1583,1611,1539,1455,44,156,101,102,25,35,76,67,34,27,550,350,250,575,0,0,0
221,1,0,50.0,41.0,58.0,46.0,1802,1835,1735,1679,67,156,179,182,95,95,84,87,34,28,550,350,250,575,0,0,0
229,1,0,56.0,42.0,66.0,46.0,1919,1947,1875,1791,44,156,108,372,20,265,88,107,36,29,550,450,250,575,0,0,0
236,1,0,57.0,43.0,66.0,61.0,2031,2003,1987,1847,44,156,211,302,115,275,96,27,38,30,700,600,250,575,0,0,0
243,1,0,61.0,45.0,66.0,61.0,2132,2031,2043,1875,89,156,268,272,160,225,108,47,42,31,850,600,250,725,0,0,0
250,1,0,62.5,46.0,66.0,61.0,2283,2026,2127,1735,156,291,438,312,310,275,128,37,43,32,825,600,250,725,25,0,0
257,1,0,66.5,50.0,66.0,61.0,2334,2098,2155,1763,179,335,413,193,265,120,148,73,45,33,1125,650,250,725,125,0,0
264,1,0,66.5,52.0,66.0,61.0,2446,2300,2267,1987,179,313,703,354,535,245,168,109,50,35,1125,650,250,725,125,0,0
271,1,0,65.5,54.0,66.0,61.0,2563,2160,2407,1847,156,313,734,249,650,100,84,149,49,36,1125,650,250,975,125,100,0
279,1,0,72.5,57.0,74.0,61.0,2647,2238,2491,1903,156,335,414,389,360,200,54,189,49,38,1125,700,250,975,125,100,0
286,1,0,73.5,62.0,74.0,69.0,2759,2574,2603,2239,156,335,304,134,230,105,74,29,47,39,1125,700,250,1075,125,100,0
293,1,0,72.5,65.0,82.0,69.0,2591,2350,2435,2015,156,335,419,340,325,275,94,65,52,41,1075,850,250,1075,175,100,0
300,1,0,76.5,67.0,90.0,69.0,2804,2653,2603,2183,201,470,473,349,355,220,118,129,53,43,1075,850,250,1075,175,100,0
307,1,0,80.5,69.0,106.0,77.0,2944,2787,2631,2183,313,604,268,486,110,310,158,176,56,44,1075,900,250,1075,175,100,0
314,1,0,85.5,71.0,114.0,77.0,2989,2922,2631,2295,358,627,302,186,100,30,202,156,55,44,1225,950,250,1075,175,100,0
321,1,0,87.5,74.0,122.0,77.0,3151,3062,2659,2435,492,627,557,301,295,115,262,186,57,46,1525,1400,250,1075,175,100,0
329,1,0,91.5,75.0,122.0,77.0,3095,3224,2603,2575,492,649,278,566,160,300,118,266,64,47,1525,1400,700,1400,175,100,0
336,1,0,92.5,83.0,122.0,93.0,3291,2989,2799,2295,492,694,378,396,325,175,53,221,64,48,1525,1550,700,1400,175,100,0
343,1,0,94.5,84.0,122.0,93.0,3314,2793,2799,2099,515,694,467,172,350,75,117,97,63,49,1675,1550,700,1400,175,100,0
350,1,0,96.5,86.0,114.0,93.0,3347,2748,2631,2099,716,649,644,439,435,270,209,169,63,51,2125,1600,700,1400,325,100,0
357,1,0,103.5,90.0,114.0,93.0,3577,3006,2771,2379,806,627,645,550,340,305,305,245,63,53,2125,1700,700,1400,325,100,0
364,1,0,104.5,96.0,122.0,109.0,3571,3034,2743,2407,828,627,1016,215,615,90,401,125,66,54,2275,1700,700,1400,325,100,0
371,1,0,108.5,100.0,122.0,109.0,3521,3286,2715,2659,806,627,842,325,520,245,322,80,71,56,2225,2075,950,1400,375,100,0
379,1,0,112.5,101.0,128.0,109.0,3661,3308,2855,2659,806,649,773,220,505,60,268,160,71,57,2275,2075,950,1400,375,100,0
386,1,0,112.5,105.0,128.0,109.0,3829,3078,3023,2407,806,671,783,346,640,110,143,236,71,57,2675,2125,950,1400,375,100,0
393,1,0,121.5,107.0,128.0,117.0,4019,3358,3191,2687,828,671,369,607,130,295,239,312,71,60,2825,2525,950,1500,375,100,0
400,1,0,120.5,109.0,128.0,117.0,3829,3538,3023,2911,806,627,715,408,380,124,335,284,70,60,3475,2850,950,1500,475,100,0
407,1,0,126.5,117.0,128.0,117.0,3913,3286,3107,2659,806,627,891,310,460,71,431,239,70,63,3475,2950,950,1500,475,100,0
414,1,0,126.5,118.0,136.0,125.0,3823,3370,2995,2743,828,627,1006,417,475,98,531,319,69,64,3825,2950,950,1500,475,100,0
421,1,0,130.0,121.0,144.0,133.0,3795,3364,2967,2715,828,649,872,720,445,321,427,399,69,66,3950,3100,950,1500,500,100,0
429,1,0,130.0,123.0,144.0,133.0,3885,3498,3079,2827,806,671,988,837,565,408,423,429,70,66,4150,3100,950,1950,600,100,0
436,1,0,130.0,111.0,144.0,133.0,3885,3045,3079,2351,806,694,1054,1088,535,583,519,505,70,59,4000,2850,950,1950,1050,757,0
443,1,0,127.5,113.0,136.0,141.0,3851,2384,3023,1735,828,649,1324,1165,705,588,619,577,70,59,3775,3175,950,2200,1425,907,0
450,1,0,117.5,114.0,136.0,141.0,3969,2278,3163,1651,806,627,1790,1023,1075,370,715,653,70,59,3175,3225,950,2200,2275,1007,0
457,1,0,119.0,113.0,136.0,141.0,3879,2502,3051,1875,828,627,1371,928,735,195,636,733,70,60,2500,3050,950,2200,3150,1282,0
464,1,0,124.0,118.0,136.0,141.0,4081,2838,3275,2211,806,627,1397,1098,765,335,632,763,70,60,2650,3200,950,2300,3150,1282,0
471,1,0,129.0,123.0,142.0,141.0,3969,2944,3163,2295,806,649,1558,843,830,175,728,668,70,61,3550,3300,950,2300,3150,1282,0
479,1,0,133.0,127.0,142.0,141.0,3969,3241,3163,2547,806,694,1483,1133,755,385,728,748,70,63,3900,3400,950,2300,3250,1282,0
486,1,0,138.0,133.0,148.0,141.0,4025,3241,3219,2547,806,694,1714,994,890,295,824,699,70,65,3900,3500,950,2300,3250,1282,0
493,1,0,138.0,134.0,148.0,133.0,3907,3392,3079,2743,828,649,2149,1341,1225,570,924,771,70,66,4450,3650,950,2300,3250,1432,0
500,1,0,148.0,133.0,148.0,133.0,3935,3370,3107,2743,828,627,1320,752,575,105,745,647,70,67,4150,3700,950,2400,3550,1532,0
507,1,0,148.0,133.0,148.0,133.0,3851,3342,3023,2715,828,627,631,907,165,280,466,627,70,67,4550,3800,950,2400,3550,1532,0
514,1,0,142.5,133.0,148.0,133.0,3913,3280,3107,2631,806,649,1087,1307,525,600,562,707,70,67,5475,3925,950,2400,3950,1732,0
521,1,0,138.0,129.0,148.0,148.0,3857,3470,3051,2799,806,671,1188,1727,530,940,658,787,70,67,4250,3075,950,2400,5325,2582,0
529,1,0,137.0,130.0,180.0,148.0,3577,3493,2771,2799,806,694,934,1958,480,1020,454,938,68,68,4250,3075,950,2400,5325,2582,0
536,1,0,147.0,141.0,180.0,148.0,3375,3358,2547,2687,828,671,559,1699,55,885,504,814,66,68,4600,3325,950,2400,5375,2582,0
543,1,0,145.0,143.0,180.0,148.0,3381,3370,2575,2743,806,627,760,1711,260,825,500,886,71,68,4550,3425,950,2400,5525,2682,0
550,1,0,150.5,145.0,180.0,148.0,3577,3202,2771,2575,806,627,851,1396,255,480,596,916,71,71,4475,3575,950,2950,5600,2732,0
557,1,0,148.5,141.0,180.0,148.0,3790,3398,2939,2771,851,627,1320,1751,620,755,700,996,78,71,4925,3375,1075,2950,5825,2982,0
564,1,0,160.5,145.0,180.0,148.0,3941,3336,3023,2687,918,649,798,1561,140,685,658,876,78,74,4675,3775,1075,2950,6075,3407,0
571,1,0,160.5,145.0,180.0,148.0,4042,3666,3079,2883,963,783,1218,1017,440,445,778,572,78,74,4675,3825,1075,2950,6075,3407,0
579,1,0,169.5,147.0,180.0,148.0,3958,3661,2995,2855,963,806,945,535,155,225,790,310,76,75,5675,3825,1075,2950,6075,3407,0
586,1,0,170.5,148.0,180.0,148.0,3924,3532,2939,2771,985,761,825,598,190,325,635,273,84,75,5675,4075,1075,3050,6075,3407,0
593,1,0,174.5,148.0,180.0,148.0,4092,3241,3107,2435,985,806,1111,393,360,120,751,273,85,75,5875,4075,1075,3200,6075,3407,0
600,1,0,173.5,152.0,180.0,156.0,4170,3487,3163,2547,1007,940,1511,723,640,355,871,368,86,76,6275,4350,1525,3200,6225,3407,0
607,1,0,177.5,150.0,180.0,172.0,4439,3795,3275,2855,1164,940,534,1178,215,690,319,488,86,76,5725,4450,1525,3350,6975,3507,0
614,1,0,180.0,158.0,180.0,172.0,4714,4086,3415,3079,1299,1007,696,438,425,80,271,358,86,78,5600,3950,1525,3900,7025,4007,0
621,1,0,180.0,158.0,196.0,211.0,4686,3890,3387,2883,1299,1007,1052,655,725,235,327,420,86,78,5600,3950,1525,4150,7025,4007,0
629,1,0,182.0,161.0,196.0,211.0,4719,4120,3443,3135,1276,985,1264,407,885,150,379,257,85,78,5600,4150,1525,4150,7025,4007,0
636,1,0,177.0,162.0,196.0,211.0,4585,4131,3331,3191,1254,940,1756,644,1225,400,531,244,81,78,7250,4850,1525,4225,7200,4157,0
643,1,0,188.5,172.0,188.0,211.0,4484,4523,3275,3583,1209,940,790,299,715,210,75,89,84,81,7025,4800,1525,4300,7425,4207,0
650,1,0,185.5,162.0,188.0,211.0,4333,4484,3079,3499,1254,985,1002,792,825,575,177,217,84,81,6575,4275,1525,4300,7875,5007,0
657,1,0,186.5,165.0,188.0,211.0,4271,4327,2883,3275,1388,1052,956,630,615,410,341,220,84,82,6675,4325,1525,4300,7875,5207,0
664,1,0,185.5,166.0,212.0,211.0,4277,3734,2687,2659,1590,1075,922,419,660,225,262,194,88,82,7875,4625,1775,4300,7875,5207,0
671,1,0,187.5,173.0,212.0,211.0,4467,3986,2855,2911,1612,1075,1009,104,705,40,304,64,88,82,7975,4425,1775,4400,7875,5407,0
679,1,0,187.0,179.0,228.0,211.0,4462,4114,2827,3107,1635,1007,1464,270,960,140,504,130,88,83,8400,4825,1775,4800,7975,5407,0
686,1,0,199.0,179.0,228.0,211.0,4467,4226,2855,3219,1612,1007,1166,699,520,445,646,254,89,86,8400,5600,1775,4900,7975,5407,0
693,1,0,195.0,189.0,236.0,211.0,4568,4338,2911,3331,1657,1007,1683,622,845,340,838,282,89,86,8200,5850,1775,5100,8175,5407,0
700,1,0,194.5,187.0,236.0,187.0,4742,4142,3107,3247,1635,895,1414,716,605,530,809,186,89,86,8025,6250,1775,5000,8350,6035,0
707,1,0,199.5,187.0,236.0,187.0,4831,4131,3219,3415,1612,716,1752,549,755,475,997,74,89,86,8025,6350,1900,5100,8350,6035,0
714,1,0,199.0,187.0,236.0,187.0,4994,4658,3359,3919,1635,739,2332,398,1135,290,1197,108,89,86,8450,6850,1900,5100,8450,6035,0
721,1,0,199.5,183.0,236.0,179.0,4971,4260,3359,3499,1612,761,2859,897,1470,705,1389,192,89,85,9025,6475,1900,5000,8450,6660,0
729,1,0,199.5,181.0,236.0,179.0,4938,3627,3303,2911,1635,716,2905,1072,1595,850,1310,222,89,85,9025,6375,1900,5000,8450,6760,0
736,1,0,193.0,175.0,242.0,164.0,5016,3241,3359,2547,1657,694,3454,591,1979,535,1475,56,90,84,8425,6325,1900,5000,8987,7685,0
743,1,0,185.0,172.0,242.0,172.0,5100,3073,3443,2379,1657,694,4041,779,2374,660,1667,119,90,84,8175,5675,2250,5300,9662,8335,0
750,1,0,197.0,172.0,242.0,172.0,4859,3129,3247,2435,1612,694,2053,268,1094,65,959,203,89,84,8075,5875,2250,5300,9937,8335,0
757,1,0,196.0,180.0,242.0,180.0,4551,3067,3051,2351,1500,716,2275,421,1144,130,1131,291,88,83,8075,5425,2250,5300,9937,8985,0
764,1,0,195.0,184.0,242.0,188.0,4282,3168,2827,2407,1455,761,2782,355,1479,180,1303,175,87,83,8875,5800,2250,5300,9937,8985,0
771,1,0,197.0,184.0,242.0,180.0,4361,3146,2883,2407,1478,739,2782,669,1299,410,1483,259,86,85,8575,5800,2250,5300,10237,9085,0
779,1,0,197.0,186.0,242.0,188.0,4221,3213,2743,2519,1478,694,2647,1444,1309,1105,1338,339,86,85,8575,6025,2250,5300,10237,9085,0
786,1,0,197.0,192.0,242.0,196.0,4574,3325,2939,2631,1635,694,3218,1222,1684,1020,1534,202,95,85,8575,5900,2250,5300,10237,9210,0
793,1,0,196.0,189.0,242.0,211.0,4814,3750,3135,3079,1679,671,3798,1141,2064,1105,1734,36,95,84,9075,6000,2375,5200,10362,9760,0
800,1,0,193.5,190.0,242.0,211.0,4882,3907,3247,3191,1635,716,3427,1554,1984,1430,1443,124,95,84,8950,7125,2775,5200,10487,9760,0
807,1,0,195.5,197.0,242.0,211.0,4831,3700,3219,2939,1612,761,3413,1337,2074,1125,1339,212,95,82,8550,7250,2775,5000,10887,10060,0
814,1,0,199.5,197.0,242.0,211.0,4887,2810,3275,2071,1612,739,3310,1242,1979,950,1331,292,95,83,8550,7250,2775,5000,10887,10060,0
821,1,0,199.5,197.0,242.0,211.0,4887,2759,3275,2043,1612,716,3896,272,2369,150,1527,122,95,83,8550,7850,2775,5000,10887,10060,0
829,1,0,198.5,198.0,242.0,211.0,4999,3442,3387,2771,1612,671,4507,657,2784,455,1723,202,94,83,9150,8750,2775,5200,10887,10060,0
836,1,0,199.5,198.0,248.0,226.0,5044,3554,3387,2883,1657,671,5053,930,3134,640,1919,290,94,83,9550,8750,2775,5600,10887,10060,0
843,1,0,199.5,200.0,248.0,226.0,5100,3683,3443,2967,1657,716,5669,1103,3554,850,2115,253,95,84,9550,8750,2775,5600,10887,10060,0
850,1,0,199.5,200.0,248.0,226.0,5167,3655,3555,2939,1612,716,5933,1227,3809,890,2124,337,95,84,9550,8750,2775,5600,10887,10060,0
857,1,0,189.5,198.0,248.0,226.0,5190,3991,3555,3275,1635,716,6538,1736,4214,1315,2324,421,95,84,8800,8650,2775,5500,11637,10260,0
864,1,0,197.5,198.0,248.0,211.0,5139,3627,3527,2911,1612,716,5166,970,3454,965,1712,5,95,79,7800,8550,2775,5700,12262,11360,0
871,1,0,197.5,200.0,248.0,211.0,5094,3554,3527,2883,1567,671,5098,815,3519,730,1579,85,95,79,7800,8825,2775,5700,12262,11360,0
879,1,0,199.5,200.0,248.0,211.0,5212,3554,3555,2771,1657,783,4963,1255,3484,1070,1479,185,94,79,7800,8875,2775,5700,12262,11360,0
886,1,0,197.5,200.0,248.0,211.0,5178,3577,3499,2771,1679,806,5574,1681,3899,1400,1675,281,93,79,8300,8875,2775,5700,12537,11360,0
893,1,0,200.5,200.0,248.0,241.0,5324,3515,3667,2687,1657,828,6126,1196,4263,815,1863,381,97,79,8600,9700,2775,5800,12918,11360,0
900,1,0,191.0,199.0,242.0,241.0,5195,3448,3583,2631,1612,817,6724,2385,4673,1910,2051,475,97,78,7525,9975,2775,5800,14343,11410,0
907,1,0,175.5,200.0,242.0,226.0,5251,2457,3639,1819,1612,638,7336,2349,5093,1935,2243,414,96,78,8250,9925,2775,5700,15293,12660,0
914,1,0,187.0,185.0,242.0,226.0,5150,2160,3583,1623,1567,537,7308,2319,4873,1995,2435,324,96,63,8225,9925,2775,5800,15343,13410,0
921,1,0,199.5,195.0,242.0,226.0,5262,2059,3695,1567,1567,492,7099,1704,4568,1645,2531,59,96,63,8200,9925,2775,5800,15368,13410,0
929,1,0,199.5,196.0,242.0,226.0,5296,2311,3639,1819,1657,492,7129,1688,4398,1540,2731,148,96,63,8850,9925,2775,5800,15368,13410,0
936,1,0,197.5,196.0,242.0,226.0,5374,2479,3695,1987,1679,492,7750,1843,4823,1635,2927,208,94,63,9700,10200,2775,5800,15368,13485,0
943,1,0,199.5,199.0,242.0,226.0,5184,2955,3527,2463,1657,492,7913,2148,4973,1880,2940,268,94,66,9700,10400,2775,5800,15368,13485,0
950,1,0,197.5,199.0,242.0,226.0,5190,3056,3555,2519,1635,537,8520,2138,5388,1960,3132,178,94,66,9550,10950,2775,5800,15518,13485,0
957,1,0,197.5,200.0,242.0,226.0,5027,3168,3415,2631,1612,537,8322,2613,5398,2375,2924,238,96,69,9900,10950,2775,5800,15518,13485,0
964,1,0,197.5,179.0,242.0,226.0,4977,2854,3387,2183,1590,671,7528,2337,4808,2265,2720,72,96,69,7600,9300,2775,5500,16243,15335,0
971,1,0,193.0,183.0,242.0,226.0,4971,2658,3359,1875,1612,783,8089,2322,5173,2275,2916,47,96,70,8125,9300,2775,5225,16868,15610,0
979,1,0,198.0,178.0,234.0,226.0,4982,2429,3303,1623,1679,806,8294,2297,5178,2200,3116,97,96,71,7775,8800,2775,5125,17218,16210,0
986,1,0,198.0,178.0,234.0,211.0,5078,2345,3443,1539,1635,806,8912,1898,5608,1830,3304,68,97,71,8175,8900,2775,5125,17218,16760,0
993,1,0,200.0,177.0,234.0,211.0,5134,2468,3499,1595,1635,873,8769,1753,5573,1585,3196,168,97,71,8475,9200,2775,5125,17243,17060,0
1000,1,0,198.5,179.0,234.0,211.0,4876,2698,3275,1847,1601,851,8585,1709,5428,1470,3157,239,97,71,8300,9375,2775,5125,17268,17160,0
1007,1,0,199.5,175.0,240.0,211.0,4708,2748,3219,1875,1489,873,8945,1944,5608,1605,3337,339,97,72,9600,8900,2775,5125,17393,17635,0
1014,1,0,199.5,183.0,240.0,211.0,4742,2311,3331,1371,1411,940,9102,1700,5593,1320,3509,380,96,73,9200,9200,2775,5125,18043,17635,0
1021,1,0,198.5,183.0,240.0,211.0,5033,2451,3555,1511,1478,940,8587,1555,5448,1205,3139,350,95,72,9200,9200,2775,4975,18043,17935,0
1029,1,0,198.5,182.0,240.0,211.0,5302,2250,3779,1287,1523,963,8842,1089,5523,740,3319,349,95,70,8700,9375,2775,4975,18493,18335,0
1036,1,0,194.0,179.0,234.0,211.0,5005,1723,3527,783,1478,940,9421,431,5938,20,3483,411,95,58,9175,9625,2775,4875,19193,19035,0
1043,1,0,200.0,177.0,234.0,196.0,4473,1533,2995,615,1478,918,8777,534,5393,34,3384,500,95,56,9175,9725,2775,4875,19193,19863,0
1050,1,0,199.5,176.0,234.0,188.0,4646,1320,3191,559,1455,761,9094,1083,5588,499,3506,584,94,55,9400,9950,2775,4775,19318,20363,0
1057,1,0,199.5,179.0,234.0,188.0,4260,1639,2827,923,1433,716,9045,988,5638,374,3407,614,94,55,10350,10400,2775,4775,19318,20363,0
1064,1,0,199.5,180.0,234.0,218.0,4316,1897,2883,1203,1433,694,9586,1206,6003,504,3583,702,94,54,10350,10675,2775,4775,19318,20413,0
1071,1,0,199.5,185.0,234.0,218.0,4719,1757,3219,1063,1500,694,9746,1060,6183,274,3563,786,94,54,11050,10800,2775,4775,19318,20413,0
1079,1,0,173.0,148.0,234.0,218.0,4249,1914,2771,1343,1478,571,10238,1261,6503,409,3735,852,94,57,8325,8125,2775,4775,20768,22163,0
1086,1,0,189.5,136.0,240.0,218.0,4333,2070,2743,1511,1590,559,8915,824,4988,29,3927,795,94,57,6450,6925,2775,4775,23043,23488,0
1093,1,0,199.5,139.0,240.0,203.0,4624,1902,2967,1343,1657,559,8979,878,4848,44,4131,834,94,58,6450,7050,2775,4775,23043,23988,0
1100,1,0,199.5,141.0,240.0,218.0,4417,1298,2603,895,1814,403,9496,948,5153,74,4343,874,94,57,8300,7175,2775,4550,23043,24263,0
1107,1,0,200.0,143.0,240.0,218.0,4540,1124,2771,811,1769,313,8758,944,4603,134,4155,810,93,59,8775,7350,2775,4550,23068,24263,0
1114,1,0,200.0,146.0,240.0,218.0,4333,1796,2519,1483,1814,313,8233,894,4383,169,3850,725,93,59,8775,7575,2775,4550,23068,24263,0
1121,1,0,198.0,150.0,246.0,218.0,4411,2244,2575,1931,1836,313,7605,849,4093,134,3512,715,93,59,9575,7700,2775,4550,23093,24263,0
1129,1,0,200.0,148.0,246.0,218.0,4579,2614,2799,2379,1780,235,8037,1290,4323,524,3714,766,93,59,10625,7700,2900,4650,23093,24263,0
1136,1,0,200.0,150.0,246.0,218.0,4613,2563,2967,2463,1646,100,8303,1016,4543,244,3760,772,94,59,11725,7700,2900,4650,23093,24263,0
1143,1,0,178.0,135.0,246.0,218.0,4910,2322,3331,2211,1579,111,8899,1286,4953,494,3946,792,94,49,9175,7900,2900,4550,24968,25238,0
1150,1,0,158.0,105.0,238.0,203.0,4949,1807,3303,1651,1646,156,9466,1467,5308,659,4158,808,95,42,6625,6450,2900,4550,26843,27688,0
1157,1,0,200.0,116.0,238.0,203.0,5038,1555,3247,1399,1791,156,7438,777,3268,74,4170,703,95,44,5975,6450,2900,4550,27493,27763,0
1164,1,0,199.5,118.0,238.0,203.0,5106,1634,3247,1455,1859,179,7534,881,3398,179,4136,702,95,45,5950,6450,2900,4550,27518,27838,0
1171,1,0,199.5,126.0,238.0,203.0,4887,1762,3107,1539,1780,223,8101,804,3763,149,4338,655,95,47,8100,6500,2900,4550,27518,27838,0
1179,1,0,199.5,134.0,238.0,203.0,4786,2149,3219,1903,1567,246,7084,427,3368,19,3716,408,95,47,8600,6925,2900,4650,27643,27913,0
1186,1,0,199.5,136.0,238.0,203.0,4730,2345,3275,2099,1455,246,7355,715,3463,279,3892,436,95,49,8600,7025,2900,4650,27643,27913,0
1193,1,0,198.5,146.0,238.0,203.0,4618,2608,3163,2407,1455,201,7891,415,3823,109,4068,306,94,52,10200,7325,2900,4650,27643,27913,0
1200,1,0,199.5,152.0,238.0,203.0,4618,2692,3163,2491,1455,201,8388,378,4148,69,4240,309,94,52,10700,7575,2900,4650,27643,27913,0
1207,1,0,199.5,158.0,244.0,203.0,4478,2742,3023,2519,1455,223,8928,436,4508,124,4420,312,95,55,10700,7575,3150,4650,27643,27913,0
1214,1,0,199.5,160.0,244.0,203.0,4467,2826,2967,2603,1500,223,9450,799,4858,459,4592,340,95,55,10700,8375,3150,4650,27643,27913,0
1221,1,0,199.5,165.0,244.0,203.0,4484,2994,3051,2771,1433,223,10003,897,5243,554,4760,343,95,56,10700,8550,3150,4650,27643,27913,0
1229,1,0,180.0,153.0,236.0,203.0,4618,3129,3163,2883,1455,246,10559,1000,5623,754,4936,246,95,56,8875,8025,3150,4650,29093,28588,0
1236,1,0,194.5,110.0,236.0,188.0,4792,2910,3359,2687,1433,223,8931,54,3823,9,5108,45,95,36,5500,5900,3150,4650,30668,32663,0
1243,1,0,199.5,97.0,236.0,188.0,4988,2238,3555,2015,1433,223,8996,523,3708,354,5288,169,95,36,4900,4675,3150,4650,30818,34013,0
1250,1,0,199.5,105.0,236.0,188.0,5206,2182,3751,1959,1455,223,8677,211,3688,114,4989,97,95,36,5850,4675,3150,4650,30818,34013,0
1257,1,0,199.5,115.0,236.0,188.0,5162,2014,3639,1791,1523,223,8547,174,3578,99,4969,75,95,36,7100,5275,3150,4650,30818,34013,0
1264,1,0,199.5,121.0,242.0,188.0,4826,2042,3303,1819,1523,223,8279,142,3563,64,4716,78,95,36,7650,5600,3150,4650,30818,34013,0
1271,1,0,191.5,122.0,242.0,188.0,4966,2076,3555,1875,1411,201,8850,211,3978,134,4872,77,92,36,7800,6150,3150,4650,31218,34013,0
1279,1,0,194.0,109.0,242.0,188.0,4826,2070,3527,1847,1299,223,7426,449,2398,344,5028,105,92,36,6375,5425,3150,4650,33493,35238,0
7,,,13.0,13.0,15.0,15.0,209,293,209,293,0,0,25,35,25,35,0,0,12,12,0,0,0,0,0,0,0
14,,,14.0,14.0,15.0,15.0,671,671,671,671,0,0,70,70,70,70,0,0,13,13,0,0,0,0,0,0,0
21,,,14.0,14.0,15.0,15.0,699,699,699,699,0,0,45,50,45,50,0,0,13,13,0,0,0,0,0,0,0
29,,,15.0,15.0,15.0,15.0,755,671,755,671,0,0,85,90,85,90,0,0,14,14,0,0,0,0,0,0,0
36,,,15.0,15.0,15.0,15.0,867,727,867,727,0,0,150,130,150,130,0,0,15,15,0,0,0,0,0,0,0
43,,,16.0,16.0,23.0,23.0,867,727,867,727,0,0,90,70,90,70,0,0,15,15,0,0,0,0,0,0,0
50,,,17.0,17.0,23.0,23.0,895,783,895,783,0,0,20,35,20,35,0,0,16,16,0,0,0,0,0,0,0
57,,,18.0,18.0,23.0,23.0,951,783,951,783,0,0,60,90,60,90,0,0,17,17,0,0,0,0,0,0,0
64,,,18.0,18.0,23.0,23.0,951,951,951,951,0,0,165,75,165,75,0,0,17,17,0,0,0,0,0,0,0
71,,,19.0,19.0,23.0,23.0,973,895,951,895,22,0,79,30,75,30,4,0,18,18,0,0,0,0,0,0,0
79,,,20.0,20.0,23.0,23.0,1034,945,923,923,111,22,150,94,130,90,20,4,19,19,0,0,0,0,0,0,0
86,,,21.0,21.0,23.0,23.0,1085,1068,839,979,246,89,72,176,20,160,52,16,20,20,0,0,150,0,0,0,0
93,,,21.0,22.0,23.0,23.0,1079,1085,811,951,268,134,143,97,55,65,88,32,20,21,0,0,150,150,0,0,0
100,,,22.0,22.0,23.0,23.0,1118,1102,783,923,335,179,183,231,55,175,128,56,21,21,0,0,150,150,0,0,0
107,,,23.0,23.0,23.0,23.0,1202,1152,867,951,335,201,274,220,110,140,164,80,22,22,0,0,150,150,0,0,0
114,,,23.0,23.0,23.0,23.0,1230,1141,895,895,335,246,404,361,200,245,204,116,22,22,0,0,300,150,0,0,0
121,,,23.0,24.0,31.0,31.0,1180,1242,867,951,313,291,255,462,165,310,90,152,23,23,0,0,450,300,0,0,0
129,,,27.0,28.0,31.0,31.0,1214,1286,923,951,291,335,51,167,25,125,26,42,23,23,0,0,450,450,0,0,0
136,,,27.0,28.0,31.0,31.0,1264,1230,951,895,313,335,201,307,135,225,66,82,23,24,0,0,450,450,0,0,0
143,,,27.0,28.0,31.0,31.0,1236,1258,923,923,313,335,351,258,245,140,106,118,23,24,0,0,450,450,0,0,0
150,,,27.0,29.0,31.0,31.0,1264,1202,951,867,313,335,506,348,360,190,146,158,23,24,0,0,450,450,0,0,0
157,,,27.0,29.0,31.0,31.0,1281,1292,923,979,358,313,661,574,475,380,186,194,23,24,250,350,450,450,0,0,0
164,,,27.0,33.0,31.0,39.0,1314,1236,979,923,335,313,402,279,180,145,222,134,23,25,250,350,750,450,0,0,0
171,,,30.0,33.0,31.0,39.0,1191,1208,923,895,268,313,145,414,45,240,100,174,23,25,250,350,750,450,0,0,0
179,,,30.0,33.0,31.0,39.0,1191,1230,923,895,268,335,292,564,160,350,132,214,23,25,250,350,750,450,0,0,0
186,,,30.0,33.0,31.0,39.0,1270,1281,979,923,291,358,188,614,120,360,68,254,23,25,250,350,750,450,0,0,0
193,,,30.0,33.0,31.0,39.0,1242,1286,951,951,291,335,334,715,230,425,104,290,23,24,550,700,750,450,0,0,0
200,,,28.0,33.0,39.0,39.0,1292,1236,979,923,313,313,489,856,345,530,144,326,23,24,425,700,750,550,125,0,0
207,,,29.0,33.0,39.0,39.0,1309,570,951,391,358,179,339,962,305,620,34,342,23,25,300,700,750,550,250,0,0
214,,,29.0,33.0,39.0,39.0,1314,475,979,475,335,0,385,647,315,305,70,342,23,25,300,700,750,550,250,0,0
221,,,30.0,33.0,39.0,39.0,1320,1007,1007,1007,313,0,491,772,385,430,106,342,23,25,300,700,750,550,250,0,0
229,,,30.0,34.0,39.0,39.0,1236,1023,923,867,313,156,636,745,490,375,146,370,24,25,300,700,750,550,250,0,0
236,,,35.0,34.0,54.0,39.0,1320,1152,1007,839,313,313,371,590,285,280,86,310,24,25,600,700,1000,550,250,0,0
243,,,40.0,37.0,54.0,39.0,1370,1040,1035,727,335,313,281,357,155,115,126,242,24,24,800,700,1100,550,250,75,0
250,,,40.0,36.0,46.0,47.0,1398,407,1063,251,335,156,441,334,275,80,166,254,25,23,800,1050,1100,550,350,175,0
257,,,42.0,36.0,46.0,47.0,1510,693,1175,559,335,134,472,285,270,15,202,270,26,23,800,1050,1100,550,350,175,0
264,,,45.0,37.0,46.0,47.0,1544,1068,1231,867,313,201,113,368,75,70,38,298,28,24,800,1050,1100,550,350,175,0
271,,,46.0,38.0,46.0,47.0,1572,1124,1259,811,313,313,483,298,380,110,103,188,28,25,1325,1050,800,800,650,175,0
279,,,46.0,39.0,46.0,47.0,1438,1236,1147,923,291,313,399,403,260,175,139,228,29,26,1325,1050,800,800,650,175,0
286,,,46.0,38.0,46.0,62.0,1611,1180,1343,867,268,313,511,243,340,75,171,168,29,25,1325,1050,800,800,650,225,0
293,,,52.0,39.0,54.0,62.0,1533,1146,1287,811,246,335,213,288,110,80,103,208,29,25,1425,1050,800,800,650,275,0
300,,,54.0,41.0,70.0,62.0,1606,1286,1315,951,291,335,309,284,170,40,139,244,29,27,1525,1050,800,800,650,275,0
307,,,58.0,43.0,70.0,62.0,1634,1348,1343,1035,291,313,216,455,145,175,71,280,31,29,1675,1050,800,800,650,275,0
314,,,60.0,44.0,70.0,62.0,1645,1376,1399,1063,246,313,409,580,310,260,99,320,33,30,1675,1050,800,800,650,275,0
321,,,64.0,45.0,70.0,62.0,1695,1488,1427,1175,268,313,185,725,150,365,35,360,33,31,2050,1050,800,800,650,275,0
329,,,70.0,46.0,78.0,62.0,1751,1544,1483,1231,268,313,62,465,45,65,17,400,35,32,2050,1050,800,1050,650,275,0
336,,,70.0,52.0,78.0,62.0,1891,1678,1623,1343,268,335,248,180,195,15,53,165,35,33,2300,1050,800,1050,650,275,0
343,,,72.0,54.0,78.0,62.0,1891,1818,1623,1483,268,335,470,301,385,100,85,201,37,35,2675,1350,800,1050,650,275,0
350,,,76.0,55.0,78.0,62.0,1992,1874,1679,1539,313,335,511,476,390,235,121,241,38,36,2675,1350,800,1050,650,275,0
357,,,76.0,56.0,78.0,62.0,2026,1964,1735,1651,291,313,268,412,115,135,153,277,39,38,2875,1450,800,1050,650,275,0
364,,,77.0,56.0,78.0,62.0,2059,1936,1791,1623,268,313,456,467,275,150,181,317,39,39,2875,1300,800,1050,650,425,0
371,,,78.0,54.0,78.0,54.0,2166,2076,1875,1763,291,313,667,732,450,375,217,357,40,40,2875,1150,800,1050,650,575,0
7,2,2,13.0,13.0,15.0,15.0,335,335,335,335,0,0,40,40,40,40,0,0,12,12,0,0,0,0,0,0,0
14,2,2,14.0,14.0,15.0,15.0,671,671,671,671,0,0,70,70,70,70,0,0,13,13,0,0,0,0,0,0,0
21,2,2,14.0,14.0,15.0,15.0,671,671,671,671,0,0,45,45,45,45,0,0,13,13,0,0,0,0,0,0,0
29,2,2,15.0,15.0,15.0,15.0,643,671,643,671,0,0,80,85,80,85,0,0,14,14,0,0,0,0,0,0,0
36,2,2,15.0,15.0,15.0,15.0,699,727,699,727,0,0,125,175,125,175,0,0,14,14,0,0,0,0,0,0,0
43,2,2,16.0,16.0,23.0,23.0,727,727,727,727,0,0,5,60,5,60,0,0,15,15,0,0,0,0,0,0,0
50,2,2,17.0,17.0,23.0,23.0,783,783,783,783,0,0,40,40,40,40,0,0,16,16,0,0,0,0,0,0,0
57,2,2,18.0,18.0,23.0,23.0,811,783,811,783,0,0,85,90,85,90,0,0,17,17,0,0,0,0,0,0,0
64,2,2,19.0,18.0,23.0,23.0,839,923,839,923,0,0,55,150,55,150,0,0,18,17,0,0,0,0,0,0,0
71,2,2,19.0,19.0,23.0,23.0,867,895,867,895,0,0,15,180,15,180,0,0,18,18,0,0,0,0,0,0,0
79,2,2,20.0,20.0,23.0,23.0,1018,906,951,839,67,67,92,242,80,230,12,12,19,19,0,0,0,0,0,0,0
86,2,2,21.0,20.0,23.0,23.0,1012,939,923,783,89,156,210,352,190,320,20,32,20,19,0,0,0,150,0,0,0
93,2,2,22.0,23.0,31.0,23.0,1062,939,951,783,111,156,131,162,95,110,36,52,21,20,0,0,150,150,0,0,0
100,2,2,24.0,23.0,31.0,23.0,1130,1023,951,755,179,268,120,188,60,100,60,88,21,20,0,0,150,150,0,0,0
107,2,2,25.0,23.0,31.0,23.0,1158,1006,979,671,179,335,200,144,120,20,80,124,22,21,0,0,150,150,0,0,0
114,2,2,25.0,24.0,31.0,31.0,1174,1040,951,727,223,313,342,275,230,115,112,160,22,21,0,100,150,150,0,0,0
121,2,2,26.0,24.0,31.0,39.0,1247,1012,979,699,268,313,434,400,290,200,144,200,23,21,100,100,150,150,0,0,0
129,2,2,29.0,26.0,31.0,39.0,1214,1068,923,755,291,313,255,105,175,40,80,65,24,22,100,100,300,300,0,0,0
136,2,2,29.0,26.0,31.0,39.0,1180,1096,867,783,313,313,291,236,175,135,116,101,24,22,100,100,300,300,0,0,0
143,2,2,30.0,27.0,31.0,39.0,1230,1079,895,811,335,268,391,173,235,40,156,133,25,22,100,100,300,300,0,0,0
150,2,2,32.0,27.0,39.0,31.0,1230,1085,895,839,335,246,367,305,225,140,142,165,25,22,275,225,300,300,0,100,0
157,2,2,33.0,29.0,39.0,31.0,1286,1169,951,923,335,246,522,318,340,150,182,168,26,23,275,225,300,300,0,100,0
164,2,2,34.0,27.0,39.0,31.0,1208,1113,895,867,313,246,613,456,395,260,218,196,27,23,275,125,300,300,0,200,0
171,2,2,34.0,26.0,39.0,31.0,1180,1197,867,951,313,246,518,599,260,375,258,224,27,22,275,125,300,600,0,250,0
179,2,2,34.0,29.0,39.0,31.0,1208,1247,895,979,313,268,668,159,370,53,298,106,28,22,450,125,300,600,0,250,0
186,2,2,36.0,31.0,39.0,31.0,1342,1225,1007,979,335,246,283,122,45,38,238,84,28,22,450,250,300,600,0,250,0
193,2,2,36.0,31.0,39.0,31.0,1348,1197,1035,951,313,246,340,165,70,53,270,112,28,22,450,250,300,600,0,250,0
200,2,2,37.0,31.0,39.0,31.0,1432,1113,1119,867,313,246,455,292,145,148,310,144,28,22,450,250,400,600,0,250,0
207,2,2,38.0,31.0,39.0,31.0,1482,1146,1147,811,335,335,421,382,75,198,346,184,29,22,450,550,400,600,0,250,0
214,2,2,38.0,32.0,39.0,39.0,1460,1124,1147,811,313,313,342,263,60,93,282,170,29,22,600,725,550,600,0,250,0
221,2,2,39.0,32.0,39.0,39.0,1438,1146,1147,811,291,335,404,298,90,88,314,210,30,22,600,725,650,600,0,250,0
229,2,2,38.0,33.0,39.0,39.0,1488,1202,1175,867,313,335,579,393,225,143,354,250,29,23,600,725,650,600,50,250,0
236,2,2,39.0,34.0,39.0,39.0,1432,1124,1119,811,313,313,744,519,350,233,394,286,30,24,600,725,650,600,50,250,0
243,2,2,39.0,34.0,39.0,39.0,1466,1152,1175,839,291,313,620,414,290,188,330,226,31,24,600,725,800,600,50,250,0
250,2,2,39.0,36.0,39.0,54.0,1410,1202,1119,867,291,335,431,314,65,48,366,266,31,25,600,725,800,600,50,250,0
257,2,2,40.0,38.0,54.0,54.0,1387,1286,1119,951,268,335,294,424,50,118,244,306,31,27,600,725,1050,750,50,250,0
264,2,2,43.0,41.0,62.0,54.0,1158,1348,867,1035,291,313,229,380,45,138,184,242,32,29,750,725,1050,750,50,250,0
271,2,2,45.0,42.0,62.0,54.0,1376,1510,1063,1175,313,335,314,415,90,133,224,282,33,29,750,725,1050,750,50,250,0
279,2,2,46.0,44.0,62.0,54.0,1768,1544,1455,1231,313,313,484,306,220,138,264,168,35,31,750,725,1050,1000,50,250,0
286,2,2,49.0,45.0,62.0,54.0,1908,1690,1595,1399,313,291,254,257,150,53,104,204,36,32,750,725,1050,1150,50,250,0
293,2,2,51.0,46.0,62.0,54.0,1930,1746,1595,1455,335,291,335,257,195,113,140,144,37,33,900,875,1200,1150,50,250,0
300,2,2,56.0,47.0,62.0,54.0,1986,1852,1651,1539,335,313,220,233,140,53,80,180,39,34,1075,875,1350,1150,50,250,0
307,2,2,57.0,48.0,62.0,54.0,2098,1880,1763,1567,335,313,266,353,150,133,116,220,39,35,1250,875,1350,1150,50,250,0
314,2,2,59.0,50.0,62.0,54.0,2104,1930,1791,1595,313,335,367,448,215,188,152,260,41,37,1250,875,1350,1150,50,250,0
321,2,2,61.0,52.0,62.0,62.0,2026,1930,1735,1595,291,335,258,358,120,108,138,250,41,38,1425,875,1250,1150,50,250,0
329,2,2,61.0,56.0,70.0,62.0,2132,1998,1819,1707,313,291,523,325,345,93,178,232,43,39,1425,1225,1250,1250,50,250,0
336,2,2,61.0,56.0,86.0,62.0,2126,2054,1791,1763,335,291,378,266,160,98,218,168,43,39,1425,1225,1500,1400,50,250,0
343,2,2,64.0,57.0,86.0,62.0,2188,2037,1875,1679,313,358,444,524,265,308,179,216,43,41,1425,1225,1500,1400,50,250,0
350,2,2,68.0,59.0,86.0,62.0,2188,2210,1763,1763,425,447,360,630,225,408,135,222,43,42,1775,1400,1500,1400,50,250,0
357,2,2,73.0,60.0,86.0,62.0,2306,2233,1791,1763,515,470,135,340,40,58,95,282,45,42,1950,1400,1500,1400,50,250,0
364,2,2,73.0,60.0,86.0,62.0,2373,2199,1903,1707,470,492,427,260,280,18,147,242,45,42,2225,1400,1500,1400,50,250,0
371,2,2,75.0,60.0,94.0,62.0,2345,2250,1875,1735,470,515,307,531,250,233,57,298,46,43,2225,1400,1500,1550,50,250,0
379,2,2,80.0,66.0,94.0,70.0,2423,2283,1931,1791,492,492,142,282,125,78,17,204,47,43,2400,1400,1500,1550,50,250,0
386,2,2,81.0,71.0,94.0,78.0,2395,2283,1903,1791,492,492,282,188,205,103,77,85,48,43,2575,2075,1500,1800,50,250,0
393,2,2,84.0,67.0,94.0,78.0,2457,2339,1987,1847,470,492,258,418,175,273,83,145,49,43,2750,1825,1500,1800,50,500,0
400,2,2,85.0,69.0,94.0,78.0,2485,2261,2015,1791,470,470,340,339,205,138,135,201,50,45,2750,1925,1500,1800,50,500,0
407,2,2,87.0,69.0,109.0,78.0,2373,2367,1903,1875,470,492,520,459,325,198,195,261,51,45,2750,1925,1500,1800,50,500,0
414,2,2,88.0,73.0,109.0,78.0,2406,2143,1959,1651,447,492,253,174,110,53,143,121,52,47,2750,2100,1600,2050,50,500,0
421,2,2,90.0,74.0,109.0,78.0,2602,2395,2155,1903,447,492,314,220,115,143,199,77,54,49,2750,2100,1600,2050,50,500,0
429,2,2,90.0,75.0,109.0,78.0,2686,2283,2239,1791,447,492,486,395,235,258,251,137,56,49,2750,2100,1600,2050,50,500,0
436,2,2,96.0,80.0,109.0,93.0,2910,2395,2463,1903,447,492,252,296,45,203,207,93,57,51,2750,2100,1600,2150,50,500,0
443,2,2,98.0,82.0,109.0,93.0,2933,2451,2463,1959,470,492,242,391,25,238,217,153,57,51,3275,2100,1900,2150,50,500,0
450,2,2,98.0,85.0,109.0,93.0,3039,2541,2547,2071,492,470,617,277,340,218,277,59,57,54,3275,2100,1900,2450,50,500,0
457,2,2,100.0,89.0,109.0,93.0,3090,2647,2575,2155,515,492,377,247,40,128,337,119,57,54,3275,2300,1900,2450,50,500,0
464,2,2,103.0,90.0,125.0,93.0,3174,2787,2659,2295,515,492,483,423,140,248,343,175,57,57,3275,2300,2200,2450,50,500,0
471,2,2,104.0,92.0,125.0,93.0,3095,2877,2603,2407,492,470,689,609,290,428,399,181,60,58,3700,2300,2350,2450,50,500,0
479,2,2,104.0,92.0,133.0,101.0,2457,2989,1987,2519,470,470,795,689,340,448,455,241,60,58,3700,2850,2500,2450,50,500,0
486,2,2,110.0,92.0,133.0,101.0,2513,3011,2043,2519,470,492,590,730,225,433,365,297,61,58,4225,2850,2500,2450,50,500,0
493,2,2,114.0,92.0,133.0,109.0,2709,3022,2239,2575,470,447,585,702,260,353,325,349,61,58,4575,2850,2500,2600,50,500,0
500,2,2,122.0,98.0,133.0,125.0,2731,2877,2239,2407,492,470,510,352,125,243,385,109,61,58,4875,2850,2650,2900,50,500,0
507,2,2,122.0,106.0,133.0,125.0,2894,2955,2379,2463,515,492,861,222,420,53,441,169,61,58,4975,3150,2800,2900,50,500,0
514,2,2,132.0,106.0,133.0,133.0,2838,2972,2323,2435,515,537,506,485,5,248,501,237,61,58,4875,3150,2800,2900,150,500,0
521,2,2,132.0,108.0,133.0,133.0,2849,2972,2379,2323,470,649,748,311,195,48,553,263,61,60,5475,3150,2800,2900,150,500,0
529,2,2,130.0,106.0,148.0,133.0,2877,2966,2407,2295,470,671,1098,666,485,323,613,343,61,60,5300,3225,2800,2900,325,600,0
536,2,2,130.0,110.0,164.0,133.0,2933,3028,2463,2379,470,649,1053,222,380,103,673,119,61,60,5225,3350,2800,3100,800,1075,0
543,2,2,108.0,99.0,164.0,141.0,2899,3034,2407,2407,492,627,908,393,175,198,733,195,61,59,2575,2800,2800,3200,3450,2075,0
550,2,2,100.0,95.0,164.0,149.0,3034,3022,2519,2351,515,671,733,548,90,273,643,275,61,59,2250,2375,2800,3350,4275,2700,0
557,2,2,98.0,91.0,164.0,149.0,3006,3134,2491,2463,515,671,894,173,195,68,699,105,61,59,2475,1925,2800,3200,4575,3637,0
564,2,2,98.0,95.0,164.0,164.0,2899,2950,2407,2323,492,627,875,215,220,38,655,177,61,59,2650,1925,2800,3200,4775,3737,0
571,2,2,94.0,91.0,164.0,164.0,2625,2978,2155,2239,470,739,586,481,25,208,561,273,61,59,2325,2275,2800,3200,5275,4387,0
579,2,2,91.0,95.0,164.0,164.0,2810,2983,2340,2155,470,828,944,531,323,158,621,373,61,59,2425,2475,2800,3200,5475,4487,0
586,2,2,101.0,85.0,164.0,164.0,3096,3157,2626,2351,470,806,815,812,134,343,681,469,61,59,2425,1575,2800,3200,5475,5387,0
593,2,2,99.0,91.0,164.0,164.0,3140,3134,2648,2351,492,783,720,483,179,68,541,415,61,59,2825,1675,2800,3200,5575,5787,0
600,2,2,102.0,95.0,164.0,164.0,3151,3235,2659,2407,492,828,853,678,256,163,597,515,61,59,2825,1975,2800,3200,5575,5787,0
607,2,2,114.0,99.0,164.0,164.0,3230,3286,2715,2435,515,851,729,788,72,173,657,615,64,59,2825,2275,2800,3200,5575,5787,0
614,2,2,108.0,105.0,164.0,164.0,3062,3123,2592,2295,470,828,1101,735,392,28,709,707,64,59,2925,2275,2800,3200,5975,5887,0
621,2,2,116.0,96.0,164.0,164.0,3359,3073,2889,2267,470,806,912,806,143,153,769,653,66,59,3225,2375,2800,3050,6175,6637,0
629,2,2,116.0,85.0,164.0,164.0,3348,2866,2878,2127,470,739,1089,835,260,98,829,737,62,50,3225,2175,2800,3050,6425,7487,0
636,2,2,111.0,78.0,164.0,156.0,2888,2350,2396,1791,492,559,1209,859,320,58,889,801,61,45,3175,1775,2800,3050,7025,8237,0
643,2,2,99.0,77.0,164.0,156.0,2984,2261,2469,1791,515,470,1080,969,131,108,949,861,61,45,2075,1775,3100,3050,8125,8437,0
650,2,2,97.0,74.0,164.0,156.0,3079,2227,2564,1735,515,492,1093,1114,288,193,805,921,61,48,2475,1475,3100,3050,8225,8737,0
657,2,2,97.0,74.0,164.0,141.0,3140,2367,2536,1763,604,604,1174,880,293,83,881,797,61,49,2475,1775,3100,3050,8225,9187,0
664,2,2,104.0,78.0,164.0,141.0,3062,2334,2413,1707,649,627,920,912,38,43,882,869,61,49,2275,1975,3100,3050,8425,9237,0
671,2,2,102.0,81.0,164.0,141.0,3045,2362,2396,1735,649,627,1299,893,337,98,962,795,61,49,2675,2075,3100,3050,8525,9237,0
679,2,2,108.0,84.0,164.0,149.0,2771,2496,2144,1735,627,761,865,994,202,178,663,816,61,50,3425,2075,3100,3050,8525,9237,0
686,2,2,110.0,86.0,164.0,149.0,3146,2558,2497,1707,649,851,1003,1197,260,273,743,924,61,52,3525,2075,3750,3050,8525,9237,0
693,2,2,124.0,87.0,164.0,149.0,3336,2726,2665,1763,671,963,300,1182,77,288,223,894,61,53,4325,2075,3750,3050,8525,9237,0
700,2,2,124.0,104.0,164.0,149.0,3543,2714,2872,1707,671,1007,734,218,435,108,299,110,61,54,4225,2475,3750,3400,8525,9237,0
707,2,2,124.0,105.0,164.0,149.0,3493,2860,2844,1875,649,985,1137,290,762,68,375,222,61,55,4275,2475,3750,3400,8525,9437,0
714,2,2,130.0,106.0,164.0,149.0,3460,2810,2811,1847,649,963,538,232,387,48,151,184,61,54,5475,3825,3750,3400,8525,9487,0
721,2,2,135.0,101.0,164.0,149.0,3158,2597,2531,1679,627,918,610,479,383,183,227,296,60,51,5375,3825,3750,3400,8575,9637,0
729,2,2,135.0,99.0,164.0,141.0,3438,2042,2811,1259,627,783,1039,720,732,328,307,392,60,49,5825,4125,3750,3400,8575,9987,0
736,2,2,135.0,99.0,164.0,141.0,3387,2087,2738,1371,649,716,1436,398,1049,68,387,330,60,44,5825,4125,3750,3400,8575,10412,0
743,2,2,149.0,100.0,164.0,141.0,3493,2356,2822,1595,671,761,344,641,281,223,63,418,60,44,6475,4775,4000,3550,9075,10412,0
750,2,2,149.0,102.0,164.0,141.0,3448,2350,2777,1567,671,783,760,569,617,63,143,506,60,45,6825,4775,4250,3550,9075,10412,0
757,2,2,145.0,100.0,164.0,141.0,3493,2250,2844,1399,649,851,1166,769,951,163,215,606,60,47,6625,4475,4250,3450,9275,10812,0
764,2,2,125.0,92.0,164.0,141.0,3443,2345,2794,1427,649,918,1576,770,1281,48,295,722,60,46,5325,3275,4250,3450,10575,12262,0
771,2,2,141.0,65.0,164.0,149.0,3393,2395,2766,1455,627,940,976,1066,605,228,371,838,60,45,5975,1300,4250,3450,10925,14637,0
779,2,2,137.0,61.0,164.0,125.0,3364,2250,2715,1399,649,851,1398,1026,947,88,451,938,58,41,5875,1050,4250,3450,11125,15587,0
7,2,1,13.0,13.0,15.0,14.0,377,377,377,377,0,0,45,45,45,45,0,0,12,12,0,0,0,0,0,0,1
14,2,1,14.0,13.0,15.0,14.0,643,671,643,671,0,0,65,20,65,20,0,0,13,13,0,0,0,0,0,0,1
21,2,1,14.0,14.0,15.0,14.0,643,671,643,671,0,0,40,45,40,45,0,0,13,13,0,0,0,0,0,0,1
29,2,1,15.0,14.0,15.0,14.0,699,727,699,727,0,0,30,150,30,150,0,0,14,13,0,0,0,0,0,0,1
36,2,1,15.0,16.0,23.0,22.0,727,727,727,727,0,0,125,140,125,140,0,0,14,14,0,0,0,0,0,0,1
43,2,1,16.0,16.0,23.0,22.0,727,783,727,783,0,0,5,225,5,225,0,0,15,16,0,0,0,0,0,0,1
50,2,1,17.0,17.0,23.0,22.0,783,811,783,811,0,0,20,275,20,275,0,0,16,16,0,0,0,0,0,0,1
57,2,1,18.0,17.0,23.0,22.0,755,867,755,867,0,0,20,35,20,35,0,0,17,16,0,0,0,0,0,0,1
64,2,1,19.0,18.0,23.0,22.0,951,923,951,923,0,0,90,85,90,85,0,0,18,16,0,0,0,0,0,0,1
71,2,1,19.0,17.0,23.0,22.0,951,951,951,951,0,0,190,170,190,170,0,0,18,17,0,0,0,0,0,0,1
79,2,1,20.0,17.0,23.0,22.0,995,895,951,895,44,0,313,30,305,30,8,0,19,16,0,0,0,0,0,0,1
86,2,1,20.0,18.0,23.0,22.0,1018,923,951,923,67,0,436,85,420,85,16,0,19,16,0,0,150,0,0,0,1
93,2,1,20.0,19.0,23.0,22.0,1012,839,923,839,89,0,148,135,120,135,28,0,20,18,0,0,150,0,0,0,1
100,2,1,21.0,20.0,23.0,22.0,1034,962,923,895,111,67,70,212,30,200,40,12,20,18,0,0,150,0,0,0,1
107,2,1,21.0,20.0,23.0,22.0,1085,1001,951,867,134,134,81,328,25,300,56,28,20,19,0,0,150,0,0,0,1
114,2,1,22.0,20.0,23.0,22.0,1006,1051,895,895,111,156,98,363,30,315,68,48,21,20,0,0,150,0,0,0,1
121,2,1,22.0,22.0,23.0,22.0,1029,1079,895,923,134,156,168,333,80,265,88,68,21,20,0,0,150,250,0,0,1
129,2,1,23.0,26.0,23.0,36.0,1046,1046,867,867,179,179,252,208,140,120,112,88,22,20,0,0,150,250,0,0,1
136,2,1,26.0,28.0,31.0,36.0,1107,1085,839,951,268,134,164,50,95,50,69,0,23,20,0,0,300,250,0,0,1
143,2,1,27.0,29.0,31.0,36.0,1230,1001,895,979,335,22,269,115,160,115,109,0,24,20,0,100,300,250,0,0,1
150,2,1,27.0,30.0,31.0,36.0,1202,979,867,979,335,0,105,185,60,185,45,0,24,22,0,100,300,250,0,0,1
157,2,1,30.0,29.0,31.0,36.0,1258,1063,923,1063,335,0,86,20,55,20,31,0,25,22,125,250,300,250,0,0,1
164,2,1,32.0,31.0,46.0,36.0,1264,1147,951,1147,313,0,97,65,30,65,67,0,26,23,125,400,300,250,0,0,1
171,2,1,33.0,32.5,46.0,36.0,1404,1231,1091,1231,313,0,212,60,105,60,107,0,27,23,125,375,300,250,0,25,1
179,2,1,35.0,34.5,46.0,36.0,1516,1231,1203,1231,313,0,207,15,60,15,147,0,29,25,125,375,300,250,0,25,1
186,2,1,37.0,35.5,46.0,36.0,1650,1427,1315,1427,335,0,297,45,110,45,187,0,31,25,300,375,300,250,0,25,1
193,2,1,37.0,39.5,46.0,44.0,1762,1505,1427,1483,335,22,193,29,120,25,73,4,31,28,300,375,550,250,0,25,1
200,2,1,39.0,41.5,46.0,44.0,1790,1555,1455,1511,335,44,203,53,90,45,113,8,33,28,300,375,550,250,0,25,1
207,2,1,41.0,44.5,46.0,52.0,1818,1662,1483,1595,335,67,279,106,155,90,124,16,33,32,300,525,550,250,0,25,1
214,2,1,45.0,46.5,46.0,52.0,1852,1662,1539,1595,313,67,165,49,5,25,160,24,35,34,300,525,550,250,0,25,1
221,2,1,45.0,49.5,54.0,52.0,1964,1902,1651,1791,313,111,325,125,125,85,200,40,35,35,300,525,550,250,0,25,1
229,2,1,47.0,50.5,54.0,58.0,1936,1970,1623,1791,313,179,350,110,110,50,240,60,37,35,300,525,700,250,0,25,1
236,2,1,47.0,53.5,54.0,66.0,1964,1998,1651,1819,313,179,495,140,215,60,280,80,37,37,425,675,700,250,0,25,1
243,2,1,51.0,54.5,62.0,66.0,2098,2031,1763,1875,335,156,140,231,95,135,45,96,39,39,425,675,1000,250,0,25,1
250,2,1,57.0,61.5,62.0,66.0,2177,2059,1819,1903,358,156,150,126,90,10,60,116,40,41,925,825,1000,250,0,25,1
257,2,1,58.0,63.5,62.0,66.0,2166,2199,1763,2043,403,156,198,171,90,35,108,136,41,40,925,825,1000,250,0,25,1
264,2,1,59.0,62.0,62.0,74.0,2093,2199,1623,2043,470,156,164,251,150,95,14,156,43,39,925,950,1000,250,0,50,1
271,2,1,59.0,62.0,62.0,74.0,2289,2227,1819,2071,470,156,484,511,360,335,124,176,43,39,1225,1300,1000,450,0,50,1
279,2,1,63.0,65.0,70.0,74.0,2289,2138,1819,1959,470,179,410,156,380,60,30,96,44,37,1225,1450,1000,575,0,50,1
286,2,1,63.0,67.0,70.0,82.0,2362,1998,1735,1819,627,179,555,291,445,175,110,116,44,37,1225,1450,1000,700,0,50,1
293,2,1,63.0,72.0,70.0,82.0,2334,2115,1707,1959,627,156,387,187,205,55,182,132,45,44,1225,1450,1000,700,0,50,1
300,2,1,63.0,71.0,70.0,82.0,2395,2087,1791,1931,604,156,528,422,270,270,258,152,45,45,1225,1450,1000,825,0,50,1
307,2,1,65.0,71.5,70.0,90.0,2367,2076,1763,1875,604,201,354,530,220,350,134,180,45,48,1700,1425,1250,825,0,75,1
314,2,1,65.0,81.0,70.0,90.0,2513,2468,1819,2155,694,313,649,360,435,265,214,95,45,49,1700,1400,1250,825,0,100,1
321,2,1,70.0,87.0,70.0,90.0,2630,2602,1959,2267,671,335,400,195,310,60,90,135,45,48,1875,1400,1250,825,0,100,1
329,2,1,70.0,87.0,70.0,98.0,2602,2653,1931,2183,671,470,586,500,420,305,166,195,45,48,1875,1900,1400,825,0,100,1
336,2,1,70.0,89.5,78.0,106.0,2630,2675,1959,2183,671,492,797,306,555,155,242,151,45,54,1875,1875,1400,1075,0,125,1
343,2,1,74.0,91.5,86.0,106.0,2602,2647,1931,2155,671,492,748,321,530,160,218,161,45,58,2225,1725,1850,1075,0,275,1
350,2,1,77.0,97.5,86.0,114.0,2574,3017,1903,2435,671,582,639,292,495,130,144,162,45,58,2525,1725,2000,1075,0,275,1
357,2,1,83.0,98.0,94.0,114.0,2474,3011,1847,2407,627,604,411,379,345,170,66,209,45,57,2700,1900,2000,1075,0,300,1
364,2,1,83.0,104.0,94.0,130.0,2530,2703,1903,1987,627,716,712,371,570,70,142,301,45,57,3050,1900,2000,1075,0,300,1
371,2,1,83.0,100.0,102.0,138.0,2530,2546,1903,1763,627,783,922,584,700,195,222,389,45,57,3050,2000,2000,1075,0,500,1
379,2,1,89.0,108.0,102.0,138.0,2558,3078,1931,2295,627,783,589,166,445,135,144,31,45,57,3575,2150,2000,1200,0,500,1
386,2,1,95.0,108.0,110.0,146.0,2546,3146,1875,2407,671,739,374,534,300,415,74,119,45,57,4400,3000,2000,1200,0,500,1
393,2,1,95.0,120.0,110.0,154.0,2502,3202,1875,2463,627,739,466,221,320,135,146,86,45,57,4400,3100,2000,1200,0,500,1
400,2,1,95.0,124.0,118.0,154.0,2474,3140,1847,2379,627,761,752,301,530,265,222,36,45,57,4400,3100,2000,1200,0,500,1
407,2,1,105.0,127.5,118.0,154.0,2412,3207,1763,2379,649,828,172,336,120,200,52,136,45,57,4925,3825,2000,1200,0,575,1
414,2,1,107.0,138.0,134.0,162.0,2518,3185,1847,2379,671,806,297,107,215,75,82,32,45,57,5450,3900,2000,1075,0,725,1
421,2,1,105.0,140.5,134.0,162.0,2468,3179,1819,2351,649,828,594,343,440,215,154,128,45,57,5325,4225,2000,1075,125,750,1
429,2,1,105.0,144.0,134.0,170.0,2518,3202,1847,2351,671,851,889,308,655,155,234,153,45,57,5325,4250,2000,1075,125,925,1
436,2,1,113.0,143.0,134.0,170.0,2412,3157,1763,2351,649,806,470,710,360,465,110,245,45,57,6025,4750,2000,950,125,1100,1
443,2,1,111.0,147.5,134.0,170.0,2395,3078,1791,2295,604,783,322,581,240,340,82,241,45,57,5850,4475,2000,950,650,1375,1
450,2,1,107.0,136.0,134.0,170.0,2479,3207,1875,2379,604,828,627,861,465,545,162,316,45,57,5550,4050,2000,950,950,2100,1
457,2,1,103.0,127.5,134.0,170.0,2412,3067,1763,2239,649,828,908,741,670,450,238,291,45,57,5300,3125,2000,950,1200,3150,1
464,2,1,94.0,125.0,142.0,170.0,2446,3129,1819,2323,627,806,159,928,145,595,14,333,45,57,4050,3150,2000,950,3150,3475,1
471,2,1,92.0,129.0,142.0,170.0,2496,3151,1847,2323,649,828,469,648,375,515,94,133,45,57,4225,2950,2000,950,3325,3775,1
479,2,1,90.0,131.0,142.0,170.0,2574,3151,1903,2323,671,828,759,879,585,650,174,229,45,57,4050,3800,2000,950,3500,3825,1
486,2,1,93.0,132.0,142.0,170.0,2502,3129,1875,2323,627,806,526,695,430,470,96,225,45,57,4275,3950,2000,950,3800,4125,1
493,2,1,81.0,121.5,142.0,170.0,2468,3106,1819,2323,649,783,821,1021,645,700,176,321,45,57,3225,3375,2000,950,4850,4850,1
499,2,1,67.0,126.5,142.0,170.0,2474,3078,1847,2295,627,783,1084,540,840,260,244,280,45,57,2000,2925,2000,950,6075,5400,1
7,1,0,13.0,13.0,14.0,15.0,335,293,335,293,0,0,40,35,40,35,0,0,12,12,0,0,0,0,0,0,0
14,1,0,14.0,14.0,14.0,15.0,643,671,643,671,0,0,65,70,65,70,0,0,13,13,0,0,0,0,0,0,0
21,1,0,14.0,14.0,14.0,15.0,727,699,727,699,0,0,55,0,55,0,0,0,13,13,0,0,0,0,0,0,0
29,1,0,15.0,15.0,14.0,15.0,699,671,699,671,0,0,89,80,89,80,0,0,14,14,0,0,0,0,0,0,0
36,1,0,15.0,15.0,22.0,15.0,783,755,783,755,0,0,194,135,194,135,0,0,14,14,0,0,0,0,0,0,0
43,1,0,16.0,16.0,22.0,23.0,783,783,783,783,0,0,234,70,234,70,0,0,15,15,0,0,0,0,0,0,0
50,1,0,15.0,16.0,22.0,23.0,811,755,811,755,0,0,39,35,39,35,0,0,15,15,0,0,0,0,0,0,0
57,1,0,17.0,17.0,22.0,23.0,811,727,811,727,0,0,44,135,44,135,0,0,15,16,0,0,0,0,0,0,0
64,1,0,18.0,18.0,22.0,23.0,923,783,923,783,0,0,99,175,99,175,0,0,16,17,0,0,0,0,0,0,0
71,1,0,17.0,18.0,22.0,23.0,895,827,895,783,0,44,184,273,184,265,0,8,17,17,0,0,0,0,0,0,0
79,1,0,17.0,19.0,22.0,23.0,951,883,951,727,0,156,44,343,44,315,0,28,16,18,0,0,0,0,0,0,0
86,1,0,18.0,19.0,22.0,23.0,951,934,951,755,0,179,109,463,109,415,0,48,16,18,0,0,0,0,0,0,0
93,1,0,19.0,20.0,22.0,23.0,951,967,951,811,0,156,174,324,174,310,0,14,18,19,0,0,0,150,0,0,0
100,1,0,19.0,20.0,22.0,23.0,1018,967,951,811,67,156,186,444,174,410,12,34,19,19,0,0,0,150,0,0,0
107,1,0,19.0,20.0,22.0,23.0,1085,939,951,783,134,156,317,159,289,105,28,54,19,19,0,0,0,150,0,0,0
114,1,0,20.0,21.0,22.0,23.0,1135,967,979,811,156,156,402,74,354,0,48,74,19,19,0,0,0,150,0,0,0
121,1,0,25.0,22.0,36.0,23.0,1107,962,951,783,156,179,173,189,109,95,64,94,20,19,0,100,250,150,0,0,0
129,1,0,26.0,23.0,36.0,23.0,1012,1130,923,951,89,179,246,274,174,160,72,114,20,20,0,100,250,150,0,0,0
136,1,0,28.0,23.0,36.0,31.0,1046,1275,979,1119,67,156,274,185,194,155,80,30,20,20,0,100,250,150,0,0,0
143,1,0,27.0,24.0,36.0,31.0,1023,1275,979,1119,44,156,103,175,19,175,84,0,21,21,100,150,250,150,0,0,0
150,1,0,27.0,24.0,36.0,31.0,1074,1247,1007,1091,67,156,231,265,139,245,92,20,21,21,100,150,250,150,0,0,0
157,1,0,30.0,25.0,36.0,31.0,1130,1275,1063,1119,67,156,234,410,134,370,100,40,21,22,400,150,250,150,0,0,0
164,1,0,32.0,26.0,36.0,31.0,1135,1359,1091,1203,44,156,223,115,119,55,104,60,22,23,400,150,250,150,0,0,0
171,1,0,32.0,26.0,36.0,31.0,1214,1326,1147,1147,67,179,276,260,164,180,112,80,24,23,400,150,250,150,0,0,0
179,1,0,31.0,27.0,36.0,46.0,1242,1494,1175,1315,67,179,164,235,144,135,20,100,23,24,400,150,250,500,0,0,0
186,1,0,31.0,27.0,44.0,46.0,1253,1331,1119,1175,134,156,119,41,79,25,40,16,23,24,400,150,250,500,0,0,0
193,1,0,34.0,30.0,44.0,46.0,1247,1415,1091,1259,156,156,124,71,64,35,60,36,23,25,400,150,250,500,0,0,0
200,1,0,35.0,33.0,60.0,46.0,1202,1303,979,1147,223,156,222,81,134,25,88,56,23,25,550,150,250,500,0,0,0
207,1,0,36.0,34.0,60.0,46.0,1342,1527,1007,1371,335,156,187,166,59,115,128,51,26,26,550,150,250,500,0,0,0
214,1,0,36.0,36.0,66.0,46.0,1348,1701,1035,1455,313,246,219,258,59,175,160,83,25,28,550,250,250,500,0,0,0
221,1,0,37.0,40.0,66.0,46.0,1460,1818,1147,1483,313,335,349,278,149,155,200,123,27,28,550,350,250,825,0,0,0
229,1,0,37.0,42.0,66.0,46.0,1404,1936,1091,1623,313,313,519,414,279,255,240,159,28,30,550,350,250,825,0,0,0
236,1,0,40.0,46.0,66.0,61.0,1393,2126,1035,1791,358,335,187,229,49,130,138,99,28,30,550,350,500,825,0,0,0
243,1,0,39.0,50.0,66.0,61.0,1387,2244,895,1931,492,313,347,80,149,45,198,35,29,32,550,550,500,825,0,0,0
250,1,0,39.0,52.0,66.0,61.0,1494,2104,979,1791,515,313,537,115,279,40,258,75,31,32,550,600,700,825,0,0,0
257,1,0,49.0,54.0,66.0,61.0,1662,2328,1147,2015,515,313,228,230,39,140,189,90,31,34,550,600,700,825,0,0,0
264,1,0,51.0,56.0,66.0,61.0,1723,2378,1231,2043,492,335,244,355,24,225,220,130,31,35,550,700,700,825,0,0,0
271,1,0,53.0,57.0,66.0,69.0,1757,2406,1287,2071,470,335,355,225,104,155,251,70,31,36,550,800,1050,900,0,0,0
279,1,0,53.0,62.0,66.0,69.0,1757,2630,1287,2295,470,335,405,191,169,85,236,106,31,39,1050,1050,1050,900,0,0,0
286,1,0,57.0,65.0,74.0,69.0,1757,2882,1287,2547,470,335,440,186,194,140,246,46,31,40,1150,1050,1050,900,0,0,0
293,1,0,60.0,66.0,74.0,69.0,1746,2888,1231,2575,515,313,230,297,49,265,181,32,28,41,1250,1050,1200,900,131,0,0
300,1,0,64.0,66.0,66.0,77.0,1684,2418,1147,2127,537,291,245,168,54,100,191,68,28,42,1450,1100,1200,900,231,50,0
307,1,0,64.0,65.0,66.0,77.0,1583,1454,1091,1343,492,111,307,261,64,185,243,76,28,42,1750,1100,1200,900,231,100,0
314,1,0,65.5,66.0,66.0,77.0,1645,1158,1175,1091,470,67,413,269,139,210,274,59,28,42,1825,1100,1200,900,256,200,0
321,1,0,64.0,64.0,66.0,77.0,1589,1018,1119,951,470,67,443,392,184,325,259,67,28,39,1950,1400,1200,1050,331,475,0
329,1,0,64.0,50.0,74.0,77.0,1645,1090,1175,979,470,111,248,438,129,355,119,83,28,24,1750,1300,1200,1300,631,1275,0
7,0,2,13.0,12.0,15.0,15.0,293,293,293,293,0,0,35,85,35,85,0,0,12,12,0,0,0,0,0,0,1
14,0,2,14.0,13.0,15.0,15.0,671,643,671,643,0,0,70,15,70,15,0,0,13,12,0,0,0,0,0,0,1
21,0,2,14.0,13.0,15.0,15.0,727,699,727,699,0,0,50,95,50,95,0,0,13,12,0,0,0,0,0,0,1
29,0,2,15.0,13.0,15.0,23.0,643,727,643,727,0,0,80,35,80,35,0,0,14,13,0,0,0,0,0,0,1
36,0,2,15.0,14.0,15.0,23.0,755,699,755,699,0,0,135,15,135,15,0,0,14,13,0,0,0,0,0,0,1
43,0,2,16.0,15.0,23.0,23.0,783,727,783,727,0,0,75,30,75,30,0,0,15,14,0,0,0,0,0,0,1
50,0,2,16.0,16.0,23.0,23.0,783,727,783,727,0,0,35,75,35,75,0,0,15,15,0,0,0,0,0,0,1
57,0,2,17.0,17.0,23.0,23.0,671,867,671,867,0,0,75,60,75,60,0,0,16,16,0,0,0,0,0,0,1
64,0,2,18.0,17.0,23.0,23.0,811,839,811,839,0,0,130,155,130,155,0,0,17,16,0,0,0,0,0,0,1
71,0,2,18.0,18.0,23.0,23.0,799,861,755,839,44,22,223,214,215,210,8,4,17,17,0,0,0,0,0,0,1
79,0,2,19.0,20.0,23.0,23.0,861,794,727,615,134,179,328,62,300,30,28,32,18,17,0,0,0,150,0,0,1
86,0,2,19.0,21.0,23.0,23.0,883,833,727,587,156,246,448,120,400,60,48,60,18,18,0,0,0,150,0,0,1
93,0,2,20.0,21.0,23.0,23.0,939,939,783,671,156,268,358,146,290,50,68,96,19,18,0,0,150,150,0,0,1
100,0,2,20.0,22.0,23.0,23.0,990,1018,811,727,179,291,478,218,390,90,88,128,19,19,0,0,150,150,0,0,1
107,0,2,20.0,23.0,23.0,23.0,990,995,811,727,179,268,198,280,90,120,108,160,19,20,50,100,150,150,0,0,1
114,0,2,21.0,23.0,23.0,31.0,1018,1102,839,811,179,291,218,117,190,75,28,42,19,20,50,100,150,300,0,0,1
121,0,2,22.0,25.0,23.0,31.0,967,1079,811,811,156,268,274,119,230,70,44,49,19,21,50,100,150,300,0,0,1
129,0,2,22.0,25.0,23.0,31.0,1051,1079,895,811,156,268,129,46,65,15,64,31,19,21,50,100,150,300,0,0,1
136,0,2,23.0,26.0,23.0,31.0,1107,1079,951,811,156,268,199,137,115,70,84,67,20,21,100,100,150,300,0,0,1
143,0,2,25.0,26.0,31.0,31.0,1135,1130,979,839,156,291,184,173,80,70,104,103,21,22,100,225,150,300,0,0,1
150,0,2,24.0,26.0,31.0,31.0,990,1135,811,867,179,268,299,305,175,170,124,135,20,22,100,225,150,300,0,0,1
157,0,2,25.0,26.0,31.0,31.0,1107,1208,839,895,268,313,345,341,185,170,160,171,21,22,100,225,250,700,0,0,1
164,0,2,26.0,31.0,39.0,39.0,1152,1208,839,895,313,313,161,91,90,30,71,61,21,22,150,225,500,700,0,0,1
171,0,2,27.0,31.0,39.0,39.0,1264,1202,951,867,313,335,171,131,60,30,111,101,22,22,150,225,500,700,0,0,1
179,0,2,28.0,31.0,39.0,39.0,1398,1208,1063,895,335,313,361,272,210,135,151,137,22,23,200,225,500,700,0,0,1
186,0,2,31.0,31.0,39.0,39.0,1264,1180,951,867,313,313,242,72,155,45,87,27,23,23,200,225,575,800,0,0,1
193,0,2,32.0,35.0,39.0,39.0,1096,1202,783,867,313,335,322,217,195,150,127,67,23,23,200,575,575,800,0,0,1
200,0,2,33.0,35.0,39.0,39.0,1062,1286,727,951,335,335,307,372,140,265,167,107,23,23,250,575,575,900,0,0,1
207,0,2,35.0,35.0,39.0,39.0,1062,1202,727,867,335,335,209,258,77,215,132,43,24,23,250,575,825,900,0,0,1
214,0,2,35.0,36.0,39.0,39.0,1320,1242,1007,951,313,291,361,365,193,290,168,75,24,23,300,575,825,900,0,0,1
221,0,2,38.0,36.0,47.0,39.0,1314,1208,979,895,335,313,233,360,125,245,108,115,24,23,550,575,825,900,0,0,1
229,0,2,39.0,36.0,47.0,39.0,1342,1264,1007,951,335,313,338,510,190,355,148,155,24,24,550,925,825,900,0,0,1
236,0,2,40.0,36.0,47.0,39.0,1320,1264,1007,951,313,313,344,565,160,370,184,195,24,24,775,925,825,900,0,0,1
243,0,2,38.0,36.0,47.0,39.0,1320,1342,1007,1007,313,335,252,415,103,330,149,85,24,24,525,925,825,1150,300,0,1
250,0,2,39.0,36.0,47.0,47.0,1342,1348,1007,1035,335,313,335,567,147,450,188,117,25,24,775,925,825,1150,300,0,1
257,0,2,42.0,36.0,55.0,47.0,1348,1370,1035,1035,313,335,201,577,93,420,108,157,25,24,775,925,825,1150,300,0,1
264,0,2,43.0,37.0,55.0,47.0,1348,1320,1035,1007,313,313,282,268,141,75,141,193,25,24,825,925,825,1300,300,0,1
271,0,2,46.0,37.0,55.0,47.0,1454,1236,1119,923,335,313,161,363,55,130,106,233,25,24,1050,925,825,1300,300,0,1
279,0,2,46.0,38.0,55.0,47.0,1426,1342,1091,1007,335,335,321,423,175,150,146,273,26,25,1050,925,825,1300,300,0,1
286,0,2,46.0,38.0,55.0,47.0,1460,1236,1147,923,313,313,367,564,185,255,182,309,26,26,1350,925,825,1300,300,0,1
293,0,2,49.0,31.0,55.0,47.0,1426,1180,1091,867,335,313,272,659,150,310,122,349,26,26,1350,225,825,1300,300,700,1
300,0,2,49.0,31.0,55.0,47.0,1482,1314,1147,979,335,335,437,774,275,385,162,389,26,26,1575,225,825,1450,300,700,1
307,0,2,51.0,28.0,63.0,55.0,1572,1230,1259,895,313,335,308,764,260,335,48,429,26,27,1575,0,825,1450,300,925,1
314,0,2,49.0,35.0,63.0,55.0,1678,1258,1343,923,335,335,618,170,455,80,163,90,26,28,1575,0,825,1750,300,925,1
321,0,2,49.0,35.0,63.0,47.0,1650,1264,1315,951,335,313,478,226,275,100,203,126,26,29,1825,750,725,1750,363,1025,1
329,0,2,52.0,36.0,63.0,47.0,1684,1320,1371,1007,313,313,289,331,175,165,114,166,26,29,1825,750,725,1450,363,1325,1
336,0,2,49.0,36.0,63.0,62.0,1600,1264,1287,951,313,313,549,481,470,275,79,206,25,30,1775,750,800,1550,413,1325,1
7,0,2,13.0,12.0,15.0,15.0,293,293,293,293,0,0,35,85,35,85,0,0,12,12,0,0,0,0,0,0,1
14,0,2,14.0,13.0,15.0,15.0,643,615,643,615,0,0,65,10,65,10,0,0,13,12,0,0,0,0,0,0,1
21,0,2,14.0,13.0,15.0,15.0,643,699,643,699,0,0,40,35,40,35,0,0,13,12,0,0,0,0,0,0,1
29,0,2,15.0,13.0,15.0,23.0,643,643,643,643,0,0,65,10,65,10,0,0,14,13,0,0,0,0,0,0,1
36,0,2,15.0,14.0,15.0,23.0,699,699,699,699,0,0,110,40,110,40,0,0,14,13,0,0,0,0,0,0,1
43,0,2,16.0,15.0,23.0,23.0,699,727,699,727,0,0,35,10,35,10,0,0,15,14,0,0,0,0,0,0,1
50,0,2,16.0,16.0,23.0,23.0,755,783,755,783,0,0,50,55,50,55,0,0,15,15,0,0,0,0,0,0,1
57,0,2,17.0,16.0,23.0,23.0,727,839,727,839,0,0,25,100,25,100,0,0,16,15,0,0,0,0,0,0,1
64,0,2,18.0,17.0,23.0,23.0,783,867,783,867,0,0,65,210,65,210,0,0,17,16,0,0,0,0,0,0,1
71,0,2,18.0,18.0,23.0,23.0,777,895,755,895,22,0,109,270,105,270,4,0,17,17,0,0,0,0,0,0,1
79,0,2,19.0,18.0,23.0,23.0,805,833,671,811,134,22,204,164,180,160,24,4,18,17,0,0,0,150,0,0,1
86,0,2,19.0,19.0,23.0,23.0,973,934,727,867,246,67,326,287,270,275,56,12,18,18,0,0,0,150,0,0,1
93,0,2,20.0,19.0,23.0,23.0,956,1006,643,895,313,111,177,358,135,330,42,28,19,18,0,0,150,150,0,0,1
100,0,2,20.0,20.0,23.0,23.0,1062,1001,727,867,335,134,207,479,125,435,82,44,19,19,0,0,150,150,0,0,1
107,0,2,20.0,20.0,23.0,23.0,956,1034,643,923,313,111,318,506,200,450,118,56,19,20,0,0,150,150,0,0,1
114,0,2,20.0,23.0,23.0,23.0,1012,1029,699,895,313,134,188,457,130,410,58,47,19,20,0,0,150,300,0,0,1
121,0,2,20.0,23.0,31.0,31.0,900,1051,587,895,313,156,113,582,15,515,98,67,18,20,0,0,150,300,50,0,1
129,0,2,21.0,24.0,31.0,31.0,1090,1079,755,923,335,156,247,162,159,125,88,37,18,21,100,0,150,300,50,0,1
136,0,2,22.0,26.0,31.0,31.0,1202,911,867,755,335,156,332,137,204,105,128,32,19,22,100,125,150,300,50,0,1
143,0,2,22.0,26.0,31.0,31.0,1342,766,1007,587,335,179,483,52,319,25,164,27,19,21,100,125,150,300,50,50,1
150,0,2,23.0,25.0,31.0,31.0,1286,385,951,251,335,134,573,89,369,50,204,39,20,20,100,125,150,300,50,100,1
157,0,2,24.0,26.0,31.0,31.0,1320,542,1007,475,313,67,284,72,44,25,240,47,21,21,100,125,400,300,50,100,1
164,0,2,26.0,29.0,31.0,31.0,1180,794,867,727,313,67,339,90,59,35,280,55,21,22,200,250,400,300,50,100,1
171,0,2,27.0,28.0,31.0,31.0,1292,816,979,727,313,89,454,132,134,65,320,67,22,21,200,250,400,300,50,200,1
179,0,2,26.0,28.0,31.0,31.0,1342,637,1007,503,335,134,374,118,114,35,260,83,22,21,100,250,400,300,150,200,1
186,0,2,27.0,29.0,31.0,31.0,1309,945,951,811,358,134,379,234,79,135,300,99,23,22,200,250,400,300,150,200,1
193,0,2,29.0,30.0,31.0,31.0,1258,1107,923,951,335,156,385,329,74,210,311,119,23,23,200,375,400,300,150,200,1
200,0,2,30.0,32.0,31.0,46.0,1404,1163,1091,1007,313,156,546,244,199,155,347,89,24,23,200,375,400,300,150,200,1
207,0,2,31.0,34.0,39.0,46.0,1432,1180,1119,979,313,201,561,278,199,165,362,113,25,24,200,375,400,300,150,200,1
214,0,2,33.0,35.0,39.0,46.0,1460,1214,1147,923,313,291,681,374,279,225,402,149,25,25,300,375,650,300,150,200,1
221,0,2,34.0,35.0,39.0,46.0,1426,1292,1091,979,335,313,661,74,319,35,342,39,26,25,200,375,650,300,250,250,1
229,0,2,34.0,37.0,39.0,46.0,1370,1292,1035,979,335,313,773,179,393,100,380,79,26,27,200,375,650,300,250,250,1
236,0,2,34.0,39.0,54.0,46.0,1370,1342,1035,1007,335,335,702,194,313,75,389,119,27,29,200,550,650,300,350,250,1
243,0,2,35.0,41.0,54.0,46.0,1454,1488,1119,1175,335,313,442,380,63,225,379,155,28,31,200,550,650,300,350,250,1
250,0,2,35.0,41.0,54.0,46.0,1460,1678,1147,1343,313,335,543,435,153,240,390,195,28,31,400,550,650,300,350,250,1
257,0,2,36.0,43.0,54.0,46.0,1460,1706,1147,1371,313,335,548,480,118,245,430,235,29,33,400,550,725,300,350,250,1
264,0,2,39.0,46.0,54.0,46.0,1600,1824,1287,1511,313,313,463,451,118,280,345,171,29,34,400,550,725,600,350,250,1
271,0,2,42.0,46.0,54.0,46.0,1762,1790,1427,1455,335,335,318,416,133,205,185,211,30,36,400,550,800,600,350,250,1
279,0,2,42.0,48.0,54.0,54.0,1790,2042,1455,1707,335,335,383,576,158,325,225,251,30,36,400,550,800,600,350,250,1
286,0,2,43.0,52.0,54.0,54.0,1650,1936,1315,1623,335,313,594,452,333,265,261,187,31,38,400,800,925,600,350,250,1
293,0,2,47.0,53.0,54.0,54.0,1488,2076,1175,1763,313,313,375,452,178,225,197,227,32,39,400,800,1325,600,350,250,1
300,0,2,46.0,54.0,62.0,62.0,1544,2042,1231,1707,313,335,553,647,316,380,237,267,31,40,675,800,1325,600,401,250,1
307,0,2,50.0,56.0,62.0,62.0,1628,2210,1315,1875,313,335,339,507,187,200,152,307,31,42,675,800,1325,600,401,250,1
314,0,2,52.0,56.0,62.0,70.0,1796,1852,1483,1539,313,313,579,663,387,320,192,343,31,42,1175,1050,1325,600,401,300,1
321,0,2,52.0,56.0,62.0,70.0,1566,1275,1231,1007,335,268,449,711,217,340,232,371,32,42,1075,1050,1325,600,515,350,1
329,0,2,53.0,59.0,62.0,70.0,1477,1505,1119,1259,358,246,524,608,252,305,272,303,33,43,1175,1050,1325,600,515,350,1
336,0,2,56.0,60.0,62.0,70.0,1650,2171,1315,1791,335,380,525,430,267,175,258,255,34,44,1450,1050,1325,750,515,350,1
343,0,2,58.0,61.0,62.0,70.0,2076,2210,1763,1763,313,447,256,386,137,175,119,211,36,45,1450,1050,1425,750,515,400,1
350,0,2,62.0,68.0,70.0,78.0,2384,2502,2071,1987,313,515,386,345,227,270,159,75,36,46,1550,1600,1425,750,515,400,1
357,0,2,66.0,69.0,70.0,78.0,2440,2311,2127,1819,313,492,436,511,262,380,174,131,38,47,1550,1600,1425,750,515,400,1
364,0,2,64.0,70.0,70.0,78.0,2406,2490,2071,1931,335,559,303,777,193,570,110,207,38,48,1575,1600,1425,750,615,400,1
371,0,2,70.0,71.0,70.0,78.0,2283,2362,1903,1735,380,627,209,593,87,410,122,183,40,49,1675,1600,1425,750,615,400,1
379,0,2,70.0,75.0,70.0,78.0,2423,2468,1931,1819,492,649,490,894,312,635,178,259,40,51,1800,1850,1425,750,615,400,1
386,0,2,76.0,76.0,78.0,93.0,2670,2446,2155,1819,515,627,435,722,247,545,188,177,42,51,1900,1850,1525,1000,615,400,1
393,0,2,78.0,82.0,78.0,101.0,2541,2642,2071,2015,470,627,112,219,97,170,15,49,42,53,2025,1850,1525,1000,615,400,1
400,0,2,86.0,83.0,86.0,101.0,2513,2726,2043,2099,470,627,107,396,57,275,50,121,44,55,2025,2100,1525,1000,615,400,1
407,0,2,88.0,84.0,94.0,101.0,2317,2899,1847,2295,470,604,202,242,92,45,110,197,44,56,2225,2100,1525,1000,615,400,1
414,0,2,94.0,88.0,102.0,101.0,2395,2815,1903,2211,492,604,97,342,27,165,70,177,46,57,2450,2100,1525,1100,615,400,1
421,0,2,98.0,89.0,102.0,101.0,2362,3084,1847,2435,515,649,152,468,47,215,105,253,46,59,2450,2250,1525,1100,615,400,1
429,0,2,98.0,89.0,102.0,109.0,2406,3196,1847,2547,559,649,351,854,182,525,169,329,48,60,2975,2625,1525,1250,615,400,1
436,0,2,103.0,95.0,118.0,117.0,2586,3252,1959,2603,627,649,143,635,77,430,66,205,47,61,3050,2500,1525,1800,790,525,1
443,0,2,103.0,95.0,118.0,125.0,2502,3252,1875,2603,627,649,353,390,207,255,146,135,47,61,3275,2600,1525,1800,790,525,1
450,0,2,109.0,97.0,118.0,125.0,2552,3286,1903,2659,649,627,238,526,137,315,101,211,47,61,3275,2700,1525,1800,790,525,1
457,0,2,111.0,99.0,126.0,125.0,2552,3196,1903,2547,649,649,469,656,292,365,177,291,47,61,3600,2700,1525,2250,790,525,1
464,0,2,109.0,99.0,134.0,125.0,2748,3084,2099,2435,649,649,809,622,552,455,257,167,49,61,3600,2800,1525,2250,1090,525,1
471,0,2,109.0,105.0,134.0,133.0,2910,3185,2239,2491,671,694,760,501,427,250,333,251,49,61,3725,2950,1525,2400,1090,775,1
479,0,2,115.0,109.0,134.0,133.0,2910,3358,2239,2463,671,895,580,392,292,225,288,167,49,59,3725,3450,1525,2500,1090,950,1
486,0,2,111.0,106.0,134.0,133.0,2810,3381,2183,2463,627,918,602,782,242,515,360,267,49,58,3700,3350,1525,2500,1190,1100,1
493,0,2,106.0,98.0,134.0,133.0,2832,3297,2183,2491,649,806,942,1173,502,810,440,363,51,58,3450,2950,1525,2500,1440,1500,1
500,0,2,107.0,109.0,134.0,133.0,2860,3269,2211,2463,649,806,782,629,312,420,470,209,51,58,3125,3825,1525,2500,1990,1500,1
507,0,2,102.0,107.0,134.0,125.0,2888,3213,2239,2407,649,806,1073,1019,527,710,546,309,53,58,2825,3650,1525,2600,2290,1775,1
514,0,2,98.0,97.0,134.0,125.0,2776,3185,2127,2379,649,806,493,900,167,695,326,205,53,59,2175,2875,1525,2600,2940,2550,1
521,0,2,99.0,101.0,142.0,125.0,2798,3101,2127,2295,671,806,324,1161,122,860,202,301,53,59,2200,3025,1525,2600,3265,2900,1
529,0,2,99.0,112.0,142.0,125.0,2664,3179,2015,2351,649,828,510,996,232,595,278,401,53,59,2150,3525,1525,2600,3315,2900,1
536,0,2,100.0,112.0,142.0,125.0,2502,2966,1875,2071,627,895,711,1344,357,835,354,509,55,61,2200,3525,1825,2600,3515,2900,1
543,0,2,100.0,112.0,157.0,125.0,2552,3090,1903,2127,649,963,696,1356,337,935,359,421,55,62,2450,3525,1825,2600,3945,2900,1
550,0,2,106.0,112.0,157.0,125.0,2670,3034,2043,2071,627,963,422,1317,137,780,285,537,57,62,2500,3525,1825,2600,3945,2900,1
557,0,2,106.0,122.0,157.0,125.0,2440,3196,1791,2211,649,985,582,1212,217,555,365,657,57,62,2550,3525,1825,2600,3945,2900,1
564,0,2,112.0,124.0,157.0,125.0,2434,3252,1763,2267,671,985,418,1088,27,415,391,673,59,62,2550,4525,1900,2600,3945,2900,1
571,0,2,114.0,124.0,157.0,125.0,2546,3202,1875,2239,671,963,553,669,132,80,421,589,61,64,2800,4525,1900,2600,3945,2900,1
579,0,2,118.0,124.0,157.0,125.0,2418,3190,1791,2183,627,1007,635,900,192,195,443,705,61,64,3200,4525,2125,2600,3945,3000,1
586,0,2,124.0,124.0,157.0,125.0,2580,3274,1931,2267,649,1007,610,995,137,170,473,825,61,64,3425,4525,2125,2950,3945,3000,1
593,0,2,123.0,130.0,157.0,149.0,2468,3207,1819,2267,649,940,915,1363,362,430,553,933,61,64,3500,4525,2125,2950,3995,3000,1
600,0,2,125.0,140.0,157.0,157.0,2692,3454,2043,2491,649,963,1161,903,532,450,629,453,61,64,3700,4525,2375,2950,3995,3000,1
607,0,2,124.0,140.0,157.0,157.0,2664,3370,2015,2407,649,963,436,1074,177,505,259,569,61,64,4000,5425,2575,2950,4045,3000,1
614,0,2,118.0,132.0,157.0,157.0,3386,3364,2715,2379,671,985,857,1489,522,800,335,689,61,64,3625,4875,2575,2950,4295,3550,1
621,0,2,116.0,128.0,157.0,165.0,3414,3336,2743,2351,671,985,812,1885,472,1080,340,805,61,64,3125,4675,2575,2950,4895,3750,1
629,0,2,117.0,129.0,157.0,173.0,3582,3414,2911,2407,671,1007,1107,2081,687,1160,420,921,61,64,3025,4675,2575,3250,4995,3750,1
636,0,2,119.0,139.0,157.0,188.0,3622,3258,2883,2295,739,963,610,1428,477,995,133,433,64,64,3025,4775,2575,3400,4995,3750,1
643,0,2,124.0,145.0,157.0,188.0,3638,3286,2855,2323,783,963,681,1274,452,725,229,549,64,65,3450,5175,2575,3400,5045,3850,1
650,0,2,125.0,142.0,157.0,188.0,3582,3280,2799,2295,783,985,433,1629,362,960,71,669,64,65,3350,6125,2575,3400,5145,4200,1
657,0,2,123.0,137.0,157.0,188.0,3689,3437,2883,2519,806,918,889,1752,722,975,167,777,64,59,3250,6000,2575,3400,5345,4625,1
664,0,2,112.0,135.0,157.0,188.0,3605,3129,2799,2323,806,806,636,2103,477,1230,159,873,66,59,2350,6250,2575,3550,6245,4775,1
671,0,2,118.0,152.0,157.0,188.0,3414,3207,2631,2379,783,828,908,1353,657,530,251,823,66,60,3175,7050,2575,3700,6295,4775,1
679,0,2,118.0,155.0,157.0,196.0,3258,3230,2407,2379,851,851,687,1518,482,595,205,923,66,61,3175,7050,2575,3700,6295,4775,1
686,0,2,124.0,157.0,157.0,196.0,3622,3246,2659,2463,963,783,832,1591,557,580,275,1011,66,65,3375,7050,2575,3700,6295,4775,1
693,0,2,124.0,169.0,157.0,196.0,3683,3129,2743,2323,940,806,1278,911,887,100,391,811,66,66,3400,7050,2575,3700,6395,4775,1
700,0,2,135.0,173.0,157.0,196.0,3566,3353,2603,2547,963,806,658,847,572,90,86,757,66,67,4050,8100,2575,3700,6395,4775,1
707,0,2,135.0,173.0,157.0,196.0,3672,3577,2687,2771,985,806,674,922,597,215,77,707,66,67,4200,8100,2575,3700,6445,4775,1
714,0,2,137.0,176.0,172.0,196.0,3745,3302,2715,2519,1030,783,1129,1113,932,310,197,803,66,71,4425,7975,2575,3950,6445,4900,1
721,0,2,142.0,188.0,172.0,196.0,3678,3510,2715,2659,963,851,957,958,752,55,205,903,64,71,4725,8475,2800,3950,6545,4900,1
729,0,2,139.0,189.0,172.0,196.0,3504,3627,2631,2799,873,828,612,1364,407,365,205,999,60,72,5125,8775,2950,3950,6795,4900,1
736,0,2,127.0,172.0,172.0,196.0,3151,3409,2435,2603,716,806,490,1466,347,525,143,941,54,71,4350,7875,2850,3950,7876,5900,1
743,0,2,117.0,159.0,172.0,196.0,2037,2933,1455,2127,582,806,311,1811,157,770,154,1041,46,68,4400,7375,2850,3950,8826,6550,1
750,0,2,73.0,163.0,172.0,196.0,374,2877,83,2071,291,806,159,1362,0,225,159,1137,16,68,3450,6725,2850,3950,11608,7200,1
757,0,2,47.0,151.0,172.0,196.0,223,2905,0,2099,223,806,183,1552,0,315,183,1237,3,65,2150,6500,2625,3950,14016,8375,1
7,2,0,13.0,13.0,15.0,15.0,293,251,293,251,0,0,35,30,35,30,0,0,12,12,0,0,0,0,0,0,1
14,2,0,14.0,14.0,15.0,15.0,671,671,671,671,0,0,70,70,70,70,0,0,13,13,0,0,0,0,0,0,1
21,2,0,14.0,14.0,15.0,15.0,699,755,699,755,0,0,50,50,50,50,0,0,13,13,0,0,0,0,0,0,1
29,2,0,15.0,14.0,15.0,15.0,671,727,671,727,0,0,35,130,35,130,0,0,14,14,0,0,0,0,0,0,1
36,2,0,15.0,14.0,15.0,15.0,755,783,755,783,0,0,140,160,140,160,0,0,14,14,0,0,0,0,0,0,1
43,2,0,16.0,14.0,23.0,23.0,783,727,783,727,0,0,35,80,35,80,0,0,15,14,0,0,0,0,0,0,1
50,2,0,17.0,14.0,23.0,23.0,811,727,811,727,0,0,10,165,10,165,0,0,16,14,0,0,0,0,0,0,1
57,2,0,18.0,14.0,23.0,23.0,811,727,811,727,0,0,120,250,120,250,0,0,17,14,0,0,0,0,0,0,1
64,2,0,19.0,14.0,23.0,23.0,867,715,867,671,0,44,175,233,175,225,0,8,18,14,0,0,0,0,0,0,1
71,2,0,19.0,14.0,23.0,23.0,973,693,951,559,22,134,299,239,295,215,4,24,18,14,0,0,0,0,0,0,1
79,2,0,20.0,14.0,23.0,23.0,995,687,951,531,44,156,368,319,360,275,8,44,19,14,0,0,0,0,0,0,1
86,2,0,20.0,14.0,23.0,23.0,1012,659,923,503,89,156,94,394,70,330,24,64,19,14,0,0,150,0,0,0,1
93,2,0,20.0,16.0,23.0,31.0,1034,659,923,503,111,156,61,374,25,290,36,84,20,14,0,0,150,150,0,0,1
100,2,0,21.0,17.0,23.0,31.0,1107,777,951,531,156,246,71,421,15,305,56,116,20,15,0,0,150,150,0,0,1
107,2,0,22.0,17.0,23.0,31.0,1079,838,923,503,156,335,151,462,75,310,76,152,21,15,0,0,150,150,0,0,1
114,2,0,22.0,18.0,23.0,31.0,1051,872,895,559,156,313,181,563,85,375,96,188,21,16,0,50,150,150,0,0,1
121,2,0,23.0,18.0,23.0,31.0,1074,844,895,531,179,313,261,618,145,390,116,228,22,16,0,50,150,150,0,0,1
129,2,0,25.0,20.0,31.0,31.0,1202,950,979,615,223,335,239,683,120,415,119,268,22,17,0,50,300,150,0,0,1
136,2,0,26.0,20.0,31.0,31.0,1236,978,923,643,313,335,79,753,70,445,9,308,23,17,0,50,300,150,0,0,1
143,2,0,27.0,21.0,31.0,31.0,1236,978,923,643,313,335,139,809,90,465,49,344,24,18,0,100,300,150,0,0,1
150,2,0,29.0,22.0,31.0,31.0,1286,1006,951,671,335,335,69,934,55,550,14,384,24,19,125,100,300,150,0,0,1
157,2,0,31.0,23.0,46.0,31.0,1342,984,1007,671,335,313,74,995,20,575,54,420,25,19,125,100,300,150,0,0,1
164,2,0,33.0,23.0,46.0,31.0,1370,1096,1035,783,335,313,245,980,155,520,90,460,27,20,125,100,300,150,0,0,1
171,2,0,35.0,23.0,46.0,31.0,1454,1096,1119,783,335,313,265,1110,135,610,130,500,29,20,125,100,300,150,0,0,1
179,2,0,38.0,23.0,46.0,31.0,1544,1090,1231,755,313,335,151,1240,135,700,16,540,29,20,250,150,600,150,0,0,1
186,2,0,40.0,23.0,46.0,31.0,1656,1068,1343,755,313,313,196,1366,140,790,56,576,31,20,250,150,600,150,0,0,1
193,2,0,40.0,23.0,46.0,31.0,1634,1062,1343,727,291,335,347,1496,255,880,92,616,31,20,250,150,600,150,0,0,1
200,2,0,42.0,23.0,46.0,31.0,1656,1258,1343,923,313,335,102,1661,70,1005,32,656,33,20,250,150,600,150,0,0,1
207,2,0,43.0,23.0,54.0,31.0,1684,1180,1371,867,313,313,102,1802,30,1110,72,692,35,20,550,150,600,150,0,0,1
214,2,0,44.0,23.0,54.0,31.0,1729,1264,1371,951,358,313,157,1972,45,1240,112,732,35,20,550,150,600,150,0,0,1
221,2,0,45.0,23.0,54.0,31.0,1818,1230,1483,895,335,335,273,2117,125,1345,148,772,36,20,550,150,600,150,0,0,1
229,2,0,46.0,23.0,54.0,31.0,1880,1258,1567,923,313,335,399,2277,215,1465,184,812,37,20,550,150,600,150,0,0,1
236,2,0,48.0,23.0,54.0,31.0,1964,1264,1651,951,313,313,344,2433,270,1585,74,848,39,20,550,150,850,150,0,0,1
243,2,0,49.0,23.0,62.0,31.0,2132,1370,1819,1035,313,335,154,2598,40,1710,114,888,40,20,550,150,850,150,0,0,1
250,2,0,50.0,23.0,62.0,31.0,2160,1292,1847,979,313,313,364,2734,210,1810,154,924,41,20,550,150,1000,150,0,0,1
257,2,0,54.0,23.0,62.0,31.0,2182,1180,1847,867,335,313,269,2864,175,1900,94,964,42,20,725,150,1150,150,0,0,1
264,2,0,57.0,23.0,62.0,31.0,2233,1180,1875,867,358,313,174,3014,90,2010,84,1004,43,20,900,150,1150,150,0,0,1
271,2,0,58.0,23.0,62.0,31.0,2210,1202,1875,867,335,335,340,3169,220,2125,120,1044,43,20,1075,150,1150,150,0,0,1
279,2,0,61.0,23.0,62.0,31.0,2104,1174,1791,839,313,335,156,3309,150,2225,6,1084,45,20,1075,150,1150,150,0,0,1
286,2,0,62.0,23.0,62.0,31.0,2121,1174,1763,839,358,335,124,3455,70,2335,54,1120,45,20,1250,150,1150,150,0,0,1
293,2,0,62.0,23.0,62.0,31.0,2350,1174,1791,839,559,335,310,3610,180,2450,130,1160,46,20,1250,150,1150,150,0,0,1
300,2,0,64.0,23.0,70.0,31.0,2390,1152,1763,839,627,313,607,3751,405,2555,202,1196,47,20,1250,150,1150,150,0,0,1
307,2,0,70.0,23.0,70.0,31.0,2434,1124,1763,811,671,313,282,3901,150,2665,132,1236,47,20,1775,150,1150,150,0,0,1
314,2,0,73.0,23.0,85.0,31.0,2541,1174,1847,839,694,335,442,4051,230,2775,212,1276,49,20,1775,150,1150,150,0,0,1
321,2,0,74.0,23.0,85.0,31.0,2502,1174,1875,839,627,335,640,4211,435,2895,205,1316,49,20,1775,150,1550,150,0,0,1
329,2,0,77.0,23.0,85.0,31.0,2608,1180,1959,867,649,313,370,4352,335,3000,35,1352,52,20,1775,150,1550,150,0,0,1
336,2,0,79.0,23.0,85.0,31.0,2703,1174,2099,839,604,335,342,4502,335,3110,7,1392,54,20,1775,150,1550,150,0,0,1
343,2,0,82.0,23.0,85.0,31.0,2866,1370,2239,1035,627,335,157,4632,70,3200,87,1432,57,19,1875,150,1550,150,0,50,1
350,2,0,84.0,23.0,85.0,31.0,2927,1320,2323,1007,604,313,269,4778,185,3310,84,1468,58,19,1875,150,1550,150,0,50,1
357,2,0,85.0,25.0,85.0,31.0,3274,1275,2603,1007,671,268,359,4460,195,3060,164,1400,60,20,1875,150,1550,150,0,50,1
364,2,0,85.0,23.0,85.0,31.0,3224,1191,2575,923,649,268,481,4551,245,3115,236,1436,62,21,1875,0,1550,150,0,200,1
371,2,0,85.0,23.0,85.0,31.0,3342,1236,2715,923,627,313,628,4691,520,3215,108,1476,62,21,1975,50,1850,150,0,200,1
379,2,0,97.0,24.0,109.0,39.0,3448,1342,2799,1007,649,335,753,4691,565,3175,188,1516,62,22,2275,50,1850,150,0,200,1
386,2,0,97.0,25.0,109.0,39.0,3560,1124,2911,811,649,313,1163,4702,895,3150,268,1552,62,22,2275,50,1950,150,0,200,1
393,2,0,97.0,26.0,109.0,39.0,3398,1068,2771,755,627,313,1564,4837,1220,3245,344,1592,62,23,2275,50,2400,150,0,200,1
400,2,0,97.0,27.0,109.0,47.0,3498,1062,2827,727,671,335,1989,4912,1565,3280,424,1632,62,24,2275,50,2400,400,0,200,1
407,2,0,97.0,27.0,109.0,47.0,3554,1124,2883,811,671,313,2400,4723,1900,3180,500,1543,62,24,2275,100,2400,400,0,200,1
414,2,0,97.0,27.0,109.0,47.0,3504,1124,2855,811,649,313,2806,4458,2230,2875,576,1583,62,25,2275,100,2400,400,0,200,1
421,2,0,97.0,28.0,109.0,47.0,3482,1197,2855,839,627,358,3222,4553,2570,2930,652,1623,62,25,2275,100,2400,475,0,200,1
429,2,0,97.0,28.0,109.0,47.0,3392,1225,2743,867,649,358,3637,4698,2905,3035,732,1663,62,25,2775,100,2400,475,0,200,1
436,2,0,97.0,28.0,109.0,47.0,3498,1208,2827,895,671,313,4052,4840,3240,3145,812,1695,62,25,2775,100,2400,475,0,200,1
443,2,0,97.0,28.0,109.0,47.0,3370,1208,2743,895,627,313,4464,4915,3580,3205,884,1710,62,25,2775,150,2400,725,0,200,1
450,2,0,97.0,28.0,109.0,47.0,3498,1208,2827,895,671,313,4874,5060,3910,3310,964,1750,62,25,2775,150,2400,725,0,200,1
457,2,0,97.0,30.0,109.0,47.0,3448,1236,2799,923,649,313,5295,5085,4255,3320,1040,1765,62,25,2775,150,2400,725,0,200,1
464,2,0,97.0,32.0,109.0,47.0,3398,1174,2771,839,627,335,5706,4925,4590,3320,1116,1605,62,25,2775,150,2400,800,0,200,1
471,2,0,97.0,32.0,109.0,47.0,3498,1197,2827,839,671,358,6126,5065,4930,3420,1196,1645,62,25,2775,150,2400,800,0,200,1
479,2,0,97.0,32.0,109.0,47.0,3420,1174,2771,839,649,335,6527,5196,5255,3515,1272,1681,62,25,2775,275,2400,800,0,200,1
486,2,0,97.0,32.0,109.0,62.0,3482,1180,2855,867,627,313,6948,5332,5600,3615,1348,1717,62,25,2775,275,2400,800,0,200,1
493,2,0,97.0,34.0,109.0,62.0,3448,967,2799,699,649,268,7358,5264,5930,3515,1428,1749,62,25,2775,275,2400,800,0,200,1
500,2,0,97.0,30.0,109.0,62.0,3442,934,2771,643,671,291,7753,5039,6245,3450,1508,1589,62,26,2775,0,2400,800,0,475,1
507,2,0,97.0,33.0,109.0,62.0,3386,1146,2715,811,671,335,8164,5049,6580,3420,1584,1629,62,27,2775,350,2400,800,0,475,1
514,2,0,97.0,34.0,109.0,62.0,3314,1320,2687,1007,627,313,8556,5165,6900,3500,1656,1665,62,28,2775,350,2400,800,0,475,1
521,2,0,97.0,37.0,109.0,62.0,3392,1527,2743,1147,649,380,8951,5208,7215,3495,1736,1713,62,29,2775,350,2400,800,0,475,1
529,2,0,97.0,38.0,109.0,62.0,3224,1516,2575,1091,649,425,9326,5341,7510,3580,1816,1761,62,30,2775,350,2400,800,0,475,1
536,2,0,97.0,39.0,109.0,62.0,3118,1611,2491,1119,627,492,9707,5494,7815,3665,1892,1829,62,31,2775,350,2400,800,0,475,1
543,2,0,97.0,40.0,109.0,62.0,3218,1886,2547,1259,671,627,10082,5714,8110,3805,1972,1909,62,32,2775,450,2400,800,0,475,1
550,2,0,97.0,43.0,109.0,62.0,3190,1992,2519,1343,671,649,10448,5754,8400,3790,2048,1964,62,33,2775,750,2400,800,0,475,1
557,2,0,97.0,44.0,109.0,62.0,3062,2037,2435,1343,627,694,10810,5949,8690,3905,2120,2044,62,34,2775,750,2400,800,0,475,1
564,2,0,97.0,45.0,109.0,62.0,3118,2048,2491,1399,627,649,11185,6131,8985,4015,2200,2116,62,35,2775,750,2400,800,0,475,1
571,2,0,97.0,46.0,109.0,62.0,3084,2104,2435,1455,649,649,11560,6227,9280,4035,2280,2192,62,36,2775,875,2400,800,0,475,1
579,2,0,97.0,49.0,109.0,62.0,3140,2194,2491,1567,649,627,11931,6308,9575,4065,2356,2243,62,37,2775,875,2400,800,0,475,1
586,2,0,97.0,50.0,109.0,62.0,3168,2194,2519,1567,649,627,12302,6509,9870,4190,2432,2319,62,38,2775,875,2400,800,0,475,1
593,2,0,97.0,51.0,109.0,70.0,3162,2250,2491,1623,671,627,12687,6729,10175,4330,2512,2399,62,39,2775,875,2400,800,0,475,1
600,2,0,97.0,51.0,109.0,70.0,3196,2272,2547,1623,649,649,13048,6989,10460,4510,2588,2479,62,40,2775,1000,2400,800,0,475,1
607,2,0,97.0,53.0,109.0,70.0,3118,2462,2491,1791,627,671,13414,7174,10750,4615,2664,2559,62,40,2775,1000,2400,800,0,475,1
614,2,0,97.0,53.0,109.0,70.0,3078,2294,2407,1623,671,671,13769,7445,11025,4810,2744,2635,62,40,2775,1000,2400,800,0,475,1
621,2,0,97.0,53.0,109.0,70.0,3112,2356,2463,1707,649,649,14145,7722,11325,5015,2820,2707,62,40,2775,1000,2400,800,0,475,1
629,2,0,97.0,53.0,109.0,70.0,3146,2328,2519,1679,627,649,14511,8007,11615,5220,2896,2787,62,40,2775,1100,2400,800,0,475,1
636,2,0,97.0,54.0,109.0,70.0,3084,2390,2435,1763,649,627,14881,8248,11905,5385,2976,2863,62,40,2775,1100,2400,800,0,475,1
643,2,0,97.0,54.0,109.0,70.0,3134,2306,2463,1679,671,627,15251,8533,12195,5590,3056,2943,62,40,2775,1100,2400,800,0,475,1
650,2,0,97.0,54.0,109.0,70.0,3134,2446,2463,1819,671,627,15632,8809,12500,5790,3132,3019,62,40,2775,1100,2400,800,0,475,1
657,2,0,97.0,57.0,109.0,70.0,3034,2462,2407,1791,627,671,15979,8854,12775,5855,3204,2999,62,40,2775,1150,2400,800,0,475,1
664,2,0,97.0,57.0,109.0,70.0,3168,2384,2519,1735,649,649,16369,9017,13085,5950,3284,3067,62,40,2775,1150,2400,800,0,475,1
671,2,0,97.0,49.0,109.0,70.0,3028,2222,2379,1595,649,627,16734,9297,13370,6154,3364,3143,62,40,2775,725,2400,800,0,901,1
679,2,0,97.0,48.0,109.0,70.0,3118,2188,2491,1539,627,649,17100,9437,13660,6239,3440,3198,62,40,2775,650,2400,800,0,1026,1
686,2,0,97.0,48.0,109.0,78.0,3017,2244,2323,1595,694,649,17450,9523,13930,6349,3520,3174,62,40,2775,650,2400,800,0,1026,1
693,2,0,97.0,50.0,109.0,78.0,2972,2222,2323,1595,649,627,17812,9799,14220,6549,3592,3250,62,40,2775,900,2400,875,0,1026,1
700,2,0,97.0,51.0,109.0,78.0,2922,2294,2295,1623,627,671,18158,10044,14490,6714,3668,3330,62,40,2775,900,2400,875,0,1026,1
707,2,0,97.0,51.0,109.0,78.0,2972,2138,2323,1511,649,627,18508,10301,14760,6899,3748,3402,62,40,2775,900,2400,875,0,1026,1
714,2,0,97.0,52.0,109.0,78.0,2972,2278,2323,1651,649,627,18863,10236,15035,6954,3828,3282,62,40,2775,950,2400,875,0,1026,1
721,2,0,97.0,54.0,109.0,78.0,2860,2468,2211,1819,649,649,19194,10526,15290,7164,3904,3362,62,40,2775,1150,2400,875,0,1026,1
729,2,0,97.0,54.0,109.0,78.0,2888,2350,2239,1679,649,671,19540,10811,15560,7369,3980,3442,62,40,2775,1150,2400,875,0,1026,1
736,2,0,97.0,56.0,109.0,78.0,2826,2356,2155,1707,671,649,19870,10972,15810,7479,4060,3493,62,40,2775,1200,2400,875,0,1026,1
743,2,0,97.0,56.0,109.0,78.0,2776,2350,2127,1679,649,671,20201,11253,16065,7684,4136,3569,62,40,2775,1200,2400,875,0,1026,1
750,2,0,97.0,59.0,109.0,78.0,2782,2322,2155,1651,627,671,20532,11249,16320,7729,4212,3520,62,40,2775,1200,2400,875,0,1026,1
757,2,0,97.0,59.0,109.0,78.0,2826,2356,2155,1707,671,649,20877,11526,16585,7934,4292,3592,62,40,2775,1325,2400,875,0,1026,1
764,2,0,97.0,59.0,109.0,78.0,2832,2334,2183,1707,649,627,21208,11812,16840,8144,4368,3668,62,40,2775,1625,2400,875,0,1026,1
771,2,0,97.0,59.0,109.0,78.0,2782,2446,2155,1819,627,627,21539,12107,17095,8359,4444,3748,62,40,2775,1625,2400,875,0,1026,1
779,2,0,97.0,59.0,109.0,78.0,2776,2272,2127,1623,649,649,21874,12377,17350,8549,4524,3828,62,40,2775,1625,2400,875,0,1026,1
786,2,0,97.0,59.0,109.0,78.0,2770,2272,2099,1623,671,649,22209,12662,17605,8754,4604,3908,62,40,2775,1900,2400,875,0,1026,1
793,2,0,97.0,59.0,109.0,78.0,2804,2350,2155,1679,649,671,22541,12958,17865,8974,4676,3984,62,40,2775,1900,2400,875,0,1026,1
800,2,0,97.0,59.0,109.0,78.0,2614,2350,1987,1679,627,671,22852,13239,18100,9179,4752,4060,62,40,2775,1900,2400,875,0,1026,1
807,2,0,97.0,58.0,109.0,78.0,2608,2222,1959,1595,649,627,23157,13511,18325,9379,4832,4132,62,39,2775,1900,2400,875,0,1076,1
814,2,0,97.0,56.0,109.0,78.0,2586,2076,1959,1539,627,537,23458,13720,18550,9524,4908,4196,62,36,2775,1900,2400,875,0,1226,1
821,2,0,95.0,55.0,109.0,78.0,2272,2009,1623,1427,649,582,23713,13611,18725,9539,4988,4072,62,34,2600,1600,2400,875,175,1626,1
829,2,0,89.0,54.0,109.0,78.0,2093,1886,1399,1259,694,627,23948,13717,18880,9569,5068,4148,62,35,2075,1450,2400,875,700,1776,1
836,2,0,83.0,54.0,109.0,78.0,1964,1718,1315,1091,649,627,24175,13924,19035,9704,5140,4220,62,36,1550,1450,2400,875,1225,1776,1
843,2,0,83.0,55.0,109.0,78.0,1886,2014,1259,1343,627,671,24391,13734,19175,9434,5216,4300,62,37,1550,1500,2400,875,1225,1776,1
850,2,0,83.0,55.0,109.0,78.0,1852,1998,1203,1371,649,627,24611,13976,19315,9604,5296,4372,62,37,1550,1500,2400,875,1225,1776,1
857,2,0,83.0,55.0,109.0,78.0,1880,1998,1231,1371,649,627,24831,14226,19455,9774,5376,4452,62,37,1550,1500,2400,875,1225,1776,1
864,2,0,83.0,56.0,109.0,78.0,1852,2160,1203,1511,649,649,25047,14461,19595,9929,5452,4532,62,37,1550,1850,2400,875,1225,1776,1
871,2,0,83.0,56.0,109.0,78.0,1880,2182,1231,1511,649,671,25263,14716,19735,10104,5528,4612,62,37,1550,1850,2400,875,1225,1776,1
879,2,0,83.0,56.0,109.0,78.0,1874,2160,1203,1511,671,649,25483,14962,19875,10274,5608,4688,62,37,1550,1850,2400,875,1225,1776,1
886,2,0,83.0,56.0,109.0,78.0,1824,2210,1175,1539,649,671,25689,15223,20005,10459,5684,4764,62,37,1550,1900,2400,875,1225,1776,1
893,2,0,83.0,56.0,109.0,78.0,1746,2132,1119,1483,627,649,25900,15474,20140,10634,5760,4840,62,37,1550,1900,2400,875,1225,1776,1
900,2,0,83.0,58.0,109.0,78.0,1818,2138,1147,1511,671,627,26120,15625,20280,10709,5840,4916,62,37,1550,1900,2400,875,1225,1776,1
907,2,0,83.0,58.0,109.0,78.0,1768,1925,1119,1399,649,526,26336,15872,20420,10894,5916,4978,62,37,1550,1900,2400,875,1225,1776,1
914,2,0,83.0,61.0,109.0,93.0,1645,2003,1119,1511,526,492,26529,15877,20555,10864,5974,5013,62,37,1550,1900,2400,875,1225,1776,1
921,2,0,83.0,62.0,109.0,93.0,1639,1762,1147,1315,492,447,26734,16019,20700,10954,6034,5065,62,37,1550,2000,2400,875,1225,1776,1
929,2,0,83.0,65.0,109.0,93.0,1611,1701,1119,1231,492,470,26929,16055,20835,10934,6094,5121,62,38,1550,2000,2400,875,1225,1776,1
936,2,0,83.0,65.0,109.0,93.0,1639,1718,1147,1259,492,459,27130,16179,20980,11004,6150,5175,62,39,1550,2125,2400,875,1225,1776,1
943,2,0,83.0,65.0,109.0,93.0,1611,1774,1119,1427,492,347,27321,16109,21115,11019,6206,5090,62,40,1550,2125,2300,875,1325,1776,1
950,2,0,83.0,68.0,109.0,93.0,1639,2042,1147,1707,492,335,27526,16339,21260,11209,6266,5130,62,40,1550,2225,2300,875,1325,1776,1
957,2,0,83.0,68.0,109.0,93.0,1589,1986,1119,1651,470,335,27717,16559,21395,11389,6322,5170,62,40,1550,2225,2300,875,1325,1776,1
964,2,0,83.0,68.0,94.0,93.0,1471,1981,1035,1511,436,470,27896,16794,21520,11564,6376,5230,62,40,1550,2225,2300,875,1725,1776,1
971,2,0,78.0,68.0,94.0,93.0,1068,2003,699,1511,369,492,28016,17054,21600,11764,6416,5290,57,40,1550,2225,2300,875,1975,1776,1
979,2,0,75.0,68.0,78.0,93.0,1090,2003,755,1399,335,604,28142,17284,21690,11914,6452,5370,54,40,1550,2225,2300,875,2325,1776,1
986,2,0,70.0,68.0,78.0,93.0,900,2182,587,1511,313,671,28238,17554,21750,12104,6488,5450,49,40,1550,2500,2300,875,2575,1776,1
993,2,0,68.0,68.0,70.0,93.0,816,2126,503,1455,313,671,28338,17801,21810,12279,6528,5522,47,40,1550,2500,2300,875,2775,1776,1
1000,2,0,66.0,68.0,70.0,93.0,872,2378,559,1707,313,671,28438,18066,21870,12464,6568,5602,45,40,1550,2500,2300,875,2875,1776,1
1007,2,0,65.0,68.0,70.0,93.0,782,2362,447,1735,335,627,28528,18328,21920,12654,6608,5674,44,40,1550,2500,2300,875,2925,1776,1
1014,2,0,65.0,64.0,70.0,93.0,620,2362,307,1735,313,627,28589,18553,21945,12799,6644,5754,44,40,1550,2225,2300,875,2925,2051,1
1021,2,0,65.0,60.0,70.0,93.0,390,2138,55,1511,335,627,28629,18813,21945,12979,6684,5834,44,40,1550,1900,2300,875,2925,2376,1
1029,2,0,65.0,61.0,70.0,93.0,313,2210,0,1539,313,671,28665,19023,21945,13109,6720,5914,44,40,1550,1950,2300,875,2925,2376,1
1036,2,0,65.0,61.0,70.0,93.0,313,2182,0,1511,313,671,28705,19283,21945,13289,6760,5994,44,40,1550,1950,2300,875,2925,2376,1
1043,2,0,65.0,61.0,70.0,93.0,335,2266,0,1595,335,671,28745,19505,21945,13439,6800,6066,44,40,1550,1950,2300,875,2925,2376,1
1050,2,0,65.0,62.0,70.0,93.0,313,2250,0,1623,313,627,28781,19787,21945,13649,6836,6138,44,40,1550,2000,2300,875,2925,2376,1
1057,2,0,65.0,65.0,70.0,93.0,313,2250,0,1623,313,627,28821,19797,21945,13704,6876,6093,44,40,1550,2000,2300,875,2925,2376,1
1064,2,0,65.0,65.0,70.0,93.0,335,2250,0,1623,335,627,28861,20082,21945,13909,6916,6173,44,40,1550,2050,2300,875,2925,2376,1
1071,2,0,65.0,67.0,70.0,93.0,335,2390,0,1763,335,627,28901,20272,21945,14044,6956,6228,44,40,1550,2050,2300,875,2925,2376,1
1079,2,0,65.0,67.0,70.0,93.0,335,2490,0,1819,335,671,28937,20557,21945,14249,6992,6308,44,40,1550,2050,2300,875,2925,2376,1
1086,2,0,65.0,67.0,70.0,93.0,313,2625,0,1931,313,694,28973,20823,21945,14439,7028,6384,44,40,1550,2050,2300,875,2925,2376,1
1093,2,0,65.0,68.0,70.0,93.0,313,2770,0,2099,313,671,29013,21124,21945,14664,7068,6460,44,40,1550,2450,2300,875,2925,2376,1
1100,2,0,65.0,68.0,70.0,93.0,313,2558,0,1931,313,627,29053,21411,21945,14879,7108,6532,44,40,1550,2450,2300,875,2925,2376,1
1107,2,0,65.0,68.0,70.0,93.0,313,2418,0,1791,313,627,29093,21686,21945,15074,7148,6612,44,40,1550,2450,2300,875,2925,2376,1
1114,2,0,65.0,68.0,70.0,93.0,347,2418,0,1791,347,627,29131,21971,21945,15279,7186,6692,44,40,1550,2500,2300,875,2925,2376,1
1121,2,0,65.0,68.0,70.0,93.0,201,2294,0,1623,201,671,29145,22226,21945,15454,7200,6772,44,40,1550,2500,2300,875,2925,2376,1
1129,2,0,65.0,68.0,70.0,93.0,33,2294,0,1623,33,671,29145,22516,21945,15664,7200,6852,44,40,1550,2500,2300,875,2925,2376,1
1136,2,0,65.0,68.0,70.0,93.0,0,2322,0,1651,0,671,29145,22788,21945,15864,7200,6924,44,40,1550,2500,2300,875,2925,2376,1
1143,2,0,65.0,68.0,70.0,93.0,0,2294,0,1623,0,671,29145,23073,21945,16069,7200,7004,44,40,1550,2500,2300,875,2925,2376,1
1150,2,0,65.0,68.0,70.0,93.0,0,2250,0,1623,0,627,29145,23340,21945,16264,7200,7076,44,40,1550,2500,2300,875,2925,2376,1
1157,2,0,65.0,68.0,70.0,93.0,0,2418,0,1791,0,627,29145,23630,21945,16474,7200,7156,44,40,1550,2500,2300,875,2925,2376,1
1164,2,0,65.0,68.0,70.0,93.0,0,2418,0,1791,0,627,29145,23915,21945,16679,7200,7236,44,40,1550,2500,2300,875,2925,2376,1
1171,2,0,65.0,68.0,70.0,93.0,0,2406,0,1735,0,671,29145,24190,21945,16874,7200,7316,44,40,1550,2500,2300,875,2925,2376,1
1179,2,0,65.0,69.0,70.0,93.0,0,2345,0,1651,0,694,29145,24410,21945,17014,7200,7396,44,40,1550,2500,2300,875,2925,2376,1
1186,2,0,65.0,69.0,70.0,93.0,0,2322,0,1651,0,671,29145,24672,21945,17204,7200,7468,44,40,1550,2500,2300,875,2925,2376,1
1193,2,0,65.0,69.0,70.0,93.0,0,2334,0,1707,0,627,29145,24874,21945,17334,7200,7540,44,40,1550,2500,2300,875,2925,2376,1
1200,2,0,65.0,70.0,70.0,93.0,0,2278,0,1651,0,627,29145,25154,21945,17534,7200,7620,44,40,1550,2550,2300,875,2925,2376,1
1207,2,0,65.0,73.0,70.0,93.0,0,2138,0,1511,0,627,29145,25119,21945,17544,7200,7575,44,40,1550,2550,2300,875,2925,2376,1
1214,2,0,65.0,73.0,70.0,93.0,0,2138,0,1511,0,627,29145,25380,21945,17729,7200,7651,44,40,1550,2600,2300,875,2925,2376,1
1221,2,0,65.0,69.0,70.0,93.0,0,2216,0,1567,0,649,29145,25240,21945,17509,7200,7731,44,40,1550,2400,2300,875,2925,2576,1
1229,2,0,57.0,65.0,70.0,93.0,0,2266,0,1595,0,671,29145,25461,21945,17654,7200,7807,44,40,1125,2025,2300,875,3350,2951,1
1236,2,0,55.0,63.0,70.0,93.0,0,2345,0,1651,0,694,29145,25721,21945,17834,7200,7887,44,40,1000,2175,2300,875,3475,3076,1
1243,2,0,49.0,64.0,70.0,93.0,0,2300,0,1651,0,649,29145,25938,21945,17979,7200,7959,44,40,500,2225,2300,875,3975,3076,1
1250,2,0,47.0,64.0,62.0,93.0,0,2362,0,1735,0,627,29145,26209,21945,18174,7200,8035,42,40,500,2225,2300,875,4175,3076,1
1257,2,0,46.0,67.0,62.0,93.0,0,2222,0,1595,0,627,29145,26184,21945,18194,7200,7990,41,40,500,2225,2300,875,4225,3076,1
1264,2,0,45.0,67.0,62.0,93.0,0,1790,0,1231,0,559,29145,26393,21945,18339,7200,8054,40,40,500,2275,2300,875,4350,3076,1
1271,2,0,45.0,67.0,62.0,93.0,0,1566,0,1007,0,559,29145,26595,21945,18469,7200,8126,40,40,500,2275,2300,875,4350,3076,1
1279,2,0,48.0,67.0,62.0,93.0,0,1779,0,1175,0,604,28845,26803,21795,18609,7050,8194,40,40,500,2275,2300,875,4350,3076,1
1286,2,0,60.0,66.0,62.0,93.0,0,1998,0,1371,0,627,28245,27043,21195,18769,7050,8274,40,39,1100,2550,2300,875,4350,3126,1
1293,2,0,60.0,64.0,62.0,108.0,0,1986,0,1315,0,671,28245,27079,21195,18729,7050,8350,40,39,1100,2325,2300,875,4350,3351,1
1300,2,0,60.0,61.0,62.0,108.0,0,1936,0,1287,0,649,28245,27225,21195,18799,7050,8426,40,39,1100,2050,2300,875,4350,3626,1
1307,2,0,59.0,61.0,62.0,108.0,0,1802,0,1175,0,627,28245,27382,21195,18884,7050,8498,40,40,1300,2050,2300,875,4450,3626,1
1314,2,0,59.0,62.0,62.0,108.0,0,1970,0,1343,0,627,28245,27603,21195,19029,7050,8574,40,40,1300,2100,2300,875,4450,3626,1
1321,2,0,59.0,65.0,62.0,108.0,0,2182,0,1511,0,671,28245,27583,21195,19054,7050,8529,40,40,1300,2100,2300,875,4450,3626,1
1329,2,0,59.0,65.0,62.0,108.0,0,2266,0,1483,0,783,28245,27858,21195,19229,7050,8629,40,40,1300,2150,2300,875,4450,3626,1
1336,2,0,59.0,65.0,62.0,108.0,0,2317,0,1399,0,918,28245,28134,21195,19389,7050,8745,40,40,1300,2150,2300,875,4450,3626,1
1343,2,0,59.0,65.0,62.0,108.0,0,2154,0,1147,0,1007,28245,28389,21195,19524,7050,8865,40,40,1300,2150,2300,875,4450,3626,1
1350,2,0,59.0,65.0,62.0,108.0,0,2406,0,1399,0,1007,28245,28695,21195,19714,7050,8981,40,40,1300,2150,2300,875,4450,3626,1
1357,2,0,59.0,65.0,62.0,108.0,0,2446,0,1483,0,963,28245,28958,21195,19869,7050,9089,40,40,1300,2425,2300,875,4450,3626,1
1364,2,0,59.0,65.0,62.0,108.0,0,2261,0,1399,0,862,28245,29231,21195,20044,7050,9187,40,40,1300,2425,2300,875,4450,3626,1
1371,2,0,59.0,65.0,62.0,108.0,0,2121,0,1315,0,806,28245,29487,21195,20204,7050,9283,40,40,1300,2425,2300,875,4450,3626,1
1379,2,0,59.0,65.0,62.0,108.0,0,2171,0,1399,0,772,28245,29761,21195,20384,7050,9377,40,40,1300,2425,2300,875,4450,3626,1
1386,2,0,59.0,65.0,62.0,108.0,0,2115,0,1455,0,660,28245,30016,21195,20559,7050,9457,40,40,1300,2425,2300,875,4450,3626,1
1393,2,0,59.0,65.0,62.0,108.0,0,2406,0,1735,0,671,28245,30326,21195,20789,7050,9537,40,40,1300,2425,2300,875,4450,3626,1
1400,2,0,59.0,65.0,62.0,108.0,0,2412,0,1763,0,649,28245,30587,21195,20974,7050,9613,40,40,1300,2425,2300,875,4450,3626,1
1407,2,0,59.0,65.0,62.0,108.0,0,2462,0,1791,0,671,28245,30873,21195,21184,7050,9689,40,40,1300,2425,2300,875,4450,3626,1
1414,2,0,59.0,65.0,62.0,108.0,0,2272,0,1623,0,649,28245,31149,21195,21384,7050,9765,40,40,1300,2425,2300,875,4450,3626,1
1421,2,0,59.0,65.0,62.0,108.0,0,2334,0,1707,0,627,28245,31440,21195,21599,7050,9841,40,40,1300,2425,2300,875,4450,3626,1
1429,2,0,59.0,66.0,62.0,108.0,0,2278,0,1651,0,627,28245,31430,21195,21609,7050,9821,40,40,1300,2425,2300,875,4450,3626,1
1436,2,0,59.0,66.0,62.0,108.0,0,2300,0,1651,0,649,28245,31715,21195,21814,7050,9901,40,40,1300,2425,2300,875,4450,3626,1
1443,2,0,59.0,66.0,62.0,108.0,0,2244,0,1595,0,649,28245,31996,21195,22019,7050,9977,40,40,1300,2425,2300,875,4450,3626,1
1450,2,0,59.0,66.0,62.0,108.0,0,2076,0,1427,0,649,28245,32242,21195,22189,7050,10053,40,40,1300,2425,2300,875,4450,3626,1
1457,2,0,59.0,66.0,62.0,108.0,0,2216,0,1567,0,649,28245,32403,21195,22299,7050,10104,40,40,1300,2425,2300,875,4450,3626,1
1464,2,0,53.0,62.0,62.0,108.0,0,1998,0,1371,0,627,28245,32644,21195,22464,7050,10180,40,40,1000,2225,2300,875,4750,3926,1
1471,2,0,47.0,62.0,62.0,108.0,0,2076,0,1427,0,649,28245,32884,21195,22624,7050,10260,40,40,700,2225,2300,875,5050,3926,1
1479,2,0,47.0,62.0,62.0,108.0,0,2300,0,1651,0,649,28245,32909,21195,22694,7050,10215,40,40,700,2225,2300,1075,5050,3926,1
1486,2,0,47.0,64.0,47.0,108.0,0,2322,0,1651,0,671,28245,33170,21195,22879,7050,10291,40,40,700,2350,2300,1075,5450,3926,1
1493,2,0,47.0,64.0,47.0,108.0,0,2322,0,1651,0,671,28245,33450,21195,23079,7050,10371,40,40,700,2350,2050,1075,5700,3926,1
1500,2,0,47.0,64.0,47.0,108.0,0,2300,0,1651,0,649,28245,33727,21195,23284,7050,10443,40,40,700,2350,2050,1075,5700,3926,1
1507,2,0,47.0,64.0,47.0,108.0,0,2496,0,1847,0,649,28245,33762,21195,23364,7050,10398,40,40,700,2350,2050,1075,5700,3926,1
1514,2,0,42.0,66.0,47.0,108.0,0,2418,0,1791,0,627,28245,34028,21195,23554,7050,10474,35,40,700,2625,2050,1075,6025,3926,1
1521,2,0,35.0,66.0,47.0,108.0,0,2468,0,1819,0,649,28245,34318,21195,23764,7050,10554,28,40,700,2625,2050,1075,6375,3926,1
1529,2,0,35.0,66.0,47.0,108.0,0,2328,0,1679,0,649,28245,34579,21195,23949,7050,10630,28,40,700,2625,2050,1075,6375,3926,1
1536,2,0,35.0,66.0,47.0,108.0,0,2182,0,1511,0,671,28245,34774,21195,24064,7050,10710,28,40,700,2625,2050,1075,6375,3926,1
1543,2,0,35.0,67.0,47.0,108.0,0,2098,0,1427,0,671,28245,35020,21195,24234,7050,10786,28,40,700,2900,2050,1075,6375,3926,1
1550,2,0,34.0,67.0,47.0,108.0,0,2216,0,1567,0,649,28245,35292,21195,24434,7050,10858,27,40,700,2900,2050,1075,6425,3926,1
1557,2,0,34.0,68.0,47.0,108.0,0,2194,0,1567,0,627,28245,35503,21195,24569,7050,10934,27,40,700,2950,1650,1075,6825,3926,1
1564,2,0,34.0,68.0,47.0,108.0,0,2194,0,1567,0,627,28245,35788,21195,24774,7050,11014,27,40,700,2950,1650,1075,6825,3926,1
1571,2,0,34.0,68.0,47.0,108.0,0,2166,0,1539,0,627,28245,36013,21195,24919,7050,11094,27,40,700,2950,1650,1075,6825,3926,1
1579,2,0,34.0,69.0,47.0,108.0,0,2188,0,1539,0,649,28245,36273,21195,25099,7050,11174,27,40,700,3000,1350,1075,7125,3926,1
1586,2,0,34.0,69.0,47.0,108.0,0,2261,0,1567,0,694,28245,36563,21195,25309,7050,11254,27,40,700,3000,1050,1075,7425,3926,1
1593,2,0,34.0,70.0,47.0,108.0,0,2406,0,1735,0,671,28245,36815,21195,25489,7050,11326,27,40,700,3050,1050,1075,7425,3926,1
1600,2,0,34.0,70.0,39.0,108.0,0,2580,0,1931,0,649,28245,37116,21195,25714,7050,11402,27,40,700,3050,1050,1075,7525,3926,1
1607,2,0,34.0,70.0,39.0,108.0,0,2586,0,1959,0,627,28245,37367,21195,25889,7050,11478,27,40,700,3050,900,1075,7675,3926,1
1614,2,0,34.0,71.0,39.0,108.0,0,2446,0,1819,0,627,28245,37657,21195,26099,7050,11558,27,40,700,3100,750,1075,7825,3926,1
1621,2,0,32.0,71.0,39.0,108.0,0,2440,0,1791,0,649,28245,37932,21195,26294,7050,11638,25,40,700,3100,750,1075,7925,3926,1
1629,2,0,32.0,72.0,39.0,108.0,0,2434,0,1763,0,671,28245,38102,21195,26434,7050,11668,25,40,700,3150,750,1075,7925,3926,1
1636,2,0,32.0,72.0,39.0,108.0,0,2490,0,1819,0,671,28245,38388,21195,26644,7050,11744,25,40,700,3150,750,1075,8000,3926,1
1643,2,0,32.0,72.0,16.0,108.0,0,2412,0,1763,0,649,28245,38260,21195,26444,7050,11816,25,40,700,3150,750,1075,8500,3926,1
1650,2,0,32.0,72.0,16.0,108.0,0,2440,0,1791,0,649,28245,38535,21195,26639,7050,11896,25,40,700,3150,750,1075,8500,3926,1
1657,2,0,32.0,72.0,16.0,108.0,0,2194,0,1567,0,627,28245,38731,21195,26759,7050,11972,25,40,700,3150,750,1075,8500,3926,1
1664,2,0,32.0,73.0,16.0,108.0,0,2054,0,1427,0,627,28245,38986,21195,26934,7050,12052,25,40,700,3250,600,1075,8650,3926,1
7,1,2,13.0,13.0,14.0,15.0,335,335,335,335,0,0,40,40,40,40,0,0,12,12,0,0,0,0,0,0,0
14,1,2,13.0,14.0,14.0,15.0,671,643,671,643,0,0,20,65,20,65,0,0,13,13,0,0,0,0,0,0,0
21,1,2,14.0,14.0,14.0,15.0,727,727,727,727,0,0,55,50,55,50,0,0,13,13,0,0,0,0,0,0,0
29,1,2,14.0,15.0,14.0,15.0,783,699,783,699,0,0,150,35,150,35,0,0,13,14,0,0,0,0,0,0,0
36,1,2,16.0,15.0,22.0,23.0,811,783,811,783,0,0,150,130,150,130,0,0,14,14,0,0,0,0,0,0,0
43,1,2,16.0,16.0,22.0,23.0,811,755,811,755,0,0,235,20,235,20,0,0,16,15,0,0,0,0,0,0,0
50,1,2,15.0,17.0,22.0,23.0,839,839,839,839,0,0,35,0,35,0,0,0,15,16,0,0,0,0,0,0,0
57,1,2,17.0,18.0,22.0,23.0,783,839,783,839,0,0,30,0,30,0,0,0,15,17,0,0,0,0,0,0,0
64,1,2,18.0,19.0,22.0,23.0,923,923,923,923,0,0,90,115,90,115,0,0,16,18,0,0,0,0,0,0,0
71,1,2,17.0,19.0,22.0,23.0,839,889,839,867,0,22,165,224,165,220,0,4,17,18,0,0,0,0,0,0,0
79,1,2,17.0,20.0,22.0,23.0,951,984,951,895,0,89,30,341,30,325,0,16,16,19,0,0,0,0,0,0,0
86,1,2,18.0,20.0,22.0,23.0,783,1029,783,895,0,134,75,67,75,35,0,32,16,19,0,0,0,150,0,0,0
93,1,2,19.0,21.0,22.0,23.0,895,1029,895,895,0,134,130,138,130,90,0,48,17,20,0,0,0,150,0,0,0
100,1,2,20.0,21.0,22.0,23.0,934,1079,867,923,67,156,192,113,180,45,12,68,19,21,0,0,0,150,0,0,0
107,1,2,20.0,22.0,22.0,23.0,1085,1051,951,895,134,156,323,113,295,25,28,88,19,21,0,0,0,150,0,0,0
114,1,2,20.0,22.0,22.0,23.0,1023,1102,867,923,156,179,339,138,295,30,44,108,20,21,0,0,0,150,0,0,0
121,1,2,22.0,23.0,28.0,23.0,1079,1079,923,923,156,156,324,214,260,90,64,124,20,22,0,0,250,150,0,0,0
129,1,2,26.0,23.0,36.0,23.0,1079,1124,923,923,156,201,194,302,110,150,84,152,20,22,0,0,250,150,0,0,0
136,1,2,28.0,26.0,36.0,31.0,1197,1236,1063,923,134,313,40,317,40,150,0,167,20,23,0,0,250,300,0,0,0
143,1,2,30.0,27.0,36.0,31.0,1029,1180,1007,867,22,313,50,103,50,50,0,53,20,24,100,0,250,300,0,0,0
150,1,2,30.0,28.0,36.0,31.0,1119,1180,1119,867,0,313,185,103,185,60,0,43,22,25,100,0,250,300,0,0,0
157,1,2,31.0,29.0,36.0,46.0,1175,1286,1175,951,0,335,285,163,285,80,0,83,24,25,250,0,250,300,0,0,0
164,1,2,31.0,31.0,36.0,46.0,1287,1370,1287,1035,0,335,85,228,85,105,0,123,23,27,400,125,250,300,0,0,0
171,1,2,33.0,34.0,36.0,46.0,1343,1460,1343,1147,0,313,0,129,0,20,0,109,24,28,400,125,250,300,0,0,0
179,1,2,36.0,35.0,36.0,46.0,1343,1594,1343,1259,0,335,5,319,5,170,0,149,25,29,400,125,250,300,0,0,0
186,1,2,36.0,40.0,36.0,46.0,1399,1594,1399,1259,0,335,85,54,85,15,0,39,25,31,400,125,250,600,0,0,0
193,1,2,40.0,40.0,44.0,46.0,1399,1684,1399,1371,0,313,0,160,0,85,0,75,28,31,400,125,250,600,0,0,0
200,1,2,43.0,42.0,44.0,46.0,1539,1712,1539,1399,0,313,45,270,45,155,0,115,28,33,400,300,250,600,0,0,0
207,1,2,45.0,47.0,52.0,54.0,1595,1846,1595,1511,0,335,140,195,140,190,0,5,31,35,550,600,250,600,0,0,0
214,1,2,49.0,47.0,52.0,54.0,1729,1846,1707,1511,22,335,99,410,95,365,4,45,34,35,550,600,250,600,0,0,0
221,1,2,52.0,49.0,52.0,54.0,1846,1992,1735,1679,111,313,75,151,55,70,20,81,35,37,550,600,250,600,0,0,0
229,1,2,52.0,49.0,52.0,54.0,1947,2014,1791,1679,156,335,160,186,120,65,40,121,38,37,700,600,250,600,0,0,0
236,1,2,54.0,54.0,58.0,54.0,1975,2104,1819,1791,156,313,155,132,95,125,60,7,36,39,700,900,250,600,0,0,0
243,1,2,58.0,55.0,66.0,62.0,2031,2188,1875,1875,156,313,200,137,120,90,80,47,36,40,800,900,250,600,0,0,0
250,1,2,60.0,56.0,66.0,62.0,2026,2266,1847,1931,179,335,210,197,110,110,100,87,36,41,1050,900,250,600,0,0,0
257,1,2,66.0,58.0,66.0,62.0,1942,2266,1763,1931,179,335,135,317,15,190,120,127,41,43,1050,900,500,600,0,0,0
264,1,2,66.0,58.0,66.0,70.0,2059,2154,1903,1819,156,335,296,213,160,150,136,63,43,43,1050,1200,500,600,0,0,0
271,1,2,65.5,60.0,66.0,70.0,2171,2283,2015,1791,156,492,351,201,195,70,156,131,47,45,1225,1200,500,600,25,0,0
279,1,2,66.0,61.0,74.0,70.0,2451,2350,2295,1679,156,671,406,251,330,65,76,186,47,46,1200,1075,625,600,50,125,0
286,1,2,73.0,62.0,90.0,62.0,2507,2440,2351,1791,156,649,146,452,100,190,46,262,46,47,1200,1200,625,600,50,225,0
293,1,2,73.0,65.0,90.0,77.0,2591,2384,2435,1735,156,649,466,342,400,100,66,242,52,49,1200,1200,625,750,50,225,0
300,1,2,77.0,70.0,90.0,77.0,2614,2434,2435,1763,179,671,266,363,180,95,86,268,54,52,1250,1200,625,1000,50,225,0
307,1,2,80.5,73.0,90.0,85.0,2726,2518,2547,1847,179,671,291,428,185,80,106,348,53,55,1225,1375,625,1000,75,225,0
314,1,2,82.5,73.0,90.0,85.0,2759,2838,2603,2211,156,627,102,535,80,215,22,320,55,55,1225,1375,625,1000,75,225,0
321,1,2,81.5,78.0,82.0,93.0,2815,2888,2659,2239,156,649,217,530,175,230,42,300,58,58,1225,1375,625,1300,175,225,0
329,1,2,81.5,79.0,82.0,93.0,2899,3168,2743,2519,156,649,342,566,280,190,62,376,62,59,1225,1525,825,1300,175,225,0
336,1,2,81.5,82.0,82.0,101.0,2983,3090,2827,2463,156,627,562,737,480,385,82,352,62,61,1225,1675,825,1300,175,225,0
343,1,2,91.5,82.0,98.0,101.0,3207,3364,2827,2715,380,649,562,678,420,250,142,428,63,62,1225,1675,825,1300,175,225,0
350,1,2,93.5,86.0,106.0,101.0,3280,3280,2743,2631,537,649,741,608,535,200,206,408,63,63,1225,2025,950,1300,175,225,0
357,1,2,97.5,88.0,106.0,101.0,3342,3398,2603,2771,739,627,947,829,645,395,302,434,71,63,1225,2200,950,1300,175,225,0
364,1,2,101.5,88.0,106.0,101.0,3627,3526,2799,2855,828,671,1083,1239,685,725,398,514,72,63,1225,2200,950,1300,175,225,0
371,1,2,100.0,88.0,114.0,101.0,3577,3386,2771,2715,806,671,1299,1034,905,440,394,594,71,63,1450,2200,1200,1300,200,225,0
379,1,2,105.0,92.0,128.0,101.0,3526,3448,2743,2799,783,649,1280,1106,890,540,390,566,71,63,1600,2550,1200,1700,200,225,0
386,1,2,105.0,98.0,128.0,109.0,3437,3336,2631,2687,806,649,1635,991,1170,345,465,646,71,63,1800,2850,1200,1700,200,225,0
393,1,2,116.5,98.0,128.0,109.0,3521,3420,2715,2771,806,649,1331,1407,770,685,561,722,75,63,1975,2850,1200,2150,225,225,0
400,1,2,116.5,106.0,128.0,117.0,3543,3336,2715,2687,828,649,1056,1323,695,525,361,798,75,63,1975,2950,1200,2150,225,225,0
407,1,2,121.5,114.0,128.0,133.0,3627,3398,2799,2771,828,627,1132,874,675,150,457,724,76,63,2575,3650,1200,2150,225,225,0
414,1,2,121.5,117.0,136.0,133.0,3739,3336,2911,2687,828,649,1483,1139,930,335,553,804,76,63,2575,3650,1575,2150,225,225,0
421,1,2,132.5,125.0,136.0,133.0,3801,3392,2995,2743,806,649,1014,1160,365,280,649,880,76,66,2775,3650,1575,2150,225,225,0
429,1,2,129.5,131.0,144.0,133.0,4053,3308,3247,2659,806,649,1095,840,550,30,545,810,75,66,2725,4050,1575,2250,325,225,0
436,1,2,135.5,133.0,152.0,133.0,4137,3420,3331,2771,806,649,900,1151,455,265,445,886,75,66,2975,4350,1575,2250,425,225,0
443,1,2,133.5,134.0,152.0,141.0,4193,3280,3387,2631,806,649,1411,942,870,180,541,762,75,66,3175,4350,1575,2150,525,475,0
450,1,2,147.5,136.0,152.0,156.0,4131,3426,3303,2799,828,627,256,903,65,65,191,838,75,67,3675,4350,1575,2150,750,525,0
457,1,2,147.5,139.0,152.0,164.0,4243,3342,3415,2715,828,627,648,1255,365,345,283,910,75,70,3675,4350,1575,2150,750,525,0
464,1,2,151.0,140.0,152.0,164.0,4215,3566,3387,2939,828,627,563,1080,280,90,283,990,75,71,3650,4350,1575,2150,775,525,0
471,1,2,157.0,142.0,184.0,172.0,4142,3666,3359,2995,783,671,600,1475,375,405,225,1070,75,74,5000,4350,1575,2150,775,525,0
479,1,2,165.0,144.0,184.0,172.0,4221,3851,3415,3135,806,716,650,1688,375,530,275,1158,75,76,5000,4350,1575,2500,775,525,0
486,1,2,164.5,152.0,208.0,172.0,4137,4002,3331,3107,806,895,1185,466,810,400,375,66,79,78,4875,3850,1575,2500,775,1025,0
493,1,2,148.0,133.0,208.0,172.0,4131,4092,3303,3107,828,985,1371,633,1050,455,321,178,79,80,4150,2750,1575,2600,1500,2125,0
500,1,2,155.5,129.0,208.0,172.0,4137,4154,3331,3191,806,963,1117,754,700,460,417,294,78,81,4575,4350,1575,2750,1525,2325,0
507,1,2,161.0,129.0,208.0,172.0,4271,4137,3443,3219,828,918,1338,841,825,635,513,206,78,84,4850,4350,1575,2750,1600,2325,0
514,1,2,168.0,129.0,208.0,172.0,4165,4310,3359,3415,806,895,859,478,550,160,309,318,78,84,5300,4350,1575,2750,1600,2325,0
521,1,2,174.0,139.0,208.0,172.0,4086,4226,3303,3219,783,1007,1065,286,660,140,405,146,78,84,5600,4750,1575,3050,1600,2325,0
529,1,2,177.0,145.0,208.0,172.0,4109,4355,3303,3079,806,1276,1405,404,900,260,505,144,78,84,6550,5450,1575,3200,1600,2325,0
536,1,2,178.0,145.0,208.0,172.0,3997,4210,3191,2911,806,1299,581,411,505,265,76,146,75,84,6850,5450,1575,3350,1600,2325,0
543,1,2,183.0,147.0,208.0,180.0,3963,4137,3135,2883,828,1254,661,440,485,300,176,140,75,84,6850,5650,1575,4050,1750,2325,0
550,1,2,182.0,143.0,208.0,180.0,3913,4221,3107,2967,806,1254,823,455,555,355,268,100,79,84,7150,5650,1575,4300,2075,2825,0
557,1,2,175.5,147.0,208.0,180.0,3935,4333,3107,3079,828,1254,993,446,625,340,368,106,79,84,6575,6025,1575,4250,2975,3225,0
564,1,2,171.0,151.0,208.0,180.0,4126,4478,3163,3135,963,1343,1192,461,700,345,492,116,79,84,5450,6375,1575,4200,4100,3550,0
571,1,2,163.0,133.0,214.0,180.0,4193,4669,3051,3303,1142,1366,1252,717,620,445,632,272,79,84,4350,4075,1825,3950,5600,6200,0
579,1,2,150.5,119.0,214.0,180.0,4333,4568,3191,3247,1142,1321,1617,955,845,535,772,420,79,84,3625,2325,1825,3950,6525,7850,0
586,1,2,148.5,125.0,214.0,180.0,4238,4467,3051,3191,1187,1276,1328,573,795,455,533,118,79,84,3975,3075,1825,3950,6675,7850,0
593,1,2,162.5,127.0,214.0,180.0,4081,4372,2939,3163,1142,1209,305,461,165,345,140,116,79,84,4225,3675,1825,3950,6675,7850,0
600,1,2,168.5,133.0,214.0,180.0,4137,4176,2995,2967,1142,1209,502,672,230,400,272,272,79,84,5175,3875,1825,3950,6700,7850,0
607,1,2,165.0,139.0,214.0,180.0,3918,4383,2799,3107,1119,1276,453,912,295,480,158,432,79,84,5300,4175,1825,3950,6925,7850,0
614,1,2,164.0,127.0,214.0,180.0,4008,4473,2911,3107,1097,1366,554,1442,260,850,294,592,79,84,5700,3650,1825,4250,7775,8675,0
621,1,2,161.0,122.0,214.0,180.0,4114,4546,2995,3135,1119,1411,599,947,165,495,434,452,79,84,5050,1125,1825,4550,8925,10300,0
629,1,2,155.5,107.0,214.0,172.0,4411,4210,3247,3023,1164,1187,800,1307,230,735,570,572,79,81,4075,1850,1825,4450,9825,11925,0
636,1,2,145.5,103.0,214.0,172.0,4299,3319,3135,2267,1164,1052,581,1291,175,595,406,696,76,79,3575,1500,1825,4300,10400,12925,0
7,0,1,13.0,13.0,15.0,14.0,377,293,377,293,0,0,45,35,45,35,0,0,12,12,0,0,0,0,0,0,0
14,0,1,14.0,13.0,15.0,14.0,671,671,671,671,0,0,70,20,70,20,0,0,13,13,0,0,0,0,0,0,0
21,0,1,14.0,14.0,15.0,14.0,699,755,699,755,0,0,50,55,50,55,0,0,13,13,0,0,0,0,0,0,0
29,0,1,15.0,14.0,15.0,14.0,671,783,671,783,0,0,40,150,40,150,0,0,14,13,0,0,0,0,0,0,0
36,0,1,15.0,16.0,15.0,22.0,783,783,783,783,0,0,135,145,135,145,0,0,14,14,0,0,0,0,0,0,0
43,0,1,16.0,16.0,23.0,22.0,783,811,783,811,0,0,80,235,80,235,0,0,15,14,0,0,0,0,0,0,0
50,0,1,16.0,15.0,23.0,22.0,783,783,783,783,0,0,40,25,40,25,0,0,15,15,0,0,0,0,0,0,0
57,0,1,17.0,17.0,23.0,22.0,839,839,839,839,0,0,40,35,40,35,0,0,16,15,0,0,0,0,0,0,0
64,0,1,18.0,18.0,23.0,22.0,839,867,839,867,0,0,130,85,130,85,0,0,17,16,0,0,0,0,0,0,0
71,0,1,18.0,17.0,23.0,22.0,883,895,839,895,44,0,238,165,230,165,8,0,17,17,0,0,0,0,0,0,0
79,0,1,19.0,17.0,23.0,22.0,911,951,755,951,156,0,343,35,315,35,28,0,18,16,0,0,0,0,0,0,0
86,0,1,19.0,18.0,23.0,22.0,1018,895,839,895,179,0,468,90,420,90,48,0,18,16,0,0,0,0,0,0,0
93,0,1,20.0,19.0,23.0,22.0,990,951,811,951,179,0,328,155,310,155,18,0,19,18,0,0,150,0,0,0,0
100,0,1,20.0,20.0,23.0,22.0,967,1046,811,979,156,67,39,232,5,220,34,12,19,18,0,0,150,0,0,0,0
107,0,1,20.0,20.0,23.0,22.0,967,1057,811,923,156,134,64,353,10,325,54,28,19,19,0,0,150,0,0,0,0
114,0,1,20.0,21.0,23.0,22.0,939,1163,783,1007,156,156,169,443,95,395,74,48,19,20,0,0,150,0,0,0,0
121,0,1,22.0,27.0,23.0,28.0,855,1135,699,979,156,156,129,164,35,100,94,64,19,20,100,0,150,250,0,0,0
129,0,1,23.0,27.0,23.0,28.0,1046,1191,867,1035,179,156,274,304,160,220,114,84,20,21,100,0,150,250,0,0,0
136,0,1,23.0,28.0,31.0,28.0,1074,1163,895,1007,179,156,104,94,70,90,34,4,20,21,100,0,150,250,0,0,0
143,0,1,24.0,28.0,31.0,28.0,1135,1074,979,1007,156,67,90,213,90,205,0,8,21,21,150,100,150,250,0,0,0
150,0,1,24.0,27.0,31.0,36.0,1135,1186,979,1119,156,67,235,66,215,50,20,16,21,21,150,100,150,250,0,0,0
157,0,1,25.0,29.0,31.0,36.0,1331,1130,1175,1063,156,67,355,89,315,65,40,24,22,21,150,400,150,250,0,0,0
164,0,1,26.0,31.0,31.0,36.0,1387,1242,1231,1175,156,67,120,152,60,120,60,32,23,21,150,400,150,250,0,0,0
171,0,1,26.0,33.0,46.0,36.0,1415,1186,1259,1119,156,67,275,130,195,90,80,40,23,23,150,400,150,250,0,0,0
179,0,1,27.0,35.0,46.0,36.0,1410,1298,1231,1231,179,67,230,108,130,60,100,48,24,25,150,400,500,250,0,0,0
186,0,1,27.0,36.0,46.0,36.0,1298,1298,1119,1231,179,67,40,216,20,160,20,56,24,25,150,400,500,250,0,0,0
193,0,1,30.0,40.0,46.0,44.0,1359,1471,1203,1427,156,44,66,190,30,130,36,60,25,28,150,400,500,250,0,0,0
200,0,1,33.0,41.0,46.0,44.0,1359,1466,1203,1399,156,67,81,223,25,155,56,68,26,28,150,400,500,250,0,0,0
207,0,1,34.0,44.0,46.0,44.0,1583,1718,1427,1651,156,67,116,226,65,150,51,76,26,32,150,550,500,250,0,0,0
214,0,1,35.0,46.0,46.0,52.0,1874,1662,1651,1595,223,67,353,169,270,85,83,84,28,34,250,550,500,250,0,0,0
221,0,1,40.0,46.0,46.0,58.0,1992,1858,1679,1791,313,67,314,382,195,290,119,92,28,34,350,550,825,250,0,0,0
229,0,1,46.0,53.0,46.0,66.0,2042,1858,1707,1791,335,67,149,210,90,110,59,100,30,34,350,550,825,250,0,0,0
236,0,1,46.0,57.0,46.0,66.0,2188,1998,1875,1931,313,67,345,248,250,140,95,108,31,36,350,550,825,250,0,0,0
243,0,1,50.0,59.0,61.0,66.0,2244,1992,1931,1903,313,89,90,225,55,105,35,120,32,40,550,800,825,250,0,0,0
250,0,1,53.0,61.0,61.0,66.0,2154,2031,1819,1875,335,156,170,260,95,120,75,140,33,41,600,950,825,250,0,0,0
257,0,1,54.0,65.0,61.0,58.0,2216,2334,1903,2155,313,179,286,350,175,190,111,160,34,41,600,950,825,250,0,100,0
264,0,1,57.0,70.0,61.0,74.0,2356,2283,2043,2127,313,156,166,151,115,25,51,126,35,43,700,1100,825,250,0,100,0
271,0,1,59.0,70.0,61.0,74.0,2294,2311,1959,2155,335,156,261,186,170,140,91,46,36,43,950,1250,825,250,100,100,0
279,0,1,64.0,73.0,69.0,74.0,2406,2339,2071,2183,335,156,251,116,145,50,106,66,37,48,950,1400,825,250,100,100,0
286,0,1,69.0,72.0,69.0,74.0,2580,2451,2267,2295,313,156,157,286,15,200,142,86,40,48,1050,1400,825,250,100,100,0
293,0,1,69.0,74.0,69.0,74.0,2714,2283,2379,2127,335,156,397,306,215,200,182,106,41,47,1150,1450,825,250,100,100,0
300,0,1,73.0,74.0,77.0,74.0,2742,2418,2407,2239,335,179,207,406,185,280,22,126,42,49,1150,1450,900,375,100,100,0
307,0,1,76.0,73.0,85.0,74.0,2776,2474,2463,2295,313,179,288,421,230,275,58,146,43,50,1250,1500,900,825,100,100,0
314,0,1,77.0,83.0,85.0,90.0,2664,2384,2351,2183,313,201,193,205,95,35,98,170,44,50,1250,1500,900,825,100,100,0
321,0,1,79.0,86.0,85.0,90.0,2574,2720,2239,2295,335,425,383,305,245,75,138,230,45,51,1650,1500,900,825,100,100,0
329,0,1,81.0,86.0,93.0,90.0,2518,2849,2183,2379,335,470,238,460,110,245,128,215,46,60,1750,1450,900,1075,100,150,0
336,0,1,87.0,85.0,93.0,98.0,2608,2899,2295,2407,313,492,194,80,30,55,164,25,49,59,1750,1450,900,1075,100,150,0
343,0,1,89.0,90.0,93.0,98.0,2350,3073,2015,2603,335,470,324,151,120,95,204,56,50,63,1750,1700,1150,1075,100,200,0
350,0,1,92.0,92.0,93.0,98.0,2412,3202,2099,2687,313,515,370,431,130,315,240,116,52,63,1800,1700,1150,1075,100,200,0
357,0,1,96.0,92.0,101.0,98.0,2457,2888,2099,2351,358,537,523,450,235,320,288,130,54,67,2000,1850,1400,1075,100,225,0
364,0,1,99.0,98.0,101.0,98.0,2832,3151,2295,2323,537,828,576,322,220,180,356,142,55,66,2050,1950,1700,1075,100,225,0
371,0,1,101.0,94.5,101.0,98.0,2938,3431,2379,2491,559,940,825,867,405,552,420,315,57,67,2050,1650,1700,1075,100,561,0
379,0,1,103.0,96.5,109.0,104.0,2910,2983,2351,2155,559,828,1014,948,580,537,434,411,58,66,2150,2050,1700,1075,100,611,0
386,0,1,100.0,95.5,117.0,104.0,2910,2468,2351,1819,559,649,303,865,55,382,248,483,60,62,1850,1900,1700,1325,500,886,0
393,0,1,101.0,94.5,117.0,104.0,2910,2059,2351,1567,559,492,396,961,80,422,316,539,62,58,1750,2050,1700,1325,600,1086,0
400,0,1,102.0,101.5,117.0,120.0,3146,2278,2519,1763,627,515,407,886,115,287,292,599,63,65,1750,2050,1700,1325,600,1086,0
407,0,1,103.0,98.5,117.0,120.0,3454,2754,2827,2239,627,515,402,711,30,302,372,409,65,65,1800,2050,1700,1775,800,1236,0
414,0,1,108.0,98.5,125.0,120.0,3672,3034,3023,2407,649,627,202,1101,50,612,152,489,67,70,1800,2050,1800,1775,800,1236,0
421,0,1,113.0,98.5,125.0,120.0,4025,3476,3331,2603,694,873,117,1231,35,772,82,459,68,70,1850,2050,1900,1775,800,1236,0
429,0,1,116.0,114.5,133.0,120.0,4098,3689,3359,2659,739,1030,440,346,170,267,270,79,69,70,1950,2050,1900,1775,800,1236,0
436,0,1,119.0,112.5,133.0,120.0,4081,3672,3163,2687,918,985,586,603,300,412,286,191,69,68,2050,2050,2200,1775,800,1236,0
443,0,1,120.0,118.5,133.0,120.0,4316,3834,3331,2827,985,1007,721,533,415,426,306,107,69,75,2600,2050,2300,1775,800,1167,0
450,0,1,130.0,118.5,133.0,120.0,4428,3952,3443,2967,985,985,307,989,160,766,147,223,69,75,2800,3050,2500,1775,800,1167,0
457,0,1,132.0,118.5,133.0,136.0,4260,3935,3275,2995,985,940,621,1191,373,956,248,235,69,75,2900,3000,2500,1900,800,1217,0
464,0,1,133.0,131.5,133.0,136.0,3974,4098,2967,3135,1007,963,457,396,117,366,340,30,69,75,3000,3450,2850,1900,800,1217,0
471,0,1,138.0,133.0,149.0,136.0,3868,4176,2883,3191,985,985,613,586,265,436,348,150,69,76,3300,3425,2850,1900,800,1242,0
479,0,1,141.0,133.0,149.0,136.0,3790,4266,2827,3303,963,963,705,708,245,646,460,62,69,76,3800,4525,3050,1900,800,1267,0
486,0,1,132.0,124.0,165.0,144.0,3622,4204,2659,3219,963,985,1105,1204,525,1026,580,178,69,76,3300,3925,3050,1900,1300,1792,0
493,0,1,132.0,138.5,165.0,152.0,3627,4282,2687,3275,940,1007,1206,834,535,536,671,298,69,76,3350,3950,3050,1900,1650,2117,0
500,0,1,121.0,127.0,173.0,152.0,3644,4238,2659,3275,985,963,1056,1341,490,931,566,410,69,76,2450,2975,3050,1900,2600,2867,0
507,0,1,131.0,137.0,173.0,152.0,3532,4131,2547,3191,985,940,717,467,235,391,482,76,69,75,2500,3875,3050,1900,2600,2867,0
514,0,1,133.0,136.5,181.0,152.0,3442,4036,2435,3051,1007,985,538,707,115,636,423,71,69,75,2800,3850,3050,1900,2600,2892,0
521,0,1,133.0,145.5,181.0,152.0,3364,4142,2379,3135,985,1007,584,397,220,356,364,41,70,78,3100,3900,3050,1900,2600,2992,0
529,0,1,136.0,144.0,181.0,152.0,3454,4064,2491,3079,963,985,811,724,385,646,426,78,70,77,3200,4875,3050,1900,2650,3017,0
536,0,1,144.0,146.0,181.0,152.0,3482,4131,2519,3079,963,1052,776,728,230,576,546,152,70,77,3600,5675,3050,1900,2650,3017,0
543,0,1,145.0,146.0,196.0,152.0,3392,4198,2407,3079,985,1119,1047,1209,385,921,662,288,73,77,4000,5825,3250,1900,2750,3017,0
550,0,1,155.0,152.0,196.0,176.0,3168,4176,2183,3079,985,1097,582,961,50,766,532,195,73,77,4350,6025,3250,1900,2850,3017,0
557,0,1,158.0,160.0,196.0,176.0,3196,4008,2211,2911,985,1097,654,642,110,611,544,31,75,77,4450,6025,3250,1900,2850,3017,0
564,0,1,164.0,165.0,196.0,176.0,3470,4053,2463,2911,1007,1142,774,867,110,696,664,171,76,79,4450,6325,3250,1900,2850,3017,0
571,0,1,161.0,176.0,196.0,176.0,3459,4109,2519,2967,940,1142,862,818,240,511,622,307,78,79,4500,6325,3250,1900,3165,3017,0
579,0,1,167.0,176.0,196.0,184.0,3258,4109,2295,2967,963,1142,807,444,115,426,692,18,78,79,4400,6575,3250,1900,3467,3017,0
586,0,1,169.0,180.0,196.0,184.0,3650,4187,2687,3023,963,1164,1082,250,370,246,712,4,78,77,4500,7175,3250,1900,3467,3017,0
593,0,1,173.0,181.0,196.0,184.0,3896,4327,2911,3163,985,1164,1063,306,360,166,703,140,79,83,4950,7275,3250,1900,3617,3592,0
600,0,1,183.0,183.0,196.0,190.0,4008,4422,3023,3303,985,1119,604,178,10,106,594,72,79,83,5100,7375,3250,1900,3767,3717,0
607,0,1,185.0,183.0,196.0,190.0,4030,4389,3023,3247,1007,1142,755,489,145,281,610,208,79,83,5250,7375,3250,1900,3767,3717,0
614,0,1,190.0,190.0,196.0,190.0,4008,4607,3023,3443,985,1164,566,694,90,346,476,348,79,83,5350,8225,3250,1900,3967,3767,0
621,0,1,195.0,188.5,196.0,206.0,4042,4674,3079,3555,963,1119,588,446,150,366,438,80,79,83,5600,8400,3250,2300,3967,3842,0
629,0,1,195.0,184.5,204.0,206.0,4070,4837,3107,3695,963,1142,673,627,115,561,558,66,79,83,5850,8200,3475,2300,3967,4042,0
636,0,1,194.0,184.5,204.0,206.0,3874,4770,2911,3583,963,1187,1019,647,345,541,674,106,79,82,5825,8550,3475,2300,4117,4842,0
643,0,1,196.0,197.5,204.0,206.0,3896,4674,2911,3555,985,1119,944,440,150,306,794,134,79,89,6575,8550,3475,2300,4117,4842,0
650,0,1,200.0,199.5,204.0,206.0,3756,4680,2771,3583,985,1097,1161,791,280,621,881,170,79,89,6675,8550,3475,2300,4117,4842,0
657,0,1,200.0,199.0,204.0,206.0,3918,4658,2911,3471,1007,1187,1446,859,545,791,901,68,79,89,7375,9075,3475,2300,4117,4867,0
664,0,1,195.0,188.0,204.0,206.0,3818,4915,2855,3639,963,1276,1903,1455,890,1231,1013,224,79,89,7125,8575,3475,2300,4367,5467,0
671,0,1,186.0,200.0,180.0,206.0,3431,4910,2603,3611,828,1299,1755,1077,825,701,930,376,69,89,7225,8375,3250,2300,5517,5792,0
679,0,1,181.0,196.5,180.0,206.0,2810,4876,2071,3555,739,1321,2081,853,1055,571,1026,282,68,89,7025,7550,3250,2300,5767,6542,0
686,0,1,172.0,188.0,172.0,206.0,2670,4932,1931,3611,739,1321,2064,919,975,731,1089,188,65,89,6450,6825,3250,2300,6592,6967,0
693,0,1,164.0,181.0,156.0,206.0,1930,4859,1371,3583,559,1276,2097,1136,940,796,1157,340,65,89,6050,6825,3700,2300,7192,8167,0
700,0,1,163.0,185.0,156.0,206.0,1858,4882,1343,3583,515,1299,1763,582,600,511,1163,71,64,89,6200,7575,3700,2650,7242,8367,0
707,0,1,171.0,190.0,171.0,206.0,2059,4758,1567,3415,492,1343,1809,637,615,531,1194,106,64,89,6325,7925,3700,2650,7242,8367,0
714,0,1,171.0,189.0,171.0,206.0,2378,4719,1931,3443,447,1276,1242,1190,225,936,1017,254,64,89,6625,8375,3850,2650,7242,8442,0
721,0,1,174.0,182.5,203.0,206.0,2434,4887,1987,3611,447,1276,1473,1526,400,1116,1073,410,60,89,6675,7750,3750,2650,7792,9617,0
729,0,1,180.0,178.0,195.0,206.0,2524,5016,2099,3695,425,1321,1275,1731,200,1361,1075,370,60,89,6525,7375,3750,2650,8042,10167,0
736,0,1,153.0,158.5,195.0,206.0,2866,4994,2463,3695,403,1299,1498,1503,375,1381,1123,122,60,89,4875,5500,3750,2650,9692,12067,0
743,0,1,145.0,165.5,195.0,206.0,3067,4977,2687,3723,380,1254,1156,1500,210,1226,946,274,60,89,4500,5050,3750,2650,10692,12217,0
750,0,1,151.0,167.0,195.0,206.0,3392,4960,2967,3639,425,1321,1229,1280,285,1046,944,234,60,89,4750,5425,3750,2650,10692,12242,0
757,0,1,153.0,171.0,195.0,206.0,3370,4758,2967,3415,403,1343,1047,780,305,661,742,119,60,89,4950,6625,3750,2650,10692,12242,0
764,0,1,154.0,165.5,195.0,198.0,3420,4658,2995,3359,425,1299,1260,1088,495,946,765,142,60,88,5325,6250,3750,2650,11092,12917,0
771,0,1,163.0,173.0,195.0,198.0,3252,4764,2827,3443,425,1321,1012,1149,270,851,742,298,60,87,5750,6925,3750,2650,11092,13067,0
779,0,1,163.0,170.5,195.0,198.0,3347,4876,2967,3555,380,1321,1011,1265,275,1011,736,254,60,87,5625,6950,3750,2650,11267,13242,0
786,0,1,164.0,175.0,195.0,198.0,3258,4719,2855,3443,403,1276,1083,1462,345,1056,738,406,60,87,5750,6975,3750,2650,11517,13467,0
793,0,1,151.0,152.5,195.0,198.0,3230,4809,2827,3555,403,1254,1171,1688,410,1276,761,412,60,87,4775,4550,3750,2650,12792,16142,0
800,0,1,149.0,157.0,195.0,198.0,2670,4848,2267,3527,403,1321,1459,1513,650,1091,809,422,58,87,4825,4675,3750,2650,12892,16417,0
807,0,1,160.0,157.0,195.0,198.0,2810,4742,2407,3443,403,1299,1052,1505,420,1206,632,299,58,87,5600,4975,3750,2650,12892,16417,0
814,0,1,162.0,166.0,195.0,198.0,3146,4574,2743,3275,403,1299,1375,1456,695,1001,680,455,58,87,6100,5175,3750,2650,12942,16642,0
821,0,1,162.0,152.0,195.0,198.0,3151,4484,2771,3163,380,1321,1343,1732,665,1246,678,486,60,87,5950,4775,3750,2650,13242,17692,0
829,0,1,166.0,158.5,195.0,198.0,3168,4546,2743,3247,425,1299,1130,1174,600,1036,530,138,60,87,5575,5000,3750,2650,13742,17867,0
836,0,1,162.0,151.5,195.0,196.0,3286,4411,2883,3135,403,1276,1213,1710,785,1416,428,294,60,87,5850,4550,3750,2650,14092,18742,0
843,0,1,157.0,156.5,195.0,202.0,3190,4512,2743,3191,447,1321,855,1246,475,921,380,325,60,87,5000,3750,3750,2650,15167,19342,0
850,0,1,152.0,149.0,180.0,202.0,3280,4730,2855,3387,425,1343,1233,1671,805,1186,428,485,60,86,4975,4075,3750,2650,15967,20067,0
856,0,1,152.0,147.5,180.0,194.0,3280,4534,2855,3303,425,1231,1233,1679,805,1086,428,593,60,86,4975,3150,3750,2650,15967,20992,0
7,0,2,13.0,12.0,15.0,15.0,377,251,377,251,0,0,45,80,45,80,0,0,12,12,0,0,0,0,0,0,1
14,0,2,14.0,13.0,15.0,15.0,671,643,671,643,0,0,70,15,70,15,0,0,13,12,0,0,0,0,0,0,1
21,0,2,14.0,13.0,15.0,15.0,699,699,699,699,0,0,50,90,50,90,0,0,13,12,0,0,0,0,0,0,1
29,0,2,15.0,13.0,15.0,23.0,699,727,699,727,0,0,85,35,85,35,0,0,14,13,0,0,0,0,0,0,1
36,0,2,15.0,14.0,15.0,23.0,755,755,755,755,0,0,135,20,135,20,0,0,14,13,0,0,0,0,0,0,1
43,0,2,16.0,15.0,23.0,23.0,755,811,755,811,0,0,70,40,70,40,0,0,15,14,0,0,0,0,0,0,1
50,0,2,16.0,16.0,23.0,23.0,783,811,783,811,0,0,35,10,35,10,0,0,15,15,0,0,0,0,0,0,1
57,0,2,17.0,16.0,23.0,23.0,699,811,699,811,0,0,130,55,130,55,0,0,16,15,0,0,0,0,0,0,1
64,0,2,17.0,17.0,23.0,23.0,755,839,755,839,0,0,165,105,165,105,0,0,16,16,0,0,0,0,0,0,1
71,0,2,18.0,18.0,23.0,23.0,687,878,643,811,44,67,198,212,190,200,8,12,17,17,0,0,0,0,0,0,1
79,0,2,19.0,20.0,23.0,23.0,805,894,671,783,134,111,299,69,275,45,24,24,18,17,0,0,0,150,0,0,1
86,0,2,19.0,21.0,23.0,23.0,911,889,755,755,156,134,414,134,370,90,44,44,18,18,0,0,0,150,0,0,1
93,0,2,20.0,21.0,23.0,23.0,911,1006,755,783,156,223,324,106,260,30,64,76,19,18,0,0,150,150,0,0,1
100,0,2,20.0,22.0,23.0,23.0,911,973,755,727,156,246,434,224,350,120,84,104,19,19,0,0,150,150,0,0,1
107,0,2,20.0,22.0,23.0,31.0,934,995,755,727,179,268,144,351,40,215,104,136,19,20,0,100,150,150,0,0,1
114,0,2,21.0,23.0,23.0,31.0,883,1096,727,783,156,313,190,132,70,110,120,22,19,20,50,100,150,300,0,0,1
121,0,2,21.0,24.0,23.0,31.0,855,1051,699,783,156,268,50,180,10,155,40,25,19,20,50,100,150,300,0,0,1
129,0,2,21.0,25.0,23.0,31.0,911,1085,755,839,156,246,160,267,100,210,60,57,19,20,100,100,150,300,0,0,1
136,0,2,21.0,25.0,23.0,31.0,1107,1079,951,811,156,268,120,303,65,210,55,93,19,21,100,100,150,300,0,0,1
143,0,2,22.0,25.0,23.0,31.0,1107,1130,951,839,156,291,95,434,20,305,75,129,19,21,100,225,150,300,0,0,1
150,0,2,22.0,26.0,23.0,39.0,1158,1124,979,811,179,313,170,524,75,355,95,169,19,21,100,225,150,300,0,0,1
157,0,2,23.0,30.0,23.0,39.0,1130,1118,951,783,179,335,220,104,105,45,115,59,20,21,100,225,225,600,0,0,1
164,0,2,23.0,30.0,31.0,39.0,1051,1202,895,867,156,335,236,159,105,60,131,99,20,22,100,225,325,600,0,0,1
171,0,2,24.0,31.0,31.0,39.0,1107,1230,951,895,156,335,316,140,165,55,151,85,21,22,100,225,575,600,0,0,1
179,0,2,28.0,31.0,46.0,39.0,1124,1258,923,923,201,335,144,290,65,165,79,125,21,23,100,225,575,600,0,0,1
186,0,2,29.0,36.0,46.0,39.0,1186,1208,895,895,291,313,30,31,15,20,15,11,21,23,150,575,575,800,0,0,1
193,0,2,30.0,36.0,46.0,39.0,1236,1292,923,979,313,313,114,186,59,135,55,51,22,23,150,575,675,900,0,0,1
200,0,2,31.0,36.0,46.0,39.0,1258,1236,923,923,335,313,207,231,112,140,95,91,23,24,150,575,675,900,0,0,1
207,0,2,33.0,36.0,46.0,39.0,1202,1286,867,951,335,335,86,386,51,255,35,131,22,24,400,575,675,900,50,0,1
214,0,2,34.0,35.0,46.0,39.0,1068,1281,755,923,313,358,86,486,15,315,71,171,22,24,450,475,675,900,104,100,1
221,0,2,34.0,36.0,46.0,39.0,1062,1286,727,951,335,335,161,437,50,330,111,107,21,24,450,825,675,900,154,100,1
229,0,2,33.0,36.0,46.0,39.0,1040,1236,727,923,313,313,279,173,132,30,147,143,21,24,450,825,675,1000,211,100,1
236,0,2,35.0,36.0,46.0,39.0,1068,1292,755,979,313,313,316,338,129,155,187,183,22,24,500,825,675,1000,211,100,1
243,0,2,34.0,37.0,46.0,39.0,1118,1264,783,951,335,313,302,433,75,210,227,223,21,24,750,1075,675,1000,261,100,1
250,0,2,34.0,39.0,46.0,39.0,1174,1258,839,923,335,335,189,228,22,65,167,163,22,25,750,1075,675,1000,261,100,1
257,0,2,34.0,39.0,46.0,39.0,1012,1230,699,895,313,335,264,333,61,130,203,203,21,25,800,1075,675,1000,312,100,1
264,0,2,34.0,39.0,46.0,39.0,1034,1286,699,951,335,335,384,239,141,100,243,139,21,25,800,1075,675,1000,312,100,1
271,0,2,37.0,42.0,46.0,47.0,1062,1286,727,951,335,335,214,85,31,10,183,75,21,25,800,1325,675,1000,362,100,1
279,0,2,37.0,42.0,46.0,47.0,1180,1236,867,923,313,313,260,231,91,120,169,111,21,25,800,1325,675,1000,362,100,1
286,0,2,37.0,43.0,46.0,47.0,1298,1236,1007,923,291,313,354,386,149,235,205,151,22,26,750,1325,925,1000,412,100,1
293,0,2,39.0,44.0,46.0,47.0,1320,1236,1007,923,313,313,303,491,158,300,145,191,22,27,750,1575,925,1000,412,100,1
300,0,2,36.0,46.0,46.0,62.0,1337,1314,979,979,358,335,184,406,101,275,83,131,23,27,500,1575,925,1250,916,100,1
307,0,2,37.0,48.0,46.0,62.0,1426,1314,1091,979,335,335,167,166,73,95,94,71,23,28,500,1575,925,1250,916,100,1
314,0,2,39.0,48.0,46.0,62.0,1348,1398,1035,1063,313,335,213,182,83,75,130,107,23,28,500,1575,1025,1250,916,100,1
321,0,2,39.0,52.0,46.0,62.0,1348,1460,1035,1147,313,313,316,258,146,115,170,143,24,30,700,1825,1025,1250,916,100,1
329,0,2,44.0,53.0,54.0,62.0,1180,1404,867,1091,313,313,151,308,16,125,135,183,24,32,800,1825,1025,1250,916,100,1
336,0,2,44.0,55.0,54.0,62.0,1236,1488,923,1175,313,313,316,398,141,175,175,223,25,33,1075,1825,1025,1250,916,100,1
343,0,2,47.0,55.0,54.0,62.0,1309,1684,951,1371,358,313,121,258,6,145,115,113,25,33,1075,2075,1025,1250,916,100,1
350,0,2,50.0,59.0,54.0,62.0,1510,1846,1175,1511,335,335,247,183,96,80,151,103,25,35,1175,2075,1025,1250,916,100,1
357,0,2,50.0,60.0,54.0,62.0,1544,1734,1231,1399,313,335,413,384,226,245,187,139,25,36,1400,2075,1025,1250,916,200,1
364,0,2,53.0,61.0,54.0,62.0,1572,1796,1259,1483,313,313,313,415,161,240,152,175,26,37,1500,2250,1025,1400,916,200,1
371,0,2,54.0,61.0,54.0,62.0,1572,1835,1259,1567,313,268,145,402,53,195,92,207,26,39,1500,2250,1025,1300,916,300,1
379,0,2,54.0,62.0,54.0,62.0,1544,2110,1231,1819,313,291,235,358,103,115,132,243,26,39,1750,2250,1025,1200,916,400,1
386,0,2,54.0,62.0,54.0,62.0,1594,2020,1259,1707,335,313,410,629,238,350,172,279,26,39,1750,2250,1025,1200,916,400,1
393,0,2,54.0,64.0,54.0,86.0,1645,2160,1287,1847,358,313,435,830,223,515,212,315,26,40,2075,2250,1025,1200,916,400,1
400,0,2,58.0,66.0,62.0,86.0,1426,2076,1091,1763,335,313,581,320,333,65,248,255,26,40,2075,2425,1025,1100,916,675,1
407,0,2,59.0,68.0,62.0,86.0,1236,2115,923,1735,313,380,706,493,433,190,273,303,26,42,2075,2425,1050,1250,961,675,1
414,0,2,61.0,69.0,70.0,78.0,1124,2205,811,1735,313,470,339,389,28,130,311,259,28,43,2075,2425,1050,1250,961,700,1
421,0,2,63.0,69.0,70.0,78.0,1320,2160,1007,1735,313,425,370,537,29,230,341,307,28,44,2075,2425,1050,1250,961,700,1
429,0,2,64.0,70.0,70.0,78.0,1376,2266,1063,1819,313,447,474,783,93,420,381,363,30,45,2075,2425,1050,1250,961,700,1
436,0,2,65.0,72.0,70.0,78.0,1510,2311,1175,1819,335,492,469,793,48,370,421,423,30,46,2375,2425,1050,1250,961,700,1
443,0,2,69.0,73.0,78.0,86.0,1645,2362,1287,1847,358,515,389,982,53,495,336,487,32,47,2425,2425,1050,1250,961,700,1
450,0,2,68.0,81.0,78.0,86.0,1331,2468,1063,1819,268,649,403,702,43,285,360,417,30,49,2425,2950,950,1250,1175,700,1
457,0,2,66.0,83.0,86.0,86.0,984,2541,895,1847,89,694,426,912,58,415,368,497,28,51,2425,2950,950,1250,1325,700,1
464,0,2,67.0,80.0,86.0,86.0,1331,2524,1287,1875,44,649,580,804,233,385,347,419,29,52,2425,2450,950,1500,1325,1200,1
471,0,2,68.0,83.0,86.0,101.0,1662,2580,1595,1931,67,649,378,870,23,450,355,420,30,53,2425,2450,950,1650,1325,1200,1
479,0,2,69.0,91.0,86.0,101.0,1880,2664,1791,2015,89,649,345,305,78,55,267,250,31,55,2700,2450,950,1650,1325,1200,1
486,0,2,70.0,93.0,101.0,101.0,1841,2726,1595,2099,246,627,396,546,93,220,303,326,32,57,2700,3075,950,1650,1325,1200,1
493,0,2,72.0,95.0,101.0,101.0,1712,2614,1399,1987,313,627,287,601,48,270,239,331,34,59,2700,3075,1025,1650,1325,1200,1
500,0,2,75.0,96.0,101.0,101.0,1846,2580,1511,1931,335,649,397,357,143,50,254,307,35,61,2700,3075,1025,1650,1325,1200,1
507,0,2,75.0,100.0,101.0,101.0,1902,2748,1567,2099,335,649,227,323,33,40,194,283,36,62,2650,3175,1025,1750,1375,1200,1
514,0,2,77.0,96.0,101.0,101.0,2020,2731,1707,2127,313,604,353,136,98,35,255,101,37,62,2650,3175,1025,2050,1375,1200,1
521,0,2,80.0,96.0,101.0,101.0,2132,3207,1819,2379,313,828,423,443,128,230,295,213,38,62,2775,3175,1325,2050,1375,1200,1
529,0,2,84.0,100.0,101.0,101.0,2378,3375,2043,2435,335,940,378,563,168,230,210,333,41,62,2775,3000,1400,2050,1375,1200,1
536,0,2,87.0,98.0,101.0,109.0,2434,3370,2099,2407,335,963,233,845,133,400,100,445,41,62,2825,2825,1400,2050,1400,1375,1
543,0,2,90.0,104.0,101.0,117.0,2496,3431,2071,2491,425,940,284,861,128,500,156,361,42,62,2825,2825,1400,2050,1400,1375,1
550,0,2,90.0,104.0,101.0,125.0,2664,3448,2015,2463,649,985,290,613,58,340,232,273,42,62,2825,3225,1400,2350,1400,1375,1
557,0,2,96.0,104.0,101.0,125.0,2586,3448,1959,2463,627,985,276,413,93,220,183,193,44,62,3225,3225,1400,2350,1400,1375,1
564,0,2,100.0,110.0,109.0,125.0,2754,3263,2127,2323,627,940,292,405,158,100,134,305,45,62,3400,3725,1400,2050,1400,1675,1
571,0,2,104.0,110.0,109.0,125.0,3006,3258,2379,2295,627,963,217,710,28,285,189,425,46,62,3400,3725,1500,2050,1400,1675,1
579,0,2,109.0,113.0,109.0,117.0,3134,3302,2463,2295,671,1007,352,955,108,410,244,545,48,62,3525,3725,1500,2200,1400,1775,1
586,0,2,108.0,113.0,109.0,133.0,2972,3386,2323,2379,649,1007,398,1266,53,605,345,661,49,62,3725,3725,1500,2350,1400,1775,1
593,0,2,110.0,129.0,117.0,133.0,3028,3392,2379,2407,649,985,459,664,38,195,421,469,51,65,3725,4225,1600,2850,1400,1775,1
600,0,2,111.0,129.0,117.0,141.0,3106,3392,2435,2407,671,985,564,509,188,20,376,489,53,65,4175,4625,1600,3000,1400,1775,1
607,0,2,116.0,137.0,117.0,141.0,3140,3319,2491,2379,649,940,435,166,58,15,377,151,53,67,4175,5125,1600,3000,1400,1775,1
614,0,2,121.0,139.0,133.0,149.0,3006,3263,2379,2323,627,940,311,212,8,45,303,167,54,67,4175,5575,1600,3000,1400,1775,1
621,0,2,125.0,141.0,133.0,157.0,3056,3353,2407,2435,649,918,496,473,113,190,383,283,56,69,4300,5175,1600,3000,1400,1775,1
629,0,2,129.0,142.0,133.0,157.0,3190,3308,2407,2323,783,985,556,419,98,20,458,399,58,71,4475,5625,1600,3000,1400,1775,1
636,0,2,129.0,143.0,133.0,172.0,3297,3554,2491,2547,806,1007,393,499,93,130,300,369,59,73,4475,5625,2100,3000,1400,1775,1
643,0,2,133.0,147.0,133.0,172.0,3269,3560,2463,2575,806,985,409,772,138,295,271,477,61,74,4600,5925,2100,3150,1400,1775,1
650,0,2,135.0,147.0,141.0,172.0,3683,3756,2743,2771,940,985,435,1062,173,465,262,597,62,74,4950,5925,2100,3150,1450,1775,1
657,0,2,141.0,163.0,141.0,172.0,3924,3879,2939,2939,985,940,147,329,48,220,99,109,64,75,4950,7025,2250,3150,1450,1775,1
664,0,2,141.0,165.0,141.0,180.0,3991,4070,3051,3107,940,963,279,619,168,540,111,79,64,75,4950,6725,2250,3400,1450,1775,1
671,0,2,142.0,165.0,149.0,180.0,4064,4058,3079,3051,985,1007,444,699,338,500,106,199,64,75,5175,6975,2250,3700,1500,1775,1
679,0,2,142.0,178.0,149.0,180.0,4142,4114,3135,3107,1007,1007,319,245,193,80,126,165,64,75,5450,7275,2250,4000,1500,1775,1
686,0,2,151.0,180.0,157.0,180.0,4154,3963,3191,3023,963,940,157,513,48,390,109,123,64,75,5950,8025,2250,4000,1500,1775,1
693,0,2,156.0,180.0,157.0,180.0,4148,3980,3163,2995,985,985,192,698,88,455,104,243,64,75,6175,8475,2475,4000,1500,1775,1
700,0,2,153.0,180.0,157.0,180.0,4008,3907,3023,2967,985,940,338,665,118,460,220,205,64,75,6275,8475,2475,4000,1500,1775,1
707,0,2,160.0,180.0,173.0,180.0,3459,3818,2519,2855,940,963,555,635,223,460,332,175,64,75,6550,8475,2475,4150,1500,1775,1
714,0,2,160.0,187.0,173.0,204.0,3342,3818,2379,2855,963,963,311,400,88,180,223,220,64,75,6550,8775,2575,4150,1500,1775,1
721,0,2,162.0,187.0,173.0,220.0,3202,3778,2239,2771,963,1007,272,411,58,225,214,186,65,78,7050,8775,2575,4150,1500,1775,1
729,0,2,168.0,190.0,181.0,220.0,3274,3806,2379,2799,895,1007,346,856,153,550,193,306,65,78,7100,8875,2675,4150,1500,1775,1
736,0,2,175.0,192.0,181.0,228.0,3353,3806,2435,2799,918,1007,293,608,38,490,255,118,65,78,7700,8875,2675,4150,1500,1775,1
743,0,2,175.0,194.0,181.0,228.0,3426,3823,2463,2771,963,1052,694,971,323,725,371,246,65,80,7750,8875,3000,4300,1500,1775,1
750,0,2,177.0,194.0,181.0,243.0,3252,3739,2267,2687,985,1052,595,814,333,440,262,374,66,80,7750,9175,3000,4700,1500,1775,1
757,0,2,181.0,197.0,196.0,243.0,3263,4075,2323,2911,940,1164,997,998,548,630,449,368,66,82,8525,9175,3250,4700,1500,1775,1
764,0,2,183.0,199.0,196.0,243.0,3476,4120,2491,2911,985,1209,1057,1405,613,885,444,520,66,82,8975,9475,3250,4700,1500,1775,1
771,0,2,189.0,199.0,196.0,243.0,3498,4170,2491,2939,1007,1231,582,1080,418,495,164,585,66,82,9025,9375,3250,4700,1500,1875,1
779,0,2,194.0,199.0,196.0,243.0,3426,4019,2463,2855,963,1164,734,1305,483,655,251,650,66,84,9475,9375,3250,4700,1500,1875,1
786,0,2,195.0,197.0,196.0,243.0,3034,3969,2071,2715,963,1254,585,1788,493,990,92,798,66,84,9475,9275,3250,4700,1500,1975,1
793,0,2,196.0,198.0,196.0,243.0,3000,4030,2015,2799,985,1231,461,2286,403,1340,58,946,66,84,9750,9675,3250,4700,1500,1975,1
800,0,2,196.0,195.0,196.0,243.0,3146,4361,2183,3219,963,1142,742,2457,568,1450,174,1007,66,84,9800,9325,3250,4850,1500,2325,1
807,0,2,195.0,191.0,196.0,243.0,3319,4624,2379,3415,940,1209,553,3034,513,1875,40,1159,69,84,10400,8975,3250,6050,1625,2675,1
814,0,2,196.0,189.0,196.0,243.0,3252,4719,2267,3443,985,1276,723,3292,588,2085,135,1207,69,84,10400,8975,3250,6050,1625,2775,1
821,0,2,200.0,199.0,204.0,243.0,3442,4669,2435,3415,1007,1254,413,2181,258,1655,155,526,70,84,10675,9075,3250,6050,1625,2775,1
829,0,2,200.0,199.0,204.0,251.0,3543,4506,2379,3275,1164,1231,752,2512,453,1950,299,562,70,84,10725,10325,3475,6200,1625,2775,1
836,0,2,200.0,199.0,204.0,259.0,3622,4562,2323,3331,1299,1231,1164,3065,713,2355,451,710,70,84,10725,10325,3475,6200,1625,2775,1
843,0,2,200.0,199.0,204.0,259.0,3655,4439,2379,3275,1276,1164,1607,3580,1008,2730,599,850,70,84,10950,10325,3575,6200,1625,2775,1
850,0,2,200.0,199.0,204.0,274.0,3666,4462,2435,3275,1231,1187,2051,4134,1308,3140,743,994,70,84,10950,10325,3575,6200,1625,2775,1
857,0,2,200.0,199.0,204.0,274.0,3767,4574,2491,3387,1276,1187,2497,4281,1598,3335,899,946,70,84,10950,10325,3575,6200,1625,2775,1
864,0,2,194.0,193.0,204.0,274.0,3381,4613,2239,3359,1142,1254,2875,4125,1848,3335,1027,790,64,84,10950,9725,3825,6200,1925,3375,1
871,0,2,199.0,200.0,204.0,274.0,2614,4590,1651,3359,963,1231,2626,2813,1758,2725,868,88,64,84,10950,8875,3825,6200,1925,4225,1
879,0,2,199.0,200.0,204.0,274.0,2894,4400,1931,3191,963,1209,2783,3334,1853,3110,930,224,64,84,10950,10375,3825,6200,1925,4225,1
886,0,2,199.0,200.0,204.0,274.0,3386,4389,2379,3135,1007,1254,3163,3836,2113,3460,1050,376,64,87,10900,10375,3825,6200,1975,4225,1
893,0,2,193.0,200.0,219.0,282.0,3437,4355,2407,3191,1030,1164,3573,4372,2403,3860,1170,512,64,87,10575,10375,3825,6200,2300,4225,1
900,0,2,194.0,200.0,219.0,282.0,3314,4400,2351,3191,963,1209,3551,4890,2469,4230,1082,660,63,87,10850,10375,3925,6200,2350,4225,1
907,0,2,189.0,198.0,219.0,282.0,3134,4607,2127,3331,1007,1276,2331,5157,1446,4345,885,812,58,87,10900,10125,3925,6200,2600,4475,1
914,0,2,192.0,195.0,219.0,282.0,2994,4562,1987,3331,1007,1231,2237,4477,1436,4025,801,452,58,87,11200,9775,3925,6800,2600,4825,1
921,0,2,187.0,189.0,219.0,282.0,3095,4551,2211,3443,884,1108,2425,4108,1551,3980,874,128,59,87,10750,8575,3925,6800,3050,6025,1
929,0,2,192.0,193.0,219.0,282.0,2983,4355,2211,3303,772,1052,2582,4101,1641,3995,941,106,59,87,10950,9000,3925,6800,3050,6125,1
936,0,2,190.0,199.0,219.0,282.0,2961,4338,2155,3387,806,951,2763,4331,1751,4115,1012,216,59,87,10575,9000,3925,7100,3425,6125,1
943,0,2,197.0,197.0,219.0,282.0,2748,4232,1987,3359,761,873,1771,4643,1121,4315,650,328,59,87,10550,8975,3925,7100,3875,6650,1
950,0,2,194.0,188.0,219.0,282.0,2882,4238,2099,3275,783,963,923,3941,531,3635,392,306,59,87,10075,8625,3925,7100,4525,7300,1
957,0,2,200.0,199.0,219.0,282.0,2770,4238,1987,3163,783,1075,584,3154,371,2720,213,434,62,87,10450,7325,3925,7400,4525,8900,1
964,0,2,199.0,195.0,219.0,282.0,2832,4400,2071,3303,761,1097,962,3657,661,3095,301,562,62,87,10575,8125,3825,8200,4675,9400,1
971,0,2,197.0,192.0,219.0,282.0,2552,4434,1791,3359,761,1075,949,3648,706,3020,243,628,58,86,11100,7325,3825,8200,4975,10450,1
979,0,2,198.0,188.0,234.0,282.0,2468,4736,1707,3639,761,1097,859,4206,649,3450,210,756,58,84,10800,7250,3825,8650,5525,10800,1
986,0,2,200.0,190.0,249.0,282.0,2686,4529,1903,3499,783,1030,639,4131,483,3255,156,876,58,80,10800,7175,3825,9100,5725,11375,1
993,0,2,197.0,186.0,241.0,282.0,2608,4215,1847,3275,761,940,952,3422,708,2630,244,792,58,78,10625,7950,3925,9100,5950,12800,1
1000,0,2,182.0,163.0,241.0,282.0,2720,3946,1959,3051,761,895,409,3777,298,2865,111,912,58,78,9000,6225,3925,9100,8083,14525,1
1007,0,2,185.0,175.0,241.0,282.0,2602,3930,1819,2967,783,963,190,3639,58,2615,132,1024,58,78,9400,6325,3925,9250,8083,14525,1
1014,0,2,188.0,193.0,241.0,282.0,2518,4019,1735,3079,783,940,332,2931,108,1995,224,936,58,78,9400,7425,3925,9250,8083,14525,1
1021,0,2,194.0,197.0,248.0,282.0,2222,4176,1483,3191,739,985,250,2827,88,2025,162,802,58,78,9800,7950,3925,9250,8483,14700,1
1029,0,2,198.0,199.0,248.0,282.0,2345,4338,1539,3331,806,1007,266,3242,158,2320,108,922,61,78,10225,8050,3925,9250,8483,14700,1
1036,0,2,200.0,200.0,248.0,282.0,2451,4226,1679,3219,772,1007,311,3643,113,2680,198,963,62,78,10325,8050,3925,9250,8483,14700,1
1043,0,2,200.0,200.0,248.0,282.0,2462,4333,1847,3303,615,1030,594,4180,328,3085,266,1095,62,78,11050,8050,3925,9250,8483,14700,1
1050,0,2,200.0,200.0,248.0,282.0,2759,4159,2155,3107,604,1052,400,4669,208,3450,192,1219,62,78,11050,8050,3925,9250,8483,14700,1
1057,0,2,200.0,198.0,248.0,282.0,2345,3722,1651,2603,694,1119,588,5130,308,3775,280,1355,62,78,11150,8050,3925,9250,8483,14800,1
1064,0,2,200.0,198.0,248.0,282.0,2838,3818,2099,2631,739,1187,435,5282,313,3795,122,1487,62,78,11150,8050,3925,9250,8483,14800,1
1071,0,2,200.0,197.0,248.0,282.0,2944,3846,2183,2659,761,1187,623,5378,438,3930,185,1448,62,77,11175,8050,4325,9250,8758,14850,1
1079,0,2,200.0,187.0,248.0,282.0,3112,3784,2239,2687,873,1097,996,5107,703,3735,293,1372,62,71,11175,8810,4325,9250,8758,15750,1
1086,0,2,200.0,199.0,248.0,282.0,3174,3812,2323,2715,851,1097,911,4062,700,3300,211,762,62,71,10875,8810,3900,9250,9483,15750,1
1093,0,2,200.0,199.0,248.0,282.0,3106,3784,2211,2687,895,1097,1140,4497,823,3595,317,902,62,71,11050,10325,3900,9400,9483,15750,1
1100,0,2,195.0,199.0,248.0,282.0,3179,3812,2239,2603,940,1209,1657,4935,1203,3885,454,1050,62,71,10825,10340,3900,9550,9758,15750,1
1107,0,2,185.0,200.0,248.0,282.0,3286,3851,2323,2575,963,1276,2053,5162,1483,3960,570,1202,62,71,10050,10005,3900,9250,10533,16400,1
1114,0,2,181.0,199.0,248.0,282.0,3269,3762,2351,2463,918,1299,2431,5195,1753,3845,678,1350,61,70,9900,9220,4000,8950,10733,17750,1
1121,0,2,174.0,197.0,248.0,282.0,3241,3734,2323,2435,918,1299,2529,5647,1768,4145,761,1502,61,70,9075,9370,4000,8950,11558,18000,1
1129,0,2,185.0,197.0,248.0,282.0,3358,3470,2463,2239,895,1231,1053,6042,1013,4400,40,1642,61,70,8800,9370,4000,8950,11608,18000,1
1136,0,2,178.0,193.0,248.0,282.0,3280,3504,2407,2295,873,1209,1102,5864,1008,4320,94,1544,61,68,8425,8970,4000,8950,12033,18500,1
1143,0,2,186.0,195.0,248.0,282.0,3409,3549,2491,2295,918,1254,933,5700,873,4250,60,1450,61,68,8650,8770,4100,8950,12033,18700,1
1150,0,2,187.0,194.0,248.0,282.0,3370,3521,2407,2267,963,1254,1339,6108,1163,4510,176,1598,61,68,8775,8670,4100,8950,12083,18800,1
1157,0,2,188.0,200.0,248.0,282.0,3381,3638,2463,2407,918,1231,997,5506,813,4160,184,1346,61,68,8825,8670,4100,8950,12083,18800,1
1164,0,2,195.0,193.0,248.0,282.0,3274,3756,2379,2435,895,1321,1416,5502,1078,4000,338,1502,61,68,9225,8120,4100,8950,12083,19350,1
1171,0,2,195.0,199.0,248.0,282.0,3157,3498,2239,2267,918,1231,1284,5303,1038,3915,246,1388,61,68,9725,8120,4300,8800,12533,19500,1
1179,0,2,198.0,199.0,248.0,282.0,3067,3364,2127,2155,940,1209,592,5705,413,4165,179,1540,61,68,9825,8120,4300,8800,12533,19500,1
1186,0,2,200.0,197.0,248.0,282.0,3011,3330,2071,2099,940,1231,1059,6101,718,4405,341,1696,61,68,10425,9340,4100,8650,12683,19750,1
1193,0,2,200.0,183.0,248.0,282.0,3129,3442,2211,2099,918,1343,1518,5894,1068,4280,450,1614,61,68,10475,8355,4100,9100,12683,20750,1
1200,0,2,200.0,191.0,248.0,282.0,3078,3510,2183,2099,895,1411,1985,4112,1479,2830,506,1282,61,68,10700,8845,4100,9100,12683,20950,1
1207,0,2,199.0,187.0,248.0,282.0,2922,3560,2071,2127,851,1433,2329,3702,1725,2660,604,1042,61,68,10700,8675,4500,9100,12733,21150,1
1214,0,2,199.0,179.0,248.0,282.0,3118,3336,2155,1903,963,1433,2299,4015,1775,2805,524,1210,61,66,11000,9080,4650,8950,12733,21850,1
1221,0,2,197.0,179.0,248.0,282.0,3022,3420,2015,1875,1007,1545,2659,2429,2015,1785,644,644,61,66,10900,8840,4650,8950,12833,22150,1
1229,0,2,196.0,188.0,248.0,282.0,3090,3465,2127,1875,963,1590,2826,1571,2170,1360,656,211,61,65,10850,10105,4650,9450,12883,22350,1
1236,0,2,186.0,198.0,248.0,282.0,3034,3414,2071,1847,963,1567,2957,1434,2260,785,697,649,61,65,9800,9445,4800,9450,13808,23850,1
1243,0,2,178.0,171.0,248.0,282.0,3095,3510,2155,2043,940,1467,2325,649,1870,330,455,319,61,65,8600,7745,5000,9450,15008,26650,1
1250,0,2,163.0,162.0,248.0,282.0,3073,3454,2155,2043,918,1411,897,421,830,230,67,191,61,65,6925,7160,5000,9150,16633,28375,1
1257,0,2,165.0,168.0,248.0,274.0,3039,3398,2099,1987,940,1411,559,485,455,130,104,355,61,65,6625,7550,5400,8550,16883,29375,1
1264,0,2,168.0,164.0,248.0,274.0,3140,2927,2155,1651,985,1276,825,768,630,265,195,503,63,65,6850,7695,5400,8550,16933,29575,1
1271,0,2,186.0,168.0,248.0,259.0,3269,2614,2351,1483,918,1131,314,549,215,170,99,379,69,65,8200,8885,5400,8350,16933,30175,1
1279,0,2,187.0,168.0,248.0,259.0,3134,2597,2239,1567,895,1030,662,693,530,190,132,503,72,65,8250,8915,5475,8350,16933,30175,1
1286,0,2,196.0,168.0,248.0,259.0,3196,2597,2323,1567,873,1030,485,999,445,380,40,619,74,65,8450,9545,5475,8350,16933,30175,1
1293,0,2,197.0,167.0,248.0,259.0,3370,2888,2295,1903,1075,985,851,1335,725,600,126,735,72,65,8725,9475,5475,8350,17083,30275,1
1300,0,2,196.0,167.0,248.0,259.0,3487,3246,2323,2239,1164,1007,996,1310,855,455,141,855,69,65,9325,10150,5475,8350,17233,30275,1
1307,0,2,189.0,165.0,248.0,259.0,3437,3314,2295,2351,1142,963,523,1051,400,330,123,721,69,65,8725,10550,5475,8500,18008,31225,1
1314,0,2,193.0,161.0,248.0,259.0,3370,3308,2183,2323,1187,985,382,1400,265,555,117,845,69,65,9775,10260,5475,8500,18108,31545,1
1321,0,2,187.0,169.0,248.0,259.0,3487,3269,2211,2239,1276,1030,185,950,70,185,115,765,70,65,9225,10275,5475,8500,19158,31590,1
1329,0,2,189.0,170.0,248.0,259.0,3330,3330,2099,2323,1231,1007,504,935,120,150,384,785,70,64,9500,10510,5650,8500,19158,31830,1
1336,0,2,189.0,167.0,248.0,259.0,3101,2686,1847,1791,1254,895,631,1181,170,300,461,881,73,61,9650,10600,5450,8500,19158,31980,1
1343,0,2,167.0,149.0,248.0,259.0,3241,2558,1987,1763,1254,795,672,1431,130,460,542,971,73,58,7125,8815,5450,8500,22183,33930,1
1350,0,2,138.0,146.0,248.0,259.0,3442,2619,2211,2015,1231,604,700,1448,35,565,665,883,73,58,4750,8275,5450,8500,25108,34530,1
1357,0,2,122.0,146.0,248.0,259.0,3762,2597,2463,2127,1299,470,846,1673,25,730,821,943,73,58,3475,8245,5450,8500,26383,34650,1
1364,0,2,133.0,153.0,248.0,259.0,3683,2597,2407,2127,1276,470,770,1694,105,695,665,999,73,58,3725,9055,5450,8500,26383,34650,1
1371,0,2,138.0,151.0,248.0,259.0,3778,2591,2491,2099,1287,492,867,1855,67,875,800,980,73,62,4175,9545,5450,8500,26383,34950,1
1379,0,2,132.0,151.0,248.0,259.0,3258,2490,2183,2043,1075,447,1110,2087,212,1055,898,1032,71,63,4350,9620,5450,8500,26783,34950,1
1386,0,2,139.0,149.0,248.0,274.0,3134,2518,2295,2071,839,447,1047,2298,57,1210,990,1088,71,63,4450,9605,5250,8500,27020,35140,1
1393,0,2,142.0,149.0,248.0,274.0,3196,2642,2435,2127,761,515,1063,2542,127,1390,936,1152,74,63,4500,9795,5050,8500,27070,35140,1
1400,0,2,148.0,165.0,248.0,274.0,3588,2698,2827,2183,761,515,875,811,97,470,778,341,74,63,4700,9855,5050,8500,27070,35140,1
1407,0,2,149.0,165.0,248.0,274.0,3806,2994,3023,2435,783,559,727,1143,107,730,620,413,74,63,5300,9885,4825,8500,27348,35155,1
1414,0,2,150.0,165.0,248.0,274.0,3375,3269,2659,2687,716,582,553,1456,1,975,552,481,73,63,5400,9885,4625,8500,27598,35200,1
1421,0,2,137.0,165.0,248.0,282.0,2748,3269,2323,2687,425,582,823,1715,241,1170,582,545,72,63,4225,9595,4625,8500,29148,35695,1
7,0,1,13.0,13.0,15.0,14.0,251,293,251,293,0,0,30,35,30,35,0,0,12,12,0,0,0,0,0,0,0
14,0,1,13.0,13.0,15.0,14.0,671,671,671,671,0,0,120,20,120,20,0,0,12,13,0,0,0,0,0,0,0
21,0,1,14.0,14.0,15.0,14.0,755,783,755,783,0,0,50,55,50,55,0,0,13,13,0,0,0,0,0,0,0
29,0,1,15.0,14.0,15.0,14.0,699,783,699,783,0,0,80,140,80,140,0,0,14,13,0,0,0,0,0,0,0
36,0,1,15.0,14.0,15.0,22.0,755,783,755,783,0,0,125,235,125,235,0,0,14,14,0,0,0,0,0,0,0
43,0,1,16.0,13.0,23.0,22.0,755,727,755,727,0,0,210,10,210,10,0,0,15,13,0,0,0,0,0,0,0
50,0,1,16.0,14.0,23.0,22.0,839,727,839,727,0,0,35,45,35,45,0,0,15,13,0,0,0,0,0,0,0
57,0,1,17.0,14.0,23.0,22.0,699,671,699,671,0,0,20,125,20,125,0,0,16,13,0,0,0,0,0,0,0
64,0,1,18.0,14.0,23.0,22.0,811,727,811,727,0,0,75,20,75,20,0,0,17,14,0,0,0,0,0,0,0
71,0,1,18.0,13.0,23.0,22.0,777,643,755,643,22,0,119,15,115,15,4,0,17,12,0,0,0,0,0,0,0
79,0,1,19.0,14.0,23.0,22.0,866,643,755,643,111,0,325,50,305,50,20,0,18,12,0,0,0,0,0,0,0
86,0,1,19.0,14.0,23.0,22.0,939,643,783,643,156,0,450,30,410,30,40,0,18,13,0,0,0,0,0,0,0
93,0,1,20.0,14.0,23.0,22.0,967,699,811,699,156,0,320,120,310,120,10,0,19,14,0,0,150,0,0,0,0
100,0,1,20.0,14.0,23.0,22.0,995,648,839,559,156,89,430,191,400,175,30,16,19,14,0,0,150,0,0,0,0
107,0,1,20.0,14.0,23.0,30.0,995,771,839,615,156,156,160,301,110,265,50,36,19,14,0,0,150,0,0,0,0
114,0,1,20.0,17.0,23.0,36.0,962,771,783,615,179,156,160,191,90,135,70,56,19,14,0,0,150,250,0,0,0
121,0,1,21.0,18.0,23.0,36.0,990,738,811,559,179,179,225,76,135,0,90,76,19,14,0,0,150,250,0,0,0
129,0,1,22.0,18.0,23.0,36.0,1107,715,951,559,156,156,306,107,200,15,106,92,19,13,100,0,150,250,0,0,0
136,0,1,23.0,18.0,31.0,36.0,1247,760,1091,671,156,89,146,120,120,20,26,100,20,12,100,100,150,250,0,0,0
143,0,1,24.0,19.0,31.0,36.0,1247,659,1091,615,156,44,231,148,185,40,46,108,21,13,150,100,150,250,0,0,0
150,0,1,24.0,20.0,31.0,36.0,1247,782,1091,671,156,111,281,194,265,70,16,124,21,14,150,250,150,250,0,0,0
157,0,1,25.0,21.0,31.0,36.0,1191,777,1035,643,156,134,381,230,345,90,36,140,22,15,150,300,150,250,0,0,0
164,0,1,25.0,22.0,31.0,36.0,1214,883,1035,727,179,156,76,285,20,125,56,160,22,16,150,300,150,450,0,0,0
171,0,1,26.0,23.0,31.0,36.0,1191,844,1035,643,156,201,232,343,160,155,72,188,23,17,150,300,150,450,0,0,0
179,0,1,27.0,24.0,46.0,36.0,1247,973,1091,727,156,246,187,146,95,30,92,116,24,18,150,300,400,450,0,0,0
186,0,1,27.0,25.0,46.0,36.0,1331,1018,1175,727,156,291,212,222,100,70,112,152,24,19,150,300,500,450,0,0,0
193,0,1,28.0,25.0,46.0,36.0,1191,1040,1035,727,156,313,312,343,180,155,132,188,25,20,150,300,500,450,0,0,0
200,0,1,33.0,25.0,46.0,36.0,1415,1090,1259,755,156,335,167,473,40,245,127,228,25,20,150,300,500,450,0,0,0
207,0,1,34.0,25.0,46.0,36.0,1634,1068,1455,755,179,313,252,599,105,335,147,264,26,20,150,300,500,450,0,0,0
214,0,1,35.0,26.0,46.0,36.0,1746,1096,1567,783,179,313,362,684,195,380,167,304,27,20,150,300,575,450,0,0,0
221,0,1,41.0,27.0,46.0,36.0,1863,1124,1707,811,156,313,133,779,50,435,83,344,28,21,350,300,575,450,0,0,0
229,0,1,43.0,28.0,46.0,36.0,1835,1146,1679,811,156,335,253,764,150,380,103,384,30,22,350,300,575,450,0,0,0
236,0,1,43.0,28.0,61.0,36.0,1981,1146,1735,811,246,335,139,449,100,225,39,224,30,22,400,300,725,700,0,0,0
243,0,1,46.0,29.0,61.0,44.0,1936,1208,1623,895,313,313,174,541,95,285,79,256,32,23,600,300,725,700,0,0,0
250,0,1,49.0,30.0,61.0,44.0,2076,1286,1763,951,313,335,149,546,80,300,69,246,33,24,600,300,725,700,0,0,0
257,0,1,50.0,31.0,61.0,44.0,2126,1376,1791,1063,335,313,269,547,160,315,109,232,34,25,600,400,725,700,0,0,0
264,0,1,54.0,32.0,61.0,44.0,2233,1348,1875,1035,358,313,264,657,115,385,149,272,36,26,750,500,725,700,0,0,0
271,0,1,55.0,33.0,61.0,44.0,2188,1432,1875,1119,313,313,496,702,315,390,181,312,36,27,750,500,975,700,0,0,0
279,0,1,57.0,34.0,69.0,44.0,2748,1510,2435,1175,313,335,646,817,425,465,221,352,38,28,800,500,975,700,0,0,0
286,0,1,60.0,35.0,77.0,52.0,2804,1516,2491,1203,313,313,506,928,270,540,236,388,38,29,900,500,1075,700,0,0,0
293,0,1,66.0,35.0,77.0,52.0,2776,1622,2463,1287,313,335,206,1053,130,625,76,428,40,29,900,500,1075,700,0,0,0
300,0,1,66.0,35.0,77.0,52.0,2826,1572,2491,1259,335,313,271,1179,155,715,116,464,40,29,1050,500,1075,700,0,0,0
307,0,1,72.0,36.0,77.0,52.0,2782,1572,2267,1259,515,313,264,1309,80,805,184,504,42,30,1050,500,1075,1150,0,0,0
314,0,1,75.0,39.0,85.0,52.0,2748,1606,2099,1315,649,291,290,1275,155,835,135,440,42,31,1050,500,1150,1150,0,0,0
321,0,1,78.0,40.0,85.0,52.0,2854,1527,2183,1147,671,380,181,1392,120,900,61,492,45,32,1600,500,1150,1150,0,0,0
329,0,1,81.0,41.0,85.0,52.0,2972,1589,2323,1119,649,470,377,1541,240,985,137,556,45,33,1600,500,1400,1150,0,0,0
336,0,1,81.0,42.0,85.0,52.0,2754,1774,2127,1147,627,627,93,1721,80,1085,13,636,45,34,1600,700,1400,1150,0,0,0
343,0,1,84.0,43.0,85.0,52.0,2894,1846,2267,1175,627,671,313,1791,220,1075,93,716,48,35,1750,700,1550,1150,0,0,0
350,0,1,85.0,46.0,85.0,52.0,3084,1992,2435,1343,649,649,168,1772,120,1080,48,692,51,36,2025,700,1550,1150,0,0,0
357,0,1,95.0,47.0,101.0,52.0,2994,1874,2323,1203,671,671,218,1848,90,1130,128,718,51,37,2025,500,1550,1150,0,200,0
364,0,1,95.0,48.0,101.0,52.0,3157,2042,2463,1371,694,671,259,1948,55,1150,204,798,51,38,2025,600,1550,1150,0,200,0
371,0,1,101.0,49.0,101.0,52.0,3302,1970,2631,1343,671,627,125,2130,45,1260,80,870,54,39,2275,800,1550,1150,0,200,0
379,0,1,101.0,49.0,101.0,60.0,3062,2138,2435,1511,627,627,242,2400,90,1450,152,950,54,40,2275,800,1550,1150,0,200,0
386,0,1,101.0,49.0,101.0,60.0,3090,2104,2463,1455,627,649,187,2650,55,1620,132,1030,56,40,2275,800,1550,1150,0,200,0
393,0,1,111.0,49.0,117.0,60.0,3140,2322,2491,1651,649,671,227,2930,140,1820,87,1110,56,40,2550,800,1550,1150,0,200,0
400,0,1,113.0,49.0,117.0,60.0,3106,2244,2435,1595,671,649,422,3187,355,2005,67,1182,58,40,2950,800,1550,1150,0,200,0
407,0,1,117.0,49.0,117.0,60.0,3280,2322,2631,1651,649,671,558,3457,415,2195,143,1262,58,40,3200,800,1850,1150,0,200,0
414,0,1,121.0,49.0,125.0,60.0,3386,2272,2715,1623,671,649,259,3718,140,2380,119,1338,58,40,3200,800,1850,1150,0,200,0
421,0,1,121.0,49.0,133.0,60.0,3526,2250,2855,1623,671,627,129,3984,80,2570,49,1414,59,40,3200,800,1850,1150,0,200,0
429,0,1,125.0,49.0,133.0,60.0,3734,2272,3107,1623,627,649,456,4254,335,2760,121,1494,61,40,3575,800,1850,1150,0,200,0
436,0,1,128.0,49.0,149.0,60.0,3834,2154,3163,1483,671,671,494,4509,285,2935,209,1574,62,40,3925,800,2100,1150,0,200,0
443,0,1,136.0,49.0,149.0,60.0,3812,2216,3051,1567,761,649,301,4780,225,3130,76,1650,63,40,4025,800,2100,1150,0,200,0
450,0,1,141.0,49.0,149.0,60.0,3823,2132,2883,1483,940,649,292,5036,100,3310,192,1726,63,40,4175,800,2100,1150,0,200,0
457,0,1,141.0,49.0,149.0,60.0,3795,2294,2855,1623,940,671,381,5321,260,3515,121,1806,66,40,4175,800,2550,1150,0,200,0
464,0,1,141.0,49.0,149.0,60.0,3879,2166,2939,1539,940,627,498,5568,440,3690,58,1878,66,40,4175,800,2550,1150,0,200,0
471,0,1,146.0,49.0,165.0,60.0,4243,2278,3303,1651,940,627,365,5848,295,3890,70,1958,66,40,4900,800,2550,1150,0,200,0
479,0,1,153.0,49.0,165.0,60.0,4042,2132,3079,1483,963,649,485,6108,295,4070,190,2038,66,40,4900,800,2550,1150,0,200,0
486,0,1,158.0,49.0,165.0,60.0,3986,2266,3023,1595,963,671,130,6373,70,4255,60,2118,66,40,4900,800,2550,1150,0,200,0
493,0,1,164.0,49.0,173.0,60.0,3980,2070,2995,1399,985,671,421,6619,245,4425,176,2194,69,40,5350,800,2550,1150,0,200,0
500,0,1,172.0,49.0,181.0,60.0,3834,2238,2827,1567,1007,671,416,6885,220,4615,196,2270,69,40,5350,800,2625,1150,0,200,0
507,0,1,180.0,49.0,196.0,60.0,3918,2216,2911,1567,1007,649,288,7146,105,4800,183,2346,69,40,5600,800,2625,1150,0,200,0
514,0,1,186.0,49.0,204.0,60.0,3980,2278,2995,1651,985,627,484,7427,285,5005,199,2422,72,40,6275,800,2625,1150,0,200,0
521,0,1,189.0,49.0,212.0,60.0,4019,2222,3079,1595,940,627,231,7687,145,5185,86,2502,72,40,6275,800,2625,1150,0,200,0
529,0,1,197.0,49.0,212.0,60.0,3986,2300,3023,1651,963,649,701,7962,495,5380,206,2582,72,40,6775,800,2625,1150,0,200,0
536,0,1,200.0,49.0,212.0,60.0,3930,2272,2967,1623,963,649,1012,8243,690,5585,322,2658,72,40,6925,800,2625,1150,0,200,0
543,0,1,200.0,49.0,212.0,60.0,4114,2272,3107,1623,1007,649,737,8494,445,5760,292,2734,75,40,7500,800,2625,1150,0,200,0
550,0,1,200.0,49.0,212.0,60.0,3812,2238,2827,1567,985,671,1169,8764,765,5950,404,2814,75,40,7975,800,2625,1150,0,200,0
557,0,1,200.0,49.0,212.0,60.0,4204,2132,3219,1483,985,649,555,9010,285,6120,270,2890,75,40,8175,800,2625,1150,0,200,0
564,0,1,200.0,49.0,212.0,60.0,4327,2138,3387,1511,940,627,677,9286,295,6320,382,2966,75,40,8175,800,2625,1150,0,200,0
571,0,1,200.0,49.0,212.0,60.0,4103,2132,3163,1483,940,649,754,9531,260,6485,494,3046,75,40,8175,800,2625,1150,0,200,0
579,0,1,200.0,49.0,212.0,60.0,4271,2182,3331,1511,940,671,1030,9811,420,6685,610,3126,75,40,8175,800,2625,1150,0,200,0
586,0,1,200.0,49.0,212.0,60.0,4299,2188,3359,1539,940,649,1108,10077,390,6875,718,3202,75,40,8175,800,2825,1150,0,200,0
593,0,1,200.0,49.0,212.0,60.0,4378,2210,3415,1539,963,671,1474,10328,690,7050,784,3278,75,40,8175,800,3275,1150,0,200,0
600,0,1,200.0,49.0,212.0,60.0,4439,2188,3499,1539,940,649,548,10589,360,7235,188,3354,75,40,8175,800,3275,1150,0,200,0
607,0,1,200.0,49.0,212.0,60.0,4574,2166,3611,1539,963,627,869,10850,665,7420,204,3430,75,40,8175,800,4025,1150,0,200,0
614,0,1,200.0,49.0,212.0,60.0,4249,2194,3331,1567,918,627,807,11115,495,7605,312,3510,75,40,8175,800,4250,1150,0,200,0
621,0,1,200.0,49.0,212.0,60.0,3857,2166,2939,1539,918,627,1284,11371,860,7785,424,3586,75,40,8175,800,4250,1150,0,200,0
629,0,1,200.0,49.0,227.0,60.0,4025,2076,3107,1427,918,649,1780,11626,1240,7960,540,3666,75,40,8175,800,4250,1150,0,200,0
636,0,1,200.0,48.0,227.0,60.0,3823,2082,2883,1455,940,627,1898,10823,1250,7485,648,3338,75,38,8175,800,4250,1150,0,200,0
643,0,1,200.0,49.0,242.0,60.0,3269,2082,2351,1455,918,627,1130,11019,945,7605,185,3414,75,38,8175,900,4450,1150,0,200,0
650,0,1,200.0,43.0,257.0,76.0,3291,2104,2351,1455,940,649,1508,11219,1215,7725,293,3494,75,39,8175,350,4450,1150,0,750,0
657,0,1,200.0,43.0,257.0,76.0,3039,2082,2099,1455,940,627,1854,11470,1445,7900,409,3570,75,40,8175,350,4575,1150,0,750,0
664,0,1,200.0,43.0,272.0,76.0,3235,2160,2071,1511,1164,649,2251,11725,1690,8075,561,3650,75,40,8175,350,4575,1400,0,750,0
671,0,1,200.0,43.0,272.0,76.0,3336,2149,2015,1455,1321,694,2191,11985,1470,8255,721,3730,75,40,8175,400,4575,1650,0,750,0
679,0,1,200.0,45.0,272.0,76.0,3442,2048,2099,1399,1343,649,2602,11722,1725,8120,877,3602,75,40,8175,400,4575,1650,0,750,0
686,0,1,200.0,45.0,272.0,76.0,3840,2082,2519,1455,1321,627,3083,11988,2050,8310,1033,3678,75,40,8175,400,4575,1650,0,750,0
693,0,1,200.0,45.0,272.0,76.0,3879,2104,2603,1455,1276,649,3396,12253,2215,8495,1181,3758,75,40,8175,400,4575,1650,0,750,0
700,0,1,200.0,45.0,287.0,76.0,3896,2110,2575,1483,1321,627,3861,12509,2520,8675,1341,3834,75,40,8175,400,4575,1650,0,750,0
707,0,1,200.0,45.0,287.0,76.0,3851,2110,2575,1483,1276,627,3138,12769,1945,8855,1193,3914,75,40,8175,550,4575,1650,0,750,0
714,0,1,200.0,45.0,287.0,76.0,3566,2154,2267,1483,1299,671,3014,13044,1665,9050,1349,3994,75,40,8175,550,4575,1650,0,750,0
721,0,1,200.0,45.0,287.0,76.0,3672,2233,2351,1539,1321,694,3459,13299,1950,9225,1509,4074,75,40,8175,550,4575,1650,0,750,0
729,0,1,200.0,45.0,287.0,76.0,3610,2216,2267,1567,1343,649,3885,13566,2220,9420,1665,4146,75,40,8175,550,5425,1650,0,750,0
736,0,1,124.0,45.0,287.0,76.0,3711,2104,2323,1455,1388,649,4323,13802,2490,9580,1833,4222,75,40,4375,550,5525,1650,0,750,0
743,0,1,143.0,44.0,287.0,76.0,3812,2082,2379,1455,1433,627,2750,13748,1495,9450,1255,4298,75,39,4225,550,5750,1650,0,750,0
750,0,1,143.0,43.0,287.0,76.0,3750,2054,2295,1427,1455,627,3016,13643,1585,9465,1431,4178,75,38,4225,550,5750,2000,0,750,0
757,0,1,143.0,43.0,287.0,76.0,3818,2054,2407,1427,1411,627,3480,13883,1885,9625,1595,4258,75,38,4225,550,5750,2000,0,750,0
764,0,1,143.0,43.0,287.0,76.0,3672,2093,2239,1399,1433,694,3921,14128,2150,9790,1771,4338,75,38,4625,550,5750,2000,0,750,0
771,0,1,165.0,43.0,287.0,76.0,3823,2042,2211,1371,1612,671,1712,14369,795,9955,917,4414,75,38,5725,550,5750,2000,0,750,0
779,0,1,171.0,43.0,287.0,76.0,3762,1992,2127,1343,1635,649,1644,14596,785,10110,859,4486,75,38,6275,550,5750,2000,0,750,0
786,0,1,171.0,43.0,287.0,76.0,3801,1970,2211,1343,1590,627,2106,14827,1055,10265,1051,4562,75,38,6275,550,5750,2000,0,750,0
793,0,1,171.0,43.0,302.0,76.0,3890,1886,2211,1259,1679,627,1480,15047,725,10405,755,4642,75,38,6675,550,5750,2000,0,750,0
800,0,1,187.0,49.0,302.0,76.0,3974,1914,2295,1287,1679,627,939,14777,280,10255,659,4522,75,38,7775,550,5750,2400,0,750,0
807,0,1,187.0,49.0,302.0,76.0,4019,1930,2295,1259,1724,671,1137,15007,420,10405,717,4602,75,38,8325,550,5750,2400,0,750,0
814,0,1,193.0,50.0,302.0,82.0,5548,1953,3779,1259,1769,694,1469,15182,540,10500,929,4682,75,38,8925,550,5750,2400,0,750,0
821,0,1,193.0,51.0,302.0,82.0,6024,1740,4255,1091,1769,649,2203,15295,1070,10545,1133,4750,75,38,9325,550,5750,2400,0,750,0
829,0,1,193.0,50.0,302.0,82.0,5968,1550,4199,923,1769,627,2589,15416,1340,10590,1249,4826,75,37,10425,550,5750,2400,0,750,0
836,0,1,193.0,51.0,302.0,82.0,6209,1606,4283,979,1926,627,3126,15557,1745,10655,1381,4902,75,38,10425,550,5750,2400,0,750,0
843,0,1,193.0,51.0,302.0,74.0,6080,1970,4087,1343,1993,627,3886,15677,2265,10770,1621,4907,75,39,10425,850,5750,2400,0,950,0
850,0,1,199.0,51.0,302.0,74.0,6427,2031,4479,1427,1948,604,3829,15924,2355,10945,1474,4979,75,40,10425,850,5850,2400,0,950,0
857,0,1,199.0,51.0,302.0,74.0,6567,2054,4619,1427,1948,627,4596,16150,2890,11095,1706,5055,75,40,11025,950,6300,2400,0,950,0
864,0,1,199.0,53.0,302.0,74.0,6590,1902,4619,1231,1971,671,5377,16234,3435,11145,1942,5089,75,40,11025,950,6300,2400,0,950,0
871,0,1,199.0,43.0,302.0,68.0,5559,1986,3611,1203,1948,783,5970,16407,3800,11230,2170,5177,75,29,11025,950,6500,2400,0,1850,0
879,0,1,199.0,41.0,302.0,68.0,4753,1505,2827,811,1926,694,6537,16513,4135,11260,2402,5253,75,27,11850,950,6500,2400,0,2150,0
886,0,1,199.0,42.0,317.0,68.0,4803,1410,2855,783,1948,627,7118,16631,4480,11310,2638,5321,75,28,11850,950,6500,2400,0,2150,0
893,0,1,199.0,42.0,317.0,68.0,4719,1466,2771,839,1948,627,7670,16261,4800,10860,2870,5401,75,29,11850,800,6500,2400,0,2450,0
900,0,1,199.0,41.0,317.0,68.0,4198,1499,2239,895,1959,604,8154,16687,5050,11210,3104,5477,75,27,11850,800,6500,2400,0,2550,0
907,0,1,199.0,35.0,317.0,68.0,4058,1471,2211,867,1847,604,8626,16513,5310,10960,3316,5553,75,27,11850,300,6500,2400,0,3100,0
914,0,1,199.0,31.0,317.0,68.0,4053,1522,2239,895,1814,627,9103,16948,5575,11315,3528,5633,75,26,11850,150,6500,2400,0,3400,0
921,0,1,199.0,33.0,317.0,68.0,4036,1538,2267,867,1769,671,9585,16964,5845,11280,3740,5684,75,26,11850,150,6500,2400,0,3450,0
929,0,1,199.0,33.0,317.0,68.0,3924,1410,2155,783,1769,627,10047,17081,6095,11325,3952,5756,75,26,11850,300,6500,2400,0,3500,0
936,0,1,199.0,33.0,317.0,68.0,4047,1275,2211,671,1836,604,10387,16883,6215,11055,4172,5828,75,26,11850,300,6500,2400,0,3550,0
943,0,1,199.0,32.0,317.0,68.0,3862,1219,2071,671,1791,548,9520,17280,5140,11390,4380,5890,75,25,11850,400,6500,2400,0,3650,0
950,0,1,199.0,35.0,317.0,60.0,3806,1258,2015,811,1791,447,9587,16732,4995,10965,4592,5767,75,26,11850,150,6500,2400,0,3900,0
957,0,1,199.0,35.0,317.0,60.0,3717,1264,1903,839,1814,425,10038,16835,5230,11020,4808,5815,75,26,11850,250,6500,2400,0,3950,0
964,0,1,199.0,36.0,317.0,60.0,3750,1314,1959,867,1791,447,10480,17105,5460,11280,5020,5825,75,25,11850,350,6500,2400,0,4050,0
971,0,1,199.0,39.0,317.0,60.0,3762,1320,2015,895,1747,425,10952,16722,5720,10945,5232,5777,75,25,11850,450,6500,2400,0,4100,0
979,0,1,199.0,39.0,317.0,60.0,3806,1365,2015,895,1791,470,11388,16838,5940,11005,5448,5833,75,25,11850,450,7000,2400,0,4150,0
986,0,1,199.0,38.0,317.0,60.0,3907,1342,2071,895,1836,447,11873,17245,6205,11360,5668,5885,75,24,11850,700,7000,2400,0,4250,0
993,0,1,199.0,38.0,317.0,60.0,3661,1314,1847,867,1814,447,12261,17051,6385,11110,5876,5941,75,24,11850,800,7000,2400,0,4300,0
1000,0,1,199.0,40.0,317.0,60.0,3661,1286,1847,839,1814,447,12708,17007,6620,11060,6088,5947,75,24,11850,800,7000,2400,0,4350,0
1007,0,1,199.0,39.0,317.0,60.0,3582,1303,1791,811,1791,492,13130,17257,6830,11250,6300,6007,75,23,11850,650,7000,2400,0,4600,0
1014,0,1,197.0,30.0,317.0,54.0,3784,978,2015,699,1769,279,13592,17299,7080,11270,6512,6029,75,14,11750,650,7000,2400,100,5525,0
1021,0,1,195.0,15.0,362.0,38.0,3980,514,2211,503,1769,11,14054,17109,7330,11080,6724,6029,75,11,11650,100,7000,2400,200,6700,0
1029,0,1,195.0,9.0,362.0,22.0,4058,391,2267,391,1791,0,14554,17349,7610,11320,6944,6029,75,6,11650,50,7000,2400,200,7300,0
1036,0,1,195.0,2.0,362.0,22.0,4114,167,2323,167,1791,0,15046,17364,7890,11335,7156,6029,75,0,11650,100,7000,2400,200,7650,0
1043,0,1,195.0,2.0,362.0,22.0,4198,0,2407,0,1791,0,15538,17314,8170,11285,7368,6029,75,0,11650,100,6800,1750,200,8525,0
1050,0,1,195.0,2.0,362.0,22.0,4170,0,2379,0,1791,0,16015,17314,8435,11285,7580,6029,75,0,11650,100,6800,850,200,9500,0
1057,0,1,195.0,3.0,362.0,22.0,4254,0,2463,0,1791,0,16527,17264,8735,11235,7792,6029,75,0,11650,100,6800,850,200,9500,0
1064,0,1,195.0,0.0,362.0,8.0,4238,0,2491,0,1747,0,17049,17464,9045,11435,8004,6029,75,0,11650,50,6800,100,200,10650,0
7,1,2,13.0,13.0,14.0,15.0,293,335,293,335,0,0,35,40,35,40,0,0,12,12,0,0,0,0,0,0,1
14,1,2,13.0,14.0,14.0,15.0,671,671,671,671,0,0,120,70,120,70,0,0,13,13,0,0,0,0,0,0,1
21,1,2,14.0,14.0,14.0,15.0,699,699,699,699,0,0,50,50,50,50,0,0,13,13,0,0,0,0,0,0,1
29,1,2,14.0,15.0,14.0,15.0,699,727,699,727,0,0,135,90,135,90,0,0,13,14,0,0,0,0,0,0,1
36,1,2,16.0,15.0,22.0,15.0,755,783,755,783,0,0,135,130,135,130,0,0,14,14,0,0,0,0,0,0,1
43,1,2,16.0,16.0,22.0,23.0,811,811,811,811,0,0,230,25,230,25,0,0,14,15,0,0,0,0,0,0,1
50,1,2,16.0,17.0,22.0,23.0,839,867,839,867,0,0,325,75,325,75,0,0,16,16,0,0,0,0,0,0,1
57,1,2,17.0,18.0,22.0,23.0,811,839,811,839,0,0,25,95,25,95,0,0,15,17,0,0,0,0,0,0,1
64,1,2,18.0,18.0,22.0,23.0,895,895,895,895,0,0,80,150,80,150,0,0,16,17,0,0,0,0,0,0,1
71,1,2,17.0,19.0,22.0,23.0,951,895,951,895,0,0,170,110,170,110,0,0,16,18,0,0,0,0,0,0,1
79,1,2,17.0,19.0,22.0,23.0,923,923,923,923,0,0,15,328,15,328,0,0,16,19,0,0,0,0,0,0,1
86,1,2,18.0,19.0,22.0,23.0,979,939,979,895,0,44,85,46,85,38,0,8,16,19,0,0,0,150,0,0,1
93,1,2,19.0,19.0,22.0,23.0,923,978,923,867,0,111,145,167,145,143,0,24,17,19,0,0,0,150,0,0,1
100,1,2,19.0,20.0,22.0,23.0,1040,978,951,867,89,111,266,84,250,48,16,36,18,19,0,0,0,150,0,0,1
107,1,2,20.0,20.0,22.0,23.0,1051,978,895,867,156,111,341,80,305,28,36,52,19,19,0,0,0,150,0,0,1
114,1,2,20.0,21.0,22.0,23.0,1074,1023,895,867,179,156,366,100,310,28,56,72,20,20,0,0,0,150,0,0,1
121,1,2,20.0,22.0,22.0,23.0,1130,1057,951,923,179,134,501,176,425,88,76,88,20,21,0,0,250,150,0,0,1
129,1,2,26.0,22.0,28.0,23.0,1135,1130,979,951,156,179,232,270,140,158,92,112,20,21,0,0,250,150,0,0,1
136,1,2,28.0,25.0,36.0,31.0,1062,1135,951,867,111,268,59,276,55,153,4,123,20,22,0,0,250,300,0,0,1
143,1,2,28.0,25.0,36.0,31.0,1001,1152,979,839,22,313,174,66,170,53,4,13,20,22,100,0,250,300,0,0,1
150,1,2,30.0,26.0,36.0,31.0,1119,1174,1119,839,0,335,214,107,210,58,4,49,22,23,100,0,250,300,0,0,1
157,1,2,30.0,29.0,36.0,46.0,1203,1230,1203,895,0,335,359,78,355,18,4,60,23,23,100,125,250,300,0,0,1
164,1,2,31.0,30.0,36.0,46.0,1253,1230,1231,895,22,335,58,133,50,33,8,100,23,24,400,125,250,300,0,0,1
171,1,2,33.0,32.0,36.0,46.0,1382,1292,1315,979,67,313,121,139,105,53,16,86,23,26,400,125,250,300,0,0,1
179,1,2,34.0,35.0,36.0,46.0,1326,1376,1259,1063,67,313,134,134,110,33,24,101,23,27,400,250,250,300,0,0,1
186,1,2,35.0,37.0,36.0,46.0,1354,1510,1287,1175,67,335,232,324,200,183,32,141,25,29,400,250,250,600,0,0,1
193,1,2,42.0,41.0,44.0,46.0,1410,1538,1343,1203,67,335,70,54,30,23,40,31,26,29,400,250,250,600,0,0,1
200,1,2,42.0,43.0,44.0,46.0,1510,1544,1399,1231,111,313,246,145,190,78,56,67,27,31,550,250,250,600,0,0,1
207,1,2,41.5,42.0,44.0,46.0,1561,1650,1427,1315,134,335,332,295,260,188,72,107,32,32,525,250,250,600,125,125,1
214,1,2,41.5,43.0,44.0,46.0,1286,1650,1175,1315,111,335,369,250,285,103,84,147,32,33,525,250,250,600,125,125,1
221,1,2,43.5,47.0,44.0,54.0,1622,1740,1511,1427,111,313,380,61,280,28,100,33,32,35,625,475,250,600,125,250,1
229,1,2,43.5,47.0,44.0,54.0,1785,1796,1651,1483,134,313,296,226,180,153,116,73,34,35,625,475,250,600,125,250,1
236,1,2,45.5,49.0,58.0,54.0,1874,1986,1763,1651,111,335,88,421,60,308,28,113,34,37,625,475,250,600,225,250,1
243,1,2,48.5,50.0,74.0,54.0,1869,2014,1735,1679,134,335,114,226,70,73,44,153,33,38,625,475,250,600,225,250,1
250,1,2,52.5,51.0,82.0,54.0,1785,2042,1651,1707,134,335,135,302,75,113,60,189,35,39,625,475,250,600,225,250,1
257,1,2,55.5,52.0,82.0,54.0,1874,2098,1763,1763,111,335,157,112,85,33,72,79,39,40,625,475,250,600,225,250,1
264,1,2,56.5,58.0,82.0,62.0,1874,2160,1763,1847,111,313,223,153,135,38,88,115,40,42,625,825,375,750,225,250,1
271,1,2,61.5,60.0,82.0,62.0,2087,2216,1931,1903,156,313,223,238,115,83,108,155,42,44,775,825,375,750,225,250,1
279,1,2,62.5,61.0,82.0,70.0,2171,2272,2015,1959,156,313,213,363,85,168,128,195,46,45,775,825,375,750,225,250,1
286,1,2,61.5,66.0,82.0,70.0,2283,2126,2127,1791,156,335,218,318,170,133,48,185,46,47,775,1075,500,750,225,250,1
293,1,2,62.0,67.0,82.0,70.0,2395,2115,2239,1735,156,380,413,521,345,288,68,233,48,47,850,1075,500,750,300,250,1
300,1,2,66.0,67.0,82.0,78.0,2586,2535,2407,1931,179,604,468,741,380,428,88,313,48,47,800,1425,500,750,350,300,1
307,1,2,74.0,69.0,82.0,78.0,2675,2496,2519,1847,156,649,379,286,275,193,104,93,50,49,800,1425,500,750,350,300,1
314,1,2,76.0,70.0,82.0,93.0,2625,2451,2379,1847,246,604,595,168,455,53,140,115,59,45,800,1425,500,750,350,550,1
321,1,2,77.0,68.0,74.0,93.0,2692,2098,2379,1539,313,559,780,207,600,28,180,179,63,43,800,1675,700,750,450,700,1
329,1,2,74.0,69.0,74.0,93.0,2776,1813,2463,1343,313,470,600,304,380,73,220,231,63,44,800,1675,700,750,450,750,1
336,1,2,73.0,70.0,74.0,93.0,2938,1779,2603,1287,335,492,670,479,410,188,260,291,62,45,800,1675,700,750,450,750,1
343,1,2,73.5,73.0,74.0,93.0,3050,2020,2715,1483,335,537,596,633,300,278,296,355,62,48,775,1675,950,750,475,750,1
350,1,2,79.0,79.0,98.0,93.0,3078,2294,2743,1735,335,559,601,505,365,228,236,277,61,50,750,1675,950,1050,500,750,1
357,1,2,81.0,81.0,138.0,93.0,3106,2194,2659,1567,447,627,891,391,595,138,296,253,61,52,800,1675,950,1350,500,750,1
364,1,2,77.0,87.0,146.0,93.0,2664,2552,1903,1903,761,649,1195,306,795,123,400,183,57,54,950,1675,950,1350,700,750,1
371,1,2,83.5,84.0,146.0,93.0,1690,2714,839,2043,851,671,830,531,330,268,500,263,53,55,1025,1425,950,1350,925,1000,1
379,1,2,83.5,84.0,146.0,93.0,1365,2798,783,2127,582,671,872,371,320,178,552,193,59,57,1025,1050,1200,1350,1025,1375,1
386,1,2,83.5,86.0,146.0,93.0,1863,2983,1371,2155,492,828,1130,516,510,223,620,293,64,59,1325,1400,1200,1350,1025,1375,1
393,1,2,82.5,91.0,146.0,93.0,2563,3039,1959,2099,604,940,1121,132,600,73,521,59,63,60,1325,1700,1200,1350,1025,1375,1
400,1,2,82.5,93.0,146.0,93.0,3185,3067,2379,2127,806,940,986,384,465,213,521,171,63,63,1325,1700,1200,1350,1025,1375,1
407,1,2,88.5,98.0,146.0,101.0,3258,3202,2295,2239,963,963,913,574,280,283,633,291,63,64,1325,2050,1200,1350,1025,1375,1
414,1,2,90.5,100.0,146.0,101.0,3325,3252,2407,2267,918,985,1172,515,435,258,737,257,62,65,1325,2400,1200,1550,1025,1375,1
421,1,2,90.0,108.0,146.0,109.0,3381,3470,2463,2463,918,1007,1569,225,720,148,849,77,65,66,1300,2400,1200,1550,1050,1375,1
429,1,2,103.5,108.0,146.0,117.0,3470,3442,2575,2435,895,1007,941,302,330,113,611,189,65,68,1275,2400,1550,1550,1075,1375,1
436,1,2,111.5,108.0,146.0,117.0,3549,3532,2631,2547,918,985,672,338,145,233,527,105,65,68,1275,2400,1550,1550,1075,1375,1
443,1,2,111.5,114.0,146.0,117.0,3672,3510,2687,2547,985,963,1118,180,475,138,643,42,65,68,1725,2750,1550,1550,1075,1375,1
450,1,2,112.5,116.0,154.0,117.0,3739,3566,2799,2603,940,963,1397,475,700,338,697,137,65,68,2725,2750,1550,1550,1125,1375,1
457,1,2,126.0,115.0,154.0,117.0,3739,3190,2799,2295,940,895,534,834,125,593,409,241,65,67,3200,3700,1550,1650,1250,1425,1
464,1,2,131.0,123.0,146.0,125.0,3711,3162,2771,2267,940,895,416,896,45,693,371,203,65,67,3150,3700,1550,1750,1400,1425,1
471,1,2,137.0,123.0,146.0,125.0,3610,3448,2715,2463,895,985,389,207,60,38,329,169,65,67,3300,4050,1550,1750,1400,1425,1
479,1,2,137.0,123.0,154.0,125.0,3711,3470,2771,2463,940,1007,745,623,300,338,445,285,65,67,4500,4050,1550,1750,1400,1425,1
486,1,2,145.0,124.0,168.0,133.0,3650,3431,2687,2491,963,940,561,366,200,148,361,218,65,67,4500,3500,1550,2250,1400,2125,1
493,1,2,143.0,124.0,176.0,141.0,3650,3493,2687,2575,963,918,907,688,480,358,427,330,65,67,5100,3500,1550,2250,1550,2125,1
500,1,2,149.0,124.0,176.0,141.0,3638,3470,2631,2575,1007,895,333,1009,140,563,193,446,65,67,4900,3500,1550,2250,2000,2125,1
507,1,2,153.0,124.0,176.0,141.0,3610,3543,2603,2603,1007,940,463,641,250,433,213,208,65,67,5500,3500,1550,2400,2000,2125,1
514,1,2,145.0,124.0,176.0,149.0,3594,3515,2631,2575,963,940,891,1052,570,728,321,324,65,67,5000,3500,1700,2700,2600,2125,1
521,1,2,145.0,143.0,176.0,157.0,3487,3566,2547,2603,940,963,1312,555,875,448,437,107,65,67,5150,5025,1700,2700,2600,2125,1
529,1,2,163.0,143.0,176.0,157.0,3566,3566,2603,2603,963,963,397,967,290,748,107,219,65,67,6050,5025,1700,2700,2600,2125,1
536,1,2,163.0,146.0,176.0,157.0,3476,3498,2491,2603,985,895,667,826,515,503,152,323,65,67,6050,5025,1700,2700,2600,2125,1
543,1,2,169.0,140.0,176.0,157.0,3532,3297,2547,2379,985,918,483,1217,415,778,68,439,65,70,5900,4650,1700,2700,2750,2500,1
550,1,2,169.0,140.0,176.0,157.0,3437,3274,2407,2379,1030,895,574,889,490,713,84,176,65,70,6950,4675,1700,2700,3200,2775,1
557,1,2,167.0,136.0,176.0,196.0,3420,3314,2435,2351,985,963,836,1280,715,988,121,292,65,70,6800,4375,1700,2700,3350,3075,1
564,1,2,157.0,142.0,176.0,204.0,3347,3454,2407,2491,940,963,1238,1277,1005,1048,233,229,65,70,6500,5350,1700,2600,4100,3375,1
571,1,2,159.0,146.0,176.0,196.0,3375,3011,2435,2071,940,940,1043,1261,915,1078,128,183,65,70,6650,5350,1700,2500,4550,3562,1
579,1,2,153.0,140.0,176.0,188.0,3314,2395,2351,1567,963,828,1463,1187,1215,908,248,279,65,68,6200,5000,1700,2400,5150,4212,1
586,1,2,159.0,144.0,176.0,180.0,3302,2154,2295,1483,1007,671,948,759,830,633,118,126,65,68,5750,5000,1700,2400,5600,4312,1
593,1,2,151.0,144.0,176.0,180.0,3274,2334,2267,1707,1007,627,890,1064,660,858,230,206,65,68,4700,5250,1700,2400,6650,4312,1
600,1,2,143.0,144.0,176.0,165.0,3330,2944,2323,2295,1007,649,1136,829,865,793,271,36,65,68,4550,5250,1700,2400,7250,4712,1
607,1,2,156.0,151.0,176.0,181.0,3179,3067,2239,2351,940,716,269,812,190,688,79,124,65,68,4850,6200,1700,2400,7700,4962,1
614,1,2,154.0,151.0,176.0,181.0,3123,3101,2183,2407,940,694,634,1182,435,978,199,204,65,68,4700,6200,1700,2400,8000,4962,1
621,1,2,155.0,157.0,176.0,181.0,3090,3157,2127,2351,963,806,395,772,255,718,140,54,71,68,4700,6200,1700,2400,8150,4962,1
629,1,2,153.0,161.0,176.0,181.0,3230,3179,2267,2239,963,940,735,879,475,763,260,116,70,68,5900,6450,1700,2400,8300,4962,1
636,1,2,148.0,161.0,176.0,181.0,3622,3347,2659,2407,963,940,831,1290,555,1058,276,232,74,68,5300,6450,1700,2400,9050,4962,1
643,1,2,148.0,161.0,176.0,197.0,3918,3431,2911,2491,1007,940,682,700,490,598,192,102,75,68,4700,6450,1700,2400,9650,4962,1
650,1,2,154.0,167.0,176.0,197.0,4058,3588,3051,2603,1007,985,718,1120,560,898,158,222,78,68,4700,6875,1825,2400,9650,4962,1
657,1,2,150.0,172.0,176.0,197.0,4014,3196,3051,2211,963,985,1200,931,930,643,270,288,78,66,4400,6875,1825,2400,9950,5062,1
664,1,2,158.0,178.0,176.0,197.0,4215,3230,3275,2267,940,963,711,695,475,553,236,142,76,66,4400,7785,2075,2400,9950,5062,1
671,1,2,165.0,179.0,176.0,197.0,4126,3011,3163,2071,963,940,391,1033,335,783,56,250,75,69,5300,7800,1925,2400,10100,5062,1
679,1,2,169.0,183.0,176.0,197.0,4120,2798,3135,1903,985,895,591,727,515,598,76,129,79,70,5450,7815,1925,2400,10100,5062,1
686,1,2,173.0,183.0,176.0,197.0,4064,2944,3079,1959,985,985,777,767,685,518,92,249,79,70,5900,8740,1925,2400,10100,5062,1
693,1,2,175.0,189.0,168.0,212.0,4282,3123,3275,2071,1007,1052,1124,528,970,393,154,135,79,70,6300,8755,1925,2500,10300,5062,1
700,1,2,173.0,189.0,168.0,212.0,4182,3386,3219,2155,963,1231,606,912,340,633,266,279,79,70,6450,9445,1925,2500,10450,5062,1
707,1,2,172.0,192.0,168.0,220.0,4019,3498,3079,2267,940,1231,497,679,315,498,182,181,78,70,6750,9460,1925,2500,10450,5062,1
714,1,2,172.0,195.0,224.0,220.0,4103,3750,3051,2407,1052,1343,437,775,265,438,172,337,78,70,6900,10150,1925,2700,10450,5062,1
721,1,2,172.0,195.0,256.0,220.0,4266,3666,2967,2323,1299,1343,742,666,460,323,282,343,78,70,6900,10165,1925,2700,10450,5062,1
729,1,2,178.0,195.0,264.0,228.0,4243,3633,2967,2379,1276,1254,344,1070,210,583,134,487,78,73,6450,10195,1925,2700,10900,5062,1
736,1,2,180.0,195.0,280.0,243.0,4305,3711,2939,2435,1366,1276,495,1490,405,843,90,647,78,73,6550,10525,1925,2700,10900,5062,1
743,1,2,175.0,195.0,294.0,243.0,3997,3728,2631,2407,1366,1321,570,1320,320,813,250,507,73,73,6650,11200,1925,2850,10900,5062,1
750,1,2,185.0,195.0,294.0,243.0,3857,3846,2603,2547,1254,1299,265,1766,125,1103,140,663,73,73,7550,11230,1925,3350,10900,5062,1
757,1,2,183.0,195.0,294.0,243.0,3767,3890,2491,2547,1276,1343,720,2208,420,1393,300,815,73,73,7400,11245,1925,3350,11050,5062,1
764,1,2,183.0,196.0,294.0,243.0,3767,3997,2491,2631,1276,1366,1181,2478,725,1653,456,825,73,73,7400,11245,2550,3350,11050,5062,1
771,1,2,189.0,194.0,278.0,243.0,3734,3935,2435,2659,1299,1276,271,1142,105,923,166,219,73,73,7100,9610,2550,3350,12350,6712,1
779,1,2,189.0,191.0,278.0,243.0,3818,3885,2519,2631,1299,1254,737,1003,415,878,322,125,73,73,7100,9375,3000,3350,12350,7062,1
786,1,2,189.0,191.0,272.0,243.0,3801,3991,2435,2715,1366,1276,1188,1478,710,1193,478,285,73,73,7100,9375,3350,3950,12700,7062,1
793,1,2,189.0,197.0,272.0,243.0,3829,3896,2463,2575,1366,1321,1329,1543,695,1098,634,445,73,73,7100,9375,3350,3950,12700,7062,1
800,1,2,189.0,199.0,272.0,235.0,3549,3935,2295,2659,1254,1276,1369,1820,745,1298,624,522,73,72,8450,9475,3350,3950,12700,7212,1
807,1,2,196.0,199.0,272.0,220.0,3493,3834,2239,2491,1254,1343,894,1551,710,973,184,578,71,72,8450,9475,3350,3950,12700,7612,1
814,1,2,200.0,199.0,272.0,220.0,3571,3862,2295,2519,1276,1343,1039,2012,795,1278,244,734,71,74,8450,9475,3350,3950,12700,7612,1
821,1,2,198.0,199.0,272.0,220.0,3650,3767,2351,2491,1299,1276,1469,1855,1065,973,404,882,71,74,8300,9575,3350,3950,12850,7612,1
829,1,2,194.0,199.0,272.0,220.0,3739,3885,2351,2631,1388,1254,1610,2566,1050,1528,560,1038,71,74,8000,11555,3475,3950,13150,7612,1
836,1,2,184.0,193.0,272.0,220.0,3801,3902,2435,2603,1366,1299,2042,2491,1330,1543,712,948,71,74,8450,11210,3475,3950,13900,8002,1
843,1,2,193.0,199.0,272.0,220.0,3633,3902,2379,2603,1254,1299,1117,1647,715,1043,402,604,70,74,7850,10555,3475,4200,14500,8702,1
850,1,2,183.0,199.0,272.0,220.0,3661,3907,2407,2631,1254,1276,1552,1674,990,1118,562,556,70,74,7100,10660,3475,4350,15250,8702,1
857,1,2,197.0,199.0,272.0,220.0,3627,3801,2351,2435,1276,1366,647,1469,375,1003,272,466,70,74,6800,11425,3475,4800,15550,8702,1
864,1,2,195.0,199.0,272.0,220.0,3756,3706,2435,2407,1321,1299,792,1867,510,1253,282,614,70,74,7900,11500,3475,4950,15800,8702,1
871,1,2,195.0,199.0,272.0,220.0,3683,3689,2407,2435,1276,1254,824,1829,590,1063,234,766,70,74,7900,11560,3475,4950,15800,8702,1
879,1,2,199.0,197.0,278.0,220.0,3745,3711,2379,2435,1366,1276,955,2121,665,1570,290,551,70,72,9250,11575,3475,4950,15800,8220,1
886,1,2,194.0,189.0,278.0,220.0,3694,3812,2351,2491,1343,1321,1401,2536,955,1825,446,711,70,72,8800,10860,3475,5300,16250,8950,1
893,1,2,196.0,196.0,278.0,220.0,3605,3762,2351,2463,1254,1299,320,1097,230,980,90,117,70,72,7450,9550,3475,5300,17600,10275,1
900,1,2,190.0,198.0,262.0,220.0,3487,3750,2211,2407,1276,1343,745,994,495,825,250,169,70,72,7000,9130,3225,5600,18500,10920,1
907,1,2,182.0,197.0,262.0,220.0,3459,3745,2183,2379,1276,1366,1166,1319,760,990,406,329,70,71,6700,10495,3225,5850,19100,11090,1
914,1,2,188.0,197.0,268.0,220.0,3454,3627,2155,2351,1299,1276,1096,1058,530,585,566,473,70,71,7950,10630,3225,5850,19350,11090,1
921,1,2,188.0,199.0,268.0,220.0,3151,3605,1875,2351,1276,1254,1398,704,680,425,718,279,70,71,7950,10705,3225,5850,19350,11090,1
929,1,2,188.0,199.0,268.0,220.0,2888,3403,1567,2183,1321,1220,1745,1000,875,575,870,425,80,71,7950,11010,3225,6150,19350,11090,1
936,1,2,188.0,200.0,268.0,220.0,2978,3269,1679,2127,1299,1142,1684,1086,870,675,814,411,80,70,7950,11130,3225,6150,19350,11090,1
943,1,2,197.0,200.0,268.0,220.0,2994,3409,1763,2267,1231,1142,998,1182,290,785,708,397,78,68,7950,11450,3225,6300,19350,11090,1
950,1,2,197.0,200.0,268.0,228.0,3252,3543,2043,2379,1209,1164,1210,1298,450,915,760,383,78,66,8050,13060,3225,6300,19350,11090,1
957,1,2,197.0,200.0,268.0,228.0,3610,3543,2379,2379,1231,1164,1166,1559,500,1040,666,519,78,66,8600,14055,3225,6300,19350,11090,1
964,1,2,187.0,199.0,268.0,228.0,3728,3504,2519,2407,1209,1097,1634,2242,820,1595,814,647,76,65,8000,14145,3225,6300,19950,10805,1
971,1,2,180.0,196.0,268.0,228.0,3946,3526,2603,2407,1343,1119,1190,2627,520,1840,670,787,76,65,6500,13905,3225,6300,21450,11105,1
979,1,2,176.0,200.0,268.0,228.0,3582,3543,2239,2379,1343,1164,927,2117,105,1490,822,627,72,65,6500,14350,3225,6300,21450,11105,1
986,1,2,159.0,198.0,268.0,228.0,3515,3426,2127,2295,1388,1131,1256,2911,270,2150,986,761,66,63,5600,14395,3225,6300,22350,11205,1
993,1,2,157.5,198.0,260.0,228.0,3538,3364,2015,2323,1523,1041,1253,2048,225,1675,1028,373,66,63,5775,12850,3225,6300,23075,12765,1
1000,1,2,142.0,198.0,260.0,228.0,3644,3302,2099,2295,1545,1007,1075,2338,55,1845,1020,493,66,63,4250,12385,3600,6300,24725,13245,1
1007,1,2,130.0,194.0,260.0,228.0,3594,3174,2071,2211,1523,963,1213,2595,105,1990,1108,605,66,63,3050,11730,4825,6300,26050,14090,1
1014,1,2,122.0,200.0,260.0,228.0,3605,3179,2071,2239,1534,940,1491,2031,255,1710,1236,321,66,63,2750,11180,4700,6300,26925,14390,1
1021,1,2,110.0,198.0,260.0,228.0,3577,3034,2043,2071,1534,963,1212,2226,25,1785,1187,441,66,63,1550,11245,4575,6300,28700,14725,1
1029,1,2,98.0,198.0,260.0,228.0,3577,3078,2099,2071,1478,1007,1635,2471,280,1910,1355,561,66,63,950,11650,4075,6300,30100,14890,1
7,1,1,13.0,13.0,14.0,14.0,335,293,335,293,0,0,40,35,40,35,0,0,12,12,0,0,0,0,0,0,1
14,1,1,13.0,13.0,14.0,14.0,671,671,671,671,0,0,20,20,20,20,0,0,13,13,0,0,0,0,0,0,1
21,1,1,14.0,14.0,14.0,14.0,727,671,727,671,0,0,50,50,50,50,0,0,13,13,0,0,0,0,0,0,1
29,1,1,14.0,14.0,14.0,14.0,783,755,783,755,0,0,150,150,150,150,0,0,13,13,0,0,0,0,0,0,1
36,1,1,16.0,16.0,22.0,22.0,755,727,755,727,0,0,140,140,140,140,0,0,14,14,0,0,0,0,0,0,1
43,1,1,16.0,16.0,22.0,22.0,811,783,811,783,0,0,235,235,235,235,0,0,14,16,0,0,0,0,0,0,1
50,1,1,15.0,16.0,22.0,22.0,783,867,783,867,0,0,30,45,30,45,0,0,15,16,0,0,0,0,0,0,1
57,1,1,17.0,17.0,22.0,22.0,839,867,839,867,0,0,35,40,35,40,0,0,15,15,0,0,0,0,0,0,1
64,1,1,18.0,18.0,22.0,22.0,839,895,839,895,0,0,85,100,85,100,0,0,16,16,0,0,0,0,0,0,1
71,1,1,17.0,17.0,22.0,22.0,895,895,895,895,0,0,175,180,175,180,0,0,17,17,0,0,0,0,0,0,1
79,1,1,17.0,17.0,22.0,22.0,951,951,951,951,0,0,30,45,30,45,0,0,16,16,0,0,0,0,0,0,1
86,1,1,18.0,18.0,22.0,22.0,951,923,951,923,0,0,100,105,100,105,0,0,16,16,0,0,0,0,0,0,1
93,1,1,19.0,19.0,22.0,22.0,923,951,923,951,0,0,155,170,155,170,0,0,18,18,0,0,0,0,0,0,1
100,1,1,20.0,20.0,22.0,22.0,1012,1034,923,923,89,111,231,250,215,230,16,20,18,19,0,0,0,0,0,0,1
107,1,1,20.0,20.0,22.0,22.0,1051,1135,895,979,156,156,352,370,320,330,32,40,19,19,0,0,0,0,0,0,1
114,1,1,20.0,20.0,22.0,22.0,1107,1135,951,979,156,156,377,410,325,350,52,60,20,20,0,0,0,0,0,0,1
121,1,1,22.0,22.0,28.0,22.0,1079,1135,923,979,156,156,362,380,290,300,72,80,20,20,0,0,250,250,0,0,1
129,1,1,26.0,26.0,28.0,36.0,1079,1219,923,1063,156,156,242,280,150,180,92,100,20,20,0,0,250,250,0,0,1
136,1,1,28.0,28.0,36.0,36.0,1163,1242,1007,1063,156,179,88,115,80,95,8,20,21,20,0,0,250,250,0,0,1
143,1,1,29.0,29.0,36.0,36.0,1068,1169,979,1035,89,134,161,192,145,160,16,32,21,21,50,50,250,250,0,0,1
150,1,1,30.0,30.0,36.0,36.0,1258,1169,1147,1035,111,134,277,288,245,240,32,48,23,23,50,50,250,250,0,0,1
157,1,1,29.0,29.0,36.0,36.0,1146,1230,1035,1119,111,111,104,130,60,70,44,60,24,24,200,200,250,250,0,0,1
164,1,1,31.0,31.0,36.0,36.0,1264,1331,1175,1175,89,156,121,140,65,60,56,80,24,24,350,350,250,250,0,0,1
171,1,1,31.0,33.0,36.0,36.0,1337,1331,1203,1175,134,156,87,205,65,105,22,100,23,24,350,350,250,250,0,0,1
179,1,1,33.0,34.0,36.0,36.0,1348,1354,1259,1175,89,179,40,115,10,45,30,70,24,23,350,350,250,250,0,0,1
186,1,1,35.0,34.0,36.0,36.0,1342,1326,1231,1147,111,179,101,175,55,85,46,90,25,25,350,350,250,250,0,0,1
193,1,1,36.0,36.0,36.0,36.0,1415,1443,1259,1287,156,156,226,256,160,150,66,106,26,26,350,400,250,250,0,0,1
200,1,1,40.0,36.0,44.0,44.0,1527,1471,1371,1315,156,156,197,436,115,310,82,126,29,27,500,550,250,250,0,0,1
207,1,1,43.0,42.0,44.0,44.0,1555,1499,1399,1343,156,156,132,296,30,150,102,146,29,27,500,600,250,250,0,0,1
214,1,1,44.0,41.0,44.0,44.0,1667,1555,1511,1399,156,156,157,221,35,155,122,66,29,32,650,600,450,250,0,0,1
221,1,1,44.0,44.0,52.0,44.0,1723,1611,1567,1455,156,156,362,261,220,175,142,86,31,32,650,600,450,450,0,0,1
229,1,1,47.5,43.0,58.0,50.0,1751,1774,1595,1595,156,179,353,381,195,275,158,106,33,31,675,600,450,450,25,0,1
236,1,1,52.5,48.0,58.0,50.0,1807,1723,1651,1567,156,156,328,227,150,105,178,122,36,34,675,600,575,450,25,0,1
243,1,1,51.5,49.5,58.0,50.0,1891,1807,1735,1651,156,156,153,202,55,85,98,117,37,34,675,575,575,450,25,25,1
250,1,1,52.5,52.0,58.0,58.0,1835,1925,1679,1679,156,246,218,288,100,135,118,153,39,39,675,550,575,575,25,50,1
257,1,1,53.5,51.0,58.0,66.0,2082,1902,1903,1567,179,335,73,163,35,70,38,93,39,40,675,600,575,575,25,50,1
264,1,1,56.5,53.0,58.0,66.0,2143,1992,1987,1679,156,313,179,314,125,185,54,129,42,43,675,600,575,575,25,50,1
271,1,1,56.5,57.0,66.0,66.0,2171,2070,2015,1735,156,335,239,274,165,105,74,169,44,45,675,600,575,825,25,50,1
279,1,1,61.0,56.0,66.0,66.0,2289,2238,2043,1903,246,335,190,414,80,205,110,209,45,44,650,600,575,825,50,50,1
286,1,1,63.0,56.5,74.0,74.0,2345,2300,1875,1987,470,313,270,570,100,325,170,245,45,47,650,575,775,825,50,75,1
293,1,1,68.0,61.5,82.0,82.0,2507,2496,2015,2183,492,313,316,190,90,105,226,85,53,48,650,575,775,825,50,75,1
300,1,1,70.0,66.5,82.0,82.0,2625,2574,2155,2239,470,335,442,135,160,60,282,75,55,54,650,575,775,1025,50,75,1
307,1,1,76.0,71.5,90.0,82.0,2782,2709,2267,2351,515,358,415,219,65,100,350,119,59,54,650,675,775,1025,50,75,1
314,1,1,77.0,73.5,90.0,82.0,3056,2714,2407,2155,649,559,745,300,315,105,430,195,59,52,650,675,1025,1025,50,75,1
321,1,1,88.0,72.5,90.0,82.0,3241,2832,2547,2183,694,649,525,436,165,165,360,271,67,57,600,875,1025,1025,100,125,1
329,1,1,87.0,79.5,90.0,82.0,3224,2910,2575,2239,649,671,502,426,270,75,232,351,66,61,600,875,1025,1025,100,125,1
336,1,1,87.0,81.5,90.0,90.0,3398,3017,2547,2323,851,694,314,685,70,250,244,435,66,61,600,875,1025,1025,100,125,1
343,1,1,89.0,81.5,90.0,98.0,3594,3353,2631,2435,963,918,539,786,250,235,289,551,66,68,1200,875,1025,1025,100,125,1
350,1,1,89.0,81.5,98.0,98.0,3683,3476,2743,2491,940,985,775,1097,470,430,305,667,66,70,1200,875,1025,1025,100,125,1
357,1,1,105.0,80.0,122.0,98.0,3711,3622,2771,2659,940,963,411,1413,190,630,221,783,66,69,1400,850,1025,1025,100,150,1
364,1,1,104.0,79.5,122.0,106.0,3750,3655,2743,2715,1007,940,336,1664,195,865,141,799,65,69,1350,775,1025,1475,150,150,1
371,1,1,103.0,96.5,122.0,114.0,3610,3722,2603,2715,1007,1007,752,309,495,290,257,19,66,69,1300,725,1025,1475,200,200,1
379,1,1,110.5,94.5,122.0,114.0,3672,3694,2687,2687,985,1007,349,445,80,310,269,135,65,69,2125,625,1025,1475,200,300,1
386,1,1,110.5,101.5,122.0,114.0,3504,3566,2519,2603,985,963,555,117,170,45,385,72,66,66,2125,625,1025,1475,200,300,1
393,1,1,116.5,103.5,122.0,114.0,3599,3644,2659,2659,940,985,397,363,125,275,272,88,66,66,2125,2225,1150,1475,200,300,1
400,1,1,110.5,103.5,138.0,114.0,3599,3644,2659,2659,940,985,1142,518,675,410,467,108,66,66,2325,2575,1600,1475,400,325,1
407,1,1,124.0,110.5,138.0,114.0,3678,3487,2715,2547,963,940,132,345,95,125,37,220,66,67,2250,3175,1600,1475,400,325,1
414,1,1,117.0,112.0,130.0,122.0,3605,3510,2575,2547,1030,963,307,280,250,140,57,140,57,72,2250,2950,1600,1475,950,325,1
421,1,1,125.0,112.0,130.0,122.0,3252,3666,2267,2659,985,1007,265,320,100,160,165,160,57,70,2250,3150,1600,1775,950,325,1
429,1,1,125.0,114.0,122.0,128.0,3118,3694,2155,2687,963,1007,387,456,110,280,277,176,61,70,2250,3150,1600,1775,1050,325,1
436,1,1,125.0,116.0,122.0,136.0,3286,3678,2323,2715,963,963,797,388,400,300,397,88,64,70,4000,3350,1600,1775,1050,525,1
443,1,1,124.0,121.0,122.0,152.0,3291,3812,2351,2827,940,985,698,504,235,400,463,104,64,70,4250,3550,1600,1775,1050,525,1
450,1,1,124.0,131.0,128.0,160.0,3454,3700,2491,2715,963,985,613,424,180,200,433,224,64,73,4250,3550,1850,1775,1050,725,1
457,1,1,128.0,128.5,136.0,160.0,3470,3347,2463,2407,1007,940,524,731,175,395,349,336,64,73,4350,3825,1850,1775,1250,850,1
464,1,1,134.0,136.0,152.0,160.0,3610,3739,2603,2575,1007,1164,215,293,50,205,165,88,64,73,4350,4000,1975,1775,1250,875,1
471,1,1,137.0,138.0,152.0,160.0,3706,4120,2743,2799,963,1321,352,630,175,390,177,240,64,73,4350,4500,1975,1775,1250,875,1
479,1,1,133.0,136.0,152.0,176.0,3650,3991,2687,2715,963,1276,773,693,480,505,293,188,64,73,3850,3900,1975,1775,1750,1475,1
486,1,1,137.0,137.0,152.0,176.0,3678,4030,2715,2799,963,1231,464,787,355,655,109,132,65,73,4100,3650,1975,1775,2000,1725,1
493,1,1,147.0,136.0,152.0,182.0,3571,3963,2631,2687,940,1276,185,1023,60,835,125,188,65,73,4850,4200,1975,1775,2000,1975,1
500,1,1,149.0,152.0,152.0,182.0,3566,3924,2603,2715,963,1209,375,517,230,385,145,132,70,73,5100,4600,1975,1775,2000,1975,1
507,1,1,148.0,151.5,144.0,182.0,3526,3689,2519,2435,1007,1254,340,548,75,460,265,88,70,72,4900,4975,1975,1775,2200,2150,1
514,1,1,146.0,157.5,144.0,182.0,3470,3616,2463,2295,1007,1321,736,499,355,255,381,244,68,71,5650,5775,1975,1775,2200,2150,1
521,1,1,145.0,162.5,144.0,182.0,3666,3762,2659,2463,1007,1299,948,262,455,170,493,92,67,70,5900,6175,1975,1775,2200,2150,1
529,1,1,149.0,167.5,168.0,182.0,3762,3750,2799,2519,963,1231,695,351,290,215,405,136,67,70,6300,6925,2100,1775,2200,2150,1
536,1,1,154.0,167.5,168.0,182.0,3571,3633,2631,2379,940,1254,576,474,255,190,321,284,67,73,6300,6925,2225,1900,2200,2150,1
543,1,1,152.0,166.5,200.0,190.0,3381,3700,2351,2267,1030,1433,877,182,420,85,457,97,67,72,5800,7125,2225,2025,2700,2550,1
550,1,1,142.0,162.5,200.0,190.0,3470,3969,2239,2379,1231,1590,1281,655,680,370,601,285,70,72,4550,6925,2225,2025,3950,2950,1
557,1,1,151.0,168.5,200.0,190.0,3588,4142,2379,2575,1209,1567,202,338,65,265,137,73,69,72,4800,6725,2225,2025,4325,3150,1
564,1,1,151.0,168.5,200.0,190.0,3706,4327,2631,2715,1075,1612,147,840,90,575,57,265,69,72,4900,6925,2225,2025,4725,3150,1
571,1,1,149.0,172.5,192.0,190.0,3694,4215,2575,2603,1119,1612,328,738,235,585,93,153,69,72,4500,6925,2225,2025,5225,3350,1
579,1,1,147.0,179.5,192.0,190.0,3890,4210,2771,2687,1119,1523,808,278,575,145,233,133,69,72,4250,6125,2225,2025,5475,4150,1
586,1,1,155.0,175.5,192.0,190.0,3801,4221,2659,2631,1142,1590,514,774,345,445,169,329,69,72,5750,6525,2225,2025,5475,4550,1
593,1,1,161.0,171.5,192.0,190.0,3862,4243,2743,2631,1119,1612,370,471,215,350,155,121,71,72,5500,6575,2225,2025,6225,5650,1
600,1,1,164.0,164.0,192.0,190.0,3386,4249,2379,2659,1007,1590,228,984,90,675,138,309,70,72,5150,6500,1775,2025,7325,6125,1
607,1,1,157.0,159.5,192.0,190.0,3330,4165,2435,2575,895,1590,232,412,190,215,42,197,69,72,4400,5125,1775,2025,8125,7500,1
614,1,1,154.0,151.0,184.0,196.0,3426,4215,2575,2603,851,1612,652,330,510,245,142,85,68,72,5250,4300,1775,2025,8475,8525,1
621,1,1,150.0,156.0,184.0,196.0,3448,4064,2575,2519,873,1545,959,189,705,120,254,69,66,71,5800,5300,1775,2025,8575,8575,1
629,1,1,157.0,159.5,184.0,196.0,3493,4221,2687,2631,806,1590,585,301,435,240,150,61,65,71,5800,5875,1775,2025,8575,8600,1
636,1,1,157.0,164.5,184.0,196.0,3280,4210,2407,2575,873,1635,898,547,640,290,258,257,65,71,5800,6025,1775,2025,8575,8600,1
643,1,1,143.0,154.5,184.0,196.0,3045,4170,2127,2603,918,1567,1147,1041,785,600,362,441,59,71,5700,5925,1650,2150,9575,9300,1
650,1,1,141.0,148.5,184.0,196.0,2978,4254,2015,2687,963,1567,1522,559,1040,430,482,129,59,71,5450,5775,1525,2150,9950,10300,1
657,1,1,138.0,148.5,184.0,196.0,2927,4271,1987,2659,940,1612,1656,846,1070,625,586,221,57,71,5450,5775,1525,2150,10050,10500,1
664,1,1,150.0,161.5,184.0,196.0,3028,4210,2043,2575,985,1635,1381,493,675,280,706,213,57,71,5450,5775,1650,2150,10050,10500,1
671,1,1,144.0,167.5,184.0,196.0,3006,4170,2043,2603,963,1567,1512,407,690,210,822,197,58,71,5200,5775,1650,2150,10350,10700,1
679,1,1,136.0,163.5,184.0,196.0,2871,4254,1931,2687,940,1567,1853,910,915,525,938,385,64,74,4200,6625,1900,2150,11350,11100,1
686,1,1,131.0,167.5,184.0,196.0,2961,4299,2043,2687,918,1612,2520,761,1320,180,1200,581,63,75,3700,6475,1900,2150,11600,11850,1
693,1,1,120.0,154.0,184.0,196.0,3174,4114,2211,2547,963,1567,2896,545,1580,130,1316,415,60,75,3150,5400,2150,2150,12425,13325,1
700,1,1,114.0,153.5,184.0,196.0,3302,4226,2295,2659,1007,1567,3292,558,1860,55,1432,503,58,75,3000,5475,2600,2150,12825,13900,1
707,1,1,120.0,140.5,160.0,196.0,2798,4047,2015,2547,783,1500,588,421,280,50,308,371,48,67,2600,4875,2600,2150,14025,14900,1
714,1,1,107.0,142.5,152.0,196.0,2384,3627,1735,2351,649,1276,879,639,495,120,384,519,43,66,2200,5475,2600,2150,14775,15000,1
721,1,1,109.0,135.0,128.0,196.0,2306,3342,1679,2155,627,1187,145,594,85,135,60,459,43,62,1900,5050,2600,2150,15375,15675,1
729,1,1,101.0,137.0,112.0,196.0,2418,3168,1791,2183,627,985,155,389,90,110,65,279,43,62,1200,5150,2600,2150,16275,16050,1
736,1,1,103.0,142.0,88.0,196.0,2390,3095,1763,2155,627,940,145,166,25,75,120,91,43,62,4200,5750,2600,2150,16575,16100,1
743,1,1,91.0,144.0,88.0,196.0,2518,3286,1847,2323,671,963,330,366,130,155,200,211,43,62,3600,6050,2600,2150,17175,16200,1
750,1,1,91.0,148.0,88.0,196.0,2367,3218,1651,2211,716,1007,410,346,130,215,280,131,43,62,4900,6650,2600,2150,17175,16200,1
757,1,1,87.0,145.0,104.0,196.0,2412,3106,1763,2099,649,1007,708,282,360,135,348,147,43,62,4500,6200,2600,2150,17675,17000,1
764,1,1,97.0,141.5,120.0,196.0,2390,3090,1763,2127,627,963,494,549,195,290,299,259,43,62,4500,6125,2600,2150,17675,17475,1
771,1,1,94.0,143.5,128.0,196.0,1790,3448,1231,2463,559,985,687,570,320,395,367,175,42,68,4350,6425,2600,2150,17875,17575,1
779,1,1,102.0,153.5,128.0,196.0,1314,3633,867,2491,447,1142,458,198,135,75,323,123,42,68,4850,6525,2600,2150,17875,17675,1
786,1,1,105.0,156.0,128.0,196.0,1712,3543,1287,2267,425,1276,481,355,160,80,321,275,41,68,4850,6400,2600,2150,17925,17800,1
793,1,1,99.0,154.0,128.0,196.0,2110,3504,1707,2183,403,1321,748,380,375,145,373,235,41,68,4500,6600,2600,2150,18675,18400,1
800,1,1,97.0,154.0,128.0,196.0,2233,3728,1763,2407,470,1321,504,242,275,155,229,87,41,73,3750,6200,2600,2150,19425,19000,1
807,1,1,100.0,162.0,128.0,196.0,2048,3790,1623,2491,425,1299,232,184,155,45,77,139,40,73,3950,6400,2600,2150,19475,19000,1
814,1,1,102.0,163.0,128.0,196.0,1774,3885,1371,2631,403,1254,359,111,230,45,129,66,40,73,3950,6750,2600,2150,19475,19050,1
821,1,1,106.0,164.0,128.0,196.0,2199,4070,1595,2771,604,1299,279,266,170,190,109,76,40,75,3950,7050,2600,2150,19475,19050,1
829,1,1,104.0,170.0,128.0,196.0,2244,4103,1595,2827,649,1276,291,162,210,130,81,32,42,75,3950,7450,2600,2150,19975,19250,1
836,1,1,109.0,172.0,128.0,196.0,2160,4176,1511,2855,649,1321,296,498,135,310,161,188,44,80,4450,7950,2600,2150,19975,19250,1
843,1,1,111.0,172.0,128.0,196.0,2322,4187,1427,2799,895,1388,336,847,155,495,181,352,49,80,4450,7500,2600,2150,19975,19700,1
850,1,1,111.0,176.0,128.0,196.0,2446,4249,1483,2659,963,1590,132,749,35,355,97,394,49,83,4200,7300,2600,2150,20475,19900,1
857,1,1,107.0,180.0,128.0,196.0,2602,4389,1595,2799,1007,1590,433,381,220,245,213,136,47,83,4200,7700,2600,2150,20825,19900,1
864,1,1,111.0,180.0,128.0,196.0,2586,4551,1623,2939,963,1612,235,522,110,390,125,132,47,83,4200,7350,2600,2150,20825,20300,1
871,1,1,109.0,175.0,128.0,196.0,2558,4551,1595,2939,963,1612,286,617,145,485,141,132,47,83,3950,7300,2600,2150,21325,21250,1
879,1,1,93.0,170.0,128.0,196.0,2110,4322,1259,2687,851,1635,527,724,290,600,237,124,41,81,3200,6850,2600,2150,22875,21950,1
7,,,13.0,13.0,14.0,15.0,293,335,293,335,0,0,35,40,35,40,0,0,12,12,0,0,0,0,0,0,1
14,,,13.0,14.0,14.0,15.0,671,643,671,643,0,0,20,65,20,65,0,0,13,13,0,0,0,0,0,0,1
21,,,14.0,14.0,14.0,15.0,699,643,699,643,0,0,50,40,50,40,0,0,13,13,0,0,0,0,0,0,1
29,,,14.0,15.0,14.0,15.0,783,699,783,699,0,0,155,30,155,30,0,0,13,14,0,0,0,0,0,0,1
36,,,16.0,15.0,22.0,15.0,755,755,755,755,0,0,145,125,145,125,0,0,14,14,0,0,0,0,0,0,1
43,,,16.0,16.0,22.0,23.0,867,783,867,783,0,0,245,155,245,155,0,0,16,15,0,0,0,0,0,0,1
50,,,15.0,17.0,22.0,23.0,783,839,783,839,0,0,35,260,35,260,0,0,15,16,0,0,0,0,0,0,1
57,,,17.0,17.0,22.0,23.0,867,811,867,811,0,0,45,355,45,355,0,0,15,16,0,0,0,0,0,0,1
64,,,18.0,17.0,22.0,23.0,867,839,867,839,0,0,100,50,100,50,0,0,16,17,0,0,0,0,0,0,1
71,,,17.0,18.0,22.0,23.0,895,839,895,839,0,0,175,95,175,95,0,0,17,17,0,0,0,0,0,0,1
79,,,17.0,18.0,22.0,23.0,895,839,895,839,0,0,35,50,35,50,0,0,16,18,0,0,0,0,0,0,1
86,,,18.0,19.0,22.0,23.0,895,895,895,895,0,0,100,35,100,35,0,0,16,18,0,0,0,0,0,0,1
93,,,19.0,20.0,22.0,23.0,945,923,923,923,22,0,154,10,150,10,4,0,18,19,0,0,0,0,0,0,1
100,,,19.0,21.0,22.0,23.0,967,923,923,923,44,0,273,80,265,80,8,0,18,20,0,0,0,0,0,0,1
107,,,20.0,22.0,22.0,23.0,1040,951,951,951,89,0,45,40,25,40,20,0,19,21,0,0,0,0,0,0,1
114,,,20.0,23.0,22.0,23.0,1085,995,951,951,134,44,126,118,90,110,36,8,19,22,0,0,0,0,0,0,1
121,,,22.0,24.0,28.0,31.0,1057,1152,923,951,134,201,92,201,40,165,52,36,19,23,0,0,250,0,0,0,1
129,,,24.0,26.0,28.0,31.0,1118,1191,1007,923,111,268,74,107,10,35,64,72,20,23,0,0,250,150,0,0,1
136,,,26.0,28.0,28.0,46.0,1113,1264,979,951,134,313,115,158,35,50,80,108,20,24,0,0,250,150,0,0,1
143,,,26.0,29.0,28.0,46.0,1169,1320,1035,1007,134,313,141,158,45,10,96,148,20,25,0,0,250,150,0,0,1
150,,,28.0,31.0,28.0,46.0,1102,1398,1035,1063,67,335,175,228,75,40,100,188,22,27,0,0,250,150,0,0,1
157,,,28.0,31.0,28.0,46.0,1191,1510,1147,1175,44,335,128,403,120,175,8,228,22,27,0,100,250,150,0,0,1
164,,,32.0,35.0,36.0,46.0,1410,1572,1343,1259,67,313,41,169,25,80,16,89,23,29,350,100,250,300,0,0,1
171,,,34.0,37.0,36.0,46.0,1298,1650,1231,1315,67,335,94,64,70,35,24,29,25,31,350,100,250,300,0,0,1
179,,,36.0,37.0,36.0,46.0,1410,1706,1343,1371,67,335,72,149,40,80,32,69,25,31,350,100,250,300,0,0,1
186,,,38.0,41.0,42.0,46.0,1354,1712,1287,1399,67,313,80,105,40,100,40,5,27,33,350,225,250,300,0,0,1
193,,,39.5,41.0,50.0,46.0,1522,1768,1455,1455,67,313,173,180,125,135,48,45,29,33,325,225,250,300,25,0,1
200,,,45.5,43.0,50.0,46.0,1555,1874,1511,1539,44,335,67,195,15,110,52,85,29,35,475,225,250,300,25,0,1
207,,,45.5,44.0,50.0,54.0,1667,1958,1623,1623,44,335,265,330,205,205,60,125,32,36,575,225,250,600,25,0,1
214,,,50.0,49.0,50.0,54.0,1790,1936,1679,1623,111,313,131,161,55,150,76,11,35,37,550,375,250,700,50,0,1
221,,,50.0,51.0,50.0,54.0,1975,2014,1819,1679,156,335,276,156,180,105,96,51,38,39,700,375,250,700,50,0,1
229,,,52.0,51.0,58.0,54.0,1919,1925,1763,1455,156,470,296,235,180,120,116,115,40,39,700,375,250,700,50,0,1
236,,,53.5,53.0,66.0,54.0,2115,2076,1959,1427,156,649,366,610,230,415,136,195,40,41,675,375,250,700,75,0,1
243,,,59.5,53.0,74.0,62.0,2278,2182,2099,1511,179,671,336,470,180,195,156,275,42,42,675,725,250,700,75,0,1
250,,,61.5,59.0,82.0,62.0,2362,2272,2183,1623,179,649,181,296,105,95,76,201,46,43,675,725,250,700,75,0,1
257,,,58.5,59.0,82.0,62.0,2311,2306,2155,1679,156,627,327,367,235,90,92,277,44,43,825,725,250,700,75,0,1
264,,,63.5,61.0,74.0,62.0,2311,2406,2155,1735,156,671,262,607,150,250,112,357,46,45,825,725,250,700,175,0,1
271,,,70.5,63.0,74.0,70.0,2535,2378,2379,1707,156,671,197,192,65,55,132,137,48,47,825,725,250,700,175,0,1
279,,,72.5,63.0,82.0,78.0,2524,2390,2323,1763,201,627,205,274,145,65,60,209,54,47,825,725,375,700,175,0,1
286,,,74.5,68.0,82.0,78.0,2608,2524,2183,1875,425,649,435,224,315,85,120,139,60,49,825,1075,375,700,175,0,1
293,,,73.5,69.0,82.0,78.0,2994,2518,2323,1847,671,671,345,224,145,105,200,119,57,49,825,1075,375,700,175,0,1
300,,,79.5,70.0,82.0,78.0,3084,2524,2435,1875,649,649,407,470,135,275,272,195,59,50,825,1075,375,700,175,0,1
307,,,79.5,70.0,74.0,78.0,3112,2502,2463,1875,649,627,397,781,145,510,252,271,62,51,825,1075,625,700,275,0,1
314,,,78.5,73.0,74.0,93.0,3196,2434,2547,1763,649,671,687,861,355,510,332,351,66,52,825,1075,625,1000,275,0,1
321,,,78.5,78.0,82.0,93.0,3286,2266,2547,1595,739,671,974,796,550,515,424,281,66,54,825,1425,625,1300,275,0,1
329,,,78.5,80.0,98.0,93.0,3403,2272,2575,1623,828,649,1298,867,770,510,528,357,66,55,825,1425,625,1300,275,0,1
336,,,77.5,80.0,106.0,93.0,3650,2272,2687,1623,963,649,1739,1162,1095,725,644,437,66,55,775,1425,625,1550,325,50,1
343,,,100.0,90.0,114.0,93.0,3745,2535,2715,1819,1030,716,179,625,115,400,64,225,66,57,700,1425,875,1550,400,50,1
350,,,104.0,90.0,114.0,93.0,3784,3017,2799,2099,985,918,222,251,150,160,72,91,66,59,700,1425,875,1550,400,50,1
357,,,108.0,91.0,114.0,93.0,3678,3146,2715,2183,963,963,153,487,65,330,88,157,66,60,700,1775,875,1550,400,50,1
364,,,112.0,93.0,128.0,93.0,3706,3302,2743,2295,963,1007,299,332,195,205,104,127,66,60,2500,1775,875,1550,400,50,1
371,,,116.0,101.0,144.0,109.0,3762,3230,2799,2267,963,963,149,370,125,285,24,85,66,63,2800,2475,875,1650,400,50,1
379,,,121.0,106.0,144.0,109.0,3683,3274,2743,2267,940,1007,290,250,200,195,90,55,66,63,2950,2475,875,1650,400,50,1
386,,,127.0,106.0,152.0,117.0,3857,3448,2827,2463,1030,985,340,671,230,500,110,171,66,64,3400,2475,875,1650,400,50,1
393,,,138.0,107.0,152.0,125.0,3778,3375,2771,2435,1007,940,81,828,5,545,76,283,66,64,3850,2475,875,1650,400,50,1
400,,,142.0,119.0,152.0,125.0,3734,3459,2771,2519,963,940,214,238,130,235,84,3,66,64,4100,2475,875,2200,400,50,1
407,,,146.0,119.0,152.0,125.0,3706,3526,2743,2519,963,1007,249,443,145,320,104,123,66,65,4400,3525,875,2200,400,50,1
414,,,144.0,117.0,152.0,125.0,3762,3526,2799,2519,963,1007,410,868,340,625,70,243,66,65,4950,3375,875,2200,550,200,1
421,,,142.0,117.0,160.0,125.0,3706,3454,2743,2491,963,963,380,1376,340,975,40,401,66,65,4650,3375,875,2150,1150,350,1
429,,,135.5,113.0,160.0,133.0,3778,3476,2771,2491,1007,985,691,1782,585,1265,106,517,66,65,4325,3025,875,2250,1775,700,1
436,,,138.0,113.0,160.0,141.0,3717,3476,2687,2491,1030,985,671,1212,595,975,76,237,66,65,4150,3075,875,2250,1950,1150,1
443,,,132.0,113.0,160.0,141.0,3728,3403,2743,2463,985,940,1104,1599,920,1250,184,349,66,65,4000,3100,875,2250,2400,1625,1
450,,,140.5,113.0,160.0,141.0,3594,3370,2631,2407,963,963,440,2019,340,1550,100,469,65,65,3975,3100,875,2250,2725,1625,1
457,,,133.0,115.0,160.0,141.0,3594,3386,2631,2379,963,1007,676,1174,560,785,116,389,65,65,4000,3100,875,2250,3150,1625,1
464,,,134.0,116.0,160.0,141.0,3566,3392,2603,2407,963,985,901,1581,665,1080,236,501,77,65,4000,3100,875,2250,3150,1625,1
471,,,147.5,118.0,160.0,141.0,3543,3414,2603,2407,940,1007,277,1487,225,870,52,617,76,67,3975,3100,875,2250,3175,1675,1
479,,,147.5,119.0,160.0,141.0,3722,3392,2715,2407,1007,985,457,1198,285,615,172,583,82,68,3975,3100,875,2250,3175,1675,1
486,,,147.5,127.0,160.0,149.0,3941,3487,2911,2547,1030,940,407,1010,265,515,142,495,82,70,3975,3600,875,2250,3175,1675,1
493,,,147.5,134.0,184.0,149.0,4210,3459,3135,2519,1075,940,621,825,355,410,266,415,82,71,4875,4100,875,2400,3175,1675,1
500,,,157.5,136.0,200.0,165.0,4372,3470,3163,2463,1209,1007,239,1245,125,710,114,535,82,73,4875,4100,1125,2550,3175,1675,1
507,,,156.5,150.0,200.0,165.0,4450,3610,3219,2603,1231,1007,427,330,315,175,112,155,81,75,4875,4100,1125,3050,3175,1675,1
514,,,165.5,157.0,200.0,173.0,4523,3510,3247,2547,1276,963,432,128,260,115,172,13,81,77,4875,4100,1125,3050,3175,1675,1
521,,,173.5,157.0,208.0,173.0,4540,3470,3219,2463,1321,1007,383,553,255,420,128,133,81,79,5175,4100,1575,3050,3175,1675,1
529,,,183.5,159.0,208.0,173.0,4646,3252,3303,2267,1343,985,268,244,130,170,138,74,81,79,5425,4100,1575,3050,3175,1675,1
536,,,185.5,161.0,208.0,173.0,4490,3403,3191,2463,1299,940,551,261,415,75,136,186,81,81,6225,4100,1575,3200,3175,1675,1
543,,,187.0,162.0,208.0,173.0,4596,3347,3275,2407,1321,940,847,616,705,310,142,306,81,82,6800,5100,1575,3200,3200,1675,1
550,,,180.0,162.0,208.0,165.0,4523,3526,3247,2519,1276,1007,1349,1051,1055,625,294,426,81,84,7100,5100,1575,3200,3550,1925,1
557,,,195.5,160.0,208.0,165.0,4299,3062,3023,2099,1276,963,665,974,615,440,50,534,81,82,7075,5100,1575,3300,3575,2575,1
564,,,195.5,160.0,208.0,165.0,4467,3403,3191,2351,1276,1052,750,964,740,310,10,654,81,82,7075,5100,1575,3300,3575,2575,1
571,,,194.5,160.0,208.0,165.0,4232,3493,2911,2463,1321,1030,1226,1305,1060,535,166,770,80,82,7325,7080,1575,3300,3575,2575,1
579,,,193.5,160.0,214.0,165.0,4226,3308,2883,2323,1343,985,1331,460,1205,70,126,390,79,82,7725,7125,1925,3300,3575,2575,1
586,,,192.5,160.0,214.0,165.0,4204,3745,2883,2715,1321,1030,1749,679,1475,165,274,514,78,82,8775,7170,1925,3300,3575,2575,1
593,,,191.5,165.0,214.0,165.0,4260,3672,2939,2575,1321,1097,2260,1062,1830,420,430,642,77,81,8775,7200,1925,3750,3575,2625,1
600,,,178.5,171.0,214.0,173.0,4187,3448,2911,2463,1276,985,2768,1477,2190,715,578,762,77,81,7975,7215,1925,3750,4375,2625,1
607,,,187.5,177.0,214.0,181.0,4159,3638,2883,2631,1276,1007,2378,1307,2240,675,138,632,77,81,7975,7260,1925,3750,4375,2625,1
614,,,193.5,179.0,214.0,181.0,4187,3588,2911,2491,1276,1097,2609,1143,2315,525,294,618,77,81,7975,7260,2050,3750,4375,2625,1
621,,,196.5,179.0,214.0,181.0,4086,3409,2743,2379,1343,1030,1889,844,1435,210,454,634,77,81,7975,7260,2050,3750,4375,2625,1
629,,,193.5,179.0,214.0,196.0,3638,3442,2295,2435,1343,1007,2244,1114,1630,360,614,754,77,81,7975,7260,2050,3750,4375,2625,1
636,,,186.5,187.0,214.0,196.0,3627,3650,2239,2575,1388,1075,1835,761,1515,275,320,486,76,81,8875,7460,2050,3750,4375,2625,1
643,,,198.5,187.0,214.0,236.0,3812,3510,2379,2435,1433,1075,1166,1159,670,545,496,614,76,81,8875,7460,2500,3750,4375,2625,1
650,,,195.5,191.0,214.0,236.0,3773,3868,2183,2659,1590,1209,1607,591,915,275,692,316,77,81,8875,8120,3250,3750,4375,2625,1
657,,,190.5,199.0,214.0,236.0,3689,4070,2099,2771,1590,1299,1478,568,840,100,638,468,80,81,8875,9455,4125,3900,4375,2625,1
664,,,190.5,199.0,214.0,236.0,3790,4120,2155,2799,1635,1321,1920,999,1090,375,830,624,80,81,8875,9500,4125,3900,4375,2625,1
671,,,189.5,199.0,214.0,236.0,4064,4159,2407,2883,1657,1276,2165,847,1285,75,880,772,79,81,8875,9515,4500,3900,4375,2625,1
679,,,191.5,199.0,214.0,236.0,4294,4098,2659,2799,1635,1299,2258,782,1190,100,1068,682,79,81,8875,9545,5125,3900,4375,2625,1
686,,,188.5,199.0,214.0,236.0,4232,3874,2575,2575,1657,1299,2299,928,1260,90,1039,838,78,81,8875,9940,5125,4350,4375,2625,1
693,,,184.5,199.0,214.0,244.0,4131,4266,2519,2967,1612,1299,2601,1314,1470,320,1131,994,77,81,8675,10670,5125,4350,4575,2625,1
700,,,182.5,199.0,214.0,259.0,4215,4131,2603,2855,1612,1276,3103,1791,1780,645,1323,1146,77,81,8525,10670,5125,4450,4725,2625,1
707,,,182.5,199.0,214.0,259.0,4198,4254,2631,2911,1567,1343,3305,2291,1940,985,1365,1306,77,81,8525,10670,5750,4600,4725,2625,1
714,,,198.5,199.0,214.0,259.0,4350,4310,2715,2967,1635,1343,1840,2821,1075,1355,765,1466,77,81,8525,11470,5875,4750,4725,2625,1
721,,,198.5,199.0,214.0,259.0,4428,4310,2771,2743,1657,1567,2065,3323,1100,1665,965,1658,77,81,8525,11470,5875,5050,4725,2625,1
729,,,193.5,199.0,214.0,259.0,4266,4417,2631,2827,1635,1590,2554,2066,1405,1120,1149,946,76,81,8225,11470,5875,4600,5025,3225,1
736,,,191.5,194.0,214.0,236.0,4344,4131,2687,2631,1657,1500,3089,2737,1740,1515,1349,1222,76,76,8075,11470,5875,4350,5175,4225,1
743,,,185.5,193.0,214.0,236.0,4210,3543,2575,2267,1635,1276,2822,3129,1535,1755,1287,1374,76,75,8875,11455,5875,4350,6375,4290,1
750,,,183.5,187.0,214.0,236.0,4243,3521,2631,2267,1612,1254,3318,3540,1835,2010,1483,1530,76,69,8725,11455,5875,4350,6525,4665,1
757,,,191.5,191.0,214.0,228.0,4193,2922,2603,1623,1590,1299,345,2086,70,1150,275,936,76,55,7225,11470,5875,4350,8025,5465,1
764,,,183.5,191.0,214.0,228.0,4232,2782,2575,1483,1657,1299,535,2412,210,1320,325,1092,76,55,6625,11470,5875,4350,8625,5465,1
771,,,181.5,189.0,214.0,228.0,4193,2759,2603,1483,1590,1276,938,1816,475,580,463,1236,76,53,7225,11470,5875,4950,8775,5565,1
779,,,179.5,189.0,214.0,228.0,4126,2541,2491,1287,1635,1254,334,2039,225,655,109,1384,76,53,7075,11470,5875,5550,8925,5565,1
786,,,187.5,188.0,214.0,228.0,4187,2625,2575,1371,1612,1254,231,2337,130,805,101,1532,76,52,11575,11470,5875,6150,8925,5615,1
793,,,191.0,188.0,214.0,228.0,4187,2535,2575,1259,1612,1276,408,2488,215,800,193,1688,76,52,11550,11470,5875,6150,8950,5615,1
800,,,191.0,200.0,220.0,236.0,4361,2586,2771,1287,1590,1299,949,1758,560,360,389,1398,76,52,11550,11470,5875,6150,8950,5615,1
807,,,199.0,200.0,220.0,236.0,4238,2563,2603,1287,1635,1276,840,2020,455,470,385,1550,76,52,12150,12790,5875,6150,8950,5615,1
814,,,199.0,200.0,220.0,236.0,4372,2451,2715,1175,1657,1276,1365,2302,780,600,585,1702,76,52,12450,13450,5875,6150,8950,5615,1
821,,,199.0,200.0,220.0,236.0,4154,2586,2519,1287,1635,1299,1858,2569,1085,715,773,1854,76,52,12450,13495,5875,6150,8950,5615,1
829,,,197.0,198.0,220.0,236.0,4372,2390,2715,1091,1657,1299,1594,2806,1025,800,569,2006,76,50,12900,13540,5875,6150,9100,5865,1
836,,,180.0,185.0,220.0,236.0,4187,2423,2575,1147,1612,1276,2082,3017,1325,855,757,2162,76,49,11000,12300,5250,6150,11625,7185,1
843,,,189.0,185.0,212.0,251.0,4243,2322,2631,1091,1612,1231,598,3190,445,880,153,2310,75,49,10050,13035,4875,6150,13000,8065,1
850,,,178.0,184.0,204.0,243.0,4053,2339,2575,1175,1478,1164,594,3376,465,930,129,2446,72,49,8950,12785,4750,6150,14375,8505,1
857,,,166.0,193.0,196.0,243.0,3991,2418,2491,1231,1500,1187,1049,2206,740,220,309,1986,72,49,7750,12070,4750,6150,15575,9310,1
864,,,168.0,188.0,180.0,235.0,3980,2468,2547,1259,1433,1209,347,2441,270,315,77,2126,72,48,6000,11720,4750,6000,17325,10035,1
871,,,160.0,182.0,180.0,227.0,3997,2552,2519,1343,1478,1209,813,2310,560,190,253,2120,72,46,7100,11065,4750,6000,18300,10965,1
879,,,154.0,181.0,180.0,227.0,3974,2429,2519,1287,1455,1142,1139,2522,760,270,379,2252,70,45,6850,11005,4375,6000,19525,11135,1
886,,,159.0,182.0,164.0,212.0,3678,2272,2267,1175,1411,1097,518,2374,325,140,193,2234,61,42,7650,11065,4125,6000,20625,11760,1
893,,,155.0,182.0,134.0,212.0,3454,2059,2155,1007,1299,1052,443,2552,90,190,353,2362,61,42,6950,12525,4125,6000,21775,11760,1
900,,,147.0,177.0,134.0,212.0,3420,1947,2099,895,1321,1052,734,2731,275,245,459,2486,61,37,6350,12555,4125,6000,22450,12025,1
907,,,131.0,177.0,166.0,212.0,3442,1421,2099,503,1343,918,949,2839,330,245,619,2594,61,37,6350,12950,4125,6000,23650,12025,1
914,,,131.0,180.0,174.0,212.0,3392,1174,2071,279,1321,895,1342,2767,575,65,767,2702,61,37,6450,13360,4125,6000,23650,12025,1
921,,,143.0,175.0,174.0,212.0,3420,1275,2099,447,1321,828,553,2818,430,20,123,2798,61,37,6450,12700,4125,6000,23650,12745,1
929,,,143.0,175.0,190.0,212.0,3375,1522,2099,783,1276,739,950,2936,675,50,275,2886,61,41,6450,12760,4125,6000,23650,12745,1
936,,,158.0,177.0,190.0,212.0,3347,1678,2071,1007,1276,671,456,2876,125,60,331,2816,61,41,6450,12820,4125,6000,23650,12745,1
943,,,164.0,179.0,190.0,212.0,3269,1824,2015,1063,1254,761,252,2953,165,45,87,2908,74,41,6450,12895,4125,6000,23650,12745,1
950,,,164.0,179.0,190.0,212.0,3476,2054,2155,1315,1321,739,177,3197,80,205,97,2992,74,41,7650,13140,4125,6000,23650,12745,1
957,,,164.0,179.0,190.0,212.0,3532,2294,2211,1623,1321,671,588,3473,335,405,253,3068,74,43,7650,13140,4125,6000,23650,12745,1
964,,,164.0,183.0,190.0,212.0,3756,2378,2435,1707,1321,671,1046,3517,645,365,401,3152,74,43,8200,13140,4125,6000,23650,12745,1
971,,,180.0,192.0,206.0,212.0,4036,2311,2715,1707,1321,604,346,3005,185,185,161,2820,74,47,8800,13140,4125,5800,23650,12945,1
979,,,176.0,188.0,206.0,212.0,4148,2434,2883,1819,1265,615,832,3258,525,360,307,2898,74,47,8400,12745,3625,5800,24550,13340,1
986,,,170.0,176.0,198.0,212.0,3980,2524,2827,1931,1153,593,302,3535,255,565,47,2970,72,48,7150,11260,2875,5800,26650,14855,1
993,,,159.0,176.0,192.0,212.0,3666,2670,2547,2043,1119,627,728,3837,545,795,183,3042,61,48,8350,11275,2750,5800,27675,14855,1
1000,,,155.0,170.0,192.0,212.0,3235,2423,2071,1819,1164,604,618,4039,495,925,123,3114,61,41,7750,11320,2750,5800,28275,15205,1
1007,,,150.0,159.0,186.0,212.0,3196,1578,2099,1063,1097,515,987,4206,740,1040,247,3166,60,30,7450,11320,2750,5800,28975,15755,1
1014,,,128.0,149.0,186.0,204.0,2350,1264,1455,951,895,313,1233,4342,890,1140,343,3202,40,27,8200,10615,2750,5800,30225,16775,1
1021,,,128.0,161.0,186.0,204.0,2042,1169,1259,923,783,246,1474,3420,1035,640,439,2780,40,27,8200,10630,2750,5800,30225,16775,1
1029,,,106.0,149.0,186.0,204.0,1981,1146,1175,923,806,223,1714,3563,1175,755,539,2808,39,27,7050,9190,2750,5800,31925,18215,1
1036,,,109.0,152.0,180.0,204.0,1393,1124,811,923,582,201,599,3547,500,715,99,2832,32,27,7050,9190,2750,5800,32625,18215,1
1043,,,109.0,146.0,164.0,204.0,1163,1141,671,895,492,246,740,3680,585,820,155,2860,32,27,6850,8470,2750,5800,32925,18935,1
1050,,,101.0,146.0,148.0,204.0,1247,1197,755,951,492,246,885,3823,670,935,215,2888,32,30,6250,8470,2750,5800,33725,18935,1
1057,,,91.0,148.0,132.0,204.0,1191,1230,699,1007,492,223,1026,2922,755,460,271,2462,32,30,5100,8450,2750,5800,35075,20005,1
1064,,,74.0,132.0,132.0,204.0,995,1314,503,1091,492,223,391,3080,360,590,31,2490,32,30,3700,7050,2750,5800,37725,21405,1
1071,,,62.0,122.0,132.0,204.0,883,1342,391,1119,492,223,492,3138,405,620,87,2518,32,30,2200,6000,2750,5800,39225,22455,1
1079,,,54.0,118.0,132.0,204.0,771,1314,279,1091,492,223,582,3296,435,750,147,2546,32,30,1200,5650,2750,5800,40225,22805,1
7,,,13.0,13.0,15.0,15.0,293,335,293,335,0,0,35,40,35,40,0,0,12,12,0,0,0,0,0,0,0
14,,,14.0,14.0,15.0,15.0,671,671,671,671,0,0,70,70,70,70,0,0,13,13,0,0,0,0,0,0,0
21,,,14.0,14.0,15.0,15.0,699,699,699,699,0,0,45,45,45,45,0,0,13,13,0,0,0,0,0,0,0
29,,,15.0,15.0,15.0,15.0,699,699,699,699,0,0,80,35,80,35,0,0,14,14,0,0,0,0,0,0,0
36,,,16.0,16.0,23.0,23.0,783,755,783,755,0,0,135,125,135,125,0,0,15,15,0,0,0,0,0,0,0
43,,,16.0,16.0,23.0,23.0,811,755,811,755,0,0,20,10,20,10,0,0,15,15,0,0,0,0,0,0,0
50,,,17.0,17.0,23.0,23.0,839,755,839,755,0,0,50,35,50,35,0,0,16,16,0,0,0,0,0,0,0
57,,,18.0,18.0,23.0,23.0,867,811,867,811,0,0,30,85,30,85,0,0,17,17,0,0,0,0,0,0,0
64,,,19.0,19.0,23.0,23.0,923,867,923,867,0,0,95,60,95,60,0,0,18,18,0,0,0,0,0,0,0
71,,,19.0,19.0,23.0,23.0,889,867,867,867,22,0,49,120,45,120,4,0,18,18,0,0,0,0,0,0,0
79,,,20.0,20.0,23.0,23.0,928,995,839,951,89,44,66,48,50,40,16,8,19,19,0,0,0,0,0,0,0
86,,,21.0,21.0,23.0,23.0,945,1034,699,923,246,111,182,119,130,95,52,24,20,20,0,0,150,150,0,0,0
93,,,22.0,21.0,23.0,23.0,1068,1146,755,923,313,223,117,157,25,105,92,52,21,21,0,0,150,150,0,0,0
100,,,22.0,22.0,23.0,23.0,1090,1118,755,895,335,223,192,136,60,60,132,76,21,21,0,0,150,150,0,0,0
107,,,23.0,22.0,23.0,23.0,1152,1085,839,839,313,246,224,217,60,105,164,112,22,21,0,0,150,150,0,0,0
114,,,23.0,23.0,23.0,31.0,1208,1214,895,923,313,291,274,258,70,110,204,148,22,22,0,0,150,150,0,0,0
121,,,23.0,24.0,31.0,31.0,1163,1186,895,895,268,291,476,349,240,165,236,184,23,23,0,0,300,150,0,0,0
129,,,27.0,28.0,31.0,31.0,1219,1186,951,895,268,291,177,65,55,45,122,20,23,23,0,0,450,450,0,0,0
136,,,27.0,28.0,31.0,39.0,1286,1258,951,923,335,335,332,110,170,50,162,60,23,24,0,0,450,450,0,0,0
143,,,27.0,28.0,31.0,39.0,1292,1225,979,867,313,358,223,250,125,150,98,100,23,24,0,0,450,450,0,0,0
150,,,27.0,29.0,31.0,39.0,1314,1286,979,951,335,335,378,351,240,215,138,136,23,24,0,0,450,450,0,0,0
157,,,31.0,33.0,31.0,47.0,1258,1236,923,923,335,313,159,172,85,150,74,22,23,24,350,325,450,450,0,0,0
164,,,31.0,33.0,31.0,47.0,1258,1236,923,923,335,313,319,322,205,260,114,62,23,25,350,325,450,450,0,0,0
171,,,31.0,33.0,31.0,47.0,1180,1264,867,951,313,313,455,477,305,375,150,102,23,25,350,325,450,450,0,0,0
179,,,31.0,33.0,31.0,39.0,1214,1258,923,923,291,335,211,227,175,85,36,142,23,25,350,325,700,450,0,100,0
186,,,31.0,34.0,31.0,39.0,1152,1202,839,867,313,335,251,217,175,35,76,182,23,25,700,650,700,450,0,100,0
193,,,31.0,36.0,31.0,39.0,1163,1202,895,867,268,335,398,213,290,95,108,118,23,25,700,650,700,450,0,100,0
200,,,35.0,37.0,39.0,39.0,1208,1258,895,923,313,335,57,218,5,60,52,158,23,26,700,650,700,450,0,100,0
207,,,35.0,37.0,39.0,39.0,1230,1236,895,923,335,313,203,259,115,65,88,194,23,26,700,650,700,450,0,100,0
214,,,35.0,38.0,39.0,39.0,1230,1292,895,979,335,313,428,174,300,40,128,134,23,27,700,650,700,550,0,100,0
221,,,35.0,39.0,39.0,47.0,1236,1242,923,951,313,291,569,275,405,105,164,170,23,28,700,800,700,550,0,100,0
229,,,35.0,40.0,39.0,47.0,1264,1314,951,979,313,335,334,235,130,25,204,210,23,29,700,800,700,550,0,100,0
236,,,35.0,40.0,39.0,47.0,1292,1286,979,951,313,335,700,380,343,130,357,250,23,30,1050,800,700,550,0,100,0
243,,,39.0,45.0,39.0,55.0,1314,1320,979,1007,335,313,210,162,63,30,147,132,23,30,1050,1125,850,550,0,100,0
250,,,39.0,46.0,39.0,78.0,1314,1432,979,1119,335,313,265,192,78,20,187,172,23,30,1400,1125,850,550,0,100,0
257,,,39.0,47.0,39.0,78.0,1314,1684,979,1371,335,313,401,337,178,125,223,212,23,31,1400,1125,850,550,0,100,0
264,,,39.0,48.0,39.0,78.0,1264,1572,951,1259,313,313,552,427,293,250,259,177,23,31,1400,1125,850,800,0,150,0
271,,,37.0,49.0,47.0,78.0,1264,1712,951,1399,313,313,707,467,408,300,299,167,23,33,1225,950,850,800,175,325,0
279,,,37.0,53.0,47.0,78.0,1264,1785,951,1427,313,358,857,292,518,135,339,157,23,34,1225,1125,850,800,175,325,0
286,,,44.0,54.0,47.0,70.0,1264,1818,951,1483,313,335,432,303,203,110,229,193,23,35,1225,1400,850,800,175,425,0
293,,,44.0,58.0,47.0,70.0,1258,1684,923,1371,335,313,537,174,268,45,269,129,23,36,1750,1400,850,800,175,425,0
300,,,46.0,61.0,62.0,70.0,1258,1852,923,1539,335,313,583,204,278,135,305,69,24,36,1750,1400,850,800,175,425,0
307,,,47.0,62.0,62.0,78.0,1314,1992,979,1679,335,313,698,199,353,90,345,109,25,37,1750,1550,850,800,175,425,0
314,,,54.0,63.0,62.0,78.0,1348,2020,1035,1707,313,313,289,239,58,90,231,149,26,38,2275,1550,850,900,175,425,0
321,,,55.0,63.0,62.0,86.0,1404,2048,1091,1735,313,313,419,240,148,155,271,85,27,39,2275,1925,850,900,175,425,0
329,,,56.0,65.0,62.0,94.0,1488,2121,1175,1763,313,358,504,185,193,60,311,125,28,40,2275,1925,850,900,175,425,0
336,,,61.0,66.0,62.0,94.0,1538,2177,1203,1819,335,358,209,410,8,245,201,165,29,41,2275,1925,850,900,175,425,0
343,,,63.0,71.0,70.0,94.0,1678,2216,1343,1679,335,537,314,233,73,100,241,133,29,42,2800,1925,850,900,175,425,0
350,,,65.0,72.0,70.0,94.0,1622,2306,1287,1679,335,627,415,509,138,300,277,209,31,43,2800,1925,850,900,175,425,0
357,,,61.0,70.0,70.0,94.0,1734,2356,1399,1707,335,649,610,444,293,255,317,189,31,44,2450,1375,850,1150,525,975,0
364,,,58.0,66.0,70.0,94.0,1740,1852,1427,1315,313,537,776,259,423,110,353,149,33,43,2100,1200,850,1200,875,1350,0
371,,,59.0,60.0,70.0,94.0,1908,1488,1595,1063,313,425,906,436,513,235,393,201,33,33,2100,1925,850,1200,875,1850,0
379,,,66.0,61.0,70.0,94.0,1908,1600,1595,1175,313,425,501,524,218,275,283,249,34,32,2625,1925,850,1200,875,1900,0
386,,,67.0,66.0,70.0,94.0,1930,1740,1595,1315,335,425,731,357,408,210,323,147,35,34,2625,1925,850,1200,875,1900,0
393,,,66.0,63.0,70.0,94.0,1936,1695,1623,1315,313,380,862,392,503,205,359,187,36,34,2450,1875,850,1200,1050,2275,0
400,,,64.0,59.0,70.0,94.0,2070,1561,1735,1203,335,358,1107,206,708,75,399,131,38,36,2100,1575,850,1200,1400,2950,0
407,,,68.0,52.0,70.0,86.0,2104,1488,1791,1175,313,313,838,406,553,235,285,171,39,35,2100,1125,850,1200,1575,3550,0
414,,,67.0,54.0,70.0,86.0,2104,1992,1791,1679,313,313,1038,191,713,80,325,111,40,35,2275,825,850,1200,1750,3850,0
421,,,68.0,54.0,70.0,86.0,2132,1964,1819,1651,313,313,503,271,138,120,365,151,41,35,2275,1175,850,1300,1750,3850,0
429,,,68.0,56.0,70.0,86.0,2210,2009,1875,1651,335,358,768,466,363,275,405,191,42,37,2275,1175,850,1300,1750,3850,0
436,,,64.0,46.0,70.0,86.0,2154,2009,1819,1651,335,358,1028,711,583,480,445,231,42,37,1925,650,850,1300,2100,4750,0
7,,,13.0,13.0,15.0,15.0,293,293,293,293,0,0,35,35,35,35,0,0,12,12,0,0,0,0,0,0,1
14,,,14.0,14.0,15.0,15.0,671,671,671,671,0,0,70,70,70,70,0,0,13,13,0,0,0,0,0,0,1
21,,,14.0,14.0,15.0,15.0,727,727,727,727,0,0,50,45,50,45,0,0,13,13,0,0,0,0,0,0,1
29,,,15.0,15.0,15.0,15.0,727,755,727,755,0,0,85,85,85,85,0,0,14,14,0,0,0,0,0,0,1
36,,,15.0,15.0,23.0,15.0,783,839,783,839,0,0,135,195,135,195,0,0,14,14,0,0,0,0,0,0,1
43,,,16.0,16.0,23.0,23.0,783,811,783,811,0,0,75,180,75,180,0,0,15,15,0,0,0,0,0,0,1
50,,,17.0,17.0,23.0,23.0,811,867,811,867,0,0,60,55,60,55,0,0,16,16,0,0,0,0,0,0,1
57,,,18.0,18.0,23.0,23.0,839,839,839,839,0,0,40,5,40,5,0,0,17,17,0,0,0,0,0,0,1
64,,,19.0,19.0,23.0,23.0,895,895,895,895,0,0,100,55,100,55,0,0,18,18,0,0,0,0,0,0,1
71,,,19.0,19.0,23.0,23.0,867,783,867,783,0,0,10,95,10,95,0,0,18,18,0,0,0,0,0,0,1
79,,,20.0,20.0,23.0,31.0,934,928,867,839,67,89,87,171,75,155,12,16,19,19,0,0,0,0,0,0,1
86,,,21.0,21.0,23.0,31.0,1034,1074,811,895,223,179,219,291,175,255,44,36,20,20,0,0,150,0,0,0,1
93,,,22.0,21.0,23.0,31.0,984,1074,671,895,313,179,134,411,50,355,84,56,21,21,0,0,150,0,0,0,1
100,,,22.0,24.0,23.0,31.0,1118,1051,783,895,335,156,124,237,0,165,124,72,21,21,0,0,150,150,0,0,1
107,,,23.0,24.0,23.0,31.0,1146,1079,811,923,335,156,260,112,100,20,160,92,22,21,0,0,150,150,0,0,1
114,,,23.0,25.0,23.0,31.0,1236,1079,923,923,313,156,401,187,205,75,196,112,23,22,0,0,300,150,0,0,1
121,,,23.0,25.0,31.0,31.0,1236,1051,923,895,313,156,561,253,325,125,236,128,23,22,0,0,300,150,0,0,1
129,,,27.0,28.0,31.0,39.0,1292,1163,979,1007,313,156,251,293,125,145,126,148,23,23,0,100,450,150,0,0,1
136,,,27.0,29.0,31.0,39.0,1264,1113,951,979,313,134,151,289,85,125,66,164,23,24,0,100,450,150,0,0,1
143,,,27.0,29.0,31.0,39.0,1286,1113,951,979,335,134,301,149,195,40,106,109,23,24,0,100,450,300,0,0,1
150,,,27.0,34.0,31.0,39.0,1337,1135,979,979,358,156,111,169,65,65,46,104,23,25,0,200,450,450,0,0,1
157,,,31.0,33.0,31.0,39.0,1264,1242,951,1063,313,179,243,163,165,35,78,128,23,24,350,200,450,450,0,50,1
164,,,31.0,34.0,31.0,39.0,1292,1219,979,951,313,268,203,304,85,140,118,164,23,25,350,200,450,450,0,50,1
171,,,31.0,34.0,31.0,39.0,1158,1286,867,951,291,335,39,134,35,55,4,79,23,25,350,200,700,450,0,50,1
179,,,31.0,39.0,31.0,47.0,1214,1314,923,979,291,335,190,239,150,120,40,119,23,26,350,450,700,450,0,50,1
186,,,31.0,40.0,39.0,47.0,1236,1314,923,979,313,335,335,385,255,230,80,155,23,27,700,450,700,450,0,50,1
193,,,35.0,40.0,39.0,47.0,1286,1398,951,1063,335,335,225,505,205,310,20,195,23,27,700,450,700,450,0,50,1
200,,,35.0,41.0,39.0,47.0,1258,1320,923,1007,335,313,370,251,310,20,60,231,23,28,700,450,700,450,0,50,1
207,,,35.0,41.0,39.0,47.0,1242,1376,951,1063,291,313,117,367,25,100,92,267,23,28,700,725,700,450,0,50,1
214,,,35.0,44.0,39.0,47.0,1158,1348,867,1035,291,313,158,357,30,100,128,257,23,29,700,725,700,450,0,50,1
221,,,35.0,44.0,39.0,47.0,1219,1432,951,1119,268,313,305,482,145,185,160,297,23,29,1050,725,700,450,0,100,1
229,,,35.0,44.0,39.0,47.0,1214,1348,923,1035,291,313,460,437,260,100,200,337,23,29,1050,725,700,450,0,100,1
236,,,39.0,45.0,39.0,47.0,1264,1376,951,1063,313,313,255,603,115,230,140,373,23,30,1400,725,700,450,0,100,1
243,,,39.0,47.0,47.0,47.0,1286,1398,951,1063,335,335,265,489,85,105,180,384,23,30,1400,1025,700,450,0,100,1
250,,,39.0,47.0,47.0,47.0,1230,1342,895,1007,335,335,405,654,185,230,220,424,23,31,1400,1025,700,450,0,100,1
257,,,43.0,47.0,47.0,47.0,1286,1432,951,1119,335,313,211,825,55,365,156,460,23,31,1400,1025,700,450,0,100,1
264,,,44.0,52.0,47.0,55.0,1202,1482,867,1147,335,335,251,710,55,260,196,450,23,31,1400,1275,700,450,0,100,1
271,,,45.0,54.0,47.0,70.0,1292,1432,979,1119,313,313,362,771,130,285,232,486,24,32,1750,1275,700,450,0,100,1
279,,,43.0,53.0,47.0,70.0,1264,1326,951,1035,313,291,512,752,240,255,272,497,24,33,1575,950,700,600,175,425,1
286,,,44.0,52.0,62.0,70.0,1286,1594,951,1259,335,335,667,552,355,115,312,437,25,34,1575,900,700,600,175,775,1
293,,,44.0,51.0,62.0,70.0,1342,1790,1007,1455,335,335,827,602,475,125,352,477,25,35,1575,850,850,600,175,1000,1
300,,,46.0,47.0,62.0,70.0,1348,1874,1035,1539,313,335,643,768,355,255,288,513,26,37,1750,575,850,600,350,1375,1
307,,,46.0,42.0,62.0,70.0,1454,1634,1119,1343,335,291,718,575,390,155,328,420,26,37,1575,225,850,600,525,1900,1
314,,,46.0,41.0,62.0,70.0,1482,950,1147,727,335,223,793,333,425,35,368,298,26,35,1575,275,850,600,525,2150,1
321,,,48.0,38.0,62.0,70.0,1516,990,1203,699,313,291,974,453,570,115,404,338,28,34,1575,325,850,600,525,2325,1
329,,,54.0,35.0,62.0,70.0,1572,1443,1259,1175,313,268,634,646,340,280,294,366,28,33,2100,175,850,600,525,2525,1
335,,,56.0,35.0,62.0,70.0,1650,1410,1315,1231,335,179,665,686,335,300,330,386,30,33,2100,100,850,600,525,2700,1
7,1,1,13.0,12.0,14.0,14.0,335,377,335,377,0,0,40,95,40,95,0,0,12,12,0,0,0,0,0,0,1
14,1,1,13.0,12.0,14.0,14.0,671,671,671,671,0,0,20,170,20,170,0,0,13,12,0,0,0,0,0,0,1
21,1,1,14.0,11.0,14.0,14.0,699,671,699,671,0,0,50,45,50,45,0,0,13,11,0,0,0,0,0,0,1
29,1,1,14.0,13.0,14.0,14.0,727,587,727,587,0,0,145,25,145,25,0,0,13,11,0,0,0,0,0,0,1
36,1,1,16.0,14.0,22.0,14.0,783,643,783,643,0,0,150,55,150,55,0,0,14,12,0,0,0,0,0,0,1
43,1,1,16.0,14.0,22.0,14.0,783,643,783,643,0,0,230,25,230,25,0,0,16,13,0,0,0,0,0,0,1
50,1,1,15.0,14.0,22.0,14.0,811,755,811,755,0,0,35,125,35,125,0,0,15,14,0,0,0,0,0,0,1
57,1,1,17.0,14.0,22.0,14.0,867,755,867,755,0,0,45,220,45,220,0,0,15,14,0,0,0,0,0,0,1
64,1,1,18.0,16.0,22.0,22.0,951,839,951,839,0,0,75,215,75,215,0,0,16,14,0,0,0,250,0,0,1
71,1,1,17.0,17.0,22.0,22.0,923,839,923,839,0,0,170,265,170,265,0,0,17,14,0,0,0,250,0,0,1
79,1,1,17.0,17.0,22.0,22.0,951,811,951,811,0,0,40,10,40,10,0,0,16,13,0,0,0,250,0,0,1
86,1,1,18.0,17.0,22.0,22.0,951,783,951,783,0,0,95,100,95,100,0,0,16,13,0,150,0,250,0,0,1
93,1,1,19.0,18.0,22.0,22.0,939,783,895,783,44,0,148,135,140,135,8,0,18,13,0,150,0,250,0,0,1
100,1,1,19.0,21.0,22.0,22.0,928,727,839,727,89,0,266,25,250,25,16,0,18,13,0,200,0,250,0,0,1
107,1,1,19.0,21.0,22.0,22.0,979,755,979,755,0,0,381,120,365,120,16,0,19,13,0,250,0,250,0,0,1
114,1,1,19.0,21.0,22.0,22.0,951,783,951,783,0,0,491,110,475,110,16,0,19,13,0,250,0,250,0,0,1
121,1,1,27.0,22.0,28.0,22.0,811,755,811,755,0,0,71,150,55,150,16,0,19,13,0,300,250,250,0,0,1
129,1,1,26.0,22.0,28.0,30.0,279,727,279,727,0,0,96,90,80,90,16,0,18,13,0,300,250,250,50,0,1
136,1,1,28.0,25.0,28.0,30.0,335,699,335,699,0,0,46,125,30,125,16,0,18,14,0,450,250,250,50,0,1
143,1,1,25.5,26.0,28.0,30.0,279,755,279,755,0,0,71,175,55,175,16,0,17,15,125,450,250,250,175,0,1
150,1,1,24.0,24.0,28.0,36.0,335,811,335,811,0,0,61,280,45,280,16,0,15,15,150,350,250,250,300,100,1
157,1,1,22.5,25.5,28.0,36.0,251,867,251,867,0,0,41,125,25,125,16,0,15,16,375,225,250,250,425,225,1
164,1,1,23.0,28.5,28.0,36.0,615,895,615,895,0,0,86,85,70,85,16,0,15,18,400,225,250,250,450,225,1
171,1,1,25.0,29.5,28.0,36.0,839,923,839,923,0,0,71,70,55,70,16,0,16,17,400,375,250,250,450,225,1
179,1,1,25.0,30.5,28.0,36.0,939,923,895,923,44,0,99,30,75,30,24,0,18,21,400,375,250,250,450,225,1
186,1,1,28.0,31.5,28.0,36.0,1012,1035,923,1035,89,0,76,100,40,100,36,0,19,22,400,375,250,250,450,225,1
193,1,1,28.5,31.5,36.0,44.0,1146,1102,1035,1035,111,67,153,177,105,165,48,12,21,23,375,475,250,250,475,275,1
200,1,1,31.0,34.5,36.0,44.0,1141,962,1007,783,134,179,94,87,30,55,64,32,22,24,300,475,250,250,550,325,1
207,1,1,31.0,35.0,36.0,44.0,1253,1107,1119,951,134,156,250,78,170,30,80,48,25,27,300,450,250,250,550,350,1
214,1,1,33.0,38.0,36.0,44.0,1426,1303,1315,1147,111,156,222,98,130,30,92,68,27,29,300,450,250,250,550,350,1
221,1,1,34.0,40.0,36.0,44.0,1555,1499,1399,1343,156,156,97,183,85,95,12,88,27,30,300,450,250,250,550,350,1
229,1,1,35.0,40.0,44.0,52.0,1583,1695,1427,1539,156,156,117,198,85,190,32,8,28,33,300,450,250,250,550,350,1
236,1,1,39.0,44.0,44.0,52.0,1578,1662,1399,1483,179,179,92,183,40,155,52,28,30,33,300,450,250,250,550,350,1
243,1,1,40.0,43.0,44.0,52.0,1695,1774,1539,1595,156,179,103,108,35,60,68,48,31,32,300,500,250,250,550,350,1
250,1,1,39.0,44.0,44.0,52.0,1723,1723,1567,1567,156,156,133,64,45,50,88,14,33,35,300,500,250,250,550,350,1
257,1,1,41.0,47.0,44.0,52.0,1863,1863,1707,1707,156,156,253,44,145,10,108,34,35,35,300,500,375,250,550,350,1
264,1,1,43.0,47.0,44.0,52.0,1863,1919,1707,1763,156,156,103,149,75,95,28,54,35,34,300,500,375,250,550,350,1
271,1,1,45.0,50.0,52.0,52.0,1891,1863,1735,1707,156,156,133,129,85,55,48,74,37,34,300,700,375,250,550,350,1
279,1,1,47.0,54.0,52.0,60.0,1942,1947,1651,1791,291,156,153,332,115,200,38,132,40,36,300,750,625,250,550,350,1
286,1,1,47.0,54.0,52.0,60.0,1919,1914,1539,1735,380,179,282,507,200,355,82,152,43,36,300,850,825,250,550,400,1
293,1,1,49.0,58.0,60.0,68.0,2042,2054,1595,1875,447,179,239,207,230,135,9,72,43,39,400,850,825,375,550,400,1
300,1,1,53.0,57.0,68.0,68.0,2261,1975,1791,1819,470,156,310,343,295,255,15,88,43,40,400,850,825,375,550,400,1
307,1,1,56.0,58.0,68.0,68.0,2233,1975,1763,1819,470,156,80,223,55,215,25,8,42,43,400,850,825,375,550,400,1
314,1,1,60.0,61.0,68.0,74.0,2317,1975,1847,1819,470,156,80,113,45,85,35,28,42,41,600,850,825,375,550,400,1
321,1,1,64.0,59.0,68.0,82.0,2042,2115,1595,1959,447,156,107,278,70,230,37,48,42,42,700,750,825,375,550,500,1
329,1,1,64.0,58.5,68.0,82.0,1460,2283,1147,2127,313,156,64,503,45,435,19,68,40,47,750,675,825,375,800,575,1
336,1,1,68.0,64.0,76.0,90.0,1880,2440,1567,2239,313,201,109,487,100,470,9,17,40,47,950,650,825,575,800,600,1
343,1,1,72.0,66.0,76.0,98.0,2261,2496,1791,2183,470,313,85,502,70,445,15,57,40,47,1250,650,825,575,800,600,1
350,1,1,76.0,74.0,76.0,98.0,2205,2524,1735,2099,470,425,145,403,120,390,25,13,40,50,1450,650,825,575,800,600,1
357,1,1,78.0,80.0,84.0,106.0,2289,2591,1819,2099,470,492,160,263,75,215,85,48,40,50,1550,950,825,575,800,600,1
364,1,1,84.0,86.0,84.0,106.0,2233,2675,1763,2183,470,492,135,278,65,245,70,33,40,52,1750,1050,825,825,800,600,1
371,1,1,84.0,88.0,84.0,106.0,2278,2737,1763,2155,515,582,395,519,265,435,130,84,40,52,1950,1350,825,825,800,600,1
379,1,1,91.0,93.0,98.0,114.0,2300,2849,1763,2155,537,694,250,304,110,290,140,14,40,52,2050,1450,825,825,800,600,1
386,1,1,92.0,101.5,98.0,114.0,2199,2961,1707,2267,492,694,423,154,249,110,174,44,40,52,2250,1825,825,825,824,625,1
393,1,1,93.0,103.0,98.0,122.0,2205,2950,1735,2323,470,627,154,47,74,35,80,12,42,52,2200,1550,825,825,1024,1100,1
400,1,1,87.0,102.0,98.0,122.0,1673,2832,1203,2183,470,649,214,87,74,70,140,17,43,52,2000,1400,825,825,1424,1500,1
407,1,1,90.0,104.0,98.0,122.0,1449,2944,979,2295,470,649,244,152,44,130,200,22,49,52,2000,1450,825,825,1424,1750,1
414,1,1,89.0,108.0,98.0,122.0,2205,2866,1735,2239,470,627,464,138,204,65,260,73,49,52,2150,1900,825,825,1424,1750,1
421,1,1,94.0,114.0,98.0,122.0,2552,2922,2015,2295,537,627,329,203,9,100,320,103,50,52,2150,2350,825,825,1424,1750,1
429,1,1,94.0,120.0,98.0,122.0,2636,2933,2099,2239,537,694,549,143,169,35,380,108,52,52,2150,2750,825,825,1424,1750,1
436,1,1,98.0,126.0,98.0,130.0,2625,2933,2155,2239,470,694,652,193,224,80,428,113,56,54,2150,2850,825,825,1424,1750,1
443,1,1,104.0,129.5,106.0,130.0,2793,2950,2323,2323,470,627,287,251,24,120,263,131,56,54,2150,3125,950,825,1424,1775,1
450,1,1,108.0,137.5,114.0,138.0,2854,3000,2295,2351,559,649,333,206,44,95,289,111,60,54,2150,3375,950,825,1424,1775,1
457,1,1,116.0,137.5,122.0,138.0,3062,3028,2435,2379,627,649,204,371,64,180,140,191,60,54,2150,3775,950,825,1424,1775,1
464,1,1,120.0,137.5,122.0,146.0,3011,3062,2407,2435,604,627,261,732,124,465,137,267,60,54,2550,3875,950,825,1524,1775,1
471,1,1,111.0,140.0,130.0,146.0,3095,3050,2491,2379,604,671,129,197,49,125,80,72,60,54,1850,3700,950,825,2524,2350,1
479,1,1,100.0,132.0,122.0,162.0,3274,3129,2715,2435,559,694,129,362,89,260,40,102,60,54,850,3100,950,825,3724,2950,1
7,1,1,13.0,13.0,14.0,14.0,377,377,377,377,0,0,45,45,45,45,0,0,12,12,0,0,0,0,0,0,0
14,1,1,13.0,13.0,14.0,14.0,671,699,671,699,0,0,20,25,20,25,0,0,13,13,0,0,0,0,0,0,0
21,1,1,14.0,14.0,14.0,14.0,727,727,727,727,0,0,55,55,55,55,0,0,13,13,0,0,0,0,0,0,0
29,1,1,14.0,14.0,14.0,14.0,699,783,699,783,0,0,150,160,150,160,0,0,13,13,0,0,0,0,0,0,0
36,1,1,16.0,17.0,22.0,22.0,783,783,783,783,0,0,150,100,150,100,0,0,14,14,0,0,0,0,0,0,0
43,1,1,16.0,17.0,22.0,22.0,755,839,755,839,0,0,235,195,235,195,0,0,16,16,0,0,0,0,0,0,0
50,1,1,15.0,17.0,22.0,22.0,811,839,811,839,0,0,40,40,40,40,0,0,15,16,0,0,0,0,0,0,0
57,1,1,17.0,17.0,22.0,22.0,811,867,811,867,0,0,30,155,30,155,0,0,15,16,0,0,0,0,0,0,0
64,1,1,18.0,17.0,22.0,22.0,951,895,951,895,0,0,100,260,100,260,0,0,16,17,0,0,0,0,0,0,0
71,1,1,17.0,17.0,22.0,22.0,867,923,867,923,0,0,165,0,165,0,0,0,17,16,0,0,0,0,0,0,0
79,1,1,17.0,17.0,22.0,22.0,1007,895,1007,895,0,0,40,60,40,60,0,0,16,15,0,0,0,0,0,0,0
86,1,1,18.0,17.0,22.0,22.0,923,867,923,867,0,0,100,160,100,160,0,0,16,16,0,0,0,0,0,0,0
93,1,1,19.0,21.0,22.0,22.0,1007,895,1007,895,0,0,160,25,160,25,0,0,18,17,0,0,0,250,0,0,0
100,1,1,20.0,22.0,22.0,22.0,1012,906,923,839,89,67,231,87,215,75,16,12,19,17,0,0,0,250,0,0,0
107,1,1,20.0,22.0,22.0,22.0,1079,967,923,811,156,156,351,207,315,175,36,32,19,18,0,0,0,250,0,0,0
114,1,1,21.0,22.0,22.0,22.0,1079,995,923,839,156,156,431,223,375,175,56,48,20,19,0,50,0,250,0,0,0
121,1,1,23.0,22.0,28.0,22.0,1107,1079,951,923,156,156,461,358,385,290,76,68,21,19,0,50,250,250,0,0,0
129,1,1,27.0,20.0,28.0,22.0,1074,1079,895,923,179,156,281,375,185,287,96,88,21,17,0,200,250,250,0,0,0
136,1,1,28.0,26.0,28.0,30.0,1113,995,979,839,134,156,63,111,55,103,8,8,21,19,0,200,250,250,0,0,0
143,1,1,28.0,28.0,28.0,36.0,1090,1029,979,895,111,134,199,138,175,118,24,20,21,19,100,200,250,250,0,0,0
150,1,1,30.0,29.0,36.0,36.0,1225,1090,1091,979,134,111,250,214,210,178,40,36,22,21,100,200,250,250,0,0,0
157,1,1,32.0,29.5,36.0,36.0,1314,1202,1203,1091,111,111,297,316,245,268,52,48,22,23,100,175,250,250,0,25,0
164,1,1,32.0,32.5,36.0,36.0,1314,1258,1203,1147,111,111,153,112,85,98,68,14,24,23,400,175,250,250,0,25,0
171,1,1,32.0,33.0,36.0,36.0,1309,1365,1175,1231,134,134,124,228,40,198,84,30,24,24,400,300,250,250,0,50,0
179,1,1,32.0,32.0,36.0,36.0,1320,1281,1231,1147,89,134,84,79,42,33,42,46,24,25,400,300,250,250,0,50,0
186,1,1,35.0,33.0,36.0,36.0,1382,1342,1315,1231,67,111,97,96,47,38,50,58,26,26,400,400,250,250,0,50,0
193,1,1,35.0,36.0,36.0,36.0,1522,1365,1455,1231,67,134,285,112,227,38,58,74,27,26,400,400,250,250,0,50,0
200,1,1,40.0,36.0,44.0,36.0,1527,1454,1483,1343,44,111,129,199,67,113,62,86,29,27,400,450,250,250,0,50,0
207,1,1,41.0,41.0,44.0,44.0,1622,1449,1511,1315,111,134,125,125,47,23,78,102,29,29,400,450,250,450,0,50,0
214,1,1,43.0,43.0,44.0,52.0,1589,1673,1455,1539,134,134,171,226,77,108,94,118,33,30,400,450,250,450,0,50,0
221,1,1,45.0,44.0,52.0,52.0,1695,1673,1539,1539,156,134,176,282,112,198,64,84,34,30,450,450,450,450,0,50,0
229,1,1,48.5,48.0,52.0,52.0,1807,1807,1651,1651,156,156,101,292,17,188,84,104,34,30,425,700,575,450,25,50,0
236,1,1,50.5,51.0,52.0,52.0,1835,1718,1679,1539,156,179,126,162,72,63,54,99,35,30,575,850,575,450,50,50,0
243,1,1,52.5,51.0,66.0,52.0,1970,1690,1791,1511,179,179,216,362,167,243,49,119,35,33,575,900,575,450,50,50,0
250,1,1,57.0,49.5,66.0,58.0,1942,1779,1763,1623,179,156,146,423,77,288,69,135,35,35,950,625,575,450,75,250,0
257,1,1,57.5,48.5,66.0,58.0,1919,1779,1763,1623,156,156,287,303,202,198,85,105,35,33,1075,725,575,450,100,250,0
264,1,1,60.5,51.5,66.0,58.0,2031,1807,1875,1651,156,156,372,218,267,93,105,125,39,35,1175,725,575,575,100,250,0
271,1,1,61.5,55.5,66.0,58.0,2059,1891,1903,1735,156,156,222,203,197,83,25,120,42,36,1175,875,575,575,100,250,0
279,1,1,60.5,55.0,74.0,66.0,2171,1863,2015,1707,156,156,327,283,282,143,45,140,43,36,925,700,575,575,275,425,0
286,1,1,61.5,58.0,74.0,66.0,2339,1998,2183,1819,156,179,462,163,397,103,65,60,45,39,875,900,575,575,325,425,0
293,1,1,65.5,62.0,74.0,66.0,2306,2026,2127,1847,179,179,212,183,127,103,85,80,45,43,825,900,575,575,375,425,0
300,1,1,65.5,64.0,74.0,66.0,2446,2154,2267,1931,179,223,422,296,317,188,105,108,47,44,825,1050,575,775,375,425,0
307,1,1,72.5,66.0,82.0,66.0,2507,2328,2351,2015,156,313,248,286,127,138,121,148,52,49,825,1100,575,775,375,425,0
314,1,1,74.5,66.0,90.0,66.0,2586,2384,2407,2071,179,313,462,306,342,218,120,88,52,49,825,1100,775,775,375,425,0
321,1,1,78.5,67.5,90.0,82.0,2866,2468,2463,2155,403,313,617,516,487,388,130,128,52,51,1075,1075,775,775,375,450,0
329,1,1,85.5,78.0,98.0,82.0,2894,2350,2379,2015,515,335,462,226,372,58,90,168,52,51,1275,1000,775,775,425,525,0
336,1,1,86.5,79.0,98.0,82.0,2978,2619,2463,2239,515,380,503,160,407,48,96,112,52,57,1125,700,775,775,675,675,0
343,1,1,86.5,81.0,98.0,82.0,2899,2770,2407,2323,492,447,444,327,392,163,52,164,50,64,1325,700,775,775,675,675,0
350,1,1,88.5,80.0,106.0,82.0,2765,3045,2295,2575,470,470,695,267,587,68,108,199,52,61,1925,800,775,775,675,725,0
357,1,1,90.0,82.5,106.0,90.0,2317,3011,1847,2519,470,492,845,307,677,123,168,184,55,58,1900,925,775,775,700,881,0
364,1,1,94.0,85.0,106.0,106.0,2261,2681,1791,2211,470,470,645,303,517,138,128,165,57,58,1650,650,775,775,1000,1081,0
371,1,1,95.5,85.0,106.0,106.0,2815,2093,2323,1623,492,470,805,363,617,188,188,175,57,58,1425,650,775,1025,1075,1281,0
379,1,1,97.0,92.0,106.0,106.0,3011,2423,2519,1819,492,604,671,164,427,38,244,126,59,58,1250,850,775,1025,1175,1431,0
386,1,1,97.0,97.0,106.0,106.0,3134,3000,2575,2351,559,649,854,215,542,163,312,52,65,59,1650,1250,775,1025,1175,1431,0
393,1,1,98.0,97.0,106.0,106.0,3134,3151,2463,2547,671,604,1119,488,727,368,392,120,65,59,1650,1650,775,1025,1175,1431,0
400,1,1,99.0,103.0,114.0,106.0,3414,3084,2631,2323,783,761,735,164,597,98,138,66,66,59,1650,1950,1025,1025,1175,1431,0
407,1,1,108.0,105.0,114.0,106.0,3526,3106,2743,2323,783,783,415,350,377,188,38,162,67,63,1650,2050,1025,1025,1175,1431,0
414,1,1,114.0,104.0,114.0,114.0,3543,3078,2715,2295,828,783,230,130,167,18,63,112,69,62,1650,2050,1025,1025,1175,1431,0
421,1,1,114.0,104.0,114.0,114.0,3622,3297,2659,2491,963,806,480,435,347,223,133,212,70,66,1650,2150,1025,1025,1175,1431,0
429,1,1,120.0,110.0,122.0,114.0,3728,3526,2743,2631,985,895,332,249,262,8,70,241,70,66,2050,2150,1025,1150,1175,1431,0
436,1,1,128.0,114.0,154.0,122.0,3644,3543,2659,2603,985,940,378,467,292,168,86,299,70,66,2450,2150,1025,1150,1175,1431,0
443,1,1,130.0,118.0,162.0,122.0,3823,3538,2883,2575,940,963,645,280,472,73,173,207,70,66,2450,2450,1025,1150,1175,1431,0
450,1,1,130.0,122.0,162.0,146.0,3678,3532,2715,2547,963,985,995,505,702,228,293,277,70,66,2750,2450,1025,1150,1175,1431,0
457,1,1,130.0,128.0,162.0,146.0,3874,3510,2911,2547,963,963,1455,521,1042,203,413,318,70,66,3250,2650,1025,1150,1175,1431,0
464,1,1,130.0,137.0,176.0,154.0,3756,3571,2771,2631,985,940,1911,297,1382,63,529,234,70,66,3250,2850,1025,1150,1175,1431,0
471,1,1,147.0,137.0,184.0,162.0,3806,3538,2799,2575,1007,963,901,662,852,308,49,354,70,65,3250,3050,1475,1150,1175,1431,0
479,1,1,153.0,145.0,184.0,162.0,3610,3605,2603,2575,1007,1030,718,442,632,93,86,349,75,66,3250,3350,1475,1150,1175,1431,0
486,1,1,163.0,145.0,184.0,168.0,3566,3476,2603,2491,963,985,635,644,562,183,73,461,75,67,3250,3750,1475,1150,1175,1431,0
493,1,1,172.0,155.0,192.0,168.0,3599,3594,2659,2631,940,963,511,576,422,128,89,448,74,67,4450,4150,1475,1150,1175,1431,0
500,1,1,180.0,153.0,208.0,184.0,3734,3588,2771,2603,963,985,561,661,452,193,109,468,74,65,5150,4150,1475,1400,1175,1431,0
507,1,1,185.0,163.0,208.0,200.0,3980,3566,2995,2603,985,963,676,337,547,3,129,334,73,65,5350,4350,1475,1400,1175,1431,0
514,1,1,195.0,165.0,208.0,192.0,3812,3459,2827,2519,985,940,627,468,507,168,120,300,73,65,5750,4650,1475,1400,1175,1531,0
521,1,1,195.0,168.0,208.0,184.0,4002,3633,2995,2603,1007,1030,1093,518,857,198,236,320,76,64,6150,4650,1475,1650,1175,1631,0
529,1,1,200.0,177.0,208.0,192.0,3834,3526,2715,2519,1119,1007,964,249,867,88,97,161,76,64,6400,5150,1475,1650,1175,1631,0
536,1,1,200.0,177.0,208.0,192.0,4081,3515,2827,2575,1254,940,1182,567,1029,298,153,269,75,64,7000,5700,1475,1650,1175,1631,0
543,1,1,198.0,182.0,208.0,192.0,3997,3566,2743,2603,1254,963,1364,492,1059,278,305,214,75,64,6900,5800,1475,1775,1275,1831,0
550,1,1,184.0,158.0,208.0,192.0,4154,3482,2855,2519,1299,963,1374,208,1034,53,340,155,75,64,5900,4150,1475,1775,2475,3881,0
557,1,1,192.0,142.0,208.0,192.0,4070,3683,2771,2743,1299,940,256,459,164,238,92,221,75,64,4700,4000,1475,1775,3675,4881,0
564,1,1,188.0,150.0,208.0,184.0,4232,3538,2911,2575,1321,963,561,469,459,228,102,241,75,64,4400,4000,1475,1775,3975,4981,0
571,1,1,198.0,156.0,208.0,184.0,4092,3717,2771,2687,1321,1030,448,409,344,123,104,286,75,64,6100,4700,1725,1775,4175,4981,0
579,1,1,200.0,161.0,208.0,184.0,4294,3476,2995,2491,1299,985,860,521,629,248,231,273,75,64,6500,5200,1725,1775,4175,4981,0
586,1,1,200.0,169.0,208.0,176.0,4159,3594,2883,2631,1276,963,794,333,663,98,131,235,75,64,6900,5600,1725,1775,4187,5081,0
593,1,1,198.0,164.0,208.0,192.0,4238,3476,2939,2491,1299,985,1285,748,998,393,287,355,75,64,7000,5700,1725,1775,4287,5381,0
600,1,1,198.0,161.0,208.0,200.0,4260,2899,2939,2071,1321,828,1695,475,1273,178,422,297,75,55,7000,5350,1725,1775,4387,6181,0
607,1,1,189.0,163.0,208.0,194.0,4154,2294,2855,1623,1299,671,1772,344,1298,63,474,281,75,53,6100,5550,1725,1775,5287,6831,0
614,1,1,195.0,159.0,208.0,194.0,4154,2350,2855,1679,1299,671,1569,624,1118,263,451,361,75,53,5800,5300,1725,1775,5687,7081,0
621,1,1,187.0,148.0,214.0,194.0,4254,2266,2911,1595,1343,671,979,499,643,158,336,341,75,53,4200,4800,1725,1775,7287,8181,0
629,1,1,160.0,140.0,214.0,194.0,4154,2614,2855,1987,1299,627,1271,606,833,243,438,363,75,53,3000,4600,1725,1775,8887,8781,0
636,1,1,164.0,142.0,214.0,194.0,4109,2636,2855,1987,1254,649,1553,516,1013,223,540,293,75,51,3700,4600,1725,1775,8887,8881,0
643,1,1,188.0,146.0,214.0,194.0,4154,2244,2855,1595,1299,649,528,592,353,273,175,319,75,51,4800,5000,1725,1775,8887,8881,0
650,1,1,199.0,152.0,214.0,194.0,4148,2524,2827,1875,1321,649,419,497,288,298,131,199,75,51,5000,5300,1725,1775,8887,8881,0
657,1,1,199.0,154.0,214.0,194.0,3952,2468,2631,1819,1321,649,480,688,393,438,87,250,75,51,6300,5600,2075,1775,8887,8881,0
664,1,1,199.0,164.0,206.0,194.0,3678,2770,2379,2099,1299,671,832,433,593,178,239,255,75,51,6900,5800,2075,1775,8987,8881,0
671,1,1,200.0,169.0,206.0,194.0,3840,2832,2519,2183,1321,649,1203,374,883,293,320,81,75,51,6900,6100,2075,1775,8987,8881,0
678,1,1,200.0,163.0,206.0,194.0,3840,2888,2519,2239,1321,649,1203,410,883,328,320,82,75,51,6900,5900,2075,1775,8987,9481,0
7,0,2,13.0,13.0,15.0,15.0,293,293,293,293,0,0,35,35,35,35,0,0,12,12,0,0,0,0,0,0,1
14,0,2,14.0,14.0,15.0,15.0,671,671,671,671,0,0,70,70,70,70,0,0,13,13,0,0,0,0,0,0,1
21,0,2,14.0,14.0,15.0,15.0,727,755,727,755,0,0,50,50,50,50,0,0,13,13,0,0,0,0,0,0,1
29,0,2,15.0,15.0,15.0,15.0,727,811,727,811,0,0,90,100,90,100,0,0,14,14,0,0,0,0,0,0,1
36,0,2,15.0,15.0,15.0,23.0,727,755,727,755,0,0,120,135,120,135,0,0,14,14,0,0,0,0,0,0,1
43,0,2,16.0,16.0,23.0,23.0,727,867,727,867,0,0,55,40,55,40,0,0,15,15,0,0,0,0,0,0,1
50,0,2,16.0,17.0,23.0,23.0,727,839,727,839,0,0,20,65,20,65,0,0,15,16,0,0,0,0,0,0,1
57,0,2,17.0,18.0,23.0,23.0,811,867,811,867,0,0,70,65,70,65,0,0,16,17,0,0,0,0,0,0,1
64,0,2,18.0,19.0,23.0,23.0,755,951,755,951,0,0,150,180,150,180,0,0,17,18,0,0,0,0,0,0,1
71,0,2,18.0,19.0,23.0,23.0,889,945,867,923,22,22,269,244,265,240,4,4,17,18,0,0,0,0,0,0,1
79,0,2,19.0,20.0,23.0,23.0,889,995,755,951,134,44,324,358,300,350,24,8,18,19,0,0,0,0,0,0,1
86,0,2,19.0,20.0,23.0,23.0,883,939,727,895,156,44,429,326,385,310,44,16,18,19,0,0,0,150,0,0,1
93,0,2,20.0,23.0,23.0,23.0,990,1018,811,951,179,67,359,124,295,100,64,24,19,20,0,0,150,150,0,0,1
100,0,2,20.0,23.0,23.0,23.0,973,978,839,867,134,111,476,240,400,200,76,40,19,20,0,0,150,150,0,0,1
107,0,2,20.0,23.0,23.0,23.0,922,1057,811,923,111,134,187,316,95,260,92,56,19,21,50,0,150,150,0,0,1
114,0,2,20.0,24.0,23.0,31.0,1057,1107,923,951,134,156,113,411,55,335,58,76,19,21,50,100,150,150,0,0,1
121,0,2,21.0,25.0,23.0,31.0,922,1079,811,811,111,268,175,482,105,370,70,112,19,22,50,100,150,300,0,0,1
129,0,2,22.0,27.0,23.0,31.0,1130,1124,1063,811,67,313,258,349,180,305,78,44,20,22,50,100,150,300,0,0,1
136,0,2,22.0,28.0,31.0,31.0,1214,1068,1147,755,67,313,396,369,310,285,86,84,20,23,50,100,150,300,0,0,1
143,0,2,23.0,28.0,31.0,31.0,1186,1096,1119,783,67,313,494,504,400,380,94,124,21,23,50,275,150,300,0,0,1
150,0,2,23.0,29.0,31.0,31.0,1169,1180,1035,867,134,313,249,214,135,50,114,164,21,24,50,275,150,300,0,0,1
157,0,2,24.0,29.0,31.0,39.0,1163,1202,1007,867,156,335,334,249,200,45,134,204,22,24,50,275,250,300,0,0,1
164,0,2,26.0,30.0,31.0,39.0,1191,1258,1035,923,156,335,194,295,40,55,154,240,22,25,50,275,250,300,0,0,1
171,0,2,27.0,29.0,31.0,39.0,1186,1314,1007,979,179,335,344,200,170,20,174,180,23,24,50,275,250,300,0,50,1
179,0,2,30.0,30.0,46.0,39.0,1242,1292,1063,979,179,313,199,346,5,130,194,216,24,25,150,275,250,300,0,50,1
186,0,2,30.0,32.0,46.0,39.0,1107,1320,951,1007,156,313,340,267,130,65,210,202,24,25,150,275,250,300,0,50,1
193,0,2,30.0,33.0,46.0,39.0,1135,1320,979,1007,156,313,350,422,120,180,230,242,25,26,150,275,250,400,0,50,1
200,0,2,30.0,34.0,46.0,39.0,1135,1404,979,1091,156,313,405,542,155,260,250,282,24,27,200,275,250,400,100,50,1
207,0,2,29.0,32.0,46.0,39.0,1275,1320,1119,1007,156,313,310,638,40,320,270,318,24,27,100,175,250,650,200,150,1
214,0,2,29.0,33.0,46.0,39.0,1219,1398,1063,1063,156,335,225,253,60,145,165,108,24,28,100,350,525,650,200,150,1
221,0,2,30.0,35.0,61.0,54.0,1438,1398,1259,1063,179,335,265,168,80,20,185,148,25,29,200,350,675,650,200,150,1
229,0,2,30.0,36.0,61.0,54.0,1438,1566,1259,1231,179,335,200,254,20,70,180,184,25,30,200,350,750,650,200,150,1
236,0,2,31.0,39.0,61.0,54.0,1527,1572,1371,1259,156,313,121,220,25,50,96,170,26,31,200,350,750,650,200,150,1
243,0,2,35.0,40.0,61.0,54.0,1751,1852,1595,1539,156,313,131,395,15,185,116,210,26,32,200,525,750,650,200,150,1
250,0,2,37.0,42.0,61.0,54.0,1835,1824,1679,1511,156,313,231,370,95,120,136,250,28,34,200,525,925,650,200,150,1
257,0,2,40.0,43.0,61.0,54.0,1723,1936,1567,1623,156,313,106,437,50,155,56,282,29,35,200,525,925,650,200,150,1
264,0,2,41.0,47.0,61.0,54.0,1970,1886,1791,1595,179,291,121,163,45,45,76,118,29,36,350,700,925,1050,200,150,1
271,0,2,45.0,49.0,61.0,62.0,1998,1942,1819,1651,179,291,166,245,70,95,96,150,32,38,400,700,925,1050,200,150,1
279,0,2,50.0,51.0,61.0,62.0,2227,2031,2071,1763,156,268,167,196,105,60,62,136,33,38,400,875,925,1050,200,150,1
286,0,2,51.0,55.0,61.0,62.0,2367,2138,2211,1847,156,291,202,272,120,150,82,122,35,40,350,1150,1125,1050,250,150,1
293,0,2,54.0,56.0,61.0,70.0,2395,2177,2239,1819,156,358,232,475,130,305,102,170,36,41,450,1150,1125,1050,250,150,1
300,0,2,60.0,58.0,61.0,70.0,2535,2149,2379,1679,156,470,177,152,105,130,72,22,38,42,700,1150,1125,1200,250,150,1
307,0,2,61.0,60.0,61.0,70.0,2384,2160,2183,1623,201,537,300,255,200,165,100,90,39,42,800,1425,1125,1200,250,150,1
314,0,2,65.0,62.0,69.0,78.0,2759,2362,2379,1735,380,627,308,495,160,325,148,170,41,44,800,1425,1125,1200,250,150,1
321,0,2,66.0,66.0,69.0,78.0,2597,2418,2127,1791,470,627,309,336,205,190,104,146,42,44,1050,1775,1125,1200,250,150,1
329,0,2,69.0,66.0,69.0,78.0,2905,2496,2435,1847,470,649,305,631,195,405,110,226,44,46,1150,1775,1025,1200,275,150,1
336,0,2,74.0,67.0,77.0,78.0,2905,2434,2435,1763,470,671,335,361,265,55,70,306,45,46,1150,1775,1025,1200,275,150,1
343,0,2,74.0,68.0,85.0,86.0,2838,2468,2323,1819,515,649,235,598,205,220,30,378,46,46,1150,1775,1025,1200,275,150,1
350,0,2,78.0,73.0,85.0,86.0,2899,2496,2407,1847,492,649,366,554,280,300,86,254,47,48,1275,2075,1025,1500,275,150,1
357,0,2,80.0,79.0,85.0,94.0,2849,2502,2379,1875,470,627,312,360,170,230,142,130,49,48,1375,2075,1025,1500,400,150,1
364,0,2,78.0,79.0,93.0,94.0,2989,2586,2407,1959,582,627,308,570,215,360,93,210,49,49,1250,2075,1275,1500,525,150,1
371,0,2,76.0,85.0,93.0,94.0,2950,2580,2323,1931,627,649,357,585,188,295,169,290,47,49,1350,2075,1275,1500,787,150,1
379,0,2,79.0,81.0,93.0,94.0,2698,2653,2071,1959,627,694,382,140,183,20,199,120,47,49,1475,1825,1275,1500,787,700,1
386,0,2,83.0,81.0,93.0,94.0,2457,2552,1763,1903,694,649,327,442,73,250,254,192,47,49,1525,1825,1275,1500,787,700,1
393,0,2,83.0,87.0,101.0,94.0,2233,2664,1539,2015,694,649,578,108,256,40,322,68,49,51,1525,1825,1275,1600,749,700,1
400,0,2,89.0,94.0,101.0,94.0,2082,2636,1455,1987,627,649,526,213,136,65,390,148,49,52,1750,2525,1525,1600,749,700,1
407,0,2,89.0,96.0,109.0,109.0,2524,2423,1875,1819,649,604,746,296,326,80,420,216,51,53,1775,2525,1525,1600,849,700,1
414,0,2,86.0,100.0,109.0,109.0,2860,2535,2211,1931,649,604,741,407,291,115,450,292,51,55,1600,2525,1525,1600,1024,700,1
421,0,2,92.0,103.0,109.0,117.0,2894,2843,2267,2239,627,604,552,553,126,185,426,368,51,56,1775,2725,1825,1600,1074,700,1
429,0,2,97.0,106.0,109.0,117.0,2944,2871,2295,2267,649,604,562,691,131,255,431,436,54,58,1900,2725,1825,1600,1074,700,1
436,0,2,97.0,106.0,117.0,117.0,3213,3118,2519,2491,694,627,697,622,186,110,511,512,54,59,2000,3325,1825,1600,1074,700,1
443,0,2,102.0,106.0,117.0,117.0,3162,3011,2491,2407,671,604,873,870,286,290,587,580,57,60,2125,3325,1825,1600,1074,700,1
450,0,2,106.0,112.0,117.0,125.0,3090,3196,2463,2547,627,649,660,600,201,140,459,460,57,60,2250,3325,2025,1600,1074,700,1
457,0,2,109.0,113.0,125.0,133.0,3308,3151,2659,2547,649,604,835,793,296,265,539,528,60,60,2350,3325,2025,1750,1074,700,1
464,0,2,122.0,113.0,125.0,133.0,3448,3230,2799,2603,649,627,695,533,151,125,544,408,63,60,2350,3325,2125,1750,1074,700,1
471,0,2,122.0,117.0,125.0,133.0,3202,3342,2575,2715,627,627,871,570,251,190,620,380,63,61,2350,3500,2375,1750,1074,700,1
479,0,2,122.0,121.0,133.0,133.0,3650,3190,2799,2519,851,671,628,355,246,95,382,260,66,61,2750,3975,2375,2050,1074,700,1
486,0,2,123.0,119.0,133.0,133.0,3997,3202,2967,2575,1030,627,733,724,256,400,477,324,66,61,3275,4375,2475,2500,1124,800,1
493,0,2,132.0,121.0,141.0,133.0,3650,3146,2687,2519,963,627,476,864,116,460,360,404,66,61,3275,4375,2475,2500,1124,800,1
500,0,2,135.0,135.0,141.0,149.0,3638,3258,2631,2631,1007,627,501,559,146,75,355,484,66,61,3275,4875,2475,2850,1124,800,1
507,0,2,135.0,135.0,157.0,149.0,3532,3342,2547,2715,985,627,722,960,301,400,421,560,66,61,3550,5075,2475,2850,1124,800,1
514,0,2,139.0,135.0,157.0,149.0,3487,3286,2547,2659,940,627,894,1360,411,720,483,640,66,61,3675,5075,2475,3250,1124,800,1
521,0,2,127.0,129.0,157.0,149.0,3398,3325,2435,2631,963,694,939,1750,361,1030,578,720,66,61,3325,4950,2700,3250,2049,1175,1
529,0,2,113.0,143.0,157.0,149.0,3470,3207,2463,2491,1007,716,1064,850,416,150,648,700,66,61,2575,5400,2700,3250,2799,1625,1
536,0,2,103.0,135.0,157.0,149.0,2972,3090,1987,2463,985,627,1140,1214,426,450,714,764,54,61,2875,5000,2675,3250,3736,2025,1
7,1,2,13.0,13.0,14.0,15.0,293,293,293,293,0,0,35,35,35,35,0,0,12,12,0,0,0,0,0,0,1
14,1,2,13.0,14.0,14.0,15.0,643,671,643,671,0,0,15,70,15,70,0,0,13,13,0,0,0,0,0,0,1
21,1,2,14.0,14.0,14.0,15.0,755,699,755,699,0,0,50,50,50,50,0,0,13,13,0,0,0,0,0,0,1
29,1,2,14.0,15.0,14.0,15.0,727,699,727,699,0,0,140,35,140,35,0,0,13,14,0,0,0,0,0,0,1
36,1,2,16.0,15.0,22.0,15.0,811,811,811,811,0,0,145,145,145,145,0,0,14,14,0,0,0,0,0,0,1
43,1,2,16.0,16.0,22.0,23.0,811,839,811,839,0,0,235,240,235,240,0,0,14,15,0,0,0,0,0,0,1
50,1,2,15.0,17.0,22.0,23.0,867,811,867,811,0,0,40,5,40,5,0,0,15,16,0,0,0,0,0,0,1
57,1,2,17.0,18.0,22.0,23.0,895,839,895,839,0,0,50,65,50,65,0,0,15,17,0,0,0,0,0,0,1
64,1,2,18.0,19.0,22.0,23.0,951,923,951,923,0,0,100,125,100,125,0,0,16,18,0,0,0,0,0,0,1
71,1,2,17.0,19.0,22.0,23.0,951,951,951,951,0,0,180,245,180,245,0,0,17,18,0,0,0,0,0,0,1
79,1,2,17.0,20.0,22.0,23.0,951,984,951,895,0,89,40,361,40,345,0,16,16,19,0,0,0,0,0,0,1
86,1,2,18.0,20.0,22.0,23.0,923,1034,923,923,0,111,105,78,105,50,0,28,16,19,0,0,0,0,0,0,1
93,1,2,19.0,20.0,22.0,23.0,895,978,895,867,0,111,160,199,160,155,0,44,18,20,0,0,0,150,0,0,1
100,1,2,19.0,21.0,22.0,23.0,934,1079,867,923,67,156,277,129,265,65,12,64,18,20,0,0,0,150,0,0,1
107,1,2,20.0,21.0,22.0,23.0,1034,1046,923,867,111,179,358,119,330,35,28,84,19,20,0,0,0,150,0,0,1
114,1,2,21.0,22.0,22.0,23.0,1023,1135,867,979,156,156,433,155,385,55,48,100,20,21,0,0,0,150,0,0,1
121,1,2,25.0,23.0,28.0,23.0,1102,1135,923,979,179,156,263,240,195,120,68,120,20,22,0,0,250,150,0,0,1
129,1,2,27.0,23.0,28.0,23.0,1079,1124,923,923,156,201,294,318,210,170,84,148,21,22,0,0,250,150,0,0,1
136,1,2,28.0,26.0,28.0,31.0,1068,1219,979,951,89,268,267,340,175,185,92,155,21,23,0,0,250,300,0,0,1
143,1,2,28.0,26.0,28.0,31.0,1270,1264,1203,951,67,313,230,195,230,100,0,95,23,23,0,0,250,300,0,0,1
150,1,2,28.0,27.0,28.0,31.0,1354,1264,1287,951,67,313,383,66,375,35,8,31,23,24,50,0,250,300,0,0,1
157,1,2,31.0,30.0,36.0,46.0,1359,1264,1315,951,44,313,92,112,80,45,12,67,23,24,350,125,250,300,0,0,1
164,1,2,32.0,31.0,36.0,46.0,1331,1314,1287,979,44,335,200,177,180,70,20,107,23,25,350,125,250,300,0,0,1
171,1,2,35.0,33.0,36.0,46.0,1354,1398,1287,1063,67,335,108,97,80,50,28,47,25,27,350,125,250,300,0,0,1
179,1,2,35.0,34.0,36.0,46.0,1471,1404,1427,1091,44,313,177,108,145,25,32,83,25,28,350,300,250,550,0,0,1
186,1,2,35.0,36.0,36.0,46.0,1499,1488,1455,1175,44,313,250,243,210,120,40,123,27,30,400,300,250,550,0,0,1
193,1,2,36.0,36.0,36.0,46.0,1522,1734,1455,1399,67,335,383,413,335,250,48,163,27,30,400,300,250,550,0,0,1
200,1,2,36.0,38.0,36.0,46.0,1606,1790,1539,1455,67,335,566,308,510,255,56,53,27,32,400,300,250,550,100,0,1
207,1,2,40.0,39.0,44.0,46.0,1583,1852,1539,1539,44,313,560,434,500,345,60,89,28,33,550,300,250,550,100,0,1
214,1,2,42.0,40.0,44.0,46.0,1606,1908,1539,1595,67,313,498,210,430,85,68,125,28,34,550,300,250,550,100,0,1
221,1,2,41.0,42.0,44.0,46.0,1600,1936,1511,1623,89,313,680,180,600,15,80,165,31,36,550,300,250,800,100,0,1
229,1,2,44.0,44.0,44.0,46.0,1729,1936,1595,1623,134,313,566,310,470,105,96,205,32,36,550,300,250,800,100,0,1
236,1,2,44.0,45.0,44.0,46.0,1835,2082,1679,1791,156,291,696,256,580,15,116,241,32,37,550,300,250,800,100,0,1
243,1,2,44.0,46.0,50.0,46.0,1835,2048,1679,1735,156,313,601,291,465,10,136,281,35,38,550,300,250,800,100,0,1
250,1,2,45.5,48.0,58.0,54.0,1807,2177,1651,1819,156,358,671,501,515,180,156,321,34,40,525,550,250,800,125,0,1
257,1,2,53.5,48.0,74.0,54.0,1919,2098,1763,1763,156,335,376,637,275,280,101,357,35,40,525,550,450,1100,125,0,1
264,1,2,56.5,50.0,74.0,62.0,1886,2171,1707,1679,179,492,396,805,275,380,121,425,38,42,525,550,575,1250,125,0,1
271,1,2,65.5,58.0,74.0,70.0,2009,2250,1763,1623,246,627,133,70,105,65,28,5,37,42,525,550,700,1550,125,0,1
279,1,2,65.5,58.0,74.0,70.0,2076,2306,1763,1679,313,627,378,360,310,275,68,85,38,44,825,1550,700,1550,125,0,1
286,1,2,70.0,58.0,74.0,70.0,2188,2418,1875,1791,313,627,353,655,320,490,33,165,38,44,750,1550,700,1550,200,0,1
293,1,2,74.0,62.0,74.0,70.0,2132,2524,1819,1875,313,649,398,286,325,245,73,41,38,44,1400,1550,825,1550,200,0,1
300,1,2,74.0,62.0,74.0,70.0,2216,2518,1903,1847,313,671,478,287,365,170,113,117,38,44,1550,550,825,1550,200,0,1
307,1,2,74.0,62.0,74.0,70.0,2177,2479,1819,1875,358,604,373,276,320,95,53,181,42,44,1850,1450,825,1550,200,0,1
314,1,2,74.0,66.0,90.0,78.0,2210,2423,1875,1819,335,604,539,193,450,40,89,153,42,44,1850,1825,825,1550,200,0,1
321,1,2,74.0,66.0,98.0,78.0,2216,2474,1903,1847,313,627,800,494,675,265,125,229,42,44,1850,1825,825,1550,200,0,1
329,1,2,83.0,70.0,106.0,78.0,2300,2530,1987,1903,313,627,555,29,390,20,165,9,41,44,1850,2125,825,1550,200,0,1
336,1,2,83.0,70.0,106.0,78.0,2384,2451,2071,1847,313,604,630,220,425,135,205,85,47,44,1850,2125,825,1550,200,0,1
343,1,2,79.0,74.0,106.0,86.0,2300,2552,1987,1903,313,649,900,427,655,270,245,157,50,44,1650,2500,825,1550,400,0,1
350,1,2,95.0,80.0,114.0,86.0,2546,2546,2211,1875,335,671,420,377,335,240,85,137,51,44,1650,2850,825,2000,400,0,1
357,1,2,95.0,82.0,114.0,102.0,2731,2580,2351,1931,380,649,534,574,405,365,129,209,51,44,1650,2950,825,2150,400,0,1
364,1,2,105.0,82.0,114.0,102.0,2933,2558,2463,1931,470,627,185,780,100,495,85,285,51,44,1950,2950,1200,2150,400,0,1
371,1,2,105.0,90.0,114.0,102.0,2955,2530,2463,1903,492,627,336,681,295,320,41,361,51,44,2450,3725,1200,2150,400,0,1
379,1,2,111.0,90.0,130.0,102.0,2961,2580,2491,1931,470,649,272,881,250,440,22,441,51,44,2800,3725,1200,2150,400,0,1
386,1,2,113.0,98.0,130.0,110.0,2933,2552,2463,1903,470,649,532,173,450,160,82,13,51,44,2950,3975,1200,2150,400,0,1
393,1,2,126.0,104.0,130.0,110.0,2849,2569,2379,1875,470,694,212,173,195,80,17,93,51,44,2950,4175,1200,2150,400,0,1
400,1,2,127.0,106.0,138.0,118.0,2894,2546,2379,1875,515,671,397,369,320,200,77,169,50,44,3350,5025,1200,2150,400,0,1
407,1,2,117.5,102.0,138.0,118.0,2843,2468,2351,1819,492,649,483,670,350,425,133,245,50,44,2625,4825,1200,2150,1125,200,1
414,1,2,92.0,108.0,138.0,118.0,2871,2468,2379,1819,492,649,824,371,635,50,189,321,50,44,1900,4525,1200,2150,2500,500,1
421,1,2,75.0,96.0,138.0,118.0,2737,2530,2267,1903,470,627,860,677,690,280,170,397,46,44,900,4525,1200,2150,3700,1100,1
429,1,2,52.5,94.0,138.0,118.0,2513,2446,2155,1819,358,627,1160,977,950,500,210,477,38,44,375,4425,1200,2150,4875,1200,1
7,,,13.0,13.0,15.0,15.0,293,293,293,293,0,0,35,35,35,35,0,0,12,12,0,0,0,0,0,0,1
14,,,14.0,14.0,15.0,15.0,615,671,615,671,0,0,60,70,60,70,0,0,13,13,0,0,0,0,0,0,1
21,,,14.0,14.0,15.0,15.0,643,727,643,727,0,0,25,45,25,45,0,0,13,13,0,0,0,0,0,0,1
29,,,15.0,15.0,15.0,15.0,643,699,643,699,0,0,60,75,60,75,0,0,14,14,0,0,0,0,0,0,1
36,,,15.0,15.0,15.0,23.0,671,727,671,727,0,0,90,20,90,20,0,0,14,14,0,0,0,0,0,0,1
43,,,16.0,16.0,23.0,23.0,727,727,727,727,0,0,25,45,25,45,0,0,15,15,0,0,0,0,0,0,1
50,,,16.0,16.0,23.0,23.0,755,727,755,727,0,0,45,10,45,10,0,0,15,15,0,0,0,0,0,0,1
57,,,17.0,17.0,23.0,23.0,699,727,699,727,0,0,70,10,70,10,0,0,16,16,0,0,0,0,0,0,1
64,,,17.0,18.0,23.0,23.0,783,839,783,839,0,0,120,60,120,60,0,0,16,17,0,0,0,0,0,0,1
71,,,18.0,18.0,23.0,23.0,755,861,755,839,0,22,155,169,155,165,0,4,17,17,0,0,0,0,0,0,1
79,,,19.0,19.0,23.0,31.0,816,861,727,727,89,134,256,79,240,55,16,24,18,18,0,0,0,0,0,0,1
86,,,19.0,18.0,23.0,31.0,883,962,727,783,156,179,361,99,325,55,36,44,18,18,0,0,0,150,0,0,1
93,,,20.0,20.0,23.0,31.0,911,883,755,727,156,156,226,95,220,35,6,60,19,18,0,0,150,150,0,0,1
100,,,20.0,21.0,23.0,31.0,939,939,783,783,156,156,346,85,320,5,26,80,19,18,0,0,150,150,0,0,1
107,,,20.0,22.0,23.0,31.0,967,911,811,755,156,156,456,150,410,50,46,100,19,19,0,0,150,150,0,0,1
114,,,20.0,22.0,23.0,31.0,990,995,811,839,179,156,171,270,105,150,66,120,19,19,0,0,150,150,0,0,1
121,,,21.0,23.0,23.0,31.0,967,1074,811,895,156,179,142,345,60,205,82,140,19,20,0,100,150,300,0,0,1
129,,,22.0,27.0,23.0,31.0,1079,1141,923,895,156,246,122,132,70,60,52,72,20,20,100,100,150,450,0,0,1
136,,,22.0,28.0,23.0,31.0,1107,1158,951,867,156,291,117,114,45,60,72,54,20,21,100,100,150,450,0,0,1
143,,,23.0,28.0,23.0,31.0,1023,1191,867,923,156,268,187,76,95,40,92,36,21,21,100,100,150,450,0,0,1
150,,,23.0,31.0,31.0,31.0,1079,1242,923,951,156,291,337,181,225,105,112,76,21,22,100,450,150,450,0,0,1
157,,,24.0,31.0,31.0,31.0,1158,1236,979,923,179,313,327,327,195,215,132,112,22,23,100,450,150,450,0,0,1
164,,,25.0,31.0,31.0,31.0,1130,1264,951,951,179,313,267,472,115,320,152,152,23,23,100,625,250,450,0,0,1
171,,,27.0,31.0,31.0,31.0,1135,1230,979,895,156,335,313,377,145,285,168,92,23,23,100,625,250,450,0,0,1
179,,,28.0,31.0,31.0,31.0,1079,1286,923,951,156,335,298,522,110,390,188,132,24,23,100,625,250,450,0,0,1
186,,,29.0,31.0,46.0,31.0,827,1208,671,895,156,313,293,268,110,100,183,168,23,23,200,625,500,450,50,0,1
193,,,29.0,31.0,46.0,31.0,799,1174,643,839,156,335,277,413,74,205,203,208,24,23,200,625,500,450,50,0,1
200,,,26.0,31.0,46.0,31.0,771,1236,615,923,156,313,261,464,38,220,223,244,21,23,200,625,500,450,200,0,1
207,,,28.0,30.0,46.0,31.0,990,1208,811,895,179,313,249,259,31,125,218,134,19,23,300,450,575,700,300,175,1
214,,,29.0,28.0,46.0,39.0,1051,1208,895,895,156,313,270,409,36,235,234,174,19,23,300,350,725,700,300,275,1
221,,,32.0,29.0,54.0,39.0,1079,1286,923,951,156,335,295,474,41,260,254,214,19,24,400,350,725,700,300,275,1
229,,,31.0,29.0,54.0,39.0,1163,1286,1007,951,156,335,225,619,51,365,174,254,18,24,525,350,725,700,350,275,1
236,,,32.0,32.0,54.0,39.0,1219,1314,1063,979,156,335,320,420,126,230,194,190,20,23,575,700,725,700,350,375,1
243,,,34.0,32.0,54.0,39.0,1331,1230,1175,895,156,335,300,465,111,235,189,230,21,23,625,700,725,700,350,375,1
250,,,34.0,33.0,54.0,39.0,1270,1270,1091,979,179,291,280,617,71,355,209,262,21,24,525,700,725,700,450,375,1
257,,,35.0,35.0,54.0,54.0,1298,1270,1119,979,179,291,240,663,11,365,229,298,22,25,625,700,725,700,450,375,1
264,,,35.0,40.0,54.0,54.0,1275,1370,1119,1035,156,335,196,254,51,53,145,201,22,26,625,1050,800,700,450,375,1
271,,,36.0,41.0,54.0,54.0,1163,1421,1007,1063,156,358,281,424,116,183,165,241,23,27,625,1050,800,700,450,375,1
279,,,39.0,42.0,54.0,54.0,1079,1516,923,1203,156,313,231,296,71,123,160,173,23,28,625,1050,925,700,450,375,1
286,,,39.0,44.0,54.0,54.0,1163,1572,1007,1259,156,313,276,471,96,258,180,213,24,30,625,1050,925,700,450,300,1
293,,,43.0,50.0,54.0,54.0,1135,1634,979,1343,156,291,176,207,1,58,175,149,24,32,625,1400,925,700,450,300,1
300,,,43.0,50.0,54.0,54.0,1046,1762,867,1427,179,335,291,272,96,83,195,189,25,32,800,1400,1025,700,450,300,1
307,,,41.0,51.0,54.0,54.0,1046,1740,867,1427,179,313,276,482,61,253,215,229,25,34,600,1400,1025,700,700,300,1
314,,,38.0,51.0,54.0,54.0,995,1925,839,1567,156,358,342,712,86,443,256,269,25,34,550,1400,1025,700,800,300,1
321,,,38.0,57.0,54.0,62.0,995,1869,839,1511,156,358,377,477,101,268,276,209,25,35,500,1400,1025,700,900,300,1
329,,,41.0,57.0,54.0,62.0,1023,1964,867,1651,156,313,342,224,46,133,296,91,26,35,600,1750,1025,950,900,300,1
336,,,41.0,58.0,54.0,62.0,1051,1824,895,1511,156,313,362,339,46,208,316,131,26,37,650,1750,1025,950,950,300,1
343,,,34.0,52.0,54.0,62.0,1102,1964,923,1651,179,313,402,579,66,408,336,171,24,38,300,1225,1125,950,1450,825,1
350,,,32.0,54.0,54.0,62.0,1158,1992,979,1679,179,313,442,434,86,223,356,211,22,38,300,1050,1125,950,1650,1000,1
357,,,33.0,54.0,54.0,70.0,1163,1897,1007,1539,156,358,420,583,98,328,322,255,23,38,350,1050,1125,950,1650,1000,1
364,,,39.0,60.0,54.0,70.0,1835,1981,1679,1399,156,582,380,284,88,153,292,131,25,40,400,1350,1125,950,1650,1000,1
371,,,42.0,60.0,54.0,70.0,2059,2076,1903,1427,156,649,445,486,133,283,312,203,26,40,400,1350,1125,950,1650,1000,1
379,,,43.0,62.0,54.0,70.0,2059,2222,1903,1595,156,627,405,262,173,183,232,79,27,42,450,1350,1125,1250,1650,1000,1
386,,,48.0,68.0,54.0,86.0,2395,2306,2239,1679,156,627,325,552,123,393,202,159,28,44,750,1600,1125,1250,1650,1000,1
393,,,51.0,68.0,54.0,86.0,2502,2384,2323,1735,179,649,295,232,73,143,222,89,29,44,750,1600,1125,1250,1650,1000,1
400,,,52.0,68.0,54.0,86.0,2698,2418,2519,1791,179,627,340,233,198,68,142,165,30,44,750,1600,1125,1250,1650,1000,1
407,,,54.0,68.0,54.0,86.0,2731,2502,2575,1875,156,627,311,330,178,193,133,137,31,44,1100,1600,1125,1250,1650,1000,1
414,,,54.0,68.0,54.0,86.0,2759,2513,2603,1819,156,694,446,615,293,398,153,217,33,44,1100,1600,1325,1250,1650,1000,1
421,,,59.0,72.0,62.0,86.0,2199,2546,2043,1875,156,671,171,371,148,178,23,193,33,44,1100,2450,1575,1250,1650,1000,1
429,,,63.0,73.0,70.0,86.0,1639,2451,1483,1847,156,604,91,409,73,223,18,186,35,44,1150,2450,1575,1250,1650,1000,1
436,,,63.0,73.0,70.0,86.0,1690,2474,1511,1847,179,627,215,695,173,433,42,262,35,44,1200,2450,1575,1250,1650,1000,1
443,,,68.0,83.0,70.0,102.0,1908,2574,1595,1903,313,671,150,155,68,113,82,42,37,44,1425,2550,1575,1700,1650,1000,1
450,,,69.0,83.0,70.0,102.0,1818,2552,1371,1903,447,649,200,351,83,233,117,118,37,44,1425,2900,1575,1850,1650,1000,1
457,,,70.0,87.0,70.0,102.0,1897,2502,1427,1875,470,627,386,287,213,193,173,94,39,44,1475,3250,1925,1850,1650,1000,1
464,,,76.0,87.0,78.0,102.0,1981,2569,1511,1875,470,694,216,587,133,413,83,174,40,44,1600,3250,1925,1850,1650,1000,1
471,,,78.0,93.0,86.0,110.0,2059,2462,1567,1791,492,671,221,253,178,153,43,100,40,44,1650,3775,1925,1850,1650,1000,1
479,,,82.0,93.0,86.0,110.0,2194,2479,1679,1875,515,604,171,541,68,373,103,168,42,44,1650,4275,1925,2000,1650,1000,1
486,,,84.0,102.0,86.0,110.0,2227,2390,1735,1763,492,627,178,236,48,138,130,98,42,44,1775,4275,1925,2000,1650,1000,1
493,,,86.0,104.0,86.0,118.0,2199,2362,1707,1735,492,627,273,426,183,248,90,178,44,44,1975,4575,1825,2000,1678,1000,1
500,,,93.0,104.0,102.0,118.0,2233,2390,1763,1763,470,627,89,721,43,463,46,258,45,44,2275,4675,1825,2000,1678,1000,1
507,,,96.0,103.0,102.0,118.0,2233,2429,1763,1735,470,694,189,1011,108,673,81,338,46,44,2400,4575,1925,2000,1678,1100,1
514,,,94.0,115.0,102.0,118.0,1908,2451,1483,1735,425,716,163,696,59,278,104,418,44,44,2400,5175,1925,2000,1828,1100,1
521,,,69.0,101.0,110.0,118.0,564,2412,363,1763,201,649,175,989,55,503,120,486,37,44,1475,4300,1925,2000,3303,2275,1
528,,,70.0,109.0,110.0,118.0,469,2278,335,1651,134,627,201,740,65,178,136,562,37,44,1875,4125,1825,2000,3403,2450,1
7,2,1,13.0,12.0,15.0,14.0,335,293,335,293,0,0,40,85,40,85,0,0,12,12,0,0,0,0,0,0,1
14,2,1,14.0,12.0,15.0,14.0,615,643,615,643,0,0,60,165,60,165,0,0,13,12,0,0,0,0,0,0,1
21,2,1,14.0,11.0,15.0,14.0,615,699,615,699,0,0,35,40,35,40,0,0,13,11,0,0,0,0,0,0,1
29,2,1,15.0,13.0,15.0,14.0,587,643,587,643,0,0,55,20,55,20,0,0,14,11,0,0,0,0,0,0,1
36,2,1,15.0,14.0,15.0,14.0,699,699,699,699,0,0,105,55,105,55,0,0,14,12,0,0,0,0,0,0,1
43,2,1,16.0,14.0,23.0,14.0,727,671,727,671,0,0,35,20,35,20,0,0,15,13,0,0,0,0,0,0,1
50,2,1,17.0,14.0,23.0,14.0,811,755,811,755,0,0,85,110,85,110,0,0,16,14,0,0,0,0,0,0,1
57,2,1,18.0,14.0,23.0,14.0,839,755,839,755,0,0,60,210,60,210,0,0,17,14,0,0,0,0,0,0,1
64,2,1,19.0,16.0,23.0,22.0,895,867,895,867,0,0,115,200,115,200,0,0,18,14,0,0,0,250,0,0,1
71,2,1,19.0,17.0,23.0,22.0,895,811,895,811,0,0,215,245,215,245,0,0,18,14,0,0,0,250,0,0,1
79,2,1,20.0,17.0,23.0,22.0,861,783,839,783,22,0,174,265,170,265,4,0,19,14,0,0,0,250,0,0,1
86,2,1,20.0,17.0,23.0,22.0,978,727,867,727,111,0,140,345,120,345,20,0,19,14,0,100,0,250,0,0,1
93,2,1,23.0,18.0,23.0,22.0,978,811,867,811,111,0,232,395,200,395,32,0,20,15,0,100,150,250,0,0,1
100,2,1,23.0,18.0,31.0,22.0,1062,715,951,671,111,44,99,128,55,120,44,8,21,14,0,100,150,250,0,0,1
107,2,1,23.0,20.0,31.0,22.0,1034,799,923,643,111,156,170,78,110,50,60,28,20,15,0,100,150,250,0,0,1
114,2,1,25.0,21.0,31.0,22.0,1135,827,979,671,156,156,210,124,130,80,80,44,21,16,100,100,150,250,0,0,1
121,2,1,25.0,21.0,39.0,22.0,1130,883,951,727,179,156,335,134,235,70,100,64,21,16,100,100,150,250,0,0,1
129,2,1,25.0,21.0,39.0,22.0,1163,911,1007,755,156,156,471,244,355,160,116,84,21,17,100,100,150,250,0,0,1
136,2,1,26.0,22.0,39.0,22.0,1107,967,951,811,156,156,126,314,15,210,111,104,21,17,100,100,300,250,0,0,1
143,2,1,26.0,23.0,39.0,30.0,1135,945,979,811,156,134,171,170,90,150,81,20,21,18,100,250,300,250,0,0,1
150,2,1,27.0,25.0,39.0,30.0,1051,883,895,839,156,44,176,120,75,100,101,20,22,18,100,250,300,250,0,0,1
157,2,1,29.0,26.0,39.0,30.0,1074,923,895,923,179,0,126,175,55,155,71,20,22,19,225,250,300,250,0,0,1
164,2,1,30.0,26.0,39.0,30.0,990,923,811,923,179,0,206,295,115,275,91,20,23,19,225,250,300,250,0,0,1
171,2,1,30.0,29.0,39.0,36.0,1051,979,895,979,156,0,282,210,175,190,107,20,23,19,225,300,300,250,0,0,1
179,2,1,31.0,34.0,39.0,36.0,1169,1007,923,1007,246,0,188,70,45,50,143,20,24,20,225,300,300,250,0,0,1
186,2,1,32.0,34.0,39.0,36.0,1242,979,951,979,291,0,79,190,50,170,29,20,25,21,225,450,300,250,0,0,1
193,2,1,34.0,33.0,39.0,36.0,1270,1119,979,1119,291,0,56,30,20,10,36,20,25,24,400,450,300,250,0,0,1
200,2,1,35.0,34.0,39.0,36.0,1270,1175,979,1175,291,0,157,130,85,110,72,20,26,24,400,450,300,250,0,0,1
207,2,1,36.0,36.0,54.0,36.0,1264,1343,951,1343,313,0,212,95,100,75,112,20,26,24,400,600,300,250,0,0,1
214,2,1,37.0,36.0,54.0,36.0,1320,1427,1007,1427,313,0,373,270,225,250,148,20,27,26,400,600,300,250,0,0,1
221,2,1,39.0,41.0,54.0,44.0,1460,1483,1147,1483,313,0,303,90,115,70,188,20,29,27,400,600,300,250,0,0,1
229,2,1,41.0,43.0,54.0,44.0,1432,1539,1119,1539,313,0,433,35,205,15,228,20,31,27,525,600,750,250,0,0,1
236,2,1,45.0,46.0,54.0,52.0,1673,1539,1315,1539,358,0,238,65,120,45,118,20,32,32,525,600,750,250,0,0,1
243,2,1,46.0,49.0,54.0,52.0,1740,1651,1427,1651,313,0,185,105,35,85,150,20,33,32,525,600,750,250,0,0,1
250,2,1,48.0,53.0,54.0,60.0,1690,1678,1399,1567,291,111,391,75,205,35,186,40,35,35,525,600,750,250,0,0,1
257,2,1,48.0,54.0,54.0,60.0,1930,1891,1595,1735,335,156,576,130,350,70,226,60,35,37,525,600,750,250,0,0,1
264,2,1,54.0,53.0,62.0,66.0,1908,1835,1595,1679,313,156,497,180,285,100,212,80,37,37,825,750,750,250,0,0,1
271,2,1,56.0,56.0,62.0,66.0,2076,1891,1763,1735,313,156,547,155,445,55,102,100,37,39,1075,800,900,250,0,0,1
279,2,1,59.0,59.0,62.0,66.0,2048,2003,1735,1847,313,156,208,120,95,0,113,120,38,38,1075,800,900,375,0,0,1
286,2,1,60.0,60.0,62.0,82.0,2126,2082,1791,1903,335,179,113,130,60,90,53,40,38,41,1200,950,900,500,0,0,1
293,2,1,61.0,64.0,62.0,82.0,2188,2143,1875,1987,313,156,234,181,145,125,89,56,39,45,1200,950,900,500,0,0,1
300,2,1,62.0,68.0,62.0,82.0,2054,2283,1763,2127,291,156,285,161,160,85,125,76,40,46,1500,950,900,625,0,0,1
307,2,1,62.0,71.0,62.0,82.0,2048,2395,1735,2239,313,156,220,126,55,30,165,96,41,49,1500,950,900,625,0,0,1
314,2,1,62.0,74.0,62.0,82.0,2076,2647,1763,2491,313,156,415,206,210,90,205,116,42,51,1500,950,900,625,0,0,1
321,2,1,62.0,70.0,62.0,82.0,2132,2339,1707,2183,425,156,416,461,155,325,261,136,42,50,1500,950,1150,625,0,200,1
329,2,1,64.0,71.0,78.0,98.0,2339,1550,1847,1371,492,179,497,381,180,225,317,156,42,47,1500,900,1300,625,0,400,1
336,2,1,64.0,76.0,78.0,98.0,2311,2026,1819,1847,492,179,257,346,130,170,127,176,42,46,1500,1300,1300,625,0,450,1
343,2,1,66.0,78.5,78.0,98.0,2345,2171,1875,2015,470,156,484,392,305,200,179,192,44,51,1500,1225,1300,625,0,525,1
350,2,1,69.0,79.5,93.0,98.0,2289,2031,1819,1875,470,156,454,482,215,270,239,212,46,57,1500,1425,1300,625,0,525,1
357,2,1,65.0,81.5,93.0,98.0,2367,2339,1875,2183,492,156,634,682,335,450,299,232,46,58,1250,1425,1300,625,250,525,1
364,2,1,71.0,81.5,93.0,98.0,2311,2832,1819,2631,492,201,169,430,60,270,109,160,49,58,1250,1425,1300,625,250,525,1
371,2,1,71.0,84.5,101.0,106.0,2373,2916,1903,2603,470,313,346,470,185,270,161,200,49,57,1250,1425,1450,625,250,525,1
379,2,1,76.0,84.5,101.0,106.0,2591,3050,2099,2715,492,335,316,540,145,300,171,240,52,58,1425,1425,1600,625,250,525,1
386,2,1,83.0,90.5,101.0,106.0,2759,3050,2267,2715,492,335,302,535,175,255,127,280,55,62,1425,1425,1600,625,250,525,1
393,2,1,83.0,90.5,101.0,106.0,2877,3190,2407,2855,470,335,394,921,215,605,179,316,55,62,1775,1425,1600,625,250,525,1
400,2,1,85.0,94.5,101.0,106.0,2849,2854,2379,2519,470,335,494,936,255,580,239,356,57,61,2075,1725,1600,625,250,625,1
407,2,1,86.0,94.5,109.0,106.0,2938,2524,2491,2211,447,313,815,1212,520,820,295,392,58,61,2075,1725,1600,625,250,625,1
414,2,1,96.0,103.5,117.0,106.0,2983,2569,2491,2099,492,470,260,785,105,325,155,460,60,67,2775,1725,2000,625,250,625,1
421,2,1,96.0,102.5,117.0,106.0,2978,2944,2463,2295,515,649,545,1037,330,505,215,532,61,75,2775,1725,2000,875,250,625,1
429,2,1,100.0,105.0,117.0,106.0,3011,3252,2519,2603,492,649,561,522,390,210,171,312,61,74,2775,1700,2000,875,250,650,1
436,2,1,106.0,103.0,117.0,120.0,3045,3286,2575,2659,470,627,398,508,325,120,73,388,61,74,3650,1700,2150,875,250,650,1
443,2,1,106.0,102.5,117.0,120.0,3062,3420,2547,2771,515,649,456,928,315,460,141,468,61,76,3900,1675,2300,875,250,675,1
450,2,1,100.0,110.5,117.0,144.0,3129,3717,2547,3023,582,694,748,803,535,255,213,548,61,74,3525,1675,2300,875,625,725,1
457,2,1,100.0,114.5,117.0,158.0,3213,3806,2631,3135,582,671,1140,1044,855,420,285,624,61,74,3525,1675,2300,1000,625,725,1
464,2,1,114.0,114.5,141.0,158.0,3342,3874,2715,3247,627,627,306,686,295,240,11,446,61,74,4575,1675,2300,1250,625,725,1
471,2,1,116.0,121.0,149.0,150.0,3286,3868,2659,3219,627,649,198,801,115,275,83,526,61,74,4850,2150,2300,1575,625,850,1
479,2,1,111.0,110.0,149.0,150.0,3370,3952,2743,3303,627,649,586,981,435,375,151,606,61,73,4375,1550,2300,1575,1100,1650,1
486,2,1,121.0,110.5,149.0,150.0,3403,4042,2799,3415,604,627,83,1202,60,520,23,682,61,73,4200,1675,2300,1575,1275,1875,1
493,2,1,121.0,117.5,149.0,156.0,3375,3974,2771,3303,604,671,499,1187,400,425,99,762,61,73,5100,1825,2300,1575,1275,2025,1
500,2,1,109.0,119.0,149.0,156.0,3347,4114,2743,3443,604,671,886,1283,715,445,171,838,61,73,4050,1700,2300,1575,2325,2400,1
507,2,1,106.0,118.0,149.0,156.0,3263,3986,2659,3359,604,627,268,1250,225,340,43,910,61,73,3150,1750,2300,1575,3575,2850,1
514,2,1,113.0,126.5,149.0,156.0,3258,4036,2631,3387,627,649,274,1140,155,150,119,990,62,73,3750,1825,2300,1575,3575,3075,1
521,2,1,116.0,133.5,149.0,156.0,2821,4064,2239,3415,582,649,178,1280,95,210,83,1070,65,73,3750,2125,2300,1575,3575,3075,1
529,2,1,114.0,127.5,149.0,156.0,2647,4126,2043,3499,604,627,505,1476,350,480,155,996,67,73,3575,1875,2300,1575,3750,3425,1
536,2,1,108.0,129.5,149.0,156.0,2731,4120,2127,3471,604,649,836,1561,605,485,231,1076,68,73,3050,2075,2300,1575,4275,3725,1
543,2,1,121.0,133.5,172.0,156.0,2821,4109,2239,3415,582,694,178,1556,75,400,103,1156,68,73,3650,2725,2300,1575,4275,3725,1
550,2,1,124.0,141.5,172.0,162.0,3129,3862,2547,3191,582,671,270,1542,95,310,175,1232,68,72,3650,2875,2300,1575,4275,3725,1
557,2,1,124.0,143.0,172.0,162.0,3325,3342,2631,2715,694,627,468,1084,205,130,263,954,69,71,3450,2950,2300,1575,4475,3900,1
564,2,1,120.0,141.0,172.0,162.0,3633,3471,2827,2822,806,649,914,1513,555,479,359,1034,72,71,3450,3500,2300,1575,4675,4000,1
571,2,1,117.0,150.0,172.0,162.0,3694,4031,2911,3382,783,649,948,1463,505,349,443,1114,65,71,3650,3400,2300,1575,5200,4100,1
579,2,1,112.0,146.0,172.0,162.0,3364,4037,2603,3410,761,627,1045,1952,510,762,535,1190,65,71,3350,3200,2650,1575,5500,4300,1
586,2,1,114.0,152.5,172.0,162.0,3616,4126,2855,3477,761,649,1087,1879,460,609,627,1270,66,82,3450,3425,2800,1575,5800,4525,1
593,2,1,118.0,152.5,172.0,162.0,3526,4216,2743,3522,783,694,863,1735,140,610,723,1125,66,82,3450,3425,2800,1825,5800,4525,1
600,2,1,119.0,160.5,180.0,162.0,3482,4406,2743,3757,739,649,1146,1464,335,467,811,997,67,82,3450,3975,2800,1825,5800,4525,1
607,2,1,122.0,160.5,180.0,170.0,3554,4468,2771,3841,783,627,1227,1227,470,304,757,923,70,82,3450,3975,2800,1825,5800,4525,1
614,2,1,132.0,160.0,188.0,178.0,3594,4411,2743,3762,851,649,853,1104,600,426,253,678,72,82,3450,3950,2950,1825,5800,4550,1
621,2,1,141.0,173.0,188.0,232.0,3678,4411,2827,3762,851,649,629,651,580,43,49,608,74,80,3450,4550,2950,1825,5800,4550,1
629,2,1,141.0,182.5,188.0,232.0,3745,4703,2603,4054,1142,649,532,726,485,42,47,684,77,81,4450,5175,2950,1825,5900,4675,1
636,2,1,127.0,178.0,188.0,232.0,3521,4636,2379,3942,1142,694,938,1268,755,504,183,764,63,91,4900,4850,2950,1825,6600,5025,1
643,2,1,127.0,184.5,188.0,232.0,3073,4753,2043,4082,1030,671,1303,546,1000,106,303,440,63,91,4900,3975,2950,1825,6600,5900,1
650,2,1,125.0,188.5,188.0,232.0,3084,4619,2099,3858,985,761,1373,503,950,117,423,386,63,90,4600,4575,2950,1825,6900,6100,1
657,2,1,141.0,193.5,188.0,232.0,3213,4737,2183,3774,1030,963,973,653,430,147,543,506,63,89,5400,4575,2950,1825,6900,6250,1
664,2,1,143.0,190.0,188.0,232.0,3353,4507,2323,3544,1030,963,1354,1204,695,578,659,626,67,89,5650,5600,2950,1825,6900,6425,1
671,2,1,128.0,181.0,188.0,240.0,3392,4938,2407,3975,985,963,1720,1784,945,1042,775,742,69,97,4850,5150,2950,1825,7700,6850,1
679,2,1,139.0,196.0,188.0,240.0,3504,5134,2519,4171,985,963,1099,849,800,391,299,458,69,97,4850,5600,2950,2175,7700,6850,1
686,2,1,149.0,195.0,188.0,240.0,3650,5117,2463,4087,1187,1030,611,1407,360,829,251,578,73,96,5550,5600,2950,2175,7700,6850,1
693,2,1,151.0,194.5,188.0,240.0,3801,5022,2547,3947,1254,1075,913,2010,510,1304,403,706,73,96,6450,6325,2950,2175,7700,6925,1
700,2,1,136.0,199.5,180.0,240.0,3386,5324,2155,4272,1231,1052,1296,2108,745,1278,551,830,61,96,6350,6375,2950,2175,8600,7025,1
707,2,1,143.0,187.5,180.0,240.0,2916,5464,1707,4367,1209,1097,420,2758,75,1792,345,966,57,96,6350,5575,2950,2175,8950,7600,1
714,2,1,141.0,197.0,172.0,240.0,2541,5503,1511,4406,1030,1097,607,2361,150,1463,457,898,55,96,7325,5250,3050,2175,9400,7850,1
721,2,1,139.0,196.5,164.0,240.0,2653,5296,1735,4199,918,1097,795,2855,230,1825,565,1030,55,96,7325,5775,3200,2175,9600,7875,1
729,2,1,139.0,195.0,148.0,240.0,2714,5184,1819,3930,895,1254,1137,3465,460,2283,677,1182,55,95,7325,6400,3200,2175,9800,7900,1
736,2,1,146.0,191.0,148.0,248.0,2950,4540,1987,3219,963,1321,953,3154,460,2220,493,934,55,95,7325,6200,3200,2175,9800,8100,1
743,2,1,148.0,198.5,148.0,240.0,2927,4193,1987,2939,940,1254,1105,2468,500,1715,605,753,55,95,7425,6025,3200,2175,9800,8375,1
750,2,1,148.0,198.0,148.0,240.0,2961,4345,2043,3046,918,1299,1473,2991,760,2074,713,917,56,95,7875,6800,3200,2175,9800,8400,1
757,2,1,148.0,196.5,148.0,240.0,3062,4148,2099,2715,963,1433,1740,3491,915,2394,825,1097,58,95,7875,7425,3350,2175,9800,8500,1
764,2,1,148.0,195.0,148.0,240.0,3028,4462,2043,3029,985,1433,1745,3444,800,2475,945,969,58,95,7875,7800,3350,2175,9800,8550,1
771,2,1,156.0,191.5,156.0,240.0,2815,4904,1875,3449,940,1455,1483,4065,880,2920,603,1145,58,95,7775,7575,3350,2175,9900,8775,1
779,2,1,156.0,193.5,164.0,240.0,3022,5218,2015,3695,1007,1523,1552,4280,975,3105,577,1175,59,94,8175,7575,3350,2175,9900,8775,1
786,2,1,162.0,199.5,164.0,240.0,3050,5111,2043,3611,1007,1500,1147,4412,700,3215,447,1197,60,97,7950,7575,3350,2175,9900,8775,1
793,2,1,162.0,199.0,164.0,240.0,3050,4759,2043,3326,1007,1433,1412,4949,845,3584,567,1365,60,97,8850,7500,3500,2175,9900,8850,1
800,2,1,162.0,198.0,180.0,240.0,3168,4803,2183,3348,985,1455,1478,4854,795,3463,683,1391,64,96,8850,7500,3500,2175,9900,8850,1
807,2,1,162.0,190.5,180.0,240.0,3078,5010,2071,3555,1007,1455,849,5653,275,3986,574,1667,64,94,8850,7325,3500,2175,9900,9475,1
814,2,1,166.0,171.5,188.0,240.0,3241,5246,2211,3813,1030,1433,593,6280,195,4437,398,1843,64,92,9150,6125,3500,2175,10250,10675,1
821,2,1,166.0,198.5,188.0,240.0,3090,5161,2127,3706,963,1455,400,4993,40,3274,360,1719,64,91,8950,5525,3500,2175,10450,11325,1
829,2,1,171.0,198.5,188.0,232.0,3330,5129,2323,3606,1007,1523,410,4930,230,3031,180,1899,65,90,9350,5325,3500,2175,10450,11575,1
836,2,1,173.0,185.5,196.0,232.0,3241,4523,2211,3068,1030,1455,689,5142,385,3079,304,2063,68,79,9350,6025,3500,2175,10450,11925,1
843,2,1,178.0,198.5,196.0,232.0,3392,3952,2407,2519,985,1433,646,2744,530,2209,116,535,69,78,9350,7125,3500,2175,10450,11925,1
850,2,1,178.0,199.5,196.0,232.0,3112,3768,2127,2223,985,1545,596,2302,360,2171,236,131,71,75,9750,6975,3950,2175,10450,12075,1
857,2,1,184.0,199.5,196.0,232.0,2989,3701,1959,2111,1030,1590,451,2734,395,2411,56,323,72,75,9750,9075,4250,2175,10450,12075,1
864,2,1,194.0,199.5,196.0,232.0,2894,3375,1931,1763,963,1612,218,3144,50,2621,168,523,72,75,10150,9075,4250,2175,10450,12075,1
871,2,1,191.0,196.0,196.0,232.0,3174,3465,2211,1763,963,1702,618,2550,330,2281,288,269,73,75,10450,9800,4250,3475,11100,12250,1
879,2,1,187.0,183.0,204.0,238.0,3218,3683,2211,2004,1007,1679,993,3005,585,2544,408,461,71,74,10250,9200,4250,3625,11400,12850,1
886,2,1,186.0,197.5,204.0,238.0,3381,4115,2351,2480,1030,1635,597,2652,215,1999,382,653,71,74,10050,9075,4250,3775,11600,12975,1
893,2,1,176.0,192.0,204.0,246.0,3364,4288,2379,2631,985,1657,654,3025,260,2168,394,857,71,74,9225,8550,3950,3775,13075,13500,1
900,2,1,185.0,190.5,204.0,246.0,3364,4322,2379,2575,985,1747,545,3542,35,2469,510,1073,70,74,9225,9275,3950,3775,13225,13625,1
907,2,1,178.0,197.0,196.0,246.0,3358,4316,2351,2592,1007,1724,645,3149,165,2468,480,681,69,74,9275,9250,3800,3775,13975,13725,1
914,2,1,179.0,193.0,188.0,246.0,3162,3975,2267,2251,895,1724,1204,3157,620,2568,584,589,67,70,9575,9100,3800,4125,13975,14075,1
921,2,1,181.0,194.5,180.0,246.0,3235,3689,2295,1875,940,1814,1000,2748,300,1943,700,805,65,67,9600,8175,3800,4125,14650,15150,1
929,2,1,176.0,194.5,180.0,246.0,3062,3510,2099,1719,963,1791,1201,2939,385,2005,816,934,67,67,9300,8625,3800,4125,14950,15150,1
936,2,1,180.0,193.5,180.0,246.0,3067,3314,2127,1635,940,1679,1169,3326,245,2200,924,1126,67,67,9500,10325,3800,4125,14950,15200,1
943,2,1,180.0,190.5,180.0,246.0,2933,3286,2015,1607,918,1679,1516,3477,480,2293,1036,1184,68,64,9800,10325,3800,4275,14950,15350,1
950,2,1,184.0,183.5,188.0,246.0,2978,3331,2015,1607,963,1724,1468,3856,320,2464,1148,1392,68,61,9625,10025,3800,4275,15125,15800,1
957,2,1,187.0,187.5,204.0,246.0,2871,3225,1931,1523,940,1702,1315,3652,55,2452,1260,1200,63,61,9750,10025,3800,4275,15550,15800,1
964,2,1,172.0,184.5,212.0,246.0,2798,3270,1903,1523,895,1747,1648,3296,280,1892,1368,1404,60,59,9475,9225,3800,4025,16475,16950,1
971,2,1,163.0,191.0,212.0,246.0,2810,3140,1847,1483,963,1657,1629,2511,320,923,1309,1588,58,55,9000,8600,3800,4025,17050,17775,1
979,2,1,143.0,194.0,196.0,246.0,2776,2692,1903,1237,873,1455,1894,2272,485,520,1409,1752,51,51,8300,9750,3800,4025,18300,18175,1
986,2,1,149.0,194.0,188.0,246.0,2390,2609,1651,1086,739,1523,1669,2435,180,562,1489,1873,47,51,8400,9750,3800,4025,18675,18175,1
993,2,1,151.0,194.0,164.0,246.0,2272,2631,1623,974,649,1657,1835,2753,270,676,1565,2077,50,54,8900,10900,3250,4025,19600,18175,1
1000,2,1,149.0,196.0,164.0,238.0,2294,2659,1623,1002,671,1657,2110,2616,465,493,1645,2123,50,54,8800,10950,2700,4175,20250,18625,1
1007,2,1,143.0,188.0,126.0,238.0,2278,2564,1651,974,627,1590,2372,2926,655,615,1717,2311,50,46,8500,10950,2400,4175,21825,19025,1
1014,2,1,116.0,188.0,126.0,232.0,2166,2424,1539,946,627,1478,2032,2148,235,19,1797,2129,49,41,5900,10500,1700,4175,25425,20075,1
1021,2,1,96.0,182.5,110.0,226.0,1790,2127,1119,739,671,1388,2194,2367,325,94,1869,2273,49,41,4000,10525,1400,4175,27900,20925,1
7,2,0,13.0,13.0,15.0,15.0,293,293,293,293,0,0,35,35,35,35,0,0,12,12,0,0,0,0,0,0,1
14,2,0,14.0,14.0,15.0,15.0,671,643,671,643,0,0,70,65,70,65,0,0,13,13,0,0,0,0,0,0,1
21,2,0,14.0,14.0,15.0,15.0,727,615,727,615,0,0,0,30,0,30,0,0,13,13,0,0,0,0,0,0,1
29,2,0,15.0,15.0,15.0,15.0,727,587,727,587,0,0,90,65,90,65,0,0,14,14,0,0,0,0,0,0,1
36,2,0,15.0,15.0,15.0,15.0,755,671,755,671,0,0,195,95,195,95,0,0,14,14,0,0,0,0,0,0,1
43,2,0,16.0,16.0,23.0,23.0,811,643,811,643,0,0,90,25,90,25,0,0,15,15,0,0,0,0,0,0,1
50,2,0,16.0,16.0,23.0,23.0,867,699,867,699,0,0,150,35,150,35,0,0,15,15,0,0,0,0,0,0,1
57,2,0,17.0,17.0,23.0,23.0,895,671,895,671,0,0,260,75,260,75,0,0,16,16,0,0,0,0,0,0,1
64,2,0,18.0,18.0,23.0,23.0,923,755,923,755,0,0,315,45,315,45,0,0,17,17,0,0,0,0,0,0,1
71,2,0,17.0,18.0,23.0,23.0,979,693,979,671,0,22,80,89,80,85,0,4,17,17,0,0,0,0,0,0,1
79,2,0,18.0,19.0,23.0,23.0,923,788,923,699,0,89,65,186,65,170,0,16,17,18,0,0,0,0,0,0,1
86,2,0,18.0,19.0,23.0,23.0,923,855,923,699,0,156,25,295,25,255,0,40,17,18,0,0,150,0,0,0,1
93,2,0,19.0,20.0,23.0,23.0,923,967,923,699,0,268,80,172,80,150,0,22,18,19,0,0,150,150,0,0,1
100,2,0,19.0,20.0,23.0,23.0,945,1023,923,755,22,268,44,189,40,135,4,54,18,19,0,0,150,150,0,0,1
107,2,0,20.0,20.0,23.0,23.0,1001,967,867,699,134,268,114,200,90,110,24,90,19,19,0,0,150,150,0,0,1
114,2,0,21.0,20.0,31.0,23.0,1051,934,895,643,156,291,89,66,45,40,44,26,20,19,0,0,150,150,0,0,1
121,2,0,21.0,21.0,31.0,31.0,1079,990,923,699,156,291,114,133,100,75,14,58,20,19,0,0,300,150,0,0,1
129,2,0,24.0,21.0,31.0,31.0,1135,1023,979,755,156,268,79,126,70,65,9,61,21,19,0,100,300,150,0,0,1
136,2,0,23.0,22.0,31.0,31.0,1074,1275,895,1007,179,268,99,287,70,190,29,97,20,20,0,100,300,150,50,0,1
143,2,0,24.0,23.0,46.0,31.0,934,1158,755,867,179,291,204,378,155,245,49,133,21,21,0,100,300,250,50,0,1
150,2,0,25.0,23.0,46.0,31.0,754,1191,643,923,111,268,242,525,185,360,57,165,21,21,125,100,300,250,100,0,1
157,2,0,27.0,26.0,46.0,31.0,906,1191,839,923,67,268,130,311,115,185,15,126,21,22,125,100,300,575,100,0,1
164,2,0,28.0,28.0,46.0,31.0,984,1158,895,867,89,291,107,107,80,45,27,62,23,22,125,100,450,575,100,0,1
171,2,0,31.0,29.0,46.0,31.0,1034,1230,923,895,111,335,54,222,40,120,14,102,24,23,125,100,450,575,100,0,1
179,2,0,31.0,29.0,46.0,39.0,1141,1376,1007,1063,134,313,104,404,70,270,34,134,24,24,125,225,450,575,100,0,1
186,2,0,32.0,31.0,46.0,39.0,1107,1320,951,1007,156,313,174,424,120,275,54,149,25,24,300,325,450,575,100,0,1
193,2,0,33.0,32.0,46.0,39.0,1219,1208,1063,895,156,313,239,449,165,285,74,164,25,24,300,325,450,575,150,0,1
200,2,0,33.0,32.0,54.0,39.0,1191,1348,1035,1035,156,313,279,503,185,324,94,179,26,24,425,325,450,825,150,0,1
207,2,0,36.0,34.0,54.0,39.0,1219,1538,1063,1203,156,335,129,602,65,408,64,194,27,25,600,450,450,900,150,0,1
214,2,0,36.0,38.0,54.0,39.0,1214,1617,1035,1259,179,358,269,386,185,252,84,134,27,25,600,450,600,900,150,0,1
221,2,0,37.0,38.0,54.0,39.0,1298,1594,1119,1259,179,335,374,562,270,392,104,170,28,25,600,450,600,975,150,0,1
229,2,0,42.0,38.0,54.0,39.0,1247,1516,1091,1203,156,313,120,263,100,182,20,81,29,26,950,575,600,975,150,0,1
236,2,0,41.0,41.0,54.0,47.0,1303,1572,1147,1259,156,313,125,448,85,327,40,121,25,26,1050,475,700,975,350,100,1
243,2,0,40.0,37.0,54.0,47.0,575,1516,419,1203,156,313,105,628,45,467,60,161,26,26,875,475,700,975,525,350,1
250,2,0,41.0,35.0,54.0,55.0,609,1376,475,1063,134,313,146,198,70,97,76,101,28,26,875,350,700,975,525,475,1
257,2,0,42.0,36.0,54.0,55.0,1174,1398,1063,1063,111,335,68,333,30,192,38,141,28,26,925,350,700,900,650,550,1
264,2,0,42.0,34.0,54.0,55.0,1253,1449,1007,1091,246,358,164,708,90,502,74,206,28,26,925,350,700,800,650,583,1
271,2,0,44.0,37.0,54.0,55.0,1264,1538,951,1203,313,335,15,344,5,331,10,13,30,27,925,350,700,800,650,583,1
279,2,0,45.0,40.0,54.0,55.0,1426,1320,1091,1007,335,313,136,103,90,55,46,48,31,27,925,600,700,800,650,583,1
286,2,0,47.0,41.0,54.0,55.0,1516,1320,1203,1007,313,313,37,223,5,135,32,88,33,27,925,600,700,800,650,583,1
293,2,0,48.0,42.0,54.0,55.0,1264,1376,951,1063,313,313,147,343,75,215,72,128,33,28,1100,600,700,800,650,583,1
300,2,0,48.0,42.0,54.0,63.0,1678,1404,1343,1091,335,313,207,523,95,355,112,168,32,28,1100,600,700,800,700,583,1
307,2,0,49.0,41.0,54.0,63.0,1734,1505,1399,1147,335,358,372,708,220,500,152,208,33,29,1100,775,700,800,750,683,1
314,2,0,50.0,43.0,54.0,55.0,1841,1286,1483,951,358,335,582,348,390,229,192,119,35,28,1100,775,800,800,750,833,1
321,2,0,45.0,41.0,54.0,70.0,1874,1096,1539,783,335,313,693,453,540,303,153,150,36,26,625,1025,1050,800,1225,933,1
329,2,0,53.0,42.0,54.0,70.0,1880,1068,1567,755,313,313,259,183,220,70,39,113,36,26,1150,1025,1050,1100,1225,933,1
336,2,0,54.0,42.0,54.0,70.0,1992,1068,1679,755,313,313,224,253,145,100,79,153,38,26,1250,1025,1050,1100,1225,933,1
343,2,0,54.0,43.0,54.0,78.0,1998,1264,1707,951,291,313,400,423,285,230,115,193,38,27,1250,1300,1050,1300,1225,933,1
350,2,0,54.0,45.0,54.0,78.0,2020,1566,1707,1231,313,335,515,278,360,170,155,108,39,28,1250,1300,1050,1300,1225,933,1
357,2,0,56.0,46.0,70.0,78.0,1992,1673,1567,1315,425,358,402,218,345,70,57,148,39,28,1250,1300,1050,1300,1225,933,1
364,2,0,57.0,46.0,70.0,78.0,2199,1818,1707,1483,492,335,509,374,475,190,34,184,39,28,1250,1300,1050,1400,1325,933,1
371,2,0,55.0,47.0,70.0,78.0,1981,1796,1511,1483,470,313,535,585,445,365,90,220,37,29,1250,1425,1050,1400,1475,933,1
379,2,0,61.0,53.0,70.0,86.0,1981,1908,1511,1595,470,313,325,475,275,265,50,210,39,30,1600,1425,1050,1500,1475,933,1
386,2,0,61.0,55.0,70.0,86.0,2065,1908,1595,1595,470,313,435,280,325,180,110,100,39,30,1700,1425,1050,1500,1475,933,1
393,2,0,65.0,55.0,70.0,86.0,2121,2104,1651,1791,470,313,465,255,345,215,120,40,41,32,1700,1425,1050,1500,1475,933,1
400,2,0,66.0,59.0,70.0,86.0,2216,2042,1679,1707,537,335,830,275,650,195,180,80,42,32,1875,1775,1050,1500,1475,933,1
407,2,0,68.0,59.0,70.0,86.0,2250,2177,1623,1819,627,358,1096,440,840,320,256,120,44,32,1875,1775,1350,1500,1475,933,1
414,2,0,68.0,65.0,70.0,86.0,2222,2216,1595,1903,627,313,269,323,145,223,124,100,46,34,1875,1875,1350,1500,1475,933,1
421,2,0,68.0,67.0,70.0,86.0,2306,1908,1679,1595,627,313,545,230,345,101,200,129,46,34,1875,1875,1350,1500,1475,933,1
429,2,0,74.0,67.0,78.0,94.0,2334,1947,1707,1567,627,380,445,435,315,265,130,170,46,36,1875,1875,1350,1500,1475,933,1
436,2,0,75.0,73.0,86.0,94.0,2367,2149,1763,1679,604,470,431,200,325,170,106,30,46,36,1875,2125,1350,1500,1475,933,1
443,2,0,78.0,75.0,86.0,102.0,2474,2238,1847,1679,627,559,491,268,405,170,86,98,46,36,2025,2225,1350,1500,1475,933,1
450,2,0,80.0,81.0,86.0,102.0,2429,2350,1735,1679,694,671,266,194,100,70,166,124,48,38,2025,2225,1350,1500,1475,933,1
457,2,0,80.0,84.0,94.0,102.0,2462,2462,1791,1791,671,671,398,235,160,160,238,75,48,38,2025,2225,1350,1500,1475,933,1
464,2,0,86.0,86.0,94.0,110.0,2362,2440,1735,1791,627,649,325,426,215,275,110,151,50,40,2325,2725,1350,1500,1475,933,1
471,2,0,86.0,91.0,94.0,110.0,2479,2530,1875,1903,604,627,611,442,425,265,186,177,50,41,2825,2975,1600,1500,1475,933,1
479,2,0,92.0,95.0,94.0,110.0,2530,2586,1903,1959,627,627,306,362,240,305,66,57,52,42,2825,2975,1600,1500,1475,933,1
486,2,0,94.0,97.0,86.0,110.0,2535,2496,1931,1847,604,649,202,457,60,320,142,137,52,42,2925,3250,1600,1500,1575,933,1
493,2,0,89.0,103.0,101.0,110.0,2322,2518,1651,1847,671,671,462,432,240,265,222,167,47,44,2925,3550,1700,1500,1825,933,1
500,2,0,92.0,106.0,109.0,110.0,2513,2490,1819,1819,694,671,492,473,240,355,252,118,46,44,3100,3550,2150,1500,1875,933,1
507,2,0,89.0,108.0,125.0,118.0,2334,2406,1707,1735,627,671,476,479,260,285,216,194,42,44,3100,3950,2150,1500,2075,933,1
514,2,0,92.0,107.0,125.0,118.0,1914,2328,1287,1679,627,649,486,765,190,495,296,270,44,44,3100,4250,2150,1500,2225,983,1
521,2,0,75.0,98.0,125.0,118.0,1947,2250,1343,1623,604,627,527,1041,155,695,372,346,37,46,2300,3750,2050,1500,3875,1483,1
529,2,0,56.0,96.0,125.0,126.0,2026,2446,1399,1819,627,627,772,1006,320,630,452,376,34,46,1100,3550,2050,1500,5225,1708,1
536,2,0,59.0,88.0,125.0,134.0,1914,2546,1287,1875,627,671,642,1301,210,845,432,456,33,46,1950,2900,2050,1500,5275,1985,1
543,2,0,59.0,90.0,117.0,134.0,1869,2602,1175,1931,694,671,853,697,345,215,508,482,33,46,1950,3000,2050,1500,5375,1985,1
548,2,0,59.0,96.0,117.0,134.0,1774,2294,1147,1623,627,671,1018,637,450,95,568,542,33,46,1950,3250,2050,1500,5375,1985,1
7,2,0,13.0,13.0,15.0,15.0,293,251,293,251,0,0,35,30,35,30,0,0,12,12,0,0,0,0,0,0,0
14,2,0,14.0,14.0,15.0,15.0,671,671,671,671,0,0,70,70,70,70,0,0,13,13,0,0,0,0,0,0,0
21,2,0,14.0,14.0,15.0,15.0,699,699,699,699,0,0,50,50,50,50,0,0,13,13,0,0,0,0,0,0,0
29,2,0,15.0,15.0,15.0,15.0,699,671,699,671,0,0,85,80,85,80,0,0,14,14,0,0,0,0,0,0,0
36,2,0,15.0,15.0,15.0,15.0,783,755,783,755,0,0,140,135,140,135,0,0,14,14,0,0,0,0,0,0,0
43,2,0,16.0,16.0,23.0,23.0,811,783,811,783,0,0,10,75,10,75,0,0,15,15,0,0,0,0,0,0,0
50,2,0,17.0,16.0,23.0,23.0,839,783,839,783,0,0,60,40,60,40,0,0,16,15,0,0,0,0,0,0,0
57,2,0,17.0,17.0,23.0,23.0,839,783,839,783,0,0,120,90,120,90,0,0,16,16,0,0,0,0,0,0,0
64,2,0,18.0,18.0,23.0,23.0,951,811,951,811,0,0,180,180,180,180,0,0,17,17,0,0,0,0,0,0,0
71,2,0,19.0,18.0,23.0,23.0,979,878,979,811,0,67,245,237,245,225,0,12,18,17,0,0,0,0,0,0,0
79,2,0,19.0,19.0,23.0,23.0,939,911,895,755,44,156,408,352,400,320,8,32,19,18,0,0,0,0,0,0,0
86,2,0,20.0,19.0,23.0,23.0,1068,939,979,783,89,156,95,462,75,410,20,52,19,18,0,0,0,0,0,0,0
93,2,0,20.0,20.0,23.0,23.0,1034,962,923,783,111,179,61,327,25,305,36,22,19,19,0,0,150,150,0,0,0
100,2,0,21.0,20.0,23.0,23.0,1057,1018,923,839,134,179,137,447,85,405,52,42,20,19,0,0,150,150,0,0,0
107,2,0,21.0,20.0,23.0,23.0,1079,967,923,811,156,156,118,153,50,95,68,58,20,19,0,0,150,150,0,0,0
114,2,0,22.0,21.0,23.0,23.0,1107,995,951,839,156,156,173,128,85,50,88,78,21,19,0,0,150,150,0,0,0
121,2,0,23.0,22.0,31.0,23.0,1107,939,951,783,156,156,253,128,145,30,108,98,22,19,0,100,150,150,0,0,0
129,2,0,25.0,23.0,31.0,23.0,1107,1163,951,1007,156,156,268,288,165,170,103,118,22,20,0,100,300,150,0,0,0
136,2,0,25.0,23.0,31.0,31.0,1074,1219,895,1063,179,156,342,58,215,20,127,38,22,20,0,100,300,150,50,0,0
143,2,0,25.0,25.0,31.0,31.0,1270,1158,979,979,291,179,448,133,285,75,163,58,22,21,0,150,300,150,50,0,0
150,2,0,28.0,26.0,31.0,31.0,1264,1242,951,1063,313,179,114,128,90,50,24,78,23,22,125,150,300,150,50,0,0
157,2,0,30.0,26.0,46.0,31.0,1264,1135,951,979,313,156,169,244,105,150,64,94,24,22,125,150,300,150,50,0,0
164,2,0,31.0,27.0,46.0,31.0,1320,1253,1007,1007,313,246,329,200,225,120,104,80,25,23,125,200,300,150,50,0,0
171,2,0,32.0,27.0,46.0,31.0,1370,1292,1035,979,335,313,439,345,295,225,144,120,26,23,125,200,300,150,50,0,0
179,2,0,33.0,28.0,46.0,46.0,1398,1314,1063,979,335,335,404,315,270,155,134,160,27,24,125,200,300,500,50,0,0
186,2,0,34.0,29.0,46.0,46.0,1454,1258,1119,923,335,335,570,211,400,115,170,96,28,25,250,200,300,500,50,0,0
193,2,0,35.0,30.0,46.0,46.0,1510,1482,1175,1147,335,335,660,251,450,115,210,136,29,25,250,100,600,500,50,100,0
200,2,0,39.0,31.0,46.0,46.0,1628,1544,1315,1231,313,313,341,392,245,220,96,172,30,26,250,100,600,600,50,100,0
207,2,0,41.0,34.0,46.0,46.0,1628,1684,1315,1371,313,313,81,247,45,60,36,187,32,26,250,100,600,600,50,100,0
214,2,0,42.0,38.0,46.0,46.0,1684,1796,1371,1483,313,313,141,367,65,140,76,227,33,28,250,200,600,600,50,100,0
221,2,0,43.0,42.0,46.0,46.0,1818,1846,1483,1511,335,335,66,182,50,15,16,167,34,28,250,300,600,850,50,100,0
229,2,0,46.0,44.0,46.0,54.0,1902,1958,1567,1623,335,335,131,312,75,105,56,207,35,30,550,300,600,850,50,100,0
236,2,0,47.0,45.0,54.0,54.0,1919,2014,1539,1679,380,335,315,323,215,105,100,218,36,31,550,400,600,850,50,100,0
243,2,0,48.0,48.0,54.0,62.0,1953,2238,1371,1903,582,335,451,393,275,135,176,258,37,32,550,500,600,850,50,100,0
250,2,0,49.0,50.0,54.0,62.0,2076,2160,1427,1847,649,313,592,524,340,230,252,294,38,34,800,700,1000,925,50,100,0
257,2,0,51.0,55.0,54.0,70.0,2076,2244,1427,1931,649,313,223,259,95,100,128,159,39,34,800,800,1100,925,50,100,0
264,2,0,57.0,59.0,62.0,78.0,2210,2294,1539,1959,671,335,329,374,125,175,204,199,40,36,800,800,1100,925,50,100,0
271,2,0,58.0,59.0,62.0,78.0,2244,2210,1595,1875,649,335,355,449,175,210,180,239,42,37,800,800,1100,925,50,100,0
279,2,0,61.0,61.0,62.0,78.0,2278,2328,1651,2015,627,313,316,635,60,360,256,275,42,38,1050,900,1100,925,50,100,0
286,2,0,62.0,64.0,62.0,78.0,2250,2518,1623,2183,627,335,246,240,60,50,186,190,43,38,1050,1150,1100,925,50,100,0
293,2,0,62.0,65.0,62.0,94.0,2328,2496,1679,2183,649,313,476,311,210,85,266,226,44,40,1050,1375,1100,925,50,100,0
300,2,0,64.0,67.0,70.0,94.0,2462,2300,1791,1987,671,313,336,396,90,130,246,266,45,41,1050,1375,1100,925,50,100,0
307,2,0,66.0,68.0,70.0,94.0,2474,2412,1847,2099,627,313,614,416,300,135,314,281,45,41,1675,1375,1100,925,50,100,0
314,2,0,69.0,69.0,70.0,102.0,2552,2294,1903,1959,649,335,724,641,405,320,319,321,47,41,1675,1375,1100,925,50,100,0
321,2,0,70.0,70.0,78.0,102.0,2630,2059,1959,1679,671,380,744,364,445,45,299,319,48,42,1675,1750,1250,1000,50,100,0
329,2,0,72.0,74.0,78.0,110.0,2558,2227,1931,1847,627,380,681,259,410,100,271,159,49,43,1925,1750,1550,1000,50,100,0
336,2,0,78.0,75.0,78.0,110.0,2558,2171,1931,1791,627,380,496,352,345,145,151,207,50,44,2025,1750,1550,1000,50,100,0
343,2,0,80.0,77.0,86.0,110.0,2658,2227,1987,1847,671,380,426,371,345,120,81,251,50,45,2025,1850,1550,1125,50,100,0
350,2,0,80.0,78.0,94.0,118.0,2770,2378,2099,1931,671,447,706,361,545,150,161,211,50,46,2025,1750,1550,1125,50,200,0
357,2,0,82.0,79.0,94.0,141.0,2642,2317,2015,1847,627,470,508,466,275,195,233,271,52,47,2275,1750,1550,1275,50,200,0
364,2,0,82.0,84.0,94.0,141.0,2714,2395,2043,1903,671,492,828,226,515,45,313,181,52,48,2275,1850,1550,1525,50,200,0
371,2,0,86.0,84.0,94.0,149.0,2686,2367,2015,1875,671,492,358,372,65,135,293,237,54,49,2275,2150,1550,1525,50,200,0
379,2,0,87.0,86.0,94.0,149.0,2698,2502,2071,1987,627,515,565,482,200,235,365,247,55,50,2775,2150,1550,1525,50,200,0
386,2,0,93.0,90.0,94.0,157.0,2726,2787,2099,2183,627,604,400,248,155,50,245,198,56,50,2775,2375,1550,1525,50,200,0
393,2,0,95.0,90.0,102.0,157.0,2798,2944,2127,2295,671,649,635,589,310,315,325,274,57,50,2775,2475,1550,1525,50,200,0
400,2,0,97.0,96.0,102.0,157.0,2804,3034,2155,2407,649,627,516,515,215,190,301,325,57,52,3025,2475,1700,1650,50,200,0
407,2,0,98.0,98.0,102.0,157.0,2670,2888,2043,2239,627,649,663,365,290,85,373,280,59,52,3025,2600,2000,1650,50,200,0
414,2,0,98.0,105.0,102.0,157.0,2479,3000,1875,2351,604,649,855,405,410,95,445,310,59,54,3025,2700,2000,1650,50,200,0
421,2,0,102.0,111.0,102.0,157.0,2496,3330,1847,2659,649,671,660,276,335,115,325,161,60,54,3325,2825,2000,1650,50,200,0
429,2,0,102.0,116.0,102.0,165.0,2754,3526,2127,2855,627,671,756,276,355,60,401,216,60,55,4075,2950,2000,1650,50,200,0
436,2,0,110.0,121.0,125.0,165.0,2798,3756,2127,3107,671,649,591,378,310,140,281,238,60,55,4075,3250,2300,1650,50,200,0
443,2,0,113.0,127.0,133.0,165.0,2961,3756,2267,3107,694,649,297,438,140,145,157,293,62,58,4075,3375,2300,1650,50,200,0
450,2,0,113.0,134.0,141.0,165.0,3123,3594,2519,2967,604,627,371,159,300,40,71,119,62,59,4075,3900,2300,1650,50,200,0
457,2,0,115.0,136.0,141.0,165.0,3067,3644,2351,2995,716,649,647,299,480,100,167,199,65,61,4075,4150,2300,1800,50,200,0
464,2,0,115.0,138.0,141.0,165.0,3381,3554,2463,2883,918,671,568,739,285,460,283,279,65,64,4075,4325,2300,1800,50,200,0
471,2,0,117.0,138.0,141.0,165.0,3515,3644,2575,2883,940,761,453,1181,300,810,153,371,67,64,4275,4450,2300,1950,350,200,0
479,2,0,119.0,146.0,141.0,173.0,3644,3829,2659,3023,985,806,684,808,415,570,269,238,67,64,4275,4450,2300,1950,350,200,0
486,2,0,119.0,144.0,141.0,173.0,3666,3588,2659,2827,1007,761,1106,726,725,600,381,126,67,64,4275,4675,2800,1950,350,500,0
493,2,0,121.0,145.0,141.0,173.0,3633,3504,2603,2743,1030,761,1457,843,960,675,497,168,69,64,4525,4550,3300,2200,350,725,0
500,2,0,133.0,157.0,149.0,173.0,3655,3638,2715,2855,940,783,685,489,580,425,105,64,69,64,4825,4875,3600,2200,350,725,0
507,2,0,133.0,157.0,149.0,173.0,3650,3364,2687,2603,963,761,1125,461,900,305,225,156,71,66,4825,4875,3600,2200,350,725,0
514,2,0,133.0,139.0,149.0,173.0,3706,3414,2743,2631,963,783,1575,868,1230,620,345,248,71,66,4825,3975,3600,2200,350,1800,0
521,2,0,135.0,139.0,149.0,173.0,3672,3353,2687,2547,985,806,1811,1184,1350,865,461,319,71,66,4825,4350,3600,2450,350,1800,0
529,2,0,138.0,151.0,149.0,173.0,3560,3442,2575,2659,985,783,1931,807,1500,525,431,282,71,66,4825,4800,3600,2700,350,1800,0
536,2,0,138.0,151.0,149.0,173.0,3493,3566,2463,2715,1030,851,2237,540,1690,500,547,40,73,68,4825,4800,3600,2950,350,1800,0
543,2,0,139.0,153.0,149.0,173.0,3454,3448,2491,2575,963,873,1900,713,1395,565,505,148,73,68,4825,4900,3600,2950,350,1800,0
550,2,0,140.0,163.0,157.0,173.0,3319,3846,2379,2883,940,963,2051,618,1530,450,521,168,74,70,4825,5400,3600,3100,350,1800,0
557,2,0,140.0,168.0,157.0,173.0,3291,4070,2351,3107,940,963,1042,724,905,565,137,159,74,70,4825,5400,3600,3100,350,1800,0
564,2,0,155.0,172.0,165.0,173.0,3375,4120,2435,3135,940,985,1042,625,885,525,157,100,75,70,6445,5400,3600,3100,350,1800,0
571,2,0,155.0,172.0,181.0,173.0,3538,4154,2575,3191,963,963,694,271,575,130,119,141,75,72,6475,6000,3700,3100,350,1800,0
579,2,0,159.0,181.0,181.0,196.0,3728,3958,2743,2995,985,963,686,282,605,175,81,107,78,73,6505,6000,4000,3100,350,1800,0
586,2,0,159.0,184.0,181.0,196.0,3622,4002,2659,2995,963,1007,988,761,795,530,193,231,79,73,6535,6275,4000,3100,350,1800,0
593,2,0,156.0,182.0,181.0,196.0,3515,3902,2575,2939,940,963,1241,1197,940,850,301,347,76,73,6565,6500,4000,3100,500,1900,0
600,2,0,156.0,187.0,189.0,212.0,3370,3834,2407,2827,963,1007,1331,681,1060,560,271,121,76,73,6565,6575,4150,3100,500,2200,0
607,2,0,162.0,191.0,197.0,212.0,3448,3638,2463,2631,985,1007,266,539,125,456,141,83,76,73,7885,6800,4450,3100,500,2200,0
614,2,0,162.0,199.0,197.0,212.0,3498,3224,2491,2239,1007,985,577,169,320,36,257,133,76,75,8215,6800,4750,3100,500,2200,0
621,2,0,169.0,199.0,197.0,212.0,3510,3162,2547,2155,963,1007,154,333,35,183,119,150,74,75,8245,7075,4900,3100,600,2200,0
629,2,0,169.0,199.0,197.0,212.0,3420,3157,2435,2127,985,1030,555,408,320,138,235,270,74,77,8245,7650,4900,3100,600,2300,0
636,2,0,170.0,200.0,197.0,212.0,3202,3185,2239,2155,963,1030,901,696,550,298,351,398,77,77,8275,8225,5200,3100,600,2300,0
643,2,0,170.0,200.0,197.0,212.0,2978,3364,2015,2267,963,1097,752,794,285,418,467,376,77,77,8305,8450,5350,3300,600,2300,0
650,2,0,176.0,200.0,197.0,227.0,3168,3739,2183,2575,985,1164,542,1258,205,738,337,520,78,77,8305,8500,5350,3300,600,2300,0
657,2,0,176.0,198.0,189.0,227.0,3437,3935,2407,2659,1030,1276,1332,1706,871,1038,461,668,78,77,8305,8600,4900,3300,774,2425,0
664,2,0,181.0,200.0,189.0,227.0,3431,3986,2379,2687,1052,1299,1120,1966,781,1213,339,753,77,77,8965,8600,4900,3500,1224,2425,0
671,2,0,181.0,200.0,189.0,227.0,3644,3823,2547,2547,1097,1276,1148,1963,681,1058,467,905,77,77,9625,8600,4900,3600,1224,2425,0
679,2,0,181.0,200.0,189.0,227.0,3594,3952,2519,2631,1075,1321,1150,2378,551,1313,599,1065,77,77,9655,8600,4900,3600,1224,2425,0
686,2,0,175.0,200.0,189.0,227.0,3521,3974,2491,2631,1030,1343,1520,2844,801,1623,719,1221,75,77,9395,8600,4900,3600,1599,2425,0
693,2,0,181.0,200.0,189.0,227.0,3375,3930,2323,2631,1052,1299,941,3307,511,1938,430,1369,75,77,9425,8825,4900,3600,1599,2425,0
700,2,0,177.0,196.0,189.0,227.0,3336,3930,2239,2631,1097,1299,1274,3773,716,2248,558,1525,71,77,10055,8575,4900,3600,1859,2675,0
707,2,0,177.0,200.0,189.0,227.0,3202,3986,2127,2687,1075,1299,1611,4019,921,2363,690,1656,71,77,10115,8575,4900,3600,1859,2675,0
714,2,0,177.0,196.0,189.0,227.0,3151,4075,2099,2687,1052,1388,1976,4491,1166,2663,810,1828,71,77,10130,8325,4900,3600,1859,2925,0
721,2,0,189.0,200.0,189.0,227.0,3202,4047,2127,2659,1075,1388,1148,4520,706,2678,442,1842,71,77,10820,8325,4900,3900,1859,2925,0
729,2,0,188.0,200.0,189.0,227.0,2950,3974,1875,2519,1075,1455,1341,4982,771,2968,570,2014,70,77,10850,8550,4900,4050,1909,2925,0
736,2,0,188.0,198.0,189.0,227.0,2916,4030,1931,2575,985,1455,1156,5455,666,3273,490,2182,70,77,11275,8450,4900,4050,2174,3025,0
743,2,0,177.0,174.0,189.0,227.0,2966,3924,1959,2491,1007,1433,1419,5572,801,3218,618,2354,70,77,10100,6400,4900,4050,3364,5134,0
750,2,0,165.0,172.0,197.0,227.0,3196,3930,2099,2519,1097,1411,1695,4435,941,2463,754,1972,70,77,8580,5250,4900,4050,4989,6734,0
757,2,0,159.0,153.0,227.0,227.0,3090,3896,2015,2463,1075,1433,1925,4551,1051,2453,874,2098,70,77,7960,3950,4900,4050,5964,8034,0
764,2,0,158.0,162.0,227.0,227.0,3291,3717,2127,2351,1164,1366,1945,4311,1031,2278,914,2033,69,77,8065,4125,4900,4050,6044,8159,0
771,2,0,158.0,156.0,227.0,227.0,3202,3706,2127,2295,1075,1411,2199,3792,1161,2058,1038,1734,69,77,8185,3575,4900,4050,6044,8709,0
779,2,0,163.0,166.0,212.0,227.0,3073,3745,2043,2267,1030,1478,1914,4059,956,2178,958,1881,69,77,9610,4275,4900,4050,6444,8709,0
786,2,0,168.0,169.0,212.0,227.0,3106,3672,2099,2239,1007,1433,1902,3983,966,2013,936,1970,69,77,9965,4400,4900,4050,6444,8709,0
793,2,0,168.0,182.0,212.0,227.0,3375,3622,2323,2211,1052,1411,2037,1075,981,333,1056,742,70,77,10085,5400,4900,4050,6444,8709,0
800,2,0,176.0,184.0,212.0,227.0,3493,3560,2463,2127,1030,1433,1291,1402,611,488,680,914,70,79,10455,5950,4900,4050,6444,8709,0
807,2,0,180.0,190.0,212.0,227.0,3566,3616,2603,2071,963,1545,718,1543,126,433,592,1110,70,81,11060,7000,4900,4275,6444,8709,0
814,2,0,186.0,200.0,212.0,227.0,3599,3661,2547,2071,1052,1590,581,1054,61,123,520,931,70,81,11465,7275,4900,4475,6444,8709,0
821,2,0,183.0,200.0,212.0,227.0,3862,3806,2743,2127,1119,1679,1238,1515,536,388,702,1127,70,81,11525,7275,4900,4575,6444,8709,0
829,2,0,182.0,200.0,212.0,227.0,3756,3946,2547,2267,1209,1679,1185,1851,581,403,604,1448,69,81,11570,7400,4900,4575,6494,8709,0
836,2,0,181.0,198.0,212.0,227.0,3622,4019,2323,2407,1299,1612,1605,2340,841,708,764,1632,68,81,12070,8825,4900,4875,6544,8934,0
843,2,0,181.0,200.0,212.0,227.0,3588,4053,2267,2463,1321,1590,2041,2557,1121,858,920,1699,68,81,12070,9925,4900,4875,6544,8934,0
850,2,0,199.0,200.0,212.0,227.0,3689,4159,2211,2547,1478,1612,921,2272,496,623,425,1649,68,81,12370,9925,5150,4875,6544,8934,0
857,2,0,199.0,200.0,212.0,227.0,3577,4131,2211,2519,1366,1612,1319,2778,746,933,573,1845,68,81,12370,9925,5150,4875,6544,8934,0
864,2,0,200.0,200.0,212.0,227.0,3420,4282,1987,2603,1433,1679,1624,3294,946,1253,678,2041,68,81,12370,9925,5150,4875,6544,8934,0
871,2,0,200.0,200.0,212.0,227.0,3286,4254,1875,2575,1411,1679,2009,3790,1171,1553,838,2237,68,81,12670,10200,5150,4875,6544,8934,0
879,2,0,200.0,199.0,227.0,227.0,3202,4238,1791,2603,1411,1635,2395,4279,1381,1858,1014,2421,68,81,12770,10150,5150,5075,6544,8984,0
886,2,0,199.0,197.0,212.0,227.0,3213,4165,1847,2575,1366,1590,2766,4801,1596,2188,1170,2613,67,81,13570,9925,5150,5275,6994,9209,0
893,2,0,199.0,197.0,212.0,227.0,3190,4271,1735,2659,1455,1612,2341,5292,991,2483,1350,2809,67,81,14845,9925,5150,5275,6994,9209,0
900,2,0,199.0,197.0,212.0,227.0,3213,4131,1847,2575,1366,1556,1824,4707,476,1708,1348,2999,67,81,14845,9925,5150,5275,6994,9209,0
907,2,0,199.0,199.0,212.0,242.0,3174,3778,1763,2323,1411,1455,2200,4483,676,1433,1524,3050,67,81,14845,9925,5150,5275,6994,9209,0
914,2,0,199.0,199.0,212.0,242.0,3157,3890,1847,2323,1310,1567,2561,4942,891,1708,1670,3234,67,81,14845,9925,5150,5275,6994,9209,0
921,2,0,199.0,199.0,212.0,242.0,3056,4081,1791,2491,1265,1590,2936,5407,1106,1993,1830,3414,67,81,14845,9925,5150,5575,7294,9209,0
929,2,0,195.0,198.0,189.0,242.0,2608,4114,1511,2547,1097,1567,3187,6403,1241,2813,1946,3590,64,80,14685,9925,5300,5575,8104,9359,0
936,2,0,189.0,168.0,189.0,242.0,2154,4081,1147,2491,1007,1590,3320,6870,1246,3088,2074,3782,64,79,13705,7775,5450,5475,9174,11934,0
943,2,0,171.0,133.0,189.0,242.0,2384,4019,1399,2407,985,1612,3534,6220,1356,2613,2178,3607,64,79,11485,4025,5450,5575,11484,15684,0
950,2,0,162.0,126.0,189.0,242.0,2115,4098,1175,2463,940,1635,3090,5901,1096,2473,1994,3428,64,79,9850,2975,5450,5475,13254,16834,0
957,2,0,142.0,136.0,189.0,242.0,2166,4142,1203,2463,963,1679,3293,3364,1191,1003,2102,2361,64,79,7760,1650,5450,5875,15419,18159,0
964,2,0,157.0,128.0,204.0,242.0,2300,4238,1315,2491,985,1747,2252,3168,551,803,1701,2365,64,79,7670,1075,5450,5875,15569,18734,0
971,2,0,157.0,133.0,219.0,242.0,2406,4378,1455,2631,951,1747,2457,2048,646,33,1811,2015,64,79,7655,1750,5450,5775,15644,19159,0
979,2,0,157.0,137.0,219.0,242.0,2110,4249,1091,2547,1019,1702,2041,2544,406,333,1635,2211,64,77,7730,2575,5450,5675,15644,19359,0
986,2,0,163.0,133.0,219.0,242.0,2317,4596,1287,2939,1030,1657,2271,3105,516,698,1755,2407,64,77,8375,3125,5450,5675,15644,20109,0
993,2,0,163.0,140.0,219.0,242.0,2440,4691,1455,3135,985,1556,2489,3005,626,658,1863,2347,64,77,8450,3125,5450,5875,15644,20109,0
1000,2,0,163.0,152.0,219.0,242.0,2664,4579,1679,3079,985,1500,2760,3304,781,773,1979,2531,64,77,8510,4125,5450,5875,15644,20109,0
1007,2,0,155.0,148.0,219.0,242.0,2726,4742,1763,3107,963,1635,3031,3870,936,1143,2095,2727,58,77,9445,5825,5450,5575,16344,20859,0
1014,2,0,155.0,144.0,219.0,242.0,2927,4898,1987,3219,940,1679,3332,4461,1121,1538,2211,2923,58,77,9385,5375,5450,5575,16464,21309,0
1021,2,0,173.0,144.0,219.0,242.0,3235,4753,2295,3163,940,1590,1857,4344,326,1416,1531,2928,58,77,10060,5925,5450,5575,16464,21409,0
1029,2,0,173.0,153.0,219.0,242.0,3353,4523,2323,2911,1030,1612,2202,2270,551,46,1651,2224,58,77,10105,5875,5450,5575,16464,21459,0
1036,2,0,170.0,137.0,219.0,242.0,3381,4546,2351,2911,1030,1635,2512,2796,741,372,1771,2424,55,77,10000,4375,5450,5575,16794,22959,0
1043,2,0,165.0,125.0,219.0,242.0,3230,4142,2267,2575,963,1567,2821,3264,946,652,1875,2612,55,77,9895,2575,5450,5675,17559,25959,0
1050,2,0,172.0,128.0,219.0,242.0,3224,3689,2239,2099,985,1590,1241,2564,71,52,1170,2512,55,75,9895,1575,5450,5575,17619,27259,0
1057,2,0,172.0,130.0,219.0,242.0,3174,3711,2211,2211,963,1500,1547,2698,261,97,1286,2601,55,75,9925,2675,5450,5375,17649,27485,0
1064,2,0,173.0,130.0,219.0,227.0,3062,3168,2155,1847,907,1321,1547,3064,151,307,1396,2757,53,75,10000,2675,5450,5375,17749,28035,0
1071,2,0,177.0,128.0,219.0,227.0,2782,3370,1987,2071,795,1299,1142,2986,21,77,1121,2909,56,77,10145,2425,5450,5375,17749,28610,0
1079,2,0,177.0,129.0,219.0,227.0,2804,3532,1987,2211,817,1321,1397,3432,186,367,1211,3065,56,76,10220,3325,5450,5375,17749,28660,0
1086,2,0,189.0,132.0,219.0,227.0,2714,3874,1987,2575,727,1299,1637,3473,346,402,1291,3071,56,75,11600,4325,5450,5575,17749,29110,0
1093,2,0,188.0,117.0,219.0,227.0,2664,3963,2015,2687,649,1276,1865,3900,506,677,1359,3223,52,75,11595,3100,5600,5675,18144,30535,0
1100,2,0,182.0,112.0,219.0,227.0,2502,3952,1875,2631,627,1321,2121,3830,686,522,1435,3308,52,75,10845,1825,5600,5475,18969,32010,0
1107,2,0,161.0,97.0,219.0,227.0,2530,3980,1903,2659,627,1321,2386,4276,871,812,1515,3464,52,73,9075,875,5600,5475,21099,33285,0
1114,2,0,167.0,95.0,219.0,227.0,2474,4210,1847,2911,627,1299,1441,4028,346,637,1095,3391,52,73,9780,550,5600,5475,21099,34060,0
1121,2,0,164.0,105.0,219.0,227.0,2574,4350,1903,3051,671,1299,1706,3515,531,372,1175,3143,52,73,9540,975,5600,5375,21399,34260,0
1129,2,0,170.0,99.0,219.0,227.0,2625,3924,1931,2603,694,1321,1396,3950,441,647,955,3303,52,72,9870,725,5600,5375,21399,34610,0
7,2,1,13.0,13.0,15.0,14.0,377,335,377,335,0,0,45,40,45,40,0,0,12,12,0,0,0,0,0,0,1
14,2,1,14.0,13.0,15.0,14.0,643,671,643,671,0,0,15,20,15,20,0,0,13,13,0,0,0,0,0,0,1
21,2,1,14.0,14.0,15.0,14.0,671,671,671,671,0,0,45,45,45,45,0,0,13,13,0,0,0,0,0,0,1
29,2,1,15.0,14.0,15.0,14.0,615,727,615,727,0,0,30,145,30,145,0,0,14,13,0,0,0,0,0,0,1
36,2,1,15.0,16.0,15.0,22.0,755,755,755,755,0,0,135,140,135,140,0,0,14,14,0,0,0,0,0,0,1
43,2,1,16.0,16.0,23.0,22.0,811,811,811,811,0,0,25,230,25,230,0,0,15,14,0,0,0,0,0,0,1
50,2,1,17.0,15.0,23.0,22.0,811,783,811,783,0,0,45,30,45,30,0,0,16,15,0,0,0,0,0,0,1
57,2,1,18.0,17.0,23.0,22.0,867,839,867,839,0,0,50,35,50,35,0,0,17,15,0,0,0,0,0,0,1
64,2,1,19.0,18.0,23.0,22.0,923,923,923,923,0,0,105,85,105,85,0,0,18,16,0,0,0,0,0,0,1
71,2,1,19.0,17.0,23.0,22.0,973,867,951,867,22,0,224,155,220,155,4,0,18,17,0,0,0,0,0,0,1
79,2,1,20.0,17.0,23.0,22.0,1023,923,979,923,44,0,333,20,325,20,8,0,19,16,0,0,0,0,0,0,1
86,2,1,20.0,18.0,23.0,22.0,1018,895,951,895,67,0,51,80,35,80,16,0,19,16,0,0,150,0,0,0,1
93,2,1,20.0,19.0,23.0,22.0,1012,839,923,839,89,0,173,115,145,115,28,0,20,18,0,0,150,0,0,0,1
100,2,1,21.0,19.0,23.0,22.0,1085,900,951,811,134,89,94,236,50,220,44,16,20,18,0,0,150,0,0,0,1
107,2,1,21.0,20.0,23.0,22.0,1068,995,979,839,89,156,97,306,45,270,52,36,20,19,0,0,150,0,0,0,1
114,2,1,22.0,20.0,23.0,22.0,1085,1023,951,867,134,156,132,326,60,270,72,56,21,20,0,0,150,0,0,0,1
121,2,1,23.0,21.0,23.0,28.0,1074,939,895,783,179,156,152,396,60,320,92,76,22,20,0,0,150,250,0,0,1
129,2,1,23.0,26.0,23.0,28.0,1090,1102,867,923,223,179,285,186,165,90,120,96,22,20,0,0,150,250,0,0,1
136,2,1,26.0,27.0,31.0,36.0,1163,984,895,895,268,89,158,40,85,40,73,0,23,20,0,0,300,250,0,0,1
143,2,1,26.0,28.0,31.0,36.0,1186,1035,895,1035,291,0,253,120,140,120,113,0,23,20,0,100,300,250,0,0,1
150,2,1,29.0,30.0,31.0,36.0,1208,1147,895,1147,313,0,178,160,75,160,103,0,24,20,125,100,300,250,0,0,1
157,2,1,31.0,30.0,46.0,36.0,1208,1063,895,1063,313,0,233,270,90,270,143,0,25,20,125,200,300,250,0,0,1
164,2,1,33.0,30.0,46.0,36.0,1320,979,1007,979,313,0,49,50,20,50,29,0,27,19,125,600,300,250,0,0,1
171,2,1,33.0,32.0,46.0,36.0,1404,1063,1091,1063,313,0,110,70,45,70,65,0,27,19,125,600,300,250,0,0,1
179,2,1,35.0,33.0,46.0,36.0,1566,1063,1231,1063,335,0,250,50,145,50,105,0,29,19,125,600,300,250,0,0,1
186,2,1,39.0,35.0,46.0,36.0,1656,1091,1343,1091,313,0,271,80,155,80,116,0,31,19,300,750,300,250,0,0,1
193,2,1,39.0,35.0,46.0,44.0,1740,1175,1427,1175,313,0,281,215,125,215,156,0,31,19,300,750,300,250,0,0,1
200,2,1,41.0,41.0,46.0,44.0,1796,1091,1483,1091,313,0,286,40,90,40,196,0,33,19,300,800,300,250,0,0,1
207,2,1,43.0,43.5,54.0,44.0,1594,1091,1259,1091,335,0,266,25,180,25,86,0,33,19,300,875,600,250,50,25,1
214,2,1,35.0,42.0,54.0,44.0,1309,1063,951,1063,358,0,361,105,235,105,126,0,25,19,300,1000,600,250,500,150,1
221,2,1,35.0,42.5,54.0,44.0,1258,1119,923,1119,335,0,207,30,45,30,162,0,24,19,425,975,600,250,550,275,1
229,2,1,37.0,43.5,54.0,44.0,1264,1063,951,1063,313,0,258,65,60,65,198,0,26,19,425,975,600,250,550,375,1
236,2,1,38.0,45.5,54.0,50.0,1320,1091,1007,1091,313,0,128,5,40,5,88,0,26,19,600,975,600,250,675,475,1
243,2,1,40.0,45.0,54.0,50.0,1432,1091,1119,1091,313,0,128,30,25,30,103,0,27,19,725,950,600,250,675,600,1
250,2,1,41.0,47.5,62.0,50.0,1454,1035,1119,1035,335,0,328,5,185,5,143,0,27,19,725,1075,750,250,600,625,1
257,2,1,44.0,46.0,62.0,50.0,1510,1119,1175,1119,335,0,328,45,170,45,158,0,28,22,725,1100,750,250,600,800,1
264,2,1,45.0,48.5,62.0,50.0,1538,1147,1203,1147,335,0,409,40,215,40,194,0,29,24,1150,1075,600,250,750,825,1
271,2,1,47.0,47.5,62.0,50.0,1594,1315,1259,1315,335,0,259,50,175,50,84,0,30,26,1150,975,700,250,750,925,1
279,2,1,47.0,49.5,62.0,50.0,1600,1427,1287,1427,313,0,195,85,75,85,120,0,30,29,1150,925,700,250,900,975,1
286,2,1,47.0,49.5,62.0,50.0,1656,1483,1343,1483,313,0,305,120,145,120,160,0,30,31,1150,875,700,250,900,1025,1
293,2,1,46.0,52.5,62.0,58.0,1572,1679,1259,1679,313,0,285,160,85,160,200,0,29,34,1275,875,700,250,1125,1025,1
300,2,1,43.0,51.0,70.0,66.0,1314,1735,979,1735,335,0,495,200,255,200,240,0,24,35,1375,750,700,250,1375,1150,1
307,2,1,41.0,52.0,70.0,66.0,866,1908,531,1819,335,89,465,186,185,170,280,16,22,36,1375,750,700,250,1475,1150,1
314,2,1,42.0,55.5,70.0,66.0,928,1998,615,1819,313,179,487,71,175,35,312,36,23,37,1375,625,700,250,1525,1275,1
321,2,1,44.0,57.5,70.0,66.0,1214,1998,923,1819,291,179,424,86,80,30,344,56,25,40,1375,625,700,375,1525,1275,1
329,2,1,45.0,59.0,70.0,66.0,1303,1891,1035,1735,268,156,536,157,160,85,376,72,26,40,1375,600,700,500,1525,1300,1
336,2,1,50.0,59.0,70.0,66.0,1387,1891,1119,1735,268,156,303,277,45,185,258,92,28,43,1375,600,700,500,1525,1300,1
343,2,1,50.0,59.0,70.0,66.0,1466,1975,1175,1819,291,156,379,522,85,410,294,112,28,43,1375,750,700,625,1525,1300,1
350,2,1,52.0,66.0,70.0,74.0,1471,2059,1203,1903,268,156,511,207,185,75,326,132,30,43,1375,750,700,625,1525,1450,1
357,2,1,55.0,66.0,70.0,74.0,1634,1897,1343,1763,291,134,427,298,115,150,312,148,31,42,1675,750,850,625,1525,1450,1
364,2,1,58.0,66.5,70.0,82.0,1566,1925,1231,1791,335,134,342,119,15,55,327,64,32,51,1975,875,850,625,1525,1475,1
371,2,1,60.0,65.5,70.0,82.0,1684,2451,1371,2295,313,156,548,94,185,10,363,84,34,49,1975,875,850,625,1525,1475,1
379,2,1,61.0,68.5,78.0,82.0,1762,2535,1427,2379,335,156,703,135,300,35,403,100,35,50,1975,875,850,750,1525,1575,1
386,2,1,67.0,74.5,78.0,82.0,1930,2787,1595,2631,335,156,633,170,240,50,393,120,37,51,2225,875,850,750,1525,1575,1
393,2,1,67.0,75.5,78.0,82.0,1992,2709,1679,2463,313,246,479,346,50,190,429,156,37,53,2225,875,850,750,1525,1575,1
400,2,1,69.0,75.5,78.0,90.0,2020,2994,1707,2547,313,447,514,602,45,390,469,212,39,53,2225,875,850,750,1525,1575,1
407,2,1,71.0,75.5,78.0,90.0,2098,2989,1763,2519,335,470,774,757,265,585,509,172,41,53,2225,1375,850,750,1525,1575,1
414,2,1,71.0,90.0,78.0,106.0,2126,2787,1791,2295,335,492,1029,132,480,75,549,57,42,51,2225,1250,850,950,1525,1800,1
421,2,1,64.0,89.5,78.0,106.0,2126,2065,1791,1595,335,470,1180,159,595,50,585,109,43,51,1550,975,850,1200,2200,2075,1
429,2,1,64.0,91.0,78.0,106.0,2238,2154,1903,1707,335,447,1015,211,490,50,525,161,43,50,1325,1650,850,1200,2425,2150,1
436,2,1,62.0,91.5,78.0,106.0,2244,2395,1931,1903,313,492,621,302,160,110,461,192,45,49,1425,1875,850,1200,2675,2225,1
443,2,1,62.0,97.5,78.0,106.0,2138,2367,1847,1875,291,492,622,123,125,100,497,23,45,49,1425,2125,850,1200,2675,2225,1
450,2,1,61.0,99.5,78.0,106.0,2014,2563,1679,2071,335,492,668,178,135,95,533,83,46,49,1425,2325,850,1200,2675,2225,1
457,2,1,65.0,105.0,94.0,106.0,2093,2737,1735,2267,358,470,517,159,140,95,377,64,46,49,1425,2550,850,1200,2675,2250,1
464,2,1,69.0,106.0,117.0,106.0,2345,2765,1763,2295,582,470,408,284,105,235,303,49,46,49,1725,2800,850,1200,2675,2250,1
471,2,1,71.0,108.0,117.0,114.0,2496,2759,1847,2267,649,492,603,349,220,240,383,109,46,49,1725,3100,1250,1200,2675,2400,1
479,2,1,66.0,104.0,117.0,114.0,2474,2726,1847,2211,627,515,924,584,465,415,459,169,45,49,1400,2850,1250,1200,2975,2625,1
486,2,1,60.0,105.5,117.0,122.0,2446,2731,1819,2239,627,492,1025,671,490,450,535,221,47,49,775,2875,1250,1200,3600,2750,1
493,2,1,64.0,107.5,94.0,122.0,2356,2731,1707,2239,649,492,360,821,95,615,265,206,47,49,1125,3125,1250,1200,4100,2750,1
500,2,1,64.0,108.0,94.0,122.0,2434,2625,1763,2155,671,470,646,1007,305,745,341,262,48,51,1525,3200,1450,1200,4200,2875,1
507,2,1,66.0,104.5,94.0,122.0,2412,2653,1763,2183,649,470,612,1322,345,1000,267,322,48,53,1500,2975,1450,1200,4475,3075,1
7,0,1,13.0,13.0,15.0,14.0,293,293,293,293,0,0,35,35,35,35,0,0,12,12,0,0,0,0,0,0,0
14,0,1,14.0,13.0,15.0,14.0,671,671,671,671,0,0,70,20,70,20,0,0,13,13,0,0,0,0,0,0,0
21,0,1,14.0,14.0,15.0,14.0,699,699,699,699,0,0,50,50,50,50,0,0,13,13,0,0,0,0,0,0,0
29,0,1,15.0,14.0,15.0,14.0,671,727,671,727,0,0,30,140,30,140,0,0,14,13,0,0,0,0,0,0,0
36,0,1,15.0,16.0,15.0,22.0,783,783,783,783,0,0,140,145,140,145,0,0,14,14,0,0,0,0,0,0,0
43,0,1,16.0,16.0,23.0,22.0,783,811,783,811,0,0,220,230,220,230,0,0,15,14,0,0,0,0,0,0,0
50,0,1,16.0,15.0,23.0,22.0,839,783,839,783,0,0,270,25,270,25,0,0,15,15,0,0,0,0,0,0,0
57,0,1,17.0,17.0,23.0,22.0,895,811,895,811,0,0,380,35,380,35,0,0,16,15,0,0,0,0,0,0,0
64,0,1,18.0,18.0,23.0,22.0,923,895,923,895,0,0,35,90,35,90,0,0,17,16,0,0,0,0,0,0,0
71,0,1,18.0,17.0,23.0,22.0,923,895,923,895,0,0,135,165,135,165,0,0,17,17,0,0,0,0,0,0,0
79,0,1,19.0,17.0,23.0,22.0,895,895,895,895,0,0,40,30,40,30,0,0,18,16,0,0,0,0,0,0,0
86,0,1,19.0,18.0,23.0,22.0,923,895,923,895,0,0,20,95,20,95,0,0,18,16,0,0,0,0,0,0,0
93,0,1,20.0,19.0,23.0,22.0,951,923,951,923,0,0,50,150,50,150,0,0,19,18,0,0,0,0,0,0,0
100,0,1,20.0,20.0,23.0,22.0,895,990,895,923,0,67,105,227,105,215,0,12,19,18,0,0,0,0,0,0,0
107,0,1,21.0,20.0,23.0,22.0,855,1034,811,923,44,111,148,349,140,325,8,24,20,19,0,0,0,0,0,0,0
114,0,1,22.0,21.0,23.0,22.0,995,1085,839,951,156,134,273,434,245,390,28,44,21,20,0,0,0,0,0,0,0
121,0,1,23.0,26.0,23.0,28.0,973,1057,727,923,246,134,290,205,280,145,10,60,21,20,0,0,150,250,0,0,0
129,0,1,23.0,27.0,23.0,28.0,1068,1046,755,979,313,67,271,288,225,220,46,68,22,21,0,0,150,250,0,0,0
136,0,1,23.0,28.0,38.0,28.0,1118,1102,783,1035,335,67,251,271,165,195,86,76,22,21,0,0,150,250,0,0,0
143,0,1,23.0,27.0,38.0,28.0,1186,1158,895,1091,291,67,153,104,135,20,18,84,22,20,0,100,150,250,0,0,0
150,0,1,23.0,28.0,38.0,36.0,1124,1191,923,1147,201,44,187,198,145,110,42,88,22,21,0,100,150,250,0,0,0
157,0,1,25.0,31.0,38.0,36.0,1208,1191,1007,1147,201,44,136,191,120,95,16,96,22,22,100,400,150,250,0,0,0
164,0,1,26.0,33.0,38.0,36.0,1415,1298,1259,1231,156,67,217,194,185,90,32,104,23,22,100,400,150,250,0,0,0
171,0,1,27.0,33.0,46.0,36.0,1600,1270,1399,1203,201,67,360,47,300,35,60,12,24,25,100,400,150,250,0,0,0
179,0,1,28.0,36.0,46.0,36.0,1706,1382,1483,1315,223,67,118,60,30,40,88,20,25,25,100,400,150,250,0,0,0
186,0,1,29.0,36.0,46.0,36.0,1914,1438,1623,1371,291,67,309,233,185,205,124,28,26,26,100,400,400,250,0,0,0
193,0,1,31.0,40.0,46.0,44.0,1942,1499,1651,1455,291,44,220,102,160,70,60,32,28,28,100,400,500,250,0,0,0
200,0,1,35.0,43.0,46.0,44.0,2042,1522,1707,1455,335,67,125,90,50,50,75,40,28,28,100,550,500,250,0,0,0
207,0,1,37.0,43.0,46.0,44.0,2177,1662,1819,1595,358,67,215,128,100,80,115,48,30,32,100,550,500,250,0,0,0
214,0,1,38.0,46.5,46.0,58.0,2160,1650,1847,1539,313,111,242,229,95,165,147,64,31,33,100,525,500,250,0,25,0
221,0,1,43.0,50.5,46.0,58.0,1936,1785,1623,1651,313,134,237,200,75,120,162,80,32,33,300,525,575,250,0,25,0
229,0,1,44.0,53.5,46.0,58.0,1796,1835,1483,1679,313,156,452,260,250,160,202,100,34,35,300,525,825,250,0,25,0
236,0,1,45.0,56.5,46.0,58.0,2132,1891,1819,1735,313,156,102,155,60,35,42,120,34,37,300,675,825,250,0,25,0
243,0,1,53.0,57.5,54.0,58.0,2378,1975,2043,1819,335,156,252,345,170,205,82,140,35,39,500,775,900,250,0,25,0
250,0,1,55.0,57.5,69.0,58.0,2457,2031,2099,1875,358,156,67,395,45,235,22,160,36,41,500,925,900,250,0,25,0
257,0,1,56.0,57.5,69.0,74.0,2524,2166,2211,1987,313,179,249,665,195,485,54,180,37,42,500,1075,900,250,0,25,0
264,0,1,61.0,65.5,69.0,82.0,2468,2418,2155,2239,313,179,149,305,55,205,94,100,38,42,700,1075,900,250,0,25,0
271,0,1,64.0,70.5,69.0,90.0,2496,2283,2183,2127,313,156,244,121,110,55,134,66,39,48,750,1075,900,250,0,25,0
279,0,1,66.0,72.5,69.0,90.0,2524,2507,2211,2351,313,156,489,331,315,245,174,86,41,50,750,1075,900,250,0,25,0
286,0,1,69.0,70.5,77.0,90.0,2608,2535,2295,2379,313,156,359,216,295,110,64,106,43,50,1250,1075,900,250,0,25,0
293,0,1,70.0,72.5,85.0,90.0,2513,2675,2155,2519,358,156,309,436,205,310,104,126,44,51,1250,1075,900,250,0,25,0
300,0,1,71.0,77.5,85.0,90.0,2653,2810,2295,2631,358,179,244,381,100,235,144,146,44,55,1250,1125,900,250,0,25,0
307,0,1,73.0,83.5,85.0,90.0,2776,2994,2463,2771,313,223,291,439,115,265,176,174,46,56,1250,1125,900,625,0,25,0
314,0,1,73.0,84.5,93.0,98.0,2692,2994,2379,2659,313,335,306,664,90,450,216,214,46,59,1250,1175,900,825,0,25,0
321,0,1,75.0,89.5,93.0,98.0,2832,2838,2519,2435,313,403,541,627,285,365,256,262,48,59,1250,1275,900,1075,0,125,0
329,0,1,75.0,89.5,93.0,98.0,2737,2608,2379,2183,358,425,384,863,330,595,54,268,49,63,1500,1275,1150,1075,0,125,0
336,0,1,78.0,91.5,101.0,98.0,3000,2961,2463,2491,537,470,441,228,315,100,126,128,50,63,1500,1625,1250,1075,0,125,0
343,0,1,83.0,92.5,101.0,98.0,2989,3207,2295,2603,694,604,456,73,375,40,81,33,52,63,1500,1625,1550,1075,0,125,0
350,0,1,89.0,96.5,101.0,98.0,2989,3274,2295,2603,694,671,207,254,50,145,157,109,53,67,1500,1625,1550,1075,0,125,0
357,0,1,91.0,97.5,109.0,98.0,2922,3414,2295,2743,627,671,545,215,320,30,225,185,56,67,1500,1675,1550,1075,0,125,0
364,0,1,92.0,97.5,109.0,106.0,3006,3442,2379,2771,627,671,460,575,255,310,205,265,56,71,1500,1775,1550,1075,0,125,0
371,0,1,97.0,92.5,109.0,106.0,3090,3414,2463,2631,627,783,445,970,285,605,160,365,58,66,1650,1775,1850,1075,100,325,0
379,0,1,103.0,93.5,109.0,138.0,3090,3353,2463,2547,627,806,360,1176,320,715,40,461,59,63,1925,1825,1850,1075,100,425,0
386,0,1,105.0,98.5,125.0,138.0,3330,3291,2659,2463,671,828,255,1331,135,770,120,561,61,63,2125,1825,1850,1075,100,425,0
393,0,1,111.0,101.5,125.0,138.0,3459,3370,2743,2519,716,851,200,1501,100,840,100,661,61,67,2175,1825,1850,1075,100,425,0
400,0,1,115.0,104.5,125.0,138.0,3610,3599,2939,2659,671,940,377,1287,205,760,172,527,63,72,2175,1825,1850,1075,100,425,0
407,0,1,117.0,110.5,133.0,146.0,3482,3510,2855,2547,627,963,499,753,255,510,244,243,65,70,2600,1825,1850,1525,100,425,0
414,0,1,123.0,112.5,149.0,152.0,3538,3610,2911,2603,627,1007,269,587,170,520,99,67,66,70,2900,2425,2150,1525,100,425,0
421,0,1,128.0,124.5,149.0,152.0,3549,3745,2855,2603,694,1142,296,347,105,240,191,107,67,70,3100,2425,2150,1525,100,425,0
429,0,1,131.0,124.5,149.0,144.0,3829,3773,3023,2631,806,1142,231,493,65,250,166,243,67,70,3250,3425,2150,1775,100,525,0
436,0,1,132.0,132.5,165.0,144.0,3756,3834,2883,2603,873,1231,616,251,350,160,266,91,67,80,3300,3625,2150,1775,100,525,0
443,0,1,145.0,132.5,173.0,144.0,3806,3885,2911,2631,895,1254,456,278,290,185,166,93,67,79,3875,3825,2150,1775,100,525,0
450,0,1,147.0,135.5,173.0,144.0,3470,3974,2687,2743,783,1231,696,415,450,270,246,145,67,79,4025,3825,2150,1775,100,525,0
457,0,1,153.0,136.5,173.0,152.0,3386,4019,2603,2743,783,1276,426,707,80,410,346,297,67,80,4275,4575,2400,1775,100,250,0
464,0,1,150.0,145.5,173.0,152.0,3358,4221,2575,2967,783,1254,756,280,310,210,446,70,67,79,3925,4725,2400,1775,600,300,0
471,0,1,151.0,145.5,173.0,152.0,3414,4439,2631,3163,783,1276,286,802,90,580,196,222,67,79,4375,4725,2700,1775,600,300,0
479,0,1,157.0,149.0,173.0,160.0,3403,4462,2575,3163,828,1299,641,924,345,750,296,174,67,79,4950,5950,2700,1775,600,325,0
486,0,1,154.0,154.5,173.0,160.0,3498,4355,2603,3079,895,1276,751,897,355,575,396,322,65,79,4900,5425,2700,1775,850,625,0
493,0,1,158.0,155.5,173.0,160.0,3459,4366,2631,3135,828,1231,759,771,275,555,484,216,65,79,5100,5275,2700,1775,950,775,0
500,0,1,153.0,147.5,173.0,160.0,3470,4422,2687,3191,783,1231,1031,838,455,470,576,368,65,79,4850,4675,2700,1775,1350,2250,0
507,0,1,146.0,142.5,173.0,160.0,3470,4417,2687,3163,783,1254,1186,360,510,215,676,145,65,79,4500,4375,2700,1775,1700,3050,0
514,0,1,145.0,131.0,173.0,160.0,3442,4338,2659,3107,783,1231,941,677,365,380,576,297,65,79,4125,3100,2700,1775,2375,3950,0
521,0,1,147.0,133.5,173.0,160.0,3274,4574,2491,3275,783,1299,846,409,170,360,676,49,65,79,4225,4075,2700,1775,2375,4475,0
529,0,1,153.0,137.0,173.0,160.0,3420,4411,2547,3135,873,1276,1186,467,410,270,776,197,65,79,4525,4050,2700,1775,2375,4700,0
536,0,1,147.0,122.0,173.0,152.0,3330,4422,2435,3191,895,1231,731,831,55,490,676,341,65,79,3975,2650,2700,1775,3025,6100,0
543,0,1,152.0,122.5,173.0,152.0,3302,4338,2519,3107,783,1231,666,1258,10,765,656,493,65,78,4425,2625,2700,1775,3025,6175,0
550,0,1,151.0,115.5,173.0,152.0,3302,4165,2519,3023,783,1142,1076,1730,320,1105,756,625,65,75,4375,3075,2700,1775,3375,6825,0
556,0,1,151.0,117.5,173.0,152.0,3302,4058,2519,2939,783,1119,1076,735,320,590,756,145,65,75,4375,1675,2700,1775,3375,8275,0
7,0,1,13.0,13.0,15.0,14.0,293,293,293,293,0,0,35,35,35,35,0,0,12,12,0,0,0,0,0,0,0
14,0,1,14.0,14.0,15.0,14.0,671,671,671,671,0,0,70,70,70,70,0,0,13,13,0,0,0,0,0,0,0
21,0,1,14.0,14.0,15.0,14.0,699,727,699,727,0,0,50,30,50,30,0,0,13,14,0,0,0,0,0,0,0
29,0,1,15.0,15.0,15.0,14.0,727,755,727,755,0,0,90,94,90,94,0,0,14,14,0,0,0,0,0,0,0
36,0,1,15.0,17.0,15.0,22.0,699,755,699,755,0,0,125,89,125,89,0,0,14,15,0,0,0,0,0,0,0
43,0,1,16.0,17.0,23.0,22.0,755,839,755,839,0,0,70,189,70,189,0,0,15,15,0,0,0,0,0,0,0
50,0,1,16.0,17.0,23.0,22.0,811,839,811,839,0,0,40,39,40,39,0,0,15,16,0,0,0,0,0,0,0
57,0,1,17.0,17.0,23.0,22.0,755,839,755,839,0,0,130,144,130,144,0,0,16,16,0,0,0,0,0,0,0
64,0,1,18.0,17.0,23.0,22.0,867,895,867,895,0,0,185,259,185,259,0,0,17,17,0,0,0,0,0,0,0
71,0,1,18.0,17.0,23.0,22.0,855,923,811,923,44,0,283,24,275,24,8,0,17,16,0,0,0,0,0,0,0
79,0,1,19.0,17.0,23.0,22.0,945,895,811,895,134,0,344,129,320,129,24,0,18,16,0,0,0,0,0,0,0
86,0,1,19.0,17.0,23.0,22.0,995,923,839,923,156,0,464,219,420,219,44,0,18,17,0,0,0,0,0,0,0
93,0,1,20.0,19.0,23.0,22.0,995,923,839,923,156,0,324,184,310,184,14,0,19,16,0,0,150,250,0,0,0
100,0,1,20.0,21.0,23.0,22.0,1023,923,867,923,156,0,444,144,410,144,34,0,19,16,0,0,150,250,0,0,0
107,0,1,20.0,21.0,23.0,22.0,1023,979,867,979,156,0,159,154,105,154,54,0,19,16,0,0,150,250,0,0,0
114,0,1,20.0,21.0,23.0,22.0,990,923,811,923,179,0,169,269,95,269,74,0,19,16,0,150,150,250,0,0,0
121,0,1,22.0,22.0,23.0,22.0,967,951,811,951,156,0,180,329,90,329,90,0,19,16,100,150,150,250,0,0,0
129,0,1,23.0,22.0,23.0,30.0,1107,956,951,867,156,89,265,290,155,274,110,16,20,16,100,150,150,250,0,0,0
136,0,1,23.0,25.0,31.0,30.0,1079,967,923,811,156,156,75,350,45,314,30,36,20,17,100,300,150,250,0,0,0
143,0,1,24.0,29.0,31.0,36.0,1079,995,923,839,156,156,160,215,110,159,50,56,21,18,150,300,150,250,0,0,0
150,0,1,24.0,29.0,31.0,36.0,1186,1018,1007,839,179,179,160,340,140,264,20,76,21,19,150,300,150,250,0,0,0
157,0,1,25.0,31.0,31.0,36.0,1163,1074,1007,895,156,179,291,365,255,269,36,96,22,20,150,300,150,250,0,0,0
164,0,1,26.0,31.0,31.0,36.0,1180,1107,979,951,201,156,394,496,330,384,64,112,23,21,150,300,150,250,0,0,0
171,0,1,26.0,35.0,31.0,36.0,1208,1135,895,979,313,156,444,136,340,104,104,32,23,22,150,450,150,250,0,0,0
179,0,1,27.0,35.0,46.0,36.0,1348,1141,1035,1007,313,134,349,272,230,224,119,48,24,26,150,600,400,250,0,0,0
186,0,1,29.0,34.0,46.0,44.0,1202,1146,867,1035,335,111,134,114,75,54,59,60,24,25,150,600,500,250,0,0,0
193,0,1,29.0,36.0,46.0,44.0,1286,1365,951,1231,335,134,305,180,210,104,95,76,25,25,150,600,575,250,0,0,0
200,0,1,35.0,41.0,46.0,44.0,1510,1449,1175,1315,335,134,75,106,40,14,35,92,25,26,250,600,675,250,0,0,0
207,0,1,36.0,41.0,46.0,44.0,1516,1482,1203,1371,313,111,201,278,130,174,71,104,25,29,250,600,675,250,0,0,0
214,0,1,38.0,43.0,46.0,44.0,1600,1538,1287,1427,313,111,281,119,170,99,111,20,27,32,250,600,575,250,25,0,0
221,0,1,37.0,44.0,46.0,44.0,1762,1729,1427,1595,335,134,481,175,330,139,151,36,27,32,250,600,825,250,125,0,0
229,0,1,39.0,44.0,46.0,44.0,1852,1807,1539,1651,313,156,642,275,455,219,187,56,29,33,500,600,825,250,125,0,0
236,0,1,42.0,44.0,54.0,44.0,1936,1863,1623,1707,313,156,427,510,400,434,27,76,30,33,500,600,825,250,125,0,0
243,0,1,44.0,52.0,54.0,60.0,2042,1858,1707,1679,335,179,102,170,60,74,42,96,31,33,500,600,825,250,125,0,0
250,0,1,46.0,54.0,54.0,60.0,2070,1914,1735,1735,335,179,247,200,165,84,82,116,31,41,500,750,825,250,125,0,0
257,0,1,48.0,56.0,54.0,66.0,2070,1723,1735,1567,335,156,288,156,170,74,118,82,33,41,500,750,825,250,125,0,0
264,0,1,52.0,54.5,54.0,74.0,2160,1863,1847,1707,313,156,179,291,150,189,29,102,34,40,600,725,900,250,175,25,0
271,0,1,52.0,55.5,54.0,74.0,1964,2199,1651,2043,313,156,299,251,230,129,69,122,34,40,600,725,900,250,175,56,0
279,0,1,59.0,57.5,62.0,82.0,2076,2115,1763,1959,313,156,119,271,110,129,9,142,36,39,850,725,900,250,175,56,0
286,0,1,59.0,59.5,62.0,82.0,2244,2194,1931,2015,313,179,419,176,370,114,49,62,36,44,850,875,900,250,175,56,0
293,0,1,61.0,62.5,62.0,82.0,2345,2250,1987,2071,358,179,439,241,350,159,89,82,38,46,950,875,900,500,175,56,0
300,0,1,61.0,67.5,70.0,82.0,2412,2283,2099,2127,313,156,386,217,315,119,71,98,38,49,1225,875,900,625,175,56,0
307,0,1,64.0,70.5,70.0,82.0,2468,2507,2155,2351,313,156,166,357,155,239,11,118,40,50,1225,875,900,825,175,56,0
314,0,1,64.0,75.5,85.0,82.0,2244,2518,1931,2295,313,223,106,264,55,114,51,150,42,54,1225,875,900,825,175,56,0
321,0,1,65.0,80.5,85.0,82.0,2272,2720,1959,2407,313,313,331,345,240,159,91,186,42,54,1475,875,900,825,175,56,0
329,0,1,68.0,79.5,85.0,82.0,2546,2608,2211,2407,335,201,381,510,300,304,81,206,43,59,1525,875,1025,825,175,106,0
336,0,1,68.0,77.5,85.0,82.0,2306,2731,1903,2463,403,268,529,666,400,424,129,242,43,62,1525,1025,1150,825,175,106,0
343,0,1,70.0,81.5,85.0,82.0,2451,3045,1847,2575,604,470,550,477,445,329,105,148,45,62,1525,1025,1550,1075,175,106,0
350,0,1,72.0,81.5,85.0,82.0,2860,3185,2211,2715,649,470,386,748,255,594,131,154,45,64,1575,1025,1550,1200,175,106,0
357,0,1,77.0,81.5,93.0,82.0,3034,3174,2407,2659,627,515,192,412,85,194,107,218,47,64,1575,1275,1550,1200,175,106,0
364,0,1,79.0,80.5,93.0,82.0,3084,3342,2435,2603,649,739,447,523,260,209,187,314,47,63,1675,1275,1550,1450,175,106,0
371,0,1,87.0,81.5,93.0,82.0,3230,3235,2603,2519,627,716,253,834,190,444,63,390,49,63,1825,1275,1550,1450,175,106,0
379,0,1,90.0,88.5,93.0,138.0,3224,3358,2575,2687,649,671,468,169,325,49,143,120,50,63,1825,1275,1550,1450,175,106,0
386,0,1,94.0,87.5,101.0,138.0,3381,3252,2687,2603,694,649,663,345,440,174,223,171,52,63,1925,1125,1650,1450,175,331,0
393,0,1,100.0,89.5,101.0,138.0,3532,3314,2883,2687,649,627,510,596,265,349,245,247,53,63,2025,1425,1650,1450,175,331,0
400,0,1,101.0,97.5,101.0,138.0,3112,3392,2463,2743,649,649,541,256,220,104,321,152,55,63,2075,1425,1800,1450,175,331,0
407,0,1,101.0,97.5,101.0,138.0,3230,3442,2603,2771,627,671,292,547,195,377,97,170,56,66,2625,1425,1950,1450,175,355,0
414,0,1,114.0,101.5,117.0,138.0,3062,3526,2435,2855,627,671,122,572,95,322,27,250,57,66,2825,1775,1950,1700,175,355,0
421,0,1,116.0,101.5,125.0,138.0,3269,3594,2575,2855,694,739,80,685,65,347,15,338,57,66,2825,2425,1950,1700,175,355,0
429,0,1,119.0,101.5,133.0,154.0,3762,3599,2911,2771,851,828,405,675,290,462,115,213,60,70,2875,2425,1950,1700,175,355,0
436,0,1,122.0,111.5,133.0,152.0,3874,3549,3023,2743,851,806,691,417,480,112,211,305,60,70,3225,2425,1950,1700,175,455,0
443,0,1,131.0,110.0,141.0,144.0,3890,3610,3107,2827,783,783,449,643,300,342,149,301,61,69,3675,2450,2150,1700,175,680,0
450,0,1,136.0,115.5,141.0,144.0,3745,3773,2939,2967,806,806,434,743,385,342,49,401,62,69,3825,2875,2150,1700,175,755,0
457,0,1,141.0,124.0,141.0,152.0,3801,3935,2995,3107,806,828,369,368,220,67,149,301,64,68,3925,3050,2150,1700,175,780,0
464,0,1,141.0,124.0,141.0,152.0,3694,3795,2911,2967,783,828,755,795,510,402,245,393,65,75,4175,3050,2150,1825,175,780,0
471,0,1,141.0,130.0,141.0,152.0,3655,4019,2827,3191,828,828,825,280,655,212,170,68,67,75,4325,3050,2400,1825,175,780,0
479,0,1,141.0,136.0,141.0,160.0,3706,3885,2855,3079,851,806,961,217,695,157,266,60,67,75,4725,3000,2400,1825,175,930,0
486,0,1,130.0,132.5,157.0,160.0,3454,4114,2603,3331,851,783,836,643,470,487,366,156,67,74,3925,3725,2400,1825,975,1080,0
493,0,1,127.0,129.0,157.0,152.0,2513,4081,1707,3275,806,806,959,773,505,517,454,256,65,74,3725,3600,2650,1825,1275,1805,0
500,0,1,132.0,122.0,173.0,152.0,2434,4131,1651,3303,783,828,906,968,360,712,546,256,68,75,3725,3200,2650,1825,1375,2355,0
507,0,1,140.0,129.0,173.0,152.0,3050,3913,2267,3107,783,806,563,374,75,272,488,102,68,78,3775,3350,2650,1950,1375,2355,0
514,0,1,144.0,129.0,173.0,160.0,3358,3879,2463,3051,895,828,679,855,175,657,504,198,70,78,3925,3350,2650,1950,1375,2355,0
521,0,1,146.0,125.0,173.0,160.0,3482,3930,2519,3079,963,851,635,1030,190,732,445,298,71,88,4175,2600,2650,1950,1375,3105,0
529,0,1,145.0,127.5,173.0,166.0,3588,4137,2603,3331,985,806,970,722,405,532,565,190,71,88,4425,1975,2650,1950,1525,3655,0
536,0,1,130.0,130.5,189.0,142.0,3588,4086,2603,3303,985,783,1246,323,565,237,681,86,71,86,3275,1275,2650,1950,2225,4855,0
543,0,1,131.0,126.5,189.0,142.0,3610,3997,2603,3079,1007,918,1248,458,580,252,668,206,71,86,3275,575,2650,2200,2575,5555,0
550,0,1,134.0,118.5,189.0,142.0,3616,3840,2631,2855,985,985,1534,291,750,152,784,139,71,77,3325,925,2650,2200,2575,6455,0
557,0,1,139.0,120.5,204.0,142.0,3650,3314,2687,2463,963,851,1425,127,650,92,775,35,71,77,3425,1775,2650,2200,2575,6630,0
564,0,1,138.0,121.0,204.0,136.0,3823,3711,2883,2883,940,828,1656,512,865,377,791,135,72,77,3575,1850,2650,2200,2675,7055,0
571,0,1,146.0,119.0,204.0,136.0,4070,3717,3107,2911,963,806,1371,604,660,377,711,227,74,76,3625,2850,2650,2200,2775,7105,0
579,0,1,148.0,121.5,204.0,136.0,3857,3885,2827,3079,1030,806,1416,444,735,342,681,102,74,75,3625,3125,2875,2200,2775,7180,0
586,0,1,160.0,125.5,204.0,136.0,3812,3722,2827,2939,985,783,1048,495,505,347,543,148,77,74,4100,3125,2950,2200,2775,7180,0
593,0,1,162.0,131.5,204.0,136.0,4462,3739,3499,2911,963,828,1040,235,385,137,655,98,78,74,4100,3325,2950,2200,2775,7180,0
600,0,1,166.0,131.5,204.0,136.0,4882,3773,3919,2967,963,806,996,291,225,97,771,194,78,74,4800,3325,2950,2200,2775,7180,0
607,0,1,172.0,131.5,204.0,136.0,5055,3706,4115,2855,940,851,1082,231,395,187,687,44,78,74,4850,3475,2950,2325,2775,7180,0
614,0,1,154.0,125.5,204.0,128.0,4742,4036,3779,3051,963,985,1532,121,725,57,807,64,78,74,4000,2625,2950,2325,3650,8305,0
621,0,1,165.0,126.0,204.0,160.0,4904,3986,3919,3023,985,963,838,436,415,291,423,145,78,74,4375,3075,2950,2325,3650,8367,0
629,0,1,166.0,129.5,204.0,160.0,4338,4047,3331,3107,1007,940,1263,737,720,476,543,261,78,74,4425,3450,2950,2325,3650,8392,0
636,0,1,170.0,133.5,204.0,160.0,4406,4120,3443,3135,963,985,756,337,255,156,501,181,78,74,5025,3950,2950,2325,3650,8392,0
643,0,1,146.0,123.0,204.0,160.0,4372,4008,3387,3023,985,985,1301,518,680,221,621,297,78,73,3500,2575,3400,2325,5325,9642,0
650,0,1,155.0,121.0,204.0,158.0,4456,4042,3471,3079,985,963,802,759,465,421,337,338,78,73,3925,2725,3400,2325,5375,10192,0
657,0,1,148.0,122.5,204.0,158.0,4187,4008,3247,3023,940,985,1094,385,645,31,449,354,78,73,3650,1800,3400,2325,6075,11042,0
664,0,1,151.0,120.0,204.0,158.0,4294,4204,3331,3219,963,985,1139,541,695,246,444,295,78,73,3825,2075,3625,2675,6075,11217,0
671,0,1,148.0,109.5,219.0,158.0,4338,4126,3331,3163,1007,963,999,822,685,411,314,411,78,73,3525,1050,3625,2675,6525,12342,0
676,0,1,148.0,99.5,219.0,158.0,4338,4064,3331,3079,1007,985,999,821,685,326,314,495,78,73,3525,550,3625,2675,6525,13592,0
7,1,1,13.0,13.0,14.0,14.0,335,335,335,335,0,0,40,40,40,40,0,0,12,12,0,0,0,0,0,0,0
14,1,1,13.0,13.0,14.0,14.0,671,643,671,643,0,0,20,15,20,15,0,0,13,13,0,0,0,0,0,0,0
21,1,1,14.0,14.0,14.0,14.0,671,699,671,699,0,0,45,55,45,55,0,0,13,13,0,0,0,0,0,0,0
29,1,1,14.0,14.0,14.0,14.0,699,755,699,755,0,0,145,155,145,155,0,0,13,13,0,0,0,0,0,0,0
36,1,1,16.0,16.0,22.0,22.0,727,755,727,755,0,0,140,145,140,145,0,0,14,14,0,0,0,0,0,0,0
43,1,1,16.0,16.0,22.0,22.0,811,839,811,839,0,0,230,240,230,240,0,0,16,15,0,0,0,0,0,0,0
50,1,1,15.0,15.0,22.0,22.0,783,755,783,755,0,0,30,35,30,35,0,0,15,15,0,0,0,0,0,0,0
57,1,1,17.0,17.0,22.0,22.0,867,867,867,867,0,0,40,40,40,40,0,0,15,15,0,0,0,0,0,0,0
64,1,1,18.0,18.0,22.0,22.0,923,923,923,923,0,0,90,95,90,95,0,0,16,16,0,0,0,0,0,0,0
71,1,1,17.0,17.0,22.0,22.0,951,895,951,895,0,0,175,170,175,170,0,0,17,17,0,0,0,0,0,0,0
79,1,1,17.0,17.0,22.0,22.0,951,923,951,923,0,0,35,30,35,30,0,0,16,16,0,0,0,0,0,0,0
86,1,1,18.0,18.0,22.0,22.0,951,951,951,951,0,0,95,85,95,85,0,0,16,16,0,0,0,0,0,0,0
93,1,1,19.0,19.0,22.0,22.0,895,979,895,979,0,0,145,155,145,155,0,0,18,18,0,0,0,0,0,0,0
100,1,1,20.0,20.0,22.0,22.0,978,1006,867,895,111,111,215,220,195,200,20,20,19,19,0,0,0,0,0,0,0
107,1,1,20.0,20.0,22.0,22.0,1102,1074,923,895,179,179,350,340,310,300,40,40,19,19,0,0,0,0,0,0,0
114,1,1,21.0,21.0,22.0,22.0,1102,1130,923,951,179,179,420,430,360,370,60,60,20,20,0,0,0,0,0,0,0
121,1,1,26.0,26.0,28.0,28.0,1107,1074,951,895,156,179,96,200,20,120,76,80,21,20,0,0,250,250,0,0,0
129,1,1,26.0,26.0,28.0,28.0,1079,1051,923,895,156,156,236,231,140,135,96,96,21,21,0,0,250,250,0,0,0
136,1,1,28.0,28.0,28.0,28.0,1141,1012,1007,923,134,89,72,64,60,60,12,4,21,21,0,0,250,250,0,0,0
143,1,1,30.0,28.0,36.0,36.0,1174,1130,1063,1063,111,67,114,207,90,195,24,12,22,21,50,50,250,250,0,0,0
150,1,1,30.0,30.0,36.0,36.0,1174,1186,1063,1119,111,67,255,255,215,235,40,20,23,23,50,50,250,250,0,0,0
157,1,1,29.0,29.0,36.0,36.0,1253,1270,1119,1203,134,67,116,108,60,80,56,28,23,22,350,350,250,250,0,0,0
164,1,1,31.0,31.0,36.0,36.0,1253,1270,1119,1203,134,67,167,61,95,25,72,36,23,23,400,400,250,250,0,0,0
171,1,1,32.0,32.0,36.0,36.0,1230,1331,1119,1287,111,44,59,165,25,125,34,40,23,23,400,400,250,250,0,0,0
179,1,1,32.5,34.0,36.0,36.0,1337,1326,1203,1259,134,67,85,228,35,180,50,48,24,25,375,400,250,250,25,0,0
186,1,1,33.5,35.0,36.0,44.0,1398,1460,1287,1371,111,89,192,345,130,285,62,60,26,26,375,400,250,250,25,0,0
193,1,1,35.5,42.0,36.0,44.0,1449,1533,1315,1399,134,134,213,181,135,105,78,76,27,27,375,450,250,250,25,0,0
200,1,1,40.5,41.0,44.0,44.0,1533,1454,1399,1343,134,111,154,103,60,15,94,88,28,27,375,450,250,250,25,0,0
207,1,1,42.5,43.0,44.0,44.0,1538,1561,1427,1427,111,134,141,198,35,90,106,108,28,27,375,650,250,250,25,0,0
214,1,1,42.0,44.0,44.0,44.0,1678,1499,1567,1343,111,156,137,328,115,200,22,128,31,28,450,800,450,250,50,0,0
221,1,1,44.0,43.5,52.0,52.0,1706,1611,1595,1455,111,156,149,528,115,380,34,148,31,30,500,775,450,250,50,25,0
229,1,1,47.5,44.0,58.0,58.0,1762,1555,1651,1399,111,156,105,358,80,190,25,168,31,30,875,700,450,250,75,100,0
236,1,1,48.0,43.5,58.0,58.0,1813,1690,1679,1511,134,179,281,508,240,320,41,188,31,30,900,625,450,250,75,175,0
243,1,1,52.0,55.5,66.0,74.0,1785,1690,1651,1511,134,179,297,118,240,60,57,58,31,31,1100,625,450,450,100,175,0
250,1,1,52.0,59.5,66.0,66.0,1790,1807,1679,1651,111,156,384,124,315,100,69,24,31,31,1150,625,450,450,100,275,0
257,1,1,52.0,61.5,66.0,66.0,1673,1779,1539,1623,134,156,305,144,220,125,85,19,33,31,1150,825,450,450,100,275,0
264,1,1,53.0,66.0,66.0,66.0,1813,1779,1679,1623,134,156,381,104,280,90,101,14,35,31,1150,1450,450,450,100,300,0
271,1,1,59.5,70.0,66.0,74.0,1947,1751,1791,1595,156,156,176,119,55,85,121,34,37,31,1125,1550,450,450,125,300,0
279,1,1,60.5,72.0,66.0,74.0,1947,1723,1791,1567,156,156,226,124,85,70,141,54,37,31,1125,1750,575,450,125,300,0
286,1,1,59.5,73.0,74.0,74.0,2003,1830,1735,1651,268,179,276,204,195,130,81,74,41,31,1125,1900,575,450,125,300,0
293,1,1,59.0,74.0,82.0,82.0,2216,1779,1903,1623,313,156,556,365,435,275,121,90,42,31,1200,2150,575,450,150,300,0
300,1,1,74.0,79.0,90.0,90.0,2294,1779,1959,1623,335,156,66,315,55,205,11,110,42,31,1200,2200,775,450,150,300,0
307,1,1,78.0,83.0,84.0,90.0,1964,1779,1651,1623,313,156,102,240,80,110,22,130,42,31,1400,2300,775,450,575,300,0
314,1,1,77.0,85.0,84.0,90.0,2205,1779,1847,1623,358,156,276,300,210,150,66,150,42,31,1850,2500,775,450,575,350,0
321,1,1,75.5,83.5,84.0,98.0,2233,1807,1763,1651,470,156,251,190,125,20,126,170,42,32,1975,2325,775,450,625,675,0
329,1,1,73.0,81.5,92.0,98.0,2311,1830,1819,1651,492,179,172,375,90,185,82,190,42,35,1850,2325,775,450,850,675,0
336,1,1,77.5,82.5,92.0,98.0,2317,1802,1847,1623,470,179,153,230,15,120,138,110,41,37,1825,2325,775,450,875,675,0
343,1,1,77.5,85.0,92.0,98.0,2339,1975,1847,1819,492,156,228,321,130,195,98,126,44,37,1825,2300,775,450,875,700,0
350,1,1,81.5,90.0,92.0,98.0,2339,2115,1847,1959,492,156,283,221,125,100,158,121,49,40,1825,2300,775,575,875,700,0
357,1,1,82.5,93.0,92.0,98.0,2395,2104,1903,1903,492,201,369,114,180,65,189,49,51,45,1825,2300,775,575,875,700,0
364,1,1,84.5,96.5,92.0,106.0,2339,2412,1847,1987,492,425,539,149,315,40,224,109,52,44,1825,2275,775,575,875,725,0
371,1,1,83.5,98.0,92.0,106.0,2507,2457,2015,1987,492,470,740,230,460,65,280,165,52,47,1775,2350,775,575,925,750,0
379,1,1,97.5,100.5,100.0,106.0,2563,2591,2071,2099,492,492,340,295,175,95,165,200,52,52,1875,2325,775,575,925,775,0
386,1,1,98.0,103.5,108.0,114.0,2686,2670,2127,2155,559,515,407,380,270,145,137,235,52,53,1950,2325,1025,575,950,775,0
393,1,1,98.0,105.0,108.0,122.0,2440,2849,1791,2267,649,582,467,227,250,95,217,132,52,56,1950,2300,1025,825,950,800,0
400,1,1,100.0,109.0,108.0,122.0,2602,3028,1931,2379,671,649,597,388,375,230,222,158,52,56,2650,2400,1025,825,950,800,0
407,1,1,106.5,115.0,122.0,122.0,2630,3134,1959,2463,671,671,368,257,170,90,198,167,53,56,2725,2700,1025,825,975,800,0
414,1,1,108.5,122.0,122.0,130.0,2916,3084,2267,2323,649,761,519,203,245,40,274,163,56,55,2725,2900,1025,825,975,800,0
421,1,1,107.5,127.0,122.0,130.0,2944,3185,2295,2379,649,806,545,303,345,94,200,209,59,56,2825,3200,1150,825,975,731,0
429,1,1,109.5,133.0,130.0,146.0,3028,3174,2379,2323,649,851,610,378,355,144,255,234,61,56,2825,3400,1150,825,975,731,0
436,1,1,121.5,137.0,130.0,154.0,3196,3207,2547,2379,649,828,296,449,115,169,181,280,61,56,2825,3600,1150,825,975,731,0
443,1,1,128.5,147.0,146.0,154.0,3241,3106,2547,2323,694,783,335,336,145,89,190,247,61,56,2825,3800,1150,825,975,731,0
450,1,1,132.5,151.0,146.0,154.0,3330,3185,2547,2379,783,806,631,416,295,119,336,297,61,56,3425,4300,1150,825,975,731,0
457,1,1,139.5,161.0,154.0,162.0,3409,3179,2603,2351,806,828,537,91,380,69,157,22,62,56,3625,4600,1150,825,975,731,0
464,1,1,145.5,165.0,162.0,170.0,3381,3185,2575,2379,806,806,103,82,50,14,53,68,61,56,4225,4800,1150,825,975,731,0
471,1,1,151.5,169.0,162.0,170.0,3487,3129,2659,2323,828,806,223,148,145,34,78,114,61,56,4325,5400,1150,825,975,731,0
479,1,1,159.5,172.5,162.0,178.0,3414,3258,2631,2407,783,851,215,238,145,74,70,164,64,56,4625,5675,1150,825,975,756,0
486,1,1,155.5,160.5,170.0,186.0,3353,3207,2547,2379,806,828,420,604,250,344,170,260,64,56,4625,5275,1150,825,1175,1356,0
493,1,1,143.5,158.0,170.0,194.0,3319,3185,2491,2379,828,806,215,286,95,109,120,177,64,56,3525,4650,1150,825,2400,2181,0
500,1,1,129.5,142.5,178.0,202.0,3543,3269,2715,2463,828,806,141,176,50,24,91,152,64,56,2675,3575,1300,825,3650,3456,0
507,1,1,122.5,138.0,186.0,202.0,3347,3241,2519,2435,828,806,437,252,275,79,162,173,63,56,2225,3550,1300,825,4150,3981,0
514,1,1,119.5,128.5,186.0,202.0,2765,3106,2071,2323,694,783,329,513,195,269,134,244,62,56,2375,3375,1300,825,4700,4556,0
521,1,1,127.5,134.5,178.0,202.0,2586,2927,1959,2099,627,828,246,453,140,309,106,144,62,56,2775,3675,1300,825,4800,4556,0
529,1,1,134.5,140.5,170.0,202.0,2983,2871,2379,2043,604,828,223,184,195,169,28,15,62,56,2775,4175,1300,825,4900,4556,0
536,1,1,142.5,144.5,170.0,202.0,3174,2994,2435,2211,739,783,204,336,180,279,24,57,62,56,3275,4275,1300,825,4900,4556,0
543,1,1,144.5,143.5,170.0,202.0,3280,3073,2519,2267,761,806,415,386,320,229,95,157,62,55,3875,4475,1300,825,4900,4556,0
550,1,1,150.5,151.5,170.0,202.0,3168,3123,2407,2295,761,828,292,201,230,44,62,157,62,54,3975,4675,1300,825,5100,4656,0
557,1,1,149.0,139.5,170.0,202.0,3185,3073,2379,2267,806,806,72,162,60,9,12,153,62,54,3500,3875,1300,825,5800,5656,0
564,1,1,143.0,110.5,178.0,202.0,3224,3017,2351,2211,873,806,48,423,40,199,8,224,62,57,2800,2575,1300,825,6500,7356,0
571,1,1,142.0,109.5,178.0,202.0,3314,3106,2463,2211,851,895,419,186,315,104,104,82,61,56,3300,2375,1300,825,6500,7556,0
579,1,1,146.0,112.5,178.0,202.0,3106,3174,2323,2211,783,963,482,167,340,69,142,98,61,56,4000,2475,1300,825,6500,7856,0
586,1,1,148.0,116.5,178.0,202.0,3218,3151,2435,2211,783,940,282,335,265,179,17,156,60,56,4300,2575,1300,825,6500,7856,0
593,1,1,156.0,127.5,186.0,202.0,3202,3224,2351,2239,851,985,220,130,170,54,50,76,60,56,4300,2975,1300,825,6500,7856,0
600,1,1,162.0,133.5,186.0,194.0,3230,3084,2267,2099,963,985,315,191,220,74,95,117,60,56,4800,3375,1300,825,6500,7956,0
607,1,1,172.0,132.5,186.0,194.0,3358,3202,2351,2239,1007,963,111,177,25,44,86,133,60,56,4800,3275,1300,825,6500,8456,0
614,1,1,162.0,123.5,186.0,194.0,3381,3118,2351,2155,1030,963,512,358,310,159,202,199,60,55,4700,2825,1300,825,7000,9506,0
621,1,1,158.0,105.5,186.0,194.0,3314,3174,2351,2211,963,963,300,275,140,39,160,236,60,55,4100,1925,1300,825,7900,10906,0
627,1,1,158.0,87.5,186.0,194.0,3314,3123,2351,2183,963,940,300,350,140,84,160,266,60,55,4100,1025,1300,825,7900,12006,0
7,2,2,13.0,13.0,15.0,15.0,293,251,293,251,0,0,35,30,35,30,0,0,12,12,0,0,0,0,0,0,1
14,2,2,14.0,14.0,15.0,15.0,643,671,643,671,0,0,65,70,65,70,0,0,13,13,0,0,0,0,0,0,1
21,2,2,14.0,14.0,15.0,15.0,699,699,699,699,0,0,45,50,45,50,0,0,13,13,0,0,0,0,0,0,1
29,2,2,15.0,15.0,15.0,15.0,699,755,699,755,0,0,85,45,85,45,0,0,14,14,0,0,0,0,0,0,1
36,2,2,15.0,15.0,15.0,23.0,811,811,811,811,0,0,140,145,140,145,0,0,14,14,0,0,0,0,0,0,1
43,2,2,16.0,16.0,23.0,23.0,783,783,783,783,0,0,30,35,30,35,0,0,15,15,0,0,0,0,0,0,1
50,2,2,17.0,17.0,23.0,23.0,867,811,867,811,0,0,10,60,10,60,0,0,16,16,0,0,0,0,0,0,1
57,2,2,18.0,18.0,23.0,23.0,895,895,895,895,0,0,45,115,45,115,0,0,17,17,0,0,0,0,0,0,1
64,2,2,19.0,19.0,23.0,23.0,979,923,979,923,0,0,110,100,110,100,0,0,18,18,0,0,0,0,0,0,1
71,2,2,19.0,19.0,23.0,23.0,1007,951,1007,951,0,0,20,65,20,65,0,0,18,18,0,0,0,0,0,0,1
79,2,2,20.0,20.0,23.0,23.0,995,973,951,951,44,22,88,79,80,75,8,4,19,19,0,0,0,0,0,0,1
86,2,2,21.0,21.0,23.0,23.0,1051,1018,895,951,156,67,63,42,35,30,28,12,20,20,0,0,150,150,0,0,1
93,2,2,22.0,22.0,23.0,23.0,1040,1113,839,979,201,134,137,132,85,100,52,32,21,21,0,0,150,150,0,0,1
100,2,2,22.0,22.0,23.0,23.0,1090,1180,867,979,223,201,110,116,30,60,80,56,21,21,0,0,150,150,0,0,1
107,2,2,23.0,23.0,23.0,23.0,1113,1219,867,951,246,268,252,203,140,115,112,88,22,22,0,0,150,150,0,0,1
114,2,2,24.0,24.0,31.0,31.0,1208,1152,895,839,313,313,342,338,190,210,152,128,23,23,0,0,300,150,0,0,1
121,2,2,24.0,28.0,31.0,31.0,1264,1230,951,895,313,335,187,138,145,70,42,68,23,23,0,0,450,450,0,0,1
129,2,2,26.0,29.0,31.0,31.0,1258,1281,923,923,335,358,167,128,135,70,32,58,24,24,0,0,450,450,0,0,1
136,2,2,28.0,29.0,31.0,31.0,1286,1208,951,895,335,313,137,260,115,170,22,90,24,24,0,0,450,450,0,0,1
143,2,2,29.0,30.0,31.0,31.0,1264,1236,951,923,313,313,29,260,25,130,4,130,24,25,0,0,450,450,0,0,1
150,2,2,29.0,30.0,31.0,31.0,1320,1180,1007,867,313,313,194,405,150,235,44,170,24,25,0,0,450,450,0,0,1
157,2,2,29.0,34.0,39.0,39.0,1292,1264,979,951,313,313,344,260,260,250,84,10,25,26,175,350,450,450,0,0,1
164,2,2,29.0,34.0,39.0,39.0,1236,1236,923,923,313,313,494,415,370,365,124,50,25,26,350,350,450,450,0,0,1
171,2,2,32.0,35.0,39.0,39.0,1286,1281,951,923,335,358,354,110,340,20,14,90,25,26,350,350,750,450,0,0,1
179,2,2,32.0,35.0,39.0,39.0,1309,1286,951,951,358,335,114,161,60,35,54,126,25,26,350,350,750,450,0,0,1
186,2,2,33.0,36.0,39.0,39.0,1286,1180,951,867,335,313,105,197,15,35,90,162,25,27,350,650,750,450,0,0,1
193,2,2,33.0,39.0,39.0,39.0,1292,1264,979,951,313,313,216,212,90,110,126,102,25,28,350,650,750,450,0,0,1
200,2,2,34.0,40.0,47.0,47.0,1208,1270,895,979,313,291,371,68,205,30,166,38,26,29,650,650,750,450,0,0,1
207,2,2,37.0,40.0,47.0,47.0,1348,1432,1035,1119,313,313,81,188,25,110,56,78,26,29,650,650,750,450,0,0,1
214,2,2,38.0,41.0,47.0,47.0,1292,1376,979,1063,313,313,141,308,45,190,96,118,27,30,650,800,750,450,0,0,1
221,2,2,39.0,42.0,47.0,47.0,1320,1482,1007,1147,313,335,97,378,65,220,32,158,28,31,650,800,750,450,0,0,1
229,2,2,39.0,45.0,47.0,47.0,1348,1426,1035,1091,313,335,153,149,85,55,68,94,28,30,650,975,750,450,0,50,1
236,2,2,40.0,46.0,47.0,47.0,1264,1320,951,1007,313,313,249,245,145,115,104,130,29,31,950,1150,850,700,0,50,1
243,2,2,40.0,47.0,47.0,62.0,1320,1264,1007,951,313,313,319,55,175,35,144,20,29,31,950,1150,850,700,0,50,1
250,2,2,42.0,48.0,62.0,62.0,1275,1628,1007,1315,268,313,366,215,190,155,176,60,30,32,950,1150,850,800,0,50,1
257,2,2,43.0,47.0,62.0,62.0,1410,1734,1119,1399,291,335,527,150,315,100,212,50,31,29,950,1325,1100,800,0,250,1
264,2,2,44.0,48.0,62.0,62.0,1460,1706,1147,1371,313,335,212,181,110,95,102,86,32,30,950,1325,1100,800,0,300,1
271,2,2,50.0,50.0,62.0,62.0,1678,1600,1343,1287,335,313,67,232,25,110,42,122,34,32,1125,1325,1100,800,0,300,1
279,2,2,52.0,51.0,62.0,62.0,1785,1634,1427,1343,358,291,232,374,150,220,82,154,36,33,1300,1325,1250,800,0,300,1
286,2,2,53.0,53.0,62.0,62.0,1824,1746,1511,1455,313,291,144,550,130,360,14,190,37,35,1300,1325,1250,800,0,300,1
293,2,2,54.0,53.0,62.0,62.0,1852,1768,1539,1455,313,313,189,315,135,85,54,230,38,35,1300,1325,1250,800,0,300,1
300,2,2,55.0,55.0,62.0,62.0,1964,1992,1651,1679,313,313,384,360,290,90,94,270,40,37,1300,1325,1250,950,0,300,1
307,2,2,58.0,56.0,70.0,62.0,1992,1964,1679,1651,313,313,70,350,40,140,30,210,40,38,1300,1325,1250,950,0,300,1
314,2,2,59.0,57.0,70.0,70.0,1998,2104,1707,1791,291,313,297,222,235,80,62,142,41,39,1450,1325,1250,950,0,300,1
321,2,2,60.0,61.0,70.0,70.0,2037,2048,1679,1735,358,313,505,192,395,60,110,132,42,41,1450,1325,1250,950,0,300,1
329,2,2,63.0,64.0,70.0,70.0,2210,2132,1763,1819,447,313,146,223,30,105,116,118,43,42,1450,1675,1250,950,0,300,1
336,2,2,64.0,66.0,70.0,70.0,2261,2104,1791,1791,470,313,256,233,80,75,176,158,45,44,1625,1675,1250,950,0,300,1
343,2,2,67.0,66.0,70.0,70.0,2367,2166,1875,1763,492,403,326,350,140,140,186,210,46,45,1800,1675,1250,950,0,300,1
350,2,2,68.0,68.0,70.0,70.0,2306,2289,1791,1819,515,470,432,385,190,115,242,270,47,46,1800,1675,1400,950,0,300,1
357,2,2,71.0,71.0,78.0,78.0,2255,2311,1763,1819,492,492,468,235,220,30,248,205,47,46,1975,1675,1550,1200,0,300,1
364,2,2,78.0,76.0,78.0,93.0,2311,2362,1819,1847,492,515,169,250,15,35,154,215,48,48,2325,1850,1550,1200,0,300,1
371,2,2,78.0,77.0,86.0,93.0,2317,2479,1847,1987,470,492,345,297,135,30,210,267,49,49,2500,2025,1550,1300,0,300,1
379,2,2,79.0,79.0,86.0,101.0,2373,2625,1903,2155,470,470,535,463,265,140,270,323,49,51,2500,2125,1550,1300,50,300,1
386,2,2,82.0,84.0,86.0,101.0,2395,2759,1903,2267,492,492,555,618,275,285,280,333,50,54,2675,2300,1550,1300,50,300,1
393,2,2,89.0,87.0,94.0,109.0,2255,2927,1763,2435,492,492,205,748,15,405,190,343,51,55,2675,2475,1550,1600,50,300,1
400,2,2,89.0,91.0,109.0,109.0,2423,3067,1931,2575,492,492,147,265,55,70,92,195,51,58,3200,2475,1550,1600,50,300,1
407,2,2,93.0,93.0,109.0,109.0,2457,3179,1987,2687,470,492,248,385,150,130,98,255,52,58,3200,2825,1550,1600,50,300,1
414,2,2,94.0,93.0,117.0,109.0,2619,3269,2127,2799,492,470,508,777,350,470,158,307,55,60,3200,2825,1550,1600,50,300,1
421,2,2,96.0,95.0,117.0,109.0,2933,3269,2463,2799,470,470,324,753,210,390,114,363,55,60,3375,2825,1550,1600,50,300,1
429,2,2,98.0,95.0,117.0,109.0,2871,3190,2379,2743,492,447,314,625,140,210,174,415,57,60,3375,2825,1550,1600,50,300,1
436,2,2,99.0,95.0,117.0,109.0,2983,3213,2491,2743,492,470,665,610,435,285,230,325,58,60,3375,2825,1550,1600,50,300,1
443,2,2,101.0,95.0,117.0,117.0,3045,3179,2575,2687,470,492,286,895,100,510,186,385,61,60,3375,2825,1550,1600,50,300,1
450,2,2,103.0,95.0,117.0,117.0,3028,3269,2491,2799,537,470,533,606,275,265,258,341,62,60,3375,2825,1550,1900,50,300,1
457,2,2,103.0,107.0,117.0,125.0,3202,3246,2463,2799,739,447,580,594,430,205,150,389,63,60,3375,3175,1550,2050,50,300,1
464,2,2,103.0,111.0,117.0,133.0,3246,3308,2463,2883,783,425,566,681,320,240,246,441,64,60,3375,3675,1550,2050,50,300,1
471,2,2,107.0,114.0,117.0,133.0,3269,3168,2463,2743,806,425,461,843,115,350,346,493,65,60,3375,3675,1550,2200,50,300,1
479,2,2,109.0,124.0,117.0,133.0,3274,3246,2491,2799,783,447,737,729,295,180,442,549,65,60,3675,3675,1850,2200,50,300,1
486,2,2,110.0,128.0,117.0,141.0,3302,3235,2519,2743,783,492,729,769,195,160,534,609,65,63,3675,4550,2100,2200,50,300,1
493,2,2,113.0,129.0,125.0,141.0,3274,2989,2491,2519,783,470,816,930,190,340,626,590,66,63,3675,4750,2750,2200,50,300,1
500,2,2,123.0,129.0,133.0,141.0,3302,2899,2519,2407,783,492,317,935,195,485,122,450,66,63,4575,4750,2750,2500,50,300,1
507,2,2,130.0,139.0,141.0,141.0,3381,2916,2575,2379,806,537,367,674,145,160,222,514,67,63,4075,4750,2750,2500,50,300,1
514,2,2,129.0,147.0,141.0,156.0,3510,3028,2659,2379,851,649,832,636,510,50,322,586,67,63,4975,5350,2900,2650,50,300,1
521,2,2,132.0,149.0,141.0,164.0,3437,3196,2631,2547,806,649,470,922,260,260,210,662,67,63,5325,5850,3050,2750,50,300,1
529,2,2,130.0,147.0,141.0,164.0,3437,3258,2631,2631,806,627,875,1293,565,555,310,738,67,63,5150,5750,3200,2750,225,400,1
536,2,2,137.0,147.0,141.0,164.0,3549,3146,2743,2519,806,627,746,1688,640,870,106,818,68,63,5150,5750,3200,2750,225,400,1
543,2,2,142.0,157.0,157.0,164.0,3302,3532,2519,2883,783,649,532,1119,330,975,202,144,68,63,5450,5750,3200,3100,225,400,1
550,2,2,144.0,163.0,172.0,164.0,3364,3526,2603,2855,761,671,834,674,540,600,294,74,69,63,5900,5950,3200,3100,225,400,1
557,2,2,158.0,163.0,180.0,164.0,3549,3504,2743,2855,806,649,269,996,175,850,94,146,70,63,6125,6400,3200,3100,400,400,1
564,2,2,156.0,161.0,180.0,164.0,3829,3482,3023,2855,806,627,754,1422,560,1200,194,222,72,63,6225,7200,3200,3100,500,500,1
571,2,2,162.0,169.0,180.0,188.0,3991,3504,3163,2855,828,649,485,1327,295,1025,190,302,72,63,6575,7200,3450,3100,600,500,1
579,2,2,162.0,179.0,180.0,196.0,3941,3426,3135,2799,806,627,607,1058,325,680,282,378,72,63,6575,8100,3450,3250,600,500,1
586,2,2,175.0,179.0,180.0,196.0,3907,3454,3079,2827,828,627,182,1468,100,1010,82,458,76,63,6875,8100,3450,3250,600,500,1
593,2,2,175.0,189.0,180.0,204.0,3890,3582,3107,2911,783,671,539,1413,365,875,174,538,77,63,7425,8100,3450,3250,600,500,1
600,2,2,183.0,199.0,196.0,220.0,3969,3498,3163,2827,806,671,634,1305,360,695,274,610,77,63,7425,9100,3600,3250,600,500,1
607,2,2,183.0,195.0,220.0,220.0,4109,3538,3303,2911,806,627,1120,1752,750,1070,370,682,77,63,8200,8825,3600,3250,600,775,1
614,2,2,162.0,167.0,220.0,220.0,4137,3510,3331,2883,806,627,1226,2172,760,1410,466,762,77,63,6600,7425,3600,3250,2200,2175,1
621,2,2,142.0,147.0,220.0,220.0,4131,3482,3303,2855,828,627,1706,1587,1140,745,566,842,77,63,5775,6425,3600,3250,3425,4175,1
629,2,2,132.0,123.0,220.0,220.0,4159,3532,3331,2883,828,649,977,1642,665,820,312,822,77,63,4925,4625,3600,3250,5150,5975,1
636,2,2,118.0,103.0,220.0,220.0,4187,3616,3359,2967,828,649,1463,2078,1055,1180,408,898,77,63,3675,3300,3600,3250,6400,7300,1
643,2,2,122.0,117.0,220.0,220.0,4226,3638,3443,2967,783,671,1095,739,695,265,400,474,77,63,3625,4550,3600,3250,6950,7800,1
650,2,2,120.0,115.0,220.0,220.0,4193,3644,3387,2995,806,649,860,1175,560,625,300,550,77,63,3075,4400,3500,3250,7525,7950,1
657,2,2,108.0,110.0,220.0,220.0,4193,3560,3387,2911,806,649,980,1191,630,765,350,426,77,63,2225,3975,3500,3250,9000,8375,1
664,2,2,116.0,120.0,220.0,220.0,3997,3650,3191,3023,806,627,852,207,410,55,442,152,77,63,2725,3175,3500,3250,9100,9175,1
671,2,2,101.0,118.0,220.0,220.0,4019,3504,3191,2855,828,649,1337,507,795,275,542,232,76,63,1825,4725,3500,3250,10425,9525,1
7,2,1,13.0,13.0,15.0,14.0,293,251,293,251,0,0,35,30,35,30,0,0,12,12,0,0,0,0,0,0,1
14,2,1,14.0,13.0,15.0,14.0,671,671,671,671,0,0,70,20,70,20,0,0,13,13,0,0,0,0,0,0,1
21,2,1,14.0,14.0,15.0,14.0,699,755,699,755,0,0,50,55,50,55,0,0,13,13,0,0,0,0,0,0,1
29,2,1,15.0,14.0,15.0,14.0,699,727,699,727,0,0,80,135,80,135,0,0,14,13,0,0,0,0,0,0,1
36,2,1,15.0,16.0,15.0,22.0,783,783,783,783,0,0,190,140,190,140,0,0,14,14,0,0,0,0,0,0,1
43,2,1,16.0,16.0,23.0,22.0,783,755,783,755,0,0,75,225,75,225,0,0,15,14,0,0,0,0,0,0,1
50,2,1,17.0,15.0,23.0,22.0,783,783,783,783,0,0,45,30,45,30,0,0,16,15,0,0,0,0,0,0,1
57,2,1,18.0,17.0,23.0,22.0,811,839,811,839,0,0,105,30,105,30,0,0,17,15,0,0,0,0,0,0,1
64,2,1,19.0,18.0,23.0,22.0,895,867,895,867,0,0,160,90,160,90,0,0,18,16,0,0,0,0,0,0,1
71,2,1,19.0,17.0,23.0,22.0,917,867,895,867,22,0,279,175,275,175,4,0,18,17,0,0,0,0,0,0,1
79,2,1,20.0,17.0,23.0,22.0,939,951,895,951,44,0,343,40,335,40,8,0,19,16,0,0,0,0,0,0,1
86,2,1,20.0,18.0,23.0,22.0,1018,895,951,895,67,0,66,100,50,100,16,0,19,16,0,0,150,0,0,0,1
93,2,1,20.0,19.0,23.0,22.0,990,979,923,979,67,0,184,160,160,160,24,0,20,18,0,0,150,0,0,0,1
100,2,1,20.0,20.0,23.0,22.0,1051,1018,895,951,156,67,84,232,40,220,44,12,20,18,0,0,150,0,0,0,1
107,2,1,21.0,20.0,23.0,22.0,995,1057,839,923,156,134,145,353,85,325,60,28,20,19,0,0,150,0,0,0,1
114,2,1,21.0,20.0,23.0,22.0,1023,1079,867,923,156,156,175,383,95,335,80,48,20,20,0,0,150,0,0,0,1
121,2,1,22.0,26.0,23.0,28.0,1023,1051,867,895,156,156,250,108,150,40,100,68,21,20,0,0,150,250,0,0,1
129,2,1,23.0,26.0,31.0,36.0,1113,1130,867,951,246,179,327,248,195,160,132,88,22,20,0,0,150,250,0,0,1
136,2,1,25.0,28.0,31.0,36.0,1152,1113,839,979,313,134,337,80,190,80,147,0,22,20,0,0,300,250,0,0,1
143,2,1,26.0,29.0,31.0,36.0,1180,1130,867,1063,313,67,122,173,85,165,37,8,23,20,0,100,300,250,0,0,1
150,2,1,26.0,30.0,31.0,36.0,1286,1130,951,1063,335,67,62,251,60,235,2,16,23,22,0,100,300,250,0,0,1
157,2,1,30.0,31.0,46.0,36.0,1281,1219,923,1175,358,44,107,55,65,35,42,20,24,24,125,400,300,250,0,0,1
164,2,1,30.0,32.0,46.0,36.0,1320,1326,1007,1259,313,67,204,73,130,45,74,28,24,23,125,400,300,250,0,0,1
171,2,1,32.0,33.0,46.0,36.0,1320,1354,1007,1287,313,67,264,76,150,40,114,36,26,24,125,400,300,250,0,0,1
179,2,1,34.0,36.0,46.0,36.0,1404,1387,1091,1343,313,44,234,95,80,55,154,40,28,24,125,400,300,250,0,0,1
186,2,1,36.0,36.0,46.0,44.0,1516,1331,1203,1287,313,44,319,253,125,205,194,48,30,25,250,400,600,250,0,0,1
193,2,1,40.0,39.5,46.0,44.0,1600,1494,1287,1427,313,67,164,236,80,180,84,56,31,28,250,375,600,250,0,25,1
200,2,1,43.0,42.5,46.0,44.0,1729,1527,1371,1483,358,44,189,110,90,50,99,60,32,28,250,525,600,250,0,25,1
207,2,1,44.0,43.5,46.0,44.0,1740,1611,1427,1567,313,44,246,273,115,205,131,68,32,32,250,525,600,250,0,25,1
214,2,1,45.0,43.5,46.0,52.0,1796,1690,1483,1623,313,67,126,341,105,265,21,76,33,32,250,525,600,250,0,25,1
221,2,1,49.0,44.5,54.0,52.0,1818,1718,1483,1651,335,67,191,399,130,315,61,84,35,33,600,525,750,250,0,25,1
229,2,1,50.0,45.5,54.0,52.0,1930,1807,1595,1763,335,44,381,443,280,355,101,88,36,34,725,525,750,250,0,25,1
236,2,1,51.0,47.5,54.0,58.0,2042,1830,1707,1763,335,67,572,471,435,375,137,96,37,35,725,675,750,375,0,25,1
243,2,1,52.0,54.0,62.0,66.0,2020,1914,1707,1847,313,67,248,104,75,0,173,104,38,35,725,650,750,375,0,50,1
250,2,1,53.0,52.0,62.0,74.0,2076,1908,1763,1819,313,89,198,291,85,175,113,116,39,35,1025,650,750,500,0,50,1
257,2,1,54.0,55.0,62.0,74.0,2188,2003,1875,1847,313,156,243,226,90,90,153,136,40,41,1025,650,750,500,0,50,1
264,2,1,57.0,56.0,70.0,74.0,2160,2194,1847,2015,313,179,229,331,65,175,164,156,41,42,1025,650,750,500,0,50,1
271,2,1,60.0,57.5,70.0,74.0,2238,2311,1903,2155,335,156,304,447,200,275,104,172,41,43,1300,625,750,500,0,75,1
279,2,1,60.0,57.5,78.0,82.0,2210,2093,1875,1847,335,246,574,523,430,315,144,208,42,41,1300,775,750,700,0,175,1
286,2,1,62.0,69.5,78.0,90.0,2216,1998,1903,1595,313,403,735,166,555,60,180,106,43,41,1300,775,750,700,0,175,1
293,2,1,64.0,73.5,78.0,82.0,2266,2048,1931,1735,335,313,380,216,210,120,170,96,45,41,1475,925,750,700,0,275,1
300,2,1,64.0,74.5,78.0,82.0,2222,1970,1931,1679,291,291,652,159,450,35,202,124,45,37,1475,925,1000,700,0,475,1
307,2,1,60.0,73.5,78.0,82.0,2328,1270,2015,1091,313,179,923,164,685,20,238,144,45,33,1125,1675,1000,700,350,675,1
314,2,1,68.0,76.5,93.0,82.0,2300,1387,1987,1231,313,156,378,195,300,35,78,160,45,33,1350,2025,1000,700,475,675,1
321,2,1,68.0,78.0,93.0,82.0,2373,1561,1903,1203,470,358,466,311,320,95,146,216,47,33,1225,2250,1000,700,600,700,1
329,2,1,68.0,79.0,93.0,82.0,2412,1863,1763,1371,649,492,293,476,75,200,218,276,47,33,1225,2400,1000,700,600,700,1
336,2,1,73.0,79.0,93.0,82.0,2468,1891,1819,1399,649,492,239,516,145,180,94,336,49,33,1225,2650,1150,700,600,700,1
343,2,1,75.0,82.0,101.0,82.0,2664,1942,2015,1427,649,515,265,282,95,115,170,167,50,33,1900,2700,1450,700,600,700,1
350,2,1,75.0,89.5,101.0,98.0,2664,1919,2015,1427,649,492,340,103,90,30,250,73,50,33,1850,2875,1550,700,750,725,1
357,2,1,79.0,90.5,101.0,98.0,2658,1897,1987,1427,671,470,321,129,145,75,176,54,50,33,2175,3175,1650,700,750,725,1
364,2,1,84.0,86.0,101.0,98.0,2782,1869,2155,1399,627,470,368,354,120,240,248,114,49,33,2375,3050,1750,700,800,950,1
371,2,1,71.0,81.0,101.0,98.0,2698,1869,2071,1399,627,470,678,219,350,120,328,99,49,33,1550,2700,1750,700,1825,1500,1
379,2,1,75.0,84.0,101.0,106.0,2804,1858,2155,1343,649,515,443,289,135,130,308,159,49,33,1600,2700,2000,700,2025,1500,1
386,2,1,79.0,86.5,101.0,106.0,2720,1886,2071,1371,649,515,463,365,75,150,388,215,49,33,1675,3175,1900,700,2250,1525,1
393,2,1,71.0,83.5,101.0,106.0,2720,1863,2071,1371,649,492,680,441,220,170,460,271,49,33,1400,2975,1800,700,2925,1875,1
400,2,1,66.0,85.5,101.0,106.0,2630,1841,1959,1371,671,470,1000,457,460,180,540,277,48,33,1250,3025,1700,700,3325,1975,1
407,2,1,62.0,83.5,101.0,106.0,2328,1813,1679,1343,649,470,576,287,110,50,466,237,44,33,800,2875,1700,700,4075,2275,1
414,2,1,66.0,86.5,93.0,106.0,2390,1863,1763,1371,627,492,317,357,75,60,242,297,44,33,1775,2875,1700,700,4175,2275,1
421,2,1,66.0,91.5,78.0,106.0,2350,1863,1679,1371,671,492,502,233,180,30,322,203,44,36,1775,3075,1700,700,4575,2275,1
429,2,1,66.0,90.0,78.0,106.0,2418,1919,1791,1427,627,492,799,468,405,205,394,263,44,39,1775,3200,1700,700,4575,2350,1
436,2,1,62.0,86.0,78.0,106.0,2384,2087,1735,1595,649,492,879,719,405,400,474,319,44,42,1575,3000,1600,700,4875,2550,1
443,2,1,70.0,93.0,78.0,106.0,2412,2171,1763,1679,649,492,414,439,35,60,379,379,44,42,1725,2850,1600,700,4975,2700,1
450,2,1,73.0,93.0,86.0,106.0,2434,2311,1763,1819,671,492,495,700,140,265,355,435,44,42,1850,2850,1700,700,4975,2700,1
457,2,1,73.0,99.0,86.0,106.0,2406,2317,1735,1847,671,470,171,656,40,165,131,491,44,50,2000,2850,2250,700,4975,2700,1
464,2,1,79.0,99.0,86.0,106.0,2390,2485,1763,2015,627,470,178,726,25,175,153,551,45,49,2000,2850,2250,950,4900,2700,1
471,2,1,82.0,102.0,86.0,106.0,2306,2619,1679,2127,627,492,453,546,220,85,233,461,45,54,2725,2850,2250,950,4900,2700,1
479,2,1,84.0,103.0,86.0,106.0,2334,2619,1707,2127,627,492,378,751,165,230,213,521,45,55,2725,3000,2250,950,4900,2700,1
486,2,1,84.0,103.0,86.0,106.0,2328,2642,1679,2127,649,515,658,992,365,415,293,577,45,55,2875,3000,2250,950,4900,2700,1
493,2,1,86.0,105.0,102.0,106.0,2350,2742,1679,2183,671,559,434,950,65,405,369,545,45,57,2875,3000,2250,1075,4900,2700,1
500,2,1,89.0,104.0,102.0,106.0,2322,2922,1651,2295,671,627,310,1001,15,380,295,621,45,56,3275,3150,2250,1075,4900,2700,1
507,2,1,89.0,101.0,102.0,106.0,2278,2838,1651,2211,627,627,572,1241,205,540,367,701,45,59,3275,2950,2250,1075,4900,2700,1
514,2,1,93.0,105.0,102.0,106.0,2306,2950,1679,2211,627,739,517,1216,170,465,347,751,45,59,3625,2950,2250,1075,4900,2700,1
521,2,1,93.0,104.0,102.0,106.0,2306,2849,1679,2043,627,806,798,1543,375,700,423,843,45,58,3625,2950,2250,1275,4900,2750,1
529,2,1,93.0,104.0,102.0,114.0,2250,2205,1623,1511,627,694,1063,1775,560,860,503,915,45,58,3925,3150,2350,1275,4900,2750,1
536,2,1,92.0,100.0,102.0,130.0,2300,2210,1651,1539,649,671,1053,1744,620,895,433,849,45,54,3550,3150,2350,1275,5275,2950,1
543,2,1,102.0,110.5,102.0,130.0,2350,2462,1679,1791,671,671,274,1391,65,470,209,921,45,52,3600,3125,2350,1275,5400,3075,1
550,2,1,98.0,115.0,102.0,130.0,2345,2552,1651,1903,694,649,399,1460,110,455,289,1005,45,52,4225,3100,2350,1275,5650,3100,1
557,2,1,98.0,119.0,102.0,130.0,2306,2978,1679,2127,627,851,327,1513,45,575,282,938,45,65,4225,3100,2350,1275,5650,3100,1
564,2,1,100.0,128.0,117.0,130.0,2278,3017,1651,2099,627,918,307,1421,45,475,262,946,45,70,4225,3300,2350,1275,5650,3100,1
571,2,1,104.0,132.0,117.0,136.0,2250,3073,1623,2155,627,918,347,1584,55,530,292,1054,45,70,4525,3300,2350,1275,5650,3100,1
579,2,1,105.0,132.0,125.0,136.0,2412,3308,1763,2323,649,985,447,1985,75,815,372,1170,47,70,4700,3800,2350,1275,5650,3100,1
586,2,1,108.0,136.0,125.0,136.0,2485,3610,1791,2603,694,1007,587,1706,135,420,452,1286,48,70,4900,3850,2350,1275,5650,3100,1
593,2,1,109.0,135.0,125.0,136.0,2574,3454,1903,2491,671,963,724,1323,200,325,524,998,50,69,4900,4050,2350,1275,5650,3100,1
600,2,1,112.0,135.0,125.0,136.0,2440,3846,1791,2883,649,963,460,1594,110,580,350,1014,51,69,4900,4250,2500,1275,5650,3100,1
607,2,1,116.0,145.0,125.0,176.0,2502,3986,1875,3023,627,963,546,1524,145,465,401,1059,51,69,5000,4650,2650,1275,5650,3100,1
614,2,1,120.0,152.0,125.0,176.0,2580,3902,1931,2939,649,963,501,1520,120,395,381,1125,51,69,5300,4950,2800,1275,5650,3100,1
621,2,1,122.0,162.0,125.0,176.0,2614,3946,1987,2939,627,1007,542,995,135,50,407,945,51,69,5650,5500,2800,1275,5650,3100,1
629,2,1,122.0,162.0,125.0,176.0,2776,3862,2127,2855,649,1007,637,1101,150,190,487,911,51,68,5650,5700,2900,1275,5650,3100,1
636,2,1,122.0,162.0,125.0,176.0,2821,3952,2127,2967,694,985,962,1313,395,290,567,1023,51,68,5950,5700,2900,1275,5650,3850,1
643,2,1,106.0,150.0,141.0,176.0,2882,3874,2211,2911,671,963,1308,1774,665,635,643,1139,51,68,4500,5100,2900,1275,7100,4575,1
650,2,1,91.0,161.0,141.0,176.0,2860,3874,2211,2911,649,963,1640,1490,925,335,715,1155,51,68,3250,4900,3150,1275,8350,4775,1
657,2,1,109.0,161.0,141.0,176.0,2866,3896,2239,2911,627,985,476,1750,85,475,391,1275,51,68,4650,5150,3150,1275,8350,4775,1
664,2,1,115.0,161.0,141.0,176.0,2815,3930,2099,2967,716,963,212,1766,25,600,187,1166,51,68,4650,5550,3150,1725,8350,4775,1
671,2,1,117.0,175.0,141.0,176.0,2905,3890,2099,2883,806,1007,458,617,175,135,283,482,53,68,4650,5900,3150,1725,8350,4775,1
679,2,1,117.0,164.0,141.0,184.0,2826,3924,1931,2939,895,985,784,2138,385,890,399,1248,53,68,4650,6200,3150,1725,8350,5150,1
686,2,1,123.0,174.0,141.0,184.0,2882,3874,1875,2911,1007,963,381,995,120,385,261,610,55,68,5475,6200,3150,1725,8350,5150,1
693,2,1,131.0,181.0,141.0,184.0,2894,3879,1931,2939,963,940,88,1101,15,375,73,726,55,68,6075,6700,3150,1725,8350,5150,1
700,2,1,131.0,188.5,141.0,190.0,2815,3874,1875,2911,940,963,314,776,125,330,189,446,55,68,6425,7825,3150,1725,8350,5250,1
707,2,1,136.0,188.5,141.0,190.0,2782,3874,1819,2911,963,963,254,1227,95,665,159,562,55,68,6425,8325,3150,1725,8350,5250,1
714,2,1,126.0,166.5,141.0,190.0,2832,3896,1847,2911,985,985,599,1297,320,615,279,682,55,68,5750,6525,3150,1725,9125,7200,1
721,2,1,67.0,152.5,141.0,190.0,2782,3890,1819,2883,963,1007,941,1408,550,685,391,723,54,68,850,4725,3150,1725,14075,8525,1
7,0,1,13.0,13.0,15.0,14.0,251,167,251,167,0,0,30,20,30,20,0,0,12,12,0,0,0,0,0,0,0
14,0,1,14.0,13.0,15.0,14.0,671,671,671,671,0,0,70,120,70,120,0,0,13,13,0,0,0,0,0,0,0
21,0,1,14.0,14.0,15.0,14.0,727,727,727,727,0,0,40,45,40,45,0,0,13,13,0,0,0,0,0,0,0
29,0,1,15.0,14.0,15.0,14.0,699,755,699,755,0,0,75,130,75,130,0,0,14,13,0,0,0,0,0,0,0
36,0,1,15.0,16.0,15.0,22.0,727,727,727,727,0,0,120,130,120,130,0,0,14,14,0,0,0,0,0,0,0
43,0,1,16.0,17.0,23.0,22.0,755,811,755,811,0,0,50,180,50,180,0,0,15,14,0,0,0,0,0,0,0
50,0,1,16.0,17.0,23.0,22.0,811,783,811,783,0,0,70,260,70,260,0,0,15,16,0,0,0,0,0,0,0
57,0,1,17.0,16.0,23.0,22.0,755,727,755,727,0,0,115,45,115,45,0,0,16,16,0,0,0,0,0,0,0
64,0,1,18.0,17.0,23.0,22.0,839,783,839,783,0,0,160,100,160,100,0,0,17,16,0,0,0,0,0,0,0
71,0,1,18.0,17.0,23.0,22.0,839,867,839,867,0,0,255,10,255,10,0,0,17,17,0,0,0,0,0,0,0
79,0,1,19.0,17.0,23.0,22.0,872,923,783,923,89,0,311,60,295,60,16,0,18,16,0,0,0,0,0,0,0
86,0,1,19.0,18.0,23.0,22.0,939,867,783,867,156,0,426,35,390,35,36,0,18,15,0,0,0,0,0,0,0
93,0,1,20.0,19.0,23.0,22.0,967,783,811,783,156,0,291,80,285,80,6,0,19,17,0,0,150,0,0,0,0
100,0,1,20.0,19.0,23.0,22.0,995,867,839,867,156,0,416,190,390,190,26,0,19,18,0,0,150,0,0,0,0
107,0,1,20.0,19.0,23.0,22.0,1046,995,867,951,179,44,136,208,90,200,46,8,19,19,0,0,150,0,0,0,0
114,0,1,20.0,20.0,23.0,22.0,939,1107,783,951,156,156,147,288,85,260,62,28,19,19,0,0,150,0,0,0,0
121,0,1,21.0,22.0,23.0,22.0,967,1074,811,895,156,179,212,263,130,215,82,48,19,19,0,0,150,250,0,0,0
129,0,1,22.0,26.0,23.0,36.0,1107,1079,951,923,156,156,307,139,205,75,102,64,20,20,100,0,150,250,0,0,0
136,0,1,23.0,26.0,31.0,36.0,1107,1023,951,867,156,156,152,259,130,175,22,84,20,20,100,0,150,250,0,0,0
143,0,1,24.0,26.0,31.0,36.0,1247,1135,1091,979,156,156,237,204,195,200,42,4,21,20,150,0,150,250,0,0,0
150,0,1,24.0,28.0,31.0,36.0,1298,1107,1119,951,179,156,232,134,220,110,12,24,21,20,150,100,150,250,0,0,0
157,0,1,25.0,29.0,31.0,36.0,1354,1135,1175,979,179,156,257,214,225,170,32,44,22,22,150,250,150,250,0,0,0
164,0,1,25.0,33.0,31.0,44.0,1303,1074,1147,895,156,179,353,94,305,30,48,64,22,23,150,400,150,250,0,0,0
171,0,1,26.0,35.0,31.0,44.0,1247,1270,1091,1091,156,179,438,149,370,65,68,84,23,24,150,400,150,250,0,0,0
179,0,1,27.0,37.0,46.0,44.0,1331,1247,1175,1091,156,156,453,135,365,35,88,100,24,25,150,400,400,250,0,0,0
186,0,1,27.0,39.0,46.0,44.0,1202,1275,979,1119,223,156,330,190,310,70,20,120,24,27,150,400,500,250,0,0,0
193,0,1,32.0,40.0,46.0,44.0,1208,1443,895,1287,313,156,164,330,125,190,39,140,25,28,150,400,500,250,0,0,0
200,0,1,32.0,44.0,46.0,44.0,1230,1499,895,1343,335,156,310,315,235,155,75,160,25,29,150,550,500,250,0,0,0
207,0,1,33.0,44.0,46.0,44.0,1426,1555,1091,1399,335,156,440,495,325,315,115,180,26,30,150,550,500,250,0,0,0
214,0,1,37.0,44.0,46.0,44.0,1432,1522,1119,1343,313,179,416,635,265,435,151,200,27,33,250,700,575,250,100,50,0
221,0,1,40.0,44.0,46.0,44.0,1432,1835,1119,1679,313,156,246,526,205,410,41,116,27,33,250,700,825,250,100,50,0
229,0,1,42.0,44.0,46.0,44.0,1370,1835,1035,1679,335,156,221,621,140,485,81,136,28,34,250,700,825,250,100,50,0
236,0,1,42.0,43.0,46.0,44.0,1622,1947,1287,1791,335,156,226,231,205,75,21,156,28,33,450,700,825,250,100,50,0
243,0,1,44.0,46.0,46.0,60.0,1902,1835,1567,1679,335,156,242,251,185,75,57,176,30,32,450,700,825,250,100,50,0
250,0,1,45.0,50.0,46.0,76.0,2070,1919,1735,1763,335,156,172,266,125,70,47,196,31,33,450,700,825,250,100,50,0
257,0,1,46.0,53.0,54.0,84.0,2020,1852,1707,1651,313,201,313,285,230,65,83,220,32,37,450,700,825,250,100,50,0
264,0,1,48.0,55.0,54.0,84.0,2020,2048,1707,1735,313,313,278,435,205,175,73,260,34,40,750,700,825,250,100,50,0
271,0,1,49.0,55.0,54.0,84.0,2020,2076,1707,1763,313,313,413,581,300,285,113,296,34,41,750,700,825,250,100,50,0
279,0,1,50.0,55.0,54.0,84.0,2042,2098,1707,1763,335,335,383,556,230,320,153,236,35,41,800,800,825,500,100,50,0
286,0,1,52.0,57.0,62.0,92.0,2070,2132,1735,1819,335,313,473,342,280,70,193,272,36,36,800,800,925,500,100,50,0
293,0,1,56.0,57.0,62.0,92.0,2154,2020,1819,1707,335,313,509,487,305,175,204,312,38,40,800,950,1225,500,100,50,0
300,0,1,56.0,59.0,62.0,92.0,2457,2020,2099,1707,358,313,488,432,240,80,248,352,39,42,850,950,1350,500,100,50,0
307,0,1,64.0,59.0,70.0,92.0,2339,2042,1959,1707,380,335,252,677,60,285,192,392,40,42,950,950,1350,500,100,50,0
314,0,1,61.0,59.5,70.0,98.0,2457,2188,2099,1875,358,313,336,538,200,110,136,428,40,43,550,625,1350,750,500,375,0
321,0,1,67.0,55.0,70.0,106.0,2479,2182,2099,1847,380,335,194,643,135,175,59,468,41,36,700,600,1425,1125,500,750,0
329,0,1,65.0,48.0,70.0,114.0,2395,1902,2015,1455,380,447,458,413,355,35,103,378,41,30,700,700,1425,1125,600,1200,0
336,0,1,65.0,50.0,70.0,114.0,2205,1617,1847,1147,358,470,282,509,235,75,47,434,41,31,700,1000,1425,1125,800,1200,0
343,0,1,68.0,53.0,70.0,114.0,2154,1729,1707,1259,447,470,198,554,95,60,103,494,41,34,850,1000,1425,1125,800,1200,0
350,0,1,69.0,53.0,70.0,114.0,2261,1802,1791,1287,470,515,174,569,115,115,59,454,43,36,1050,1000,1575,1125,800,1200,0
357,0,1,70.0,54.0,70.0,114.0,2037,1970,1567,1455,470,515,200,459,85,95,115,364,43,38,1575,1000,1725,1125,800,1200,0
364,0,1,78.0,57.0,78.0,114.0,2121,2065,1651,1595,470,470,70,551,20,135,50,416,43,38,1625,1000,1725,1125,800,1200,0
371,0,1,80.0,61.0,86.0,114.0,2115,2115,1623,1623,492,492,226,601,120,125,106,476,43,39,1675,1000,1725,1125,800,1200,0
379,0,1,83.0,65.5,94.0,114.0,2188,2205,1651,1735,537,470,294,632,120,100,174,532,43,44,1925,975,1725,1125,800,1225,0
386,0,1,83.0,70.0,94.0,114.0,2110,2345,1483,1875,627,470,536,672,290,80,246,592,43,46,1975,950,1725,1125,800,1250,0
393,0,1,87.0,75.0,94.0,114.0,2171,2513,1567,2043,604,470,394,722,80,70,314,652,43,47,2025,950,1725,1125,800,1250,0
400,0,1,94.0,71.0,102.0,114.0,2093,2334,1511,1819,582,515,256,942,70,230,186,712,43,46,2450,1100,1725,1475,800,1500,0
407,0,1,97.0,73.0,102.0,108.0,2171,2278,1567,1763,604,515,317,762,55,190,262,572,43,46,2650,1250,1725,1475,800,1850,0
414,0,1,98.0,75.0,102.0,108.0,2121,2255,1539,1763,582,492,520,884,190,260,330,624,43,45,2800,1500,1725,1475,800,1850,0
421,0,1,96.0,64.0,102.0,108.0,2194,2401,1567,1819,627,582,591,930,185,230,406,700,43,45,2550,750,1725,1475,1050,2650,0
7,2,0,13.0,13.0,15.0,15.0,293,293,293,293,0,0,35,35,35,35,0,0,12,12,0,0,0,0,0,0,1
14,2,0,14.0,14.0,15.0,15.0,671,671,671,671,0,0,70,70,70,70,0,0,13,13,0,0,0,0,0,0,1
21,2,0,14.0,14.0,15.0,15.0,699,755,699,755,0,0,0,50,0,50,0,0,13,13,0,0,0,0,0,0,1
29,2,0,15.0,14.0,15.0,15.0,727,727,727,727,0,0,90,130,90,130,0,0,14,14,0,0,0,0,0,0,1
36,2,0,15.0,14.0,23.0,15.0,783,783,783,783,0,0,40,235,40,235,0,0,14,14,0,0,0,0,0,0,1
43,2,0,16.0,14.0,23.0,23.0,839,755,839,755,0,0,95,160,95,160,0,0,15,14,0,0,0,0,0,0,1
50,2,0,17.0,14.0,23.0,23.0,867,755,867,755,0,0,140,245,140,245,0,0,16,14,0,0,0,0,0,0,1
57,2,0,17.0,14.0,23.0,23.0,895,755,895,755,0,0,250,340,250,340,0,0,16,14,0,0,0,0,0,0,1
64,2,0,18.0,14.0,23.0,23.0,951,727,951,727,0,0,320,20,320,20,0,0,17,14,0,0,0,0,0,0,1
71,2,0,18.0,14.0,23.0,23.0,1007,699,1007,699,0,0,35,100,35,100,0,0,17,14,0,0,0,0,0,0,1
79,2,0,18.0,14.0,23.0,23.0,867,671,867,671,0,0,45,180,45,180,0,0,18,14,0,0,0,0,0,0,1
86,2,0,18.0,14.0,23.0,23.0,1007,671,1007,671,0,0,30,265,30,265,0,0,18,14,0,0,150,0,0,0,1
93,2,0,19.0,15.0,23.0,23.0,923,671,923,671,0,0,80,45,80,45,0,0,18,14,0,0,150,150,0,0,1
100,2,0,19.0,15.0,23.0,23.0,973,671,951,671,22,0,94,55,90,55,4,0,19,14,0,0,150,150,0,0,1
107,2,0,20.0,15.0,23.0,23.0,973,643,839,643,134,0,164,55,140,55,24,0,19,14,0,50,150,150,0,0,1
114,2,0,21.0,15.0,31.0,31.0,967,643,811,643,156,0,80,130,40,130,40,0,20,14,0,50,150,150,0,0,1
121,2,0,21.0,16.0,31.0,31.0,1051,559,895,559,156,0,60,150,50,150,10,0,20,14,0,50,300,150,0,0,1
129,2,0,24.0,17.0,31.0,31.0,1051,648,895,559,156,89,70,171,65,155,5,16,21,15,0,50,300,150,0,0,1
136,2,0,24.0,17.0,31.0,46.0,1051,676,895,475,156,201,145,209,120,165,25,44,21,15,0,50,300,150,0,0,1
143,2,0,26.0,20.0,46.0,46.0,1163,878,1007,587,156,291,90,180,45,150,45,30,22,16,0,50,300,150,0,0,1
150,2,0,28.0,20.0,46.0,46.0,1102,906,923,615,179,291,85,242,45,180,40,62,23,16,125,50,300,150,0,0,1
157,2,0,30.0,22.0,46.0,46.0,1242,1034,1063,699,179,335,145,322,85,220,60,102,24,18,125,50,300,150,0,0,1
164,2,0,33.0,22.0,46.0,46.0,1359,1090,1203,755,156,335,81,427,30,285,51,142,25,18,125,50,450,150,0,0,1
171,2,0,34.0,24.0,46.0,46.0,1415,1068,1259,755,156,313,146,428,75,250,71,178,26,20,125,150,450,150,0,0,1
179,2,0,35.0,26.0,46.0,46.0,1499,1146,1343,811,156,335,221,473,130,255,91,218,27,21,250,150,450,150,0,0,1
186,2,0,36.0,27.0,46.0,46.0,1471,1236,1315,923,156,313,226,580,115,330,111,250,28,22,250,150,600,150,0,0,1
193,2,0,38.0,28.0,46.0,46.0,1662,1466,1483,1175,179,291,351,461,220,275,131,186,30,23,375,150,600,150,0,0,1
200,2,0,44.0,28.0,54.0,46.0,1690,1516,1511,1203,179,313,166,616,90,390,76,226,31,24,375,200,600,150,0,0,1
7,2,2,13.0,13.0,15.0,15.0,293,293,293,293,0,0,35,35,35,35,0,0,12,12,0,0,0,0,0,0,0
14,2,2,14.0,14.0,15.0,15.0,671,671,671,671,0,0,70,70,70,70,0,0,13,13,0,0,0,0,0,0,0
21,2,2,14.0,14.0,15.0,15.0,727,699,727,699,0,0,50,50,50,50,0,0,13,13,0,0,0,0,0,0,0
29,2,2,15.0,15.0,15.0,15.0,727,755,727,755,0,0,90,95,90,95,0,0,14,14,0,0,0,0,0,0,0
36,2,2,16.0,15.0,23.0,23.0,839,811,839,811,0,0,145,135,145,135,0,0,15,14,0,0,0,0,0,0,0
43,2,2,16.0,16.0,23.0,23.0,839,783,839,783,0,0,35,30,35,30,0,0,15,15,0,0,0,0,0,0,0
50,2,2,17.0,17.0,23.0,23.0,839,839,839,839,0,0,60,10,60,10,0,0,16,16,0,0,0,0,0,0,0
57,2,2,18.0,18.0,23.0,23.0,895,839,895,839,0,0,50,30,50,30,0,0,17,17,0,0,0,0,0,0,0
64,2,2,19.0,19.0,23.0,23.0,951,895,951,895,0,0,105,95,105,95,0,0,18,18,0,0,0,0,0,0,0
71,2,2,19.0,19.0,23.0,23.0,1001,979,979,979,22,0,29,10,25,10,4,0,18,18,0,0,0,0,0,0,0
79,2,2,20.0,20.0,23.0,23.0,1040,939,951,895,89,44,151,118,135,110,16,8,19,19,0,0,0,0,0,0,0
86,2,2,21.0,21.0,23.0,23.0,1090,1068,867,867,223,201,78,46,30,10,48,36,20,20,0,0,150,150,0,0,0
93,2,2,22.0,22.0,23.0,23.0,1107,1046,839,755,268,291,146,127,70,55,76,72,21,21,0,0,150,150,0,0,0
100,2,2,22.0,22.0,23.0,23.0,1102,1102,811,811,291,291,132,154,20,50,112,104,21,21,0,0,150,150,0,0,0
107,2,2,23.0,23.0,23.0,23.0,1118,1124,783,811,335,313,262,230,110,90,152,140,22,22,0,0,150,150,0,0,0
114,2,2,23.0,23.0,31.0,23.0,1124,1180,811,867,313,313,388,330,200,150,188,180,22,23,0,0,300,150,0,0,0
121,2,2,23.0,24.0,31.0,31.0,1236,1208,923,895,313,313,543,485,315,265,228,220,23,23,0,0,300,450,0,0,0
129,2,2,27.0,28.0,31.0,31.0,1342,1309,1007,951,335,358,93,180,25,70,68,110,23,24,0,0,450,450,0,0,0
136,2,2,27.0,29.0,31.0,31.0,1342,1281,1007,923,335,358,148,285,90,135,58,150,23,24,0,0,450,450,0,0,0
143,2,2,27.0,29.0,31.0,31.0,1292,1236,979,923,313,313,199,327,105,145,94,182,23,24,0,0,450,450,0,0,0
150,2,2,27.0,29.0,31.0,31.0,1292,1264,979,951,313,313,165,477,85,255,80,222,23,24,0,0,450,450,0,0,0
157,2,2,29.0,33.0,39.0,39.0,1236,1225,923,867,313,358,135,272,65,110,70,162,23,25,175,350,450,450,0,0,0
164,2,2,31.0,33.0,39.0,39.0,1292,1258,979,923,313,335,290,128,180,80,110,48,23,25,350,350,450,450,0,0,0
171,2,2,34.0,34.0,39.0,39.0,1292,1264,979,951,313,313,70,229,20,145,50,84,22,25,350,350,700,450,50,0,0
179,2,2,35.0,34.0,39.0,39.0,1286,1236,951,923,335,313,170,374,80,250,90,124,22,26,350,350,700,450,50,0,0
186,2,2,35.0,35.0,39.0,39.0,1292,1208,979,895,313,313,167,474,45,310,122,164,22,26,525,700,700,450,50,0,0
193,2,2,35.0,35.0,39.0,39.0,1186,1236,895,923,291,313,204,224,50,20,154,204,23,26,700,700,700,450,50,0,0
200,2,2,35.0,35.0,39.0,39.0,1214,1314,923,979,291,335,355,384,165,140,190,244,23,27,1075,700,700,450,50,0,0
207,2,2,37.0,35.0,39.0,39.0,1208,1365,895,1007,313,358,250,184,20,50,230,134,23,27,1075,350,700,750,50,350,0
214,2,2,37.0,33.0,47.0,39.0,1264,1292,951,979,313,313,405,436,135,270,270,166,23,27,1075,175,700,750,50,525,0
221,2,2,37.0,33.0,47.0,39.0,1286,1298,951,1007,335,291,560,392,250,190,310,202,23,27,1075,175,700,750,50,525,0
229,2,2,37.0,35.0,47.0,39.0,1309,1292,951,979,358,313,710,442,360,250,350,192,23,27,1075,175,700,750,50,525,0
236,2,2,38.0,36.0,47.0,31.0,1286,1314,951,979,335,335,761,427,450,245,311,182,23,26,1325,875,850,750,50,525,0
243,2,2,38.0,36.0,47.0,31.0,1264,1264,951,951,313,313,907,478,560,260,347,218,23,26,1325,875,850,950,50,525,0
250,2,2,40.0,36.0,47.0,31.0,1214,1286,923,951,291,335,528,183,295,75,233,108,23,26,950,875,850,950,425,525,0
257,2,2,40.0,36.0,47.0,31.0,1219,1208,951,895,268,313,424,229,255,85,169,144,23,26,1575,875,850,950,425,525,0
264,2,2,40.0,36.0,47.0,39.0,1242,1264,951,951,291,313,575,384,370,200,205,184,23,26,1575,875,850,950,425,525,0
271,2,2,40.0,40.0,47.0,47.0,1292,1236,979,923,313,313,721,544,480,320,241,224,23,26,1575,875,850,950,425,525,0
279,2,2,46.0,40.0,47.0,47.0,1286,1258,951,923,335,335,346,439,215,175,131,264,23,26,2100,875,850,950,425,525,0
286,2,2,46.0,40.0,47.0,47.0,1264,1247,951,979,313,268,497,437,330,145,167,292,23,26,2100,875,850,950,425,525,0
293,2,2,46.0,44.0,47.0,47.0,1236,1186,923,895,313,291,642,337,435,55,207,282,23,26,2100,1000,850,950,425,525,0
300,2,2,46.0,44.0,47.0,55.0,1236,1342,923,1007,313,335,497,497,400,175,97,322,23,26,2100,1125,1100,950,425,525,0
307,2,2,46.0,48.0,47.0,55.0,1236,1236,923,923,313,313,242,293,105,85,137,208,23,26,2100,1475,1100,950,425,525,0
314,2,2,46.0,50.0,47.0,55.0,1286,1292,951,979,335,313,302,328,125,105,177,223,23,26,2100,1600,1100,950,425,525,0
321,2,2,46.0,52.0,47.0,55.0,1258,1314,923,979,335,335,443,258,230,20,213,238,23,26,2100,1725,1100,800,425,675,0
329,2,2,46.0,52.0,47.0,55.0,1264,1354,951,1063,313,291,599,415,350,145,249,270,23,26,2100,1725,1100,1100,425,675,0
336,2,2,48.0,52.0,55.0,55.0,1236,1303,923,1035,313,268,469,567,230,265,239,302,23,26,2100,1725,1100,1100,425,675,0
343,2,2,50.0,51.0,55.0,63.0,1236,1303,923,1035,313,268,299,719,70,385,229,334,23,25,2450,1725,950,1100,575,700,0
350,2,2,52.0,54.0,55.0,63.0,1264,1247,951,979,313,268,299,515,130,295,169,220,23,24,2600,2075,950,1100,575,750,0
357,2,2,53.0,54.0,55.0,63.0,1286,1270,951,979,335,291,399,271,190,15,209,256,23,25,2600,2075,950,1100,575,750,0
364,2,2,55.0,54.0,55.0,63.0,1253,1264,895,951,358,313,369,321,170,25,199,296,24,25,2600,2075,950,1100,575,750,0
371,2,2,55.0,54.0,47.0,63.0,1258,1286,923,951,335,335,475,481,240,145,235,336,24,25,2775,2075,1050,1100,675,750,0
379,2,2,57.0,55.0,62.0,63.0,1236,1314,923,979,313,335,466,586,195,210,271,376,24,25,2775,2375,800,1100,925,750,0
386,2,2,59.0,55.0,62.0,71.0,1236,1292,923,979,313,313,301,492,40,180,261,312,24,25,2950,2375,800,1100,925,750,0
393,2,2,61.0,56.0,70.0,71.0,1286,1342,951,1007,335,335,366,552,65,200,301,352,26,26,2950,2375,800,1100,925,750,0
400,2,2,62.0,55.0,70.0,71.0,1320,1370,1007,1035,313,335,527,412,190,120,337,292,28,26,2850,2075,950,1100,1025,1050,0
407,2,2,62.0,59.0,70.0,71.0,1454,1320,1119,1007,335,313,512,268,235,90,277,178,30,27,2850,2225,950,1100,1025,1050,0
414,2,2,56.0,58.0,70.0,71.0,1566,1398,1231,1063,335,335,712,263,395,95,317,168,30,28,2325,1875,950,1100,1550,1400,0
421,2,2,56.0,50.0,70.0,71.0,1600,1426,1287,1091,313,335,388,208,185,50,203,158,30,28,2325,1400,950,1100,2075,2225,0
427,2,2,56.0,45.0,70.0,71.0,1600,1376,1287,1063,313,313,388,336,185,150,203,186,30,29,2325,975,950,1350,2075,2650,0
7,1,0,13.0,13.0,14.0,15.0,293,251,293,251,0,0,35,30,35,30,0,0,12,12,0,0,0,0,0,0,1
14,1,0,14.0,14.0,14.0,15.0,671,671,671,671,0,0,70,70,70,70,0,0,13,13,0,0,0,0,0,0,1
21,1,0,14.0,14.0,14.0,15.0,755,699,755,699,0,0,55,50,55,50,0,0,14,13,0,0,0,0,0,0,1
29,1,0,15.0,15.0,14.0,15.0,755,699,755,699,0,0,94,85,94,85,0,0,14,14,0,0,0,0,0,0,1
36,1,0,15.0,15.0,22.0,15.0,839,755,839,755,0,0,199,125,199,125,0,0,14,14,0,0,0,0,0,0,1
43,1,0,16.0,16.0,22.0,23.0,867,811,867,811,0,0,249,70,249,70,0,0,15,15,0,0,0,0,0,0,1
50,1,0,16.0,16.0,22.0,23.0,923,811,923,811,0,0,4,40,4,40,0,0,15,15,0,0,0,0,0,0,1
57,1,0,17.0,17.0,22.0,23.0,867,811,867,811,0,0,44,135,44,135,0,0,15,16,0,0,0,0,0,0,1
64,1,0,18.0,18.0,22.0,23.0,895,867,895,867,0,0,99,185,99,185,0,0,16,17,0,0,0,0,0,0,1
71,1,0,18.0,18.0,22.0,23.0,923,883,923,839,0,44,199,283,199,275,0,8,17,17,0,0,0,0,0,0,1
79,1,0,16.0,19.0,22.0,23.0,839,967,839,811,0,156,69,343,69,315,0,28,16,18,0,0,0,0,0,0,1
86,1,0,18.0,19.0,22.0,23.0,811,990,811,811,0,179,74,463,74,415,0,48,16,18,0,0,0,0,0,0,1
93,1,0,19.0,20.0,22.0,23.0,839,967,839,811,0,156,134,324,134,310,0,14,18,19,0,0,0,150,0,0,1
100,1,0,20.0,20.0,22.0,23.0,911,967,867,811,44,156,197,44,189,10,8,34,19,19,0,0,0,150,0,0,1
107,1,0,20.0,20.0,22.0,23.0,978,939,867,783,111,156,314,159,294,105,20,54,19,19,0,0,0,150,0,0,1
114,1,0,19.0,21.0,22.0,23.0,1023,967,867,811,156,156,144,129,104,55,40,74,19,19,0,0,0,150,0,0,1
121,1,0,19.0,22.0,28.0,23.0,995,911,839,755,156,156,264,184,204,90,60,94,19,19,0,100,0,150,0,0,1
129,1,0,24.0,23.0,28.0,23.0,995,1214,839,1035,156,179,89,294,9,180,80,114,19,20,0,100,250,150,0,0,1
136,1,0,24.0,23.0,28.0,31.0,939,1163,783,1007,156,156,209,110,109,80,100,30,19,20,0,100,250,150,0,0,1
143,1,0,26.0,24.0,28.0,31.0,934,1219,755,1063,179,156,224,100,104,100,120,0,19,21,100,150,250,150,0,0,1
150,1,0,26.0,25.0,28.0,31.0,883,1191,727,1035,156,156,130,195,94,175,36,20,21,22,150,150,250,150,0,0,1
157,1,0,26.0,25.0,28.0,31.0,1023,1247,867,1091,156,156,260,340,204,300,56,40,21,22,150,150,250,150,0,0,1
164,1,0,25.0,26.0,28.0,31.0,995,1376,839,1175,156,201,235,453,159,385,76,68,20,23,300,150,250,150,0,0,1
171,1,0,25.0,26.0,28.0,46.0,1079,1471,923,1203,156,268,170,620,74,520,96,100,20,23,300,150,250,150,0,0,1
179,1,0,25.0,27.0,28.0,46.0,1191,1494,1035,1203,156,291,315,587,199,455,116,132,20,24,300,150,250,500,0,0,1
186,1,0,29.0,29.0,34.0,46.0,1186,1292,1007,979,179,313,205,403,69,335,136,68,20,24,300,150,250,500,0,0,1
193,1,0,29.0,32.0,50.0,46.0,1214,1460,1035,1147,179,313,345,353,189,270,156,83,20,25,300,150,250,500,0,0,1
200,1,0,30.0,33.0,50.0,46.0,1191,1628,1035,1315,156,313,426,368,254,245,172,123,20,25,400,150,450,500,0,0,1
207,1,0,36.0,37.0,50.0,46.0,1107,1650,951,1315,156,335,261,228,144,90,117,138,20,26,400,150,450,575,0,100,1
214,1,0,39.0,41.0,50.0,46.0,1163,1908,1007,1595,156,313,251,364,114,190,137,174,21,28,400,250,450,575,0,100,1
221,1,0,43.0,43.0,50.0,46.0,1163,2042,1007,1707,156,335,181,254,49,115,132,139,21,28,550,250,450,825,0,100,1
229,1,0,45.0,46.0,50.0,54.0,1219,2014,1063,1679,156,335,146,309,144,205,2,104,21,30,1000,475,450,825,0,100,1
236,1,0,45.0,49.0,50.0,54.0,1242,2160,1063,1847,179,313,181,185,159,170,22,15,21,30,1100,575,450,825,0,100,1
243,1,0,44.5,49.0,50.0,54.0,1163,1852,1007,1539,156,313,267,250,229,195,38,55,21,30,1325,575,450,825,75,200,1
250,1,0,47.0,45.0,50.0,54.0,1219,1258,1063,923,156,335,122,405,64,310,58,95,21,27,1150,525,450,825,250,400,1
257,1,0,46.0,42.0,58.0,62.0,1191,1258,1035,923,156,335,117,459,39,324,78,135,21,22,950,625,450,825,450,751,1
264,1,0,47.0,41.0,58.0,62.0,1135,1314,979,979,156,335,152,280,129,234,23,46,21,22,1000,575,450,825,450,801,1
271,1,0,50.0,45.0,58.0,62.0,1219,1314,1063,979,156,335,157,335,114,249,43,86,21,23,1500,1150,450,825,450,801,1
279,1,0,52.0,46.0,58.0,46.0,1158,1152,979,839,179,313,192,90,129,51,63,39,21,23,1550,1150,450,825,450,1051,1
286,1,0,55.5,46.0,58.0,46.0,1270,1096,1091,783,179,313,92,111,9,39,83,72,26,23,1475,1150,450,725,525,1231,1
293,1,0,57.5,46.0,58.0,38.0,1359,1096,1203,783,156,313,168,161,69,49,99,112,29,23,1475,1150,450,725,525,1331,1
300,1,0,53.0,45.0,58.0,38.0,1471,1398,1315,1063,156,335,238,246,119,94,119,152,31,23,1250,1425,450,825,750,1381,1
307,1,0,55.5,45.0,58.0,46.0,1583,1566,1427,1231,156,335,228,161,164,94,64,67,33,23,1225,1300,450,825,775,1831,1
314,1,0,55.5,46.0,58.0,46.0,1555,1706,1399,1371,156,335,173,242,89,189,84,53,35,23,1125,1300,450,825,1006,1831,1
321,1,0,55.5,46.0,58.0,54.0,1667,1622,1511,1287,156,335,373,442,269,349,104,93,35,23,1125,1300,450,825,1006,1831,1
329,1,0,57.5,48.0,66.0,54.0,1718,1628,1539,1315,179,313,368,233,244,204,124,29,38,25,1125,1200,450,825,1006,1931,1
336,1,0,57.5,47.0,66.0,54.0,1774,1516,1595,1203,179,313,288,383,144,314,144,69,40,25,1125,1200,450,825,1006,1931,1
343,1,0,56.5,48.0,74.0,54.0,1919,1734,1763,1399,156,335,419,568,259,459,160,109,39,26,1125,1475,450,825,1006,1931,1
350,1,0,61.5,49.0,74.0,62.0,1919,2048,1763,1735,156,313,104,744,24,599,80,145,39,26,1125,1475,450,925,1006,1931,1
357,1,0,59.5,47.0,74.0,62.0,2003,1942,1847,1651,156,291,199,565,99,384,100,181,39,27,825,1400,450,925,1306,2206,1
364,1,0,58.0,46.0,82.0,62.0,2059,1902,1903,1567,156,335,294,715,174,494,120,221,42,29,550,1275,450,925,1581,2331,1
371,1,0,57.0,52.0,82.0,62.0,2110,2042,1931,1707,179,335,514,505,374,369,140,136,44,29,550,1275,450,1025,1581,2331,1
379,1,0,65.0,53.0,74.0,62.0,2166,2238,1987,1903,179,335,134,535,99,384,35,151,45,30,550,1275,450,1025,1681,2331,1
386,1,0,68.0,55.0,74.0,62.0,1975,2188,1819,1875,156,313,115,421,89,234,26,187,44,31,700,1375,450,925,1681,2356,1
393,1,0,68.0,56.0,74.0,62.0,2199,2070,2043,1735,156,335,385,516,339,289,46,227,44,33,700,1275,450,925,1681,2456,1
400,1,0,73.0,58.0,74.0,70.0,2255,1958,2099,1623,156,335,225,171,159,154,66,17,44,33,1200,1550,575,1000,1681,2456,1
407,1,0,72.0,59.0,74.0,70.0,2177,2104,1931,1791,246,313,411,537,309,434,102,103,45,35,1300,1600,825,1000,1681,2456,1
414,1,0,75.0,61.0,88.0,70.0,2222,2188,1819,1875,403,313,347,247,189,204,158,43,46,36,1300,1600,825,1000,1681,2456,1
421,1,0,75.0,62.0,88.0,70.0,2378,2042,1819,1707,559,335,429,322,299,239,130,83,51,37,1450,1600,825,1000,1681,2456,1
429,1,0,81.0,64.0,88.0,85.0,2457,1986,1763,1651,694,335,224,387,64,264,160,123,51,39,1450,1600,950,1000,1681,2456,1
436,1,0,80.0,64.0,88.0,85.0,2518,2076,1847,1763,671,313,445,493,209,384,236,109,50,39,1550,1650,1200,1300,1681,2456,1
443,1,0,83.0,69.0,96.0,85.0,2586,2171,1959,1791,627,380,97,566,39,409,58,157,56,41,1550,1950,1200,1550,1681,2456,1
450,1,0,85.0,71.0,96.0,85.0,2748,2126,2099,1679,649,447,237,388,99,329,138,59,56,42,1550,1950,1200,1550,1681,2456,1
457,1,0,87.0,72.0,96.0,85.0,2972,2362,2323,1735,649,627,487,583,269,444,218,139,59,43,1550,1950,1325,1550,1681,2456,1
464,1,0,91.0,79.0,96.0,85.0,3090,2698,2463,2071,627,627,258,599,14,509,244,90,63,45,1550,2100,1325,1550,1681,2456,1
471,1,0,89.0,80.0,96.0,85.0,3246,2552,2575,1903,671,649,393,394,69,224,324,170,61,46,1350,2100,1325,1650,1881,2456,1
479,1,0,89.0,83.0,120.0,85.0,3162,2502,2491,1875,671,627,659,405,259,159,400,246,65,47,1450,2250,1325,1650,1881,2456,1
486,1,0,99.0,84.0,120.0,85.0,3000,2742,2351,2071,649,671,510,750,159,424,351,326,65,48,1450,2250,1325,1550,1881,2481,1
493,1,0,99.0,85.0,144.0,85.0,2966,3078,2295,2407,671,671,584,710,149,304,435,406,65,48,1450,2300,1325,1550,1881,2481,1
500,1,0,107.0,94.0,136.0,109.0,3381,3028,2463,2379,918,649,609,632,154,279,455,353,65,49,1450,2725,1325,1550,1981,2481,1
507,1,0,117.0,96.0,136.0,109.0,3538,3028,2575,2379,963,649,445,682,124,349,321,333,65,50,1950,2725,1325,1550,1981,2481,1
514,1,0,121.0,103.0,152.0,109.0,3594,3084,2631,2435,963,649,576,488,239,279,337,209,65,51,2250,2825,1325,1550,2081,2481,1
521,1,0,131.0,105.0,152.0,125.0,3638,2860,2631,2211,1007,649,496,313,164,124,332,189,65,52,2650,2975,1325,1850,2081,2481,1
529,1,0,142.0,109.0,152.0,125.0,3560,2944,2575,2295,985,649,217,274,94,109,123,165,65,54,3050,3250,1325,1850,2081,2481,1
536,1,0,148.0,113.0,152.0,125.0,3510,3750,2547,3079,963,671,334,149,174,29,160,120,65,54,3250,3400,1325,1850,2081,2481,1
543,1,0,148.0,117.0,152.0,125.0,3594,3890,2631,3219,963,671,475,330,249,234,226,96,65,56,4050,3800,1325,2050,2081,2481,1
550,1,0,152.0,120.0,152.0,125.0,3644,3868,2659,3219,985,649,605,556,309,384,296,172,65,57,4450,3900,1325,2050,2081,2481,1
557,1,0,168.0,124.0,168.0,125.0,3650,3734,2687,3107,963,627,236,447,24,299,212,148,65,58,4850,3950,1325,2150,2081,2481,1
564,1,0,168.0,130.0,176.0,133.0,3566,3896,2603,3247,963,649,467,447,139,319,328,128,65,61,4850,4225,1325,2350,2081,2481,1
571,1,0,168.0,133.0,170.0,133.0,3666,3868,2659,3219,1007,649,622,547,174,339,448,208,65,61,5050,4325,1325,2350,2431,2481,1
579,1,0,170.0,133.0,170.0,133.0,3750,3778,2743,3107,1007,671,853,468,439,184,414,284,65,64,5850,4625,1325,2350,2431,2481,1
586,1,0,166.0,134.0,186.0,149.0,3678,3778,2715,3107,963,671,1180,798,654,434,526,364,65,63,5650,4500,1325,2350,2631,2806,1
593,1,0,182.0,136.0,210.0,141.0,3538,3246,2575,2575,963,671,501,979,59,539,442,440,65,62,5850,4750,1325,2350,2631,3031,1
600,1,0,187.0,141.0,218.0,141.0,3504,3067,2519,2351,985,716,321,957,209,429,112,528,64,62,5850,4850,1325,2350,2631,3031,1
607,1,0,191.0,143.0,218.0,149.0,3504,2955,2519,2239,985,716,392,1023,239,411,153,612,64,62,6350,5050,1325,2350,2731,3081,1
614,1,0,191.0,147.0,218.0,149.0,3448,2938,2463,2155,985,783,798,754,529,221,269,533,64,64,7250,5150,1325,2600,2731,3081,1
621,1,0,195.0,148.0,218.0,149.0,3392,2989,2407,2183,985,806,744,560,459,156,285,404,64,64,7300,5250,1325,2600,2931,3081,1
629,1,0,199.0,152.0,218.0,165.0,3314,2843,2351,2015,963,828,731,471,434,146,297,325,64,66,7100,5500,1325,2600,3131,3081,1
636,1,0,199.5,156.0,218.0,165.0,3314,3185,2351,2379,963,806,717,661,529,240,188,421,64,67,7075,5500,1325,2600,3156,3081,1
643,1,0,169.0,132.0,218.0,165.0,3308,2776,2323,2015,985,761,512,578,354,69,158,509,62,52,5350,4625,1325,2600,5381,4981,1
650,1,0,166.0,120.0,218.0,180.0,3398,2406,2435,1735,963,671,328,768,204,179,124,589,62,45,4950,4475,1325,2600,6181,5756,1
657,1,0,165.0,122.0,210.0,180.0,3342,2423,2379,1707,963,716,309,741,219,64,90,677,62,48,4450,4550,1325,2600,6681,5956,1
664,1,0,168.0,124.0,210.0,180.0,3274,2507,2267,1791,1007,716,309,599,199,59,110,540,61,48,5050,4750,1325,2600,6681,5956,1
671,1,0,168.0,129.0,216.0,180.0,3302,3134,2295,2351,1007,783,605,765,379,129,226,636,61,50,5650,5000,1325,2600,6681,5956,1
679,1,0,168.0,135.0,216.0,180.0,3286,3067,2323,2239,963,828,547,821,434,89,113,732,65,51,5850,5000,1325,2600,6681,5956,1
686,1,0,181.0,138.0,216.0,180.0,3342,3185,2379,2379,963,806,303,838,199,114,104,724,65,52,5850,5100,1325,2600,6681,5956,1
693,1,0,183.0,142.0,224.0,180.0,3364,3521,2379,2715,985,806,583,848,359,124,224,724,65,54,5850,5250,1325,2600,6681,5956,1
700,1,0,185.0,146.0,224.0,180.0,3342,3274,2379,2491,963,783,554,909,314,214,240,695,64,55,6500,5625,1575,2600,6681,5956,1
707,1,0,184.0,152.0,224.0,180.0,3370,3353,2407,2547,963,806,970,999,614,204,356,795,63,57,6500,5775,1575,2825,6681,5956,1
714,1,0,199.0,158.0,224.0,180.0,3286,3521,2211,2715,1075,806,627,1035,139,144,488,891,66,58,6500,5825,1575,2825,6681,5956,1
721,1,0,199.0,160.0,224.0,180.0,3454,3566,2155,2715,1299,851,1053,1055,409,214,644,841,66,60,6500,6075,1575,2825,6681,5956,1
729,1,0,196.0,163.0,224.0,180.0,3543,3263,2267,2435,1276,828,1484,1311,684,374,800,937,81,61,6500,6450,1950,2825,6831,5956,1
736,1,0,187.0,164.0,218.0,188.0,3353,3157,2211,2351,1142,806,1548,1095,624,216,924,879,78,57,6200,6450,1950,3075,7631,6256,1
743,1,0,178.0,164.0,218.0,188.0,3090,3129,2127,2323,963,806,1939,975,899,146,1040,829,77,56,5800,6450,1950,3075,8031,6506,1
750,1,0,174.0,165.0,218.0,188.0,3062,3297,2099,2491,963,806,1115,1206,359,281,756,925,75,58,5700,6500,1950,3075,8131,6556,1
757,1,0,179.0,174.0,218.0,188.0,3078,3381,2071,2575,1007,806,1035,841,309,66,726,775,74,61,5700,6550,1950,3150,8131,6556,1
764,1,0,179.0,174.0,218.0,188.0,2854,3207,1847,2379,1007,828,951,717,309,96,642,621,74,62,5700,6600,1950,3150,8131,6556,1
771,1,0,180.0,177.0,218.0,188.0,2838,3174,1875,2323,963,851,993,982,414,261,579,721,74,63,5700,6875,2075,3150,8131,6556,1
779,1,0,190.0,176.0,218.0,188.0,2866,3302,1903,2407,963,895,584,876,139,301,445,575,74,63,6250,7025,2075,3150,8131,6606,1
786,1,0,190.0,183.0,218.0,188.0,3336,3655,2351,2715,985,940,904,908,389,221,515,687,74,63,6250,7275,2075,3150,8131,6656,1
793,1,0,199.0,185.0,218.0,196.0,3006,3638,2043,2743,963,895,725,1226,94,431,631,795,74,63,6350,7550,2075,3150,8131,6656,1
800,1,0,199.0,189.0,218.0,196.0,2754,3851,1791,2911,963,940,1061,957,314,171,747,786,83,64,7100,8075,2075,3150,8131,6656,1
807,1,0,198.0,193.0,218.0,196.0,3106,3767,2099,2827,1007,940,1371,1074,504,301,867,773,82,64,7100,8275,2075,3150,8131,6656,1
814,1,0,185.0,184.0,224.0,196.0,3000,3504,2015,2519,985,985,1713,1436,734,551,979,885,80,64,6350,7650,2075,3150,8881,7281,1
821,1,0,172.0,175.0,230.0,196.0,3062,3538,2099,2575,963,963,384,1663,89,666,295,997,80,64,4150,7100,2425,3150,11081,7931,1
829,1,0,170.0,178.0,230.0,196.0,3454,3521,2491,2603,963,918,605,927,244,126,361,801,77,64,3950,6700,2550,3150,11431,8381,1
836,1,0,180.0,178.0,222.0,196.0,3157,3437,2015,2519,1142,918,138,1343,79,426,59,917,77,64,3950,6975,2550,3150,11531,8381,1
843,1,0,184.0,183.0,222.0,196.0,3846,3409,2435,2491,1411,918,314,1351,154,451,160,900,77,64,4700,7550,2550,3150,11681,8381,1
850,1,0,184.0,179.0,222.0,196.0,4103,3297,2603,2379,1500,918,813,1282,469,391,344,891,77,64,6250,6550,2550,3150,11681,9381,1
857,1,0,200.0,184.0,222.0,196.0,4210,3291,2687,2351,1523,940,307,1379,154,376,153,1003,77,64,6550,6650,2550,3150,11681,9381,1
864,1,0,198.0,180.0,222.0,196.0,4232,3448,2687,2463,1545,985,517,1790,334,671,183,1119,77,64,6750,6450,2550,3150,11781,9781,1
871,1,0,200.0,175.0,222.0,211.0,4170,3325,2603,2407,1567,918,531,1974,314,751,217,1223,77,64,6550,6800,2550,3150,11981,10356,1
879,1,0,200.0,175.0,222.0,211.0,4165,3375,2575,2435,1590,940,648,1976,439,641,209,1335,77,64,7550,7275,2550,3450,11981,10356,1
886,1,0,163.0,153.0,222.0,211.0,4170,3302,2603,2407,1567,895,1122,2244,729,826,393,1418,77,64,5450,6150,2550,3600,14081,11631,1
893,1,0,147.0,149.0,214.0,211.0,4120,3263,2575,2323,1545,940,270,1640,114,406,156,1234,77,64,3600,5450,2550,3600,16381,12431,1
900,1,0,124.0,138.0,214.0,211.0,3622,3314,2099,2407,1523,907,375,1200,114,231,261,969,66,64,2500,4450,2550,3600,18031,13331,1
907,1,0,124.0,140.0,214.0,211.0,3062,3168,1651,2351,1411,817,539,1412,164,351,375,1061,64,64,2350,4650,2550,3825,18281,13331,1
914,1,0,116.0,136.0,214.0,211.0,3050,3213,1819,2407,1231,806,919,1808,404,651,515,1157,64,64,3150,4550,2425,3825,18956,13531,1
921,1,0,105.0,137.0,214.0,211.0,3510,3202,2323,2463,1187,739,616,1894,144,661,472,1233,63,64,1650,5100,2300,3825,20931,13731,1
7,1,0,13.0,13.0,14.0,15.0,251,335,251,335,0,0,30,40,30,40,0,0,12,12,0,0,0,0,0,0,0
14,1,0,13.0,14.0,14.0,15.0,671,671,671,671,0,0,20,70,20,70,0,0,13,13,0,0,0,0,0,0,0
21,1,0,14.0,14.0,14.0,15.0,727,699,727,699,0,0,55,0,55,0,0,0,13,13,0,0,0,0,0,0,0
29,1,0,14.0,15.0,14.0,15.0,755,699,755,699,0,0,145,40,145,40,0,0,13,14,0,0,0,0,0,0,0
36,1,0,16.0,15.0,22.0,15.0,783,783,783,783,0,0,145,135,145,135,0,0,14,14,0,0,0,0,0,0,0
43,1,0,16.0,16.0,22.0,23.0,839,783,839,783,0,0,245,75,245,75,0,0,16,15,0,0,0,0,0,0,0
50,1,0,15.0,16.0,22.0,23.0,839,727,839,727,0,0,40,35,40,35,0,0,15,15,0,0,0,0,0,0,0
57,1,0,17.0,17.0,22.0,23.0,895,755,895,755,0,0,40,75,40,75,0,0,15,16,0,0,0,0,0,0,0
64,1,0,18.0,18.0,22.0,23.0,923,755,923,755,0,0,105,170,105,170,0,0,16,17,0,0,0,0,0,0,0
71,1,0,17.0,18.0,22.0,23.0,895,844,895,755,0,89,185,226,185,210,0,16,17,17,0,0,0,0,0,0,0
79,1,0,17.0,19.0,22.0,23.0,951,911,951,755,0,156,40,327,40,295,0,32,16,18,0,0,0,0,0,0,0
86,1,0,18.0,19.0,22.0,23.0,923,934,923,755,0,179,105,447,105,395,0,52,16,18,0,0,0,150,0,0,0
93,1,0,19.0,20.0,22.0,23.0,979,934,979,755,0,179,170,297,170,275,0,22,18,19,0,0,0,150,0,0,0
100,1,0,20.0,20.0,22.0,23.0,1034,911,923,755,111,156,250,408,230,370,20,38,18,19,0,0,0,150,0,0,0
107,1,0,20.0,20.0,22.0,23.0,1079,939,923,783,156,156,365,123,325,65,40,58,19,19,0,0,0,150,0,0,0
114,1,0,21.0,20.0,22.0,23.0,1079,939,923,783,156,156,450,93,390,15,60,78,20,19,0,0,0,150,0,0,0
121,1,0,25.0,21.0,28.0,23.0,1062,883,951,727,111,156,272,143,200,45,72,98,20,19,0,0,250,150,0,0,0
129,1,0,26.0,22.0,28.0,23.0,1102,1018,1035,839,67,179,360,233,280,115,80,118,21,19,0,100,250,150,0,0,0
136,1,0,28.0,23.0,28.0,23.0,1163,1158,1119,979,44,179,289,113,205,75,84,38,21,20,0,100,250,150,0,0,0
143,1,0,27.0,24.0,28.0,31.0,1247,1247,1203,1091,44,156,147,109,55,105,92,4,20,21,50,150,250,150,0,0,0
150,1,0,28.0,24.0,28.0,31.0,1158,1191,1091,1035,67,156,30,189,30,165,0,24,22,21,50,150,250,150,0,0,0
157,1,0,30.0,25.0,36.0,31.0,1354,1303,1287,1147,67,156,88,344,80,300,8,44,22,22,350,150,250,150,0,0,0
164,1,0,30.0,25.0,36.0,31.0,1298,1191,1231,1035,67,156,251,94,235,30,16,64,23,22,350,150,250,150,0,0,0
171,1,0,34.0,26.0,36.0,31.0,1382,1247,1315,1091,67,156,54,144,30,60,24,84,24,23,400,150,250,150,0,0,0
179,1,0,34.0,26.0,36.0,46.0,1359,1242,1315,1063,44,179,218,344,190,240,28,104,24,23,400,150,250,250,0,0,0
186,1,0,36.0,27.0,36.0,46.0,1382,1326,1315,1147,67,179,126,314,90,190,36,124,26,24,400,150,250,500,0,0,0
193,1,0,42.0,27.0,44.0,46.0,1550,1275,1483,1119,67,156,124,240,80,125,44,115,28,24,400,150,250,500,0,0,0
200,1,0,42.0,32.0,44.0,46.0,1522,1499,1455,1343,67,156,192,165,140,30,52,135,28,25,400,150,250,500,0,0,0
207,1,0,44.0,33.0,44.0,46.0,1634,1443,1567,1287,67,156,250,165,190,10,60,155,32,25,550,150,250,575,0,0,0
214,1,0,47.0,34.0,58.0,46.0,1785,1527,1651,1371,134,156,215,140,135,65,80,75,32,26,550,150,250,575,0,0,0
221,1,0,51.0,35.0,58.0,46.0,1886,1746,1707,1567,179,179,180,245,80,150,100,95,32,27,550,350,250,575,0,0,0
229,1,0,55.0,37.0,66.0,46.0,1891,1690,1735,1511,156,179,206,60,90,45,116,15,35,28,700,350,250,575,0,0,0
236,1,0,57.0,38.0,66.0,61.0,1919,1779,1763,1511,156,268,326,156,190,155,136,1,37,29,700,350,250,725,0,0,0
243,1,0,59.0,40.0,66.0,61.0,2031,1880,1875,1567,156,313,371,131,215,90,156,41,39,30,950,400,250,725,0,0,0
250,1,0,58.5,44.0,66.0,61.0,2171,1992,2015,1679,156,313,636,121,460,40,176,81,41,32,925,400,250,725,25,0,0
257,1,0,65.5,45.0,74.0,61.0,2166,2210,1987,1875,179,335,486,241,290,120,196,121,41,33,1175,400,250,725,25,0,0
264,1,0,68.5,49.0,74.0,61.0,2362,2272,2183,1959,179,313,371,282,155,125,216,157,44,34,1175,550,250,975,25,0,0
271,1,0,72.5,50.0,74.0,61.0,2199,2462,2043,2127,156,335,342,407,110,210,232,197,43,35,1175,550,250,1075,25,0,0
279,1,0,73.5,52.0,74.0,61.0,2143,2350,1987,2015,156,335,312,217,110,30,202,187,49,36,1175,600,250,1075,25,0,0
286,1,0,73.5,60.0,74.0,69.0,2395,2272,2239,1959,156,313,357,38,135,15,222,23,52,38,1175,700,250,1075,25,0,0
293,1,0,73.5,60.0,74.0,69.0,2423,2440,2267,2127,156,313,452,103,210,40,242,63,52,38,1325,700,500,1075,25,0,0
300,1,0,73.5,65.0,74.0,69.0,2647,2462,2491,2127,156,335,597,133,435,30,162,103,52,40,1325,750,500,1075,25,100,0
307,1,0,87.5,65.0,98.0,69.0,2866,2440,2575,2127,291,313,237,69,35,30,202,39,52,40,1325,750,500,1325,25,100,0
314,1,0,87.5,68.0,98.0,77.0,2994,2580,2659,2267,335,313,602,164,360,85,242,79,52,43,1475,1200,500,1425,25,100,0
321,1,0,87.5,71.0,106.0,77.0,2972,2692,2659,2267,313,425,438,290,385,155,53,135,55,43,1475,1300,700,1425,25,100,0
329,1,0,87.5,72.0,98.0,77.0,3078,2927,2743,2323,335,604,273,197,205,190,68,7,55,45,1925,1300,700,1425,125,100,0
336,1,0,87.5,77.0,98.0,77.0,3134,2838,2799,2211,335,627,533,82,425,70,108,12,55,47,2175,1450,700,1425,125,100,0
343,1,0,97.5,77.0,114.0,77.0,3112,2888,2799,2239,313,649,354,188,210,75,144,113,54,47,2375,1450,700,1425,125,100,0
350,1,0,96.0,84.0,122.0,85.0,3140,2692,2827,2043,313,649,669,238,485,45,184,193,54,49,2250,1500,700,1425,250,100,0
357,1,0,99.0,84.0,122.0,85.0,3050,2670,2715,2043,335,627,879,489,655,220,224,269,54,51,2750,1600,700,1425,250,100,0
364,1,0,96.0,69.0,122.0,85.0,3056,2686,2743,2015,313,671,1205,869,945,520,260,349,54,51,2550,900,700,1575,400,900,0
371,1,0,98.5,64.0,122.0,93.0,3078,2261,2743,1679,335,582,1065,852,765,439,300,413,54,50,2325,700,700,1575,775,1200,0
379,1,0,97.0,64.0,122.0,93.0,2994,2171,2659,1679,335,492,800,941,460,522,340,419,53,48,2350,700,950,1575,800,1275,0
386,1,0,98.0,63.0,122.0,93.0,2888,2009,2575,1539,313,470,646,555,420,80,226,475,61,47,2300,800,950,1575,850,1425,0
393,1,0,96.0,65.0,122.0,93.0,2776,1902,2463,1455,313,447,926,651,660,124,266,527,59,47,2300,850,950,1575,850,1425,0
400,1,0,96.0,69.0,122.0,93.0,2826,2009,2491,1539,335,470,1271,627,965,44,306,583,63,47,2300,900,950,1875,850,1425,0
407,1,0,105.0,73.0,122.0,93.0,3050,2395,2715,1791,335,604,1206,797,860,234,346,563,63,49,2300,1100,950,1875,850,1425,0
414,1,0,112.0,76.0,128.0,93.0,3140,2989,2827,2295,313,694,822,742,640,99,182,643,63,50,2300,1100,950,1875,850,1425,0
421,1,0,117.0,80.0,128.0,93.0,3526,3280,3191,2631,335,649,1002,834,780,144,222,690,64,51,2750,1200,950,1975,850,1425,0
429,1,0,117.0,87.0,128.0,93.0,3498,3398,3163,2771,335,627,1122,745,1010,104,112,641,70,53,3150,1350,950,1975,875,1425,0
436,1,0,117.0,91.0,128.0,109.0,3560,3532,3247,2883,313,649,1528,755,1380,84,148,671,75,54,3150,1400,950,2425,875,1425,0
443,1,0,120.0,95.0,128.0,109.0,3930,3728,3303,3079,627,649,1504,840,1410,164,94,676,74,56,3150,1600,950,2525,875,1425,0
450,1,0,116.0,96.0,134.0,109.0,4002,3784,3219,3135,783,649,1986,1241,1800,489,186,752,74,57,2800,1750,950,2625,1225,1475,0
457,1,0,131.0,104.0,140.0,117.0,4019,3918,3191,3247,828,671,1586,841,1300,34,286,807,77,58,2800,1750,950,2775,1225,1575,0
464,1,0,129.5,112.0,140.0,117.0,3918,4008,3135,3359,783,649,1463,743,1185,64,278,679,92,58,2775,2000,950,2775,1250,1575,0
471,1,0,134.5,117.0,140.0,117.0,4053,3426,3247,2799,806,627,928,889,900,184,28,705,92,60,2775,2300,950,3125,1250,1575,0
479,1,0,144.5,115.0,172.0,125.0,4299,2978,3471,2351,828,627,939,529,815,169,124,360,92,60,2775,2400,1075,3125,1250,1575,0
486,1,0,148.5,120.0,172.0,125.0,4551,3073,3723,2379,828,694,1309,452,1085,29,224,423,92,60,3725,2450,1075,3125,1300,1575,0
493,1,0,149.5,125.0,180.0,125.0,4932,3095,4059,2379,873,716,1272,550,1240,39,32,511,92,60,3725,3150,1075,3125,1300,1575,0
500,1,0,158.0,125.0,180.0,125.0,5128,3263,4143,2547,985,716,1437,825,1285,234,152,591,92,60,4300,3300,1325,3125,1325,1575,0
507,1,0,149.5,128.0,180.0,133.0,5078,3202,4115,2463,963,739,2043,1118,1775,439,268,679,92,60,4475,3550,1325,3125,1900,1575,0
514,1,0,159.0,126.0,180.0,133.0,5184,2737,4199,2043,985,694,1674,749,1440,119,234,630,92,49,4550,3600,1325,3125,2050,2175,0
521,1,0,159.0,120.0,180.0,141.0,5066,2278,4059,1651,1007,627,1104,925,1075,219,29,706,92,45,4150,3400,1325,3125,2225,2575,0
529,1,0,168.0,123.0,180.0,141.0,5044,2300,4059,1651,985,649,991,765,950,54,41,711,92,45,4750,3550,1325,3375,2275,2575,0
536,1,0,162.5,116.0,180.0,149.0,4770,2412,3807,1763,963,649,1532,855,1375,89,157,766,90,47,5375,3125,1325,3375,2425,2736,0
543,1,0,156.0,114.0,180.0,149.0,4904,2362,3919,1735,985,627,1528,926,1255,84,273,842,88,48,4700,2825,1325,3375,3125,3036,0
550,1,0,163.0,110.0,180.0,149.0,4820,2490,3835,1819,985,671,1543,1031,1150,134,393,897,99,49,4700,2700,1325,3375,3300,3436,0
557,1,0,154.0,100.0,180.0,149.0,4887,2714,3947,2043,940,671,2120,987,1615,64,505,923,99,49,3900,2325,1325,3375,3950,4286,0
562,1,0,154.0,95.0,180.0,149.0,4887,2776,3947,2127,940,649,2120,1023,1615,44,505,979,99,45,3900,2125,1325,3375,3950,4736,0
7,2,2,13.0,13.0,15.0,15.0,293,293,293,293,0,0,35,35,35,35,0,0,12,12,0,0,0,0,0,0,1
14,2,2,14.0,14.0,15.0,15.0,671,671,671,671,0,0,70,70,70,70,0,0,13,13,0,0,0,0,0,0,1
21,2,2,14.0,14.0,15.0,15.0,699,699,699,699,0,0,50,50,50,50,0,0,13,13,0,0,0,0,0,0,1
29,2,2,15.0,15.0,15.0,15.0,699,783,699,783,0,0,90,45,90,45,0,0,14,14,0,0,0,0,0,0,1
36,2,2,15.0,15.0,23.0,15.0,811,755,811,755,0,0,140,135,140,135,0,0,14,14,0,0,0,0,0,0,1
43,2,2,16.0,16.0,23.0,23.0,811,811,811,811,0,0,30,35,30,35,0,0,15,15,0,0,0,0,0,0,1
50,2,2,17.0,17.0,23.0,23.0,867,839,867,839,0,0,10,10,10,10,0,0,16,16,0,0,0,0,0,0,1
57,2,2,18.0,18.0,23.0,23.0,923,839,923,839,0,0,45,35,45,35,0,0,17,17,0,0,0,0,0,0,1
64,2,2,19.0,19.0,23.0,23.0,1007,951,1007,951,0,0,115,100,115,100,0,0,18,18,0,0,0,0,0,0,1
71,2,2,19.0,19.0,23.0,23.0,979,979,979,979,0,0,25,10,25,10,0,0,18,18,0,0,0,0,0,0,1
79,2,2,20.0,20.0,23.0,23.0,1051,945,1007,923,44,22,103,64,95,60,8,4,19,19,0,0,0,0,0,0,1
86,2,2,21.0,21.0,23.0,23.0,1102,1012,923,923,179,89,77,41,45,25,32,16,20,20,0,0,150,150,0,0,1
93,2,2,22.0,22.0,23.0,23.0,1018,1085,839,951,179,134,98,122,50,90,48,32,21,21,0,0,150,150,0,0,1
100,2,2,22.0,22.0,23.0,23.0,1191,1130,923,951,268,179,144,101,60,45,84,56,21,21,0,0,150,150,0,0,1
107,2,2,23.0,23.0,23.0,23.0,1158,1163,867,895,291,268,220,241,100,145,120,96,22,22,0,0,150,150,0,0,1
114,2,2,23.0,24.0,23.0,31.0,1236,1152,923,839,313,313,325,336,165,200,160,136,23,23,0,0,150,150,0,0,1
121,2,2,24.0,24.0,31.0,31.0,1230,1236,895,923,335,313,460,486,260,310,200,176,23,23,0,0,300,450,0,0,1
129,2,2,28.0,29.0,31.0,31.0,1314,1281,979,923,335,358,86,161,50,145,36,16,24,24,0,0,450,450,0,0,1
136,2,2,28.0,29.0,31.0,31.0,1370,1202,1035,867,335,335,141,207,115,155,26,52,24,24,0,0,450,450,0,0,1
143,2,2,28.0,29.0,31.0,31.0,1320,1236,1007,923,313,313,117,353,105,265,12,88,24,25,0,0,450,450,0,0,1
150,2,2,29.0,29.0,31.0,31.0,1270,1208,979,895,291,313,213,403,165,275,48,128,24,25,0,150,450,450,0,0,1
157,2,2,31.0,29.0,39.0,39.0,1314,1214,979,923,335,291,268,254,180,240,88,14,25,25,175,325,450,450,0,0,1
164,2,2,29.0,29.0,39.0,39.0,1314,1242,979,951,335,291,533,489,405,435,128,54,25,25,175,325,450,450,0,0,1
171,2,2,32.0,31.0,39.0,39.0,1292,1258,979,923,313,335,374,64,360,20,14,44,25,25,350,325,750,450,0,0,1
179,2,2,32.0,32.0,39.0,39.0,1258,1342,923,1007,335,335,124,184,70,100,54,84,25,25,350,325,750,450,0,0,1
186,2,2,33.0,32.0,39.0,39.0,1286,1264,951,951,335,313,129,220,35,100,94,120,25,25,350,325,750,450,0,0,1
193,2,2,33.0,35.0,39.0,39.0,1292,1342,979,1007,313,335,180,165,50,55,130,110,25,26,350,325,750,450,0,0,1
200,2,2,37.0,35.0,39.0,39.0,1292,1264,979,951,313,313,90,311,70,165,20,146,26,26,650,500,750,750,0,0,1
207,2,2,37.0,37.0,47.0,39.0,1342,1320,1007,1007,335,313,195,196,135,110,60,86,26,27,650,500,750,750,0,0,1
214,2,2,38.0,37.0,47.0,39.0,1314,1292,979,979,335,313,250,292,150,170,100,122,27,27,650,500,750,850,0,0,1
221,2,2,38.0,38.0,47.0,39.0,1326,1348,1035,1035,291,313,107,402,75,240,32,162,27,28,650,500,750,850,0,0,1
229,2,2,39.0,41.0,47.0,47.0,1376,1348,1063,1035,313,313,177,267,105,165,72,102,28,29,950,800,750,850,0,0,1
236,2,2,40.0,41.0,47.0,47.0,1342,1477,1007,1119,335,358,322,437,210,295,112,142,29,29,950,800,750,850,0,0,1
243,2,2,40.0,44.0,47.0,62.0,1264,1286,951,951,313,335,428,98,280,70,148,28,29,30,950,800,850,850,0,0,1
250,2,2,43.0,45.0,62.0,62.0,1438,1158,1147,867,291,291,274,140,140,80,134,60,30,30,1125,1225,850,850,0,0,1
257,2,2,43.0,45.0,62.0,62.0,1488,1023,1175,755,313,268,439,82,265,40,174,42,30,28,1125,1225,1100,850,0,125,1
264,2,2,43.0,46.0,62.0,62.0,1326,838,1035,615,291,223,321,99,165,25,156,74,27,29,1125,1400,1100,850,200,125,1
271,2,2,38.0,47.0,62.0,62.0,743,1471,587,1203,156,268,388,136,220,30,168,106,25,31,1000,1400,1100,850,650,125,1
279,2,2,39.0,48.0,62.0,62.0,346,1572,279,1371,67,201,231,281,55,155,176,126,26,32,1000,1400,1250,1100,650,125,1
286,2,2,41.0,50.0,62.0,62.0,1074,1762,1007,1539,67,223,184,84,100,80,84,4,28,33,1000,1400,1250,1100,650,125,1
293,2,2,42.0,51.0,62.0,62.0,1359,1802,1203,1511,156,291,188,115,80,75,108,40,29,34,1000,1400,1250,1100,650,125,1
300,2,2,44.0,52.0,62.0,62.0,1566,1824,1343,1511,223,313,442,321,310,245,132,76,31,35,1000,1400,1250,1100,650,125,1
307,2,2,44.0,53.0,62.0,62.0,1606,1908,1315,1595,291,313,232,301,210,285,22,16,31,37,1000,1400,1250,1250,650,125,1
314,2,2,45.0,53.0,62.0,70.0,1790,1986,1455,1651,335,335,492,391,430,335,62,56,33,36,1000,1400,1250,1250,650,175,1
321,2,2,47.0,55.0,62.0,70.0,1790,2042,1455,1707,335,335,202,531,100,435,102,96,34,38,1000,1400,1250,1250,650,175,1
329,2,2,50.0,56.0,62.0,70.0,1740,1986,1427,1651,313,335,133,362,45,230,88,132,35,39,1000,1400,1250,1250,650,175,1
336,2,2,50.0,57.0,62.0,70.0,1824,2070,1511,1735,313,335,134,572,60,400,74,172,33,40,1175,1400,1250,1250,800,175,1
343,2,2,51.0,57.0,62.0,70.0,1751,2076,1483,1763,268,313,236,768,130,560,106,208,34,40,1350,1400,1250,1250,800,225,1
350,2,2,54.0,58.0,62.0,70.0,1818,2059,1483,1791,335,268,327,425,235,285,92,140,35,41,1350,1400,1250,1250,800,225,1
357,2,2,53.0,64.0,62.0,70.0,1930,2093,1595,1847,335,246,362,171,230,145,132,26,37,43,1225,1725,1250,1250,1100,225,1
364,2,2,54.0,64.0,62.0,70.0,1964,2222,1651,1931,313,291,168,197,0,135,168,62,38,43,1225,1725,1250,1250,1100,225,1
371,2,2,55.0,66.0,62.0,70.0,1970,2306,1679,2015,291,291,304,268,100,170,204,98,39,45,1225,1725,1250,1250,1100,225,1
379,2,2,56.0,70.0,70.0,70.0,2070,2283,1735,2015,335,268,499,131,255,105,244,26,40,46,1225,1725,1250,1250,1100,225,1
386,2,2,57.0,72.0,70.0,78.0,1986,2171,1651,1791,335,380,385,138,205,60,180,78,41,47,1225,2075,1250,1250,1100,225,1
393,2,2,64.0,72.0,85.0,78.0,2149,2322,1791,1875,358,447,169,255,95,125,74,130,43,47,1225,2075,1250,1550,1100,225,1
400,2,2,65.0,76.0,85.0,101.0,2339,2289,1847,1819,492,470,154,227,20,120,134,107,44,49,1550,2075,1250,1800,1100,225,1
407,2,2,67.0,82.0,85.0,109.0,2283,2490,1791,2043,492,447,369,104,175,95,194,9,46,51,1550,2075,1250,1800,1100,225,1
414,2,2,70.0,84.0,85.0,109.0,2401,2434,1931,1987,470,447,215,90,115,25,100,65,49,53,1550,2400,1550,2200,1100,225,1
421,2,2,77.0,88.0,85.0,109.0,2569,2658,2099,2211,470,447,85,171,25,50,60,121,52,56,1550,2500,1550,2200,1100,225,1
429,2,2,78.0,88.0,93.0,109.0,2838,2821,2323,2351,515,470,320,236,200,155,120,81,53,58,1900,2500,1550,2200,1100,225,1
436,2,2,80.0,86.0,93.0,125.0,3062,3067,2547,2575,515,492,250,461,220,370,30,91,55,58,1900,2500,1900,2200,1100,225,1
443,2,2,82.0,86.0,93.0,125.0,2989,3095,2519,2603,470,492,242,217,160,170,82,47,58,58,1900,2500,1900,2200,1100,225,1
450,2,2,85.0,87.0,93.0,125.0,2961,3118,2491,2603,470,515,263,497,175,465,88,32,59,58,1900,2500,1900,2200,1100,225,1
457,2,2,88.0,99.0,93.0,133.0,2961,3235,2491,2743,470,492,179,278,135,190,44,88,61,58,2075,2500,1900,2200,1100,225,1
464,2,2,87.0,99.0,93.0,133.0,3286,3157,2659,2687,627,470,238,124,110,80,128,44,61,58,2075,3100,1900,2200,1100,225,1
471,2,2,89.0,103.0,101.0,133.0,3375,3241,2771,2771,604,470,451,374,255,270,196,104,63,58,2075,3200,1900,2200,1100,225,1
479,2,2,95.0,112.0,101.0,133.0,3269,3179,2687,2687,582,492,153,294,35,130,118,164,63,58,2075,3200,1900,2200,1100,225,1
486,2,2,98.0,118.0,109.0,133.0,3325,3118,2631,2603,694,515,260,369,200,145,60,224,65,61,2600,3600,2200,2500,1100,225,1
493,2,2,98.0,120.0,117.0,133.0,3353,3179,2547,2687,806,492,256,545,100,265,156,280,65,61,2600,3800,2500,2500,1100,225,1
500,2,2,99.0,122.0,117.0,133.0,3431,2961,2603,2491,828,470,431,297,175,165,256,132,65,61,2600,4275,2500,2500,1100,225,1
507,2,2,100.0,128.0,117.0,133.0,3437,2905,2631,2435,806,470,492,327,290,135,202,192,65,61,2600,4275,2650,2500,1100,225,1
514,2,2,104.0,134.0,125.0,156.0,3465,2905,2659,2435,806,470,558,363,410,115,148,248,66,61,2900,4575,2800,2650,1100,225,1
521,2,2,104.0,138.0,125.0,156.0,3353,3269,2547,2799,806,470,304,573,210,265,94,308,67,61,2900,5075,2950,2800,1100,225,1
529,2,2,108.0,142.0,133.0,156.0,3269,3403,2463,2911,806,492,360,678,270,310,90,368,68,61,3250,5525,2950,2800,1100,225,1
536,2,2,115.0,139.0,133.0,156.0,3302,3482,2519,2967,783,515,231,1078,195,650,36,428,68,61,3725,5225,2950,3150,1275,525,1
543,2,2,111.0,125.0,133.0,164.0,3543,3381,2715,2911,828,470,671,1475,535,995,136,480,68,61,3575,4450,2950,3150,1600,1300,1
550,2,2,115.0,141.0,133.0,164.0,3515,3459,2687,2967,828,492,462,650,380,210,82,440,68,61,3700,4150,2950,3150,1775,1600,1
557,2,2,124.0,139.0,133.0,164.0,3459,3459,2631,2967,828,492,423,850,245,650,178,200,68,61,4100,4350,3150,3150,1775,700,1
564,2,2,127.0,143.0,148.0,164.0,3493,3353,2687,2883,806,470,284,801,210,545,74,256,68,61,4100,5100,3300,3150,1775,700,1
571,2,2,132.0,146.0,148.0,164.0,3325,3403,2519,2911,806,492,520,971,350,755,170,216,70,62,4400,5550,3300,3150,1775,700,1
579,2,2,133.0,162.0,148.0,172.0,3470,3538,2687,3023,783,515,786,586,520,310,266,276,72,65,4400,5850,3300,3150,1775,700,1
586,2,2,137.0,164.0,148.0,180.0,3493,3515,2687,3023,806,492,511,657,345,425,166,232,74,66,4400,6600,3600,3150,1775,700,1
593,2,2,147.0,166.0,148.0,180.0,3818,3655,2967,3163,851,492,312,888,175,600,137,288,75,66,5200,6700,3600,3150,1775,800,1
600,2,2,148.0,178.0,148.0,188.0,3857,3627,3051,3135,806,492,474,603,395,255,79,348,75,66,5600,6450,3600,3150,1875,1050,1
607,2,2,147.0,180.0,148.0,188.0,3997,3717,3191,3247,806,470,605,814,430,510,175,304,75,66,5425,7400,3750,3150,2050,1050,1
614,2,2,134.0,152.0,156.0,188.0,3997,3801,3191,3331,806,470,1075,1274,800,910,275,364,75,66,4475,5850,3600,3150,3150,2600,1
621,2,2,123.0,168.0,148.0,188.0,3946,3767,3163,3275,783,492,1546,539,1175,215,371,324,74,66,3800,5750,3500,3150,3725,2700,1
629,2,2,112.0,154.0,172.0,188.0,3666,3818,2883,3303,783,515,1176,659,705,375,471,284,59,66,3175,5850,3650,3150,5200,3750,1
636,2,2,116.0,143.0,149.0,188.0,3174,3487,2323,2995,851,492,1146,950,725,685,421,265,58,58,4075,5750,3650,3150,5750,4350,1
643,2,2,113.0,144.0,149.0,188.0,3084,2899,2211,2407,873,492,761,761,390,440,371,321,59,55,3725,5750,3650,3150,6100,4500,1
650,2,2,117.0,145.0,149.0,188.0,3045,2871,2239,2379,806,492,609,1056,300,675,309,381,60,58,4150,5850,3650,3150,6200,4500,1
657,2,2,117.0,149.0,149.0,188.0,2989,2485,2183,2015,806,470,965,932,560,595,405,337,61,58,4150,6100,3650,3150,6200,4550,1
664,2,2,118.0,161.0,149.0,188.0,3050,2653,2267,2183,783,470,1036,557,685,160,351,397,61,59,3900,6100,3650,3150,6450,4650,1
671,2,2,124.0,163.0,149.0,188.0,2994,2871,2211,2379,783,492,606,642,280,285,326,357,61,60,4200,7050,3650,3450,6450,4650,1
679,2,2,124.0,167.0,149.0,188.0,3263,3151,2435,2659,828,492,801,618,375,205,426,413,60,60,4200,7050,3650,3450,6500,4650,1
686,2,2,124.0,171.0,149.0,188.0,3174,3297,2323,2827,851,470,1131,494,655,175,476,319,58,64,4450,6950,3650,3450,6450,4750,1
693,2,2,137.0,179.0,149.0,188.0,3207,3403,2379,2911,828,492,328,594,160,215,168,379,60,64,5800,8025,3650,3450,6450,4750,1
700,2,2,123.0,169.0,149.0,204.0,3129,3437,2323,2967,806,470,685,1005,425,570,260,435,58,64,5425,7075,3650,3450,7125,5700,1
707,2,2,104.0,155.0,149.0,204.0,3101,3409,2295,2939,806,470,1050,1420,690,925,360,495,58,64,3875,6075,3650,3450,8500,6950,1
714,2,2,100.0,129.0,149.0,204.0,3022,3459,2239,2967,783,492,571,1850,240,1295,331,555,58,64,2250,4775,3800,3450,10325,8250,1
721,2,2,92.0,135.0,164.0,204.0,3050,3538,2267,3023,783,515,781,1035,350,520,431,515,58,64,2325,4825,3800,3450,11100,9200,1
729,2,2,75.0,121.0,164.0,204.0,3039,3151,2211,2659,828,492,836,1251,455,755,381,496,56,64,1275,3950,3800,3450,12500,10075,1
7,1,2,13.0,13.0,14.0,15.0,293,293,293,293,0,0,35,35,35,35,0,0,12,12,0,0,0,0,0,0,1
14,1,2,14.0,14.0,14.0,15.0,671,671,671,671,0,0,70,70,70,70,0,0,13,13,0,0,0,0,0,0,1
21,1,2,14.0,14.0,14.0,15.0,727,727,727,727,0,0,55,0,55,0,0,0,14,13,0,0,0,0,0,0,1
29,1,2,15.0,15.0,14.0,15.0,811,755,811,755,0,0,99,40,99,40,0,0,14,14,0,0,0,0,0,0,1
36,1,2,15.0,15.0,22.0,15.0,811,727,811,727,0,0,194,130,194,130,0,0,14,14,0,0,0,0,0,0,1
43,1,2,16.0,16.0,22.0,23.0,811,811,811,811,0,0,244,20,244,20,0,0,15,15,0,0,0,0,0,0,1
50,1,2,15.0,17.0,22.0,23.0,839,811,839,811,0,0,44,40,44,40,0,0,15,16,0,0,0,0,0,0,1
57,1,2,17.0,18.0,22.0,23.0,867,811,867,811,0,0,49,90,49,90,0,0,15,17,0,0,0,0,0,0,1
64,1,2,18.0,18.0,22.0,23.0,923,923,923,923,0,0,104,150,104,150,0,0,16,17,0,0,0,0,0,0,1
71,1,2,17.0,19.0,22.0,23.0,951,951,951,951,0,0,194,210,194,210,0,0,17,18,0,0,0,0,0,0,1
79,1,2,17.0,20.0,22.0,23.0,923,1023,923,979,0,44,44,338,44,330,0,8,16,19,0,0,0,0,0,0,1
86,1,2,18.0,20.0,22.0,23.0,979,990,979,923,0,67,119,56,119,40,0,16,16,19,0,0,0,150,0,0,1
93,1,2,19.0,20.0,22.0,23.0,923,990,923,923,0,67,174,174,174,150,0,24,18,20,0,0,0,150,0,0,1
100,1,2,20.0,21.0,22.0,23.0,995,1012,951,923,44,89,237,101,229,65,8,36,19,20,0,0,0,150,0,0,1
107,1,2,19.0,21.0,22.0,23.0,1068,973,979,839,89,134,64,141,44,85,20,56,18,20,0,0,0,150,0,0,1
114,1,2,20.0,22.0,22.0,23.0,1057,1001,923,867,134,134,140,112,104,40,36,72,19,21,0,0,0,150,0,0,1
121,1,2,23.0,22.0,28.0,23.0,1113,1107,979,951,134,156,71,202,19,110,52,92,20,21,0,0,250,150,0,0,1
129,1,2,24.0,23.0,28.0,31.0,1085,1079,951,923,134,156,152,277,84,165,68,112,20,22,0,0,250,150,0,0,1
136,1,2,26.0,26.0,28.0,31.0,1118,1219,1007,951,111,268,139,302,59,175,80,127,21,23,0,0,250,300,0,0,1
143,1,2,26.0,27.0,28.0,31.0,1225,1174,1091,839,134,335,180,37,84,20,96,17,22,24,0,0,250,300,0,0,1
150,1,2,28.0,29.0,28.0,31.0,1158,1337,1091,979,67,358,14,22,14,15,0,7,22,24,0,125,250,300,0,0,1
157,1,2,30.0,30.0,36.0,46.0,1231,1292,1231,979,0,313,14,114,14,75,0,39,24,25,150,125,250,300,0,0,1
164,1,2,32.0,32.0,36.0,46.0,1259,1236,1259,923,0,313,69,59,69,30,0,29,24,26,150,125,250,300,0,0,1
171,1,2,34.0,33.0,36.0,46.0,1371,1292,1371,979,0,313,39,114,39,45,0,69,24,27,300,125,250,300,0,0,1
179,1,2,34.0,34.0,42.0,46.0,1315,1460,1315,1147,0,313,189,244,189,135,0,109,26,28,400,300,250,300,0,0,1
186,1,2,40.0,35.0,42.0,46.0,1371,1460,1371,1147,0,313,14,389,14,240,0,149,26,29,400,300,250,600,0,0,1
193,1,2,40.0,40.0,50.0,46.0,1483,1673,1483,1315,0,358,104,129,104,90,0,39,26,30,550,300,250,600,0,0,1
200,1,2,44.0,42.0,50.0,46.0,1427,1762,1427,1427,0,335,14,290,14,215,0,75,30,32,550,300,250,600,0,0,1
207,1,2,47.0,43.0,58.0,46.0,1651,1768,1651,1455,0,313,79,391,79,280,0,111,30,33,550,300,250,600,0,0,1
214,1,2,50.0,44.0,58.0,46.0,1651,1824,1651,1511,0,313,129,276,129,125,0,151,33,34,550,300,250,600,0,0,1
221,1,2,52.0,45.0,58.0,46.0,1835,1830,1791,1539,44,291,67,332,59,145,8,187,34,35,700,650,250,600,0,0,1
229,1,2,52.0,46.0,50.0,46.0,1975,1891,1819,1623,156,268,112,268,84,195,28,73,37,36,700,650,250,600,31,0,1
236,1,2,52.0,51.0,50.0,54.0,2143,1874,1987,1539,156,335,258,238,214,125,44,113,40,38,850,650,250,600,31,0,1
243,1,2,53.0,51.0,50.0,62.0,2227,2093,2071,1735,156,358,373,348,309,195,64,153,40,38,850,650,250,600,131,0,1
250,1,2,58.0,53.0,74.0,70.0,2177,2126,1931,1791,246,335,169,599,69,410,100,189,40,40,850,650,250,600,131,0,1
257,1,2,59.0,54.0,82.0,70.0,2322,2132,1987,1819,335,313,144,450,104,225,40,225,41,41,850,650,250,600,131,0,1
264,1,2,61.0,55.0,98.0,70.0,2429,2104,2071,1791,358,313,114,465,34,200,80,265,45,42,850,950,250,750,131,0,1
271,1,2,64.0,61.0,98.0,70.0,2317,2076,1959,1763,358,313,169,320,49,165,120,155,45,44,850,950,250,750,131,0,1
279,1,2,66.0,61.0,98.0,78.0,2384,2076,2071,1763,313,313,221,270,69,175,152,95,46,44,1000,950,250,750,131,0,1
286,1,2,63.5,63.0,98.0,78.0,2328,2261,2015,1903,313,358,441,555,249,420,192,135,47,46,975,950,250,750,156,0,1
293,1,2,71.5,64.0,98.0,78.0,2412,2317,2099,1959,313,358,326,680,94,505,232,175,47,47,975,1300,250,750,156,0,1
300,1,2,72.5,73.0,98.0,78.0,2580,2373,2267,2015,313,358,388,355,116,340,272,15,48,48,975,1550,250,750,156,0,1
307,1,2,75.5,75.0,98.0,78.0,2518,2496,2183,2071,335,425,333,357,21,290,312,67,54,50,975,1550,575,750,156,0,1
314,1,2,77.5,75.0,98.0,78.0,2765,2490,2407,1931,358,559,533,348,181,305,352,43,54,50,1125,1550,825,750,156,0,1
321,1,2,80.5,77.0,98.0,78.0,2793,2569,2435,1987,358,582,378,501,86,390,292,111,59,52,1125,1550,825,750,156,0,1
329,1,2,81.5,78.0,98.0,101.0,2989,2569,2631,1987,358,582,323,362,91,175,232,187,59,52,1125,1900,825,1000,156,0,1
336,1,2,82.0,81.0,106.0,101.0,2972,2608,2547,1959,425,649,388,518,96,330,292,188,59,54,1100,1900,950,1000,181,0,1
343,1,2,85.5,86.0,106.0,101.0,3112,2552,2575,1903,537,649,556,469,196,305,360,164,62,57,1075,2050,950,1000,206,0,1
350,1,2,86.5,88.0,106.0,101.0,3168,2866,2631,2239,537,627,699,271,371,185,328,86,66,59,1075,2050,950,1400,206,0,1
357,1,2,89.5,90.0,106.0,101.0,3252,3168,2603,2519,649,649,939,456,531,390,408,66,67,61,1075,2150,1200,1400,206,0,1
364,1,2,101.5,91.0,106.0,101.0,3560,3274,2687,2603,873,671,677,446,311,400,366,46,67,62,1275,2150,1450,1400,206,0,1
371,1,2,101.5,94.0,106.0,101.0,3683,3448,2743,2799,940,649,1000,802,526,680,474,122,67,65,1425,2150,1450,1500,206,0,1
379,1,2,108.5,99.0,120.0,101.0,3739,3476,2799,2827,940,649,566,688,276,590,290,98,67,66,1425,2150,1450,1800,206,0,1
386,1,2,111.5,99.0,120.0,109.0,3896,3560,2911,2687,985,873,766,1109,356,895,410,214,67,68,2025,2150,1450,1800,206,0,1
393,1,2,111.5,100.0,128.0,109.0,3840,3683,2855,2743,985,940,1026,591,496,465,530,126,70,69,2025,2150,1450,2100,206,0,1
400,1,2,121.5,100.0,128.0,117.0,3874,3678,2911,2715,963,963,688,821,271,575,417,246,68,70,2175,2150,1450,2100,206,0,1
407,1,2,125.5,101.0,152.0,117.0,3946,3622,2939,2659,1007,963,948,706,461,340,487,366,77,70,2475,2150,1450,2100,206,0,1
414,1,2,132.5,106.0,152.0,117.0,3840,3728,2855,2743,985,985,940,732,441,350,499,382,77,70,2875,2525,1450,2100,206,0,1
421,1,2,138.5,108.0,152.0,117.0,4047,3728,3107,2743,940,985,1142,623,556,275,586,348,77,71,3075,2525,1450,2100,206,0,1
429,1,2,143.5,110.0,152.0,117.0,4299,3756,3359,2771,940,985,752,470,396,360,356,110,76,72,3175,2525,1450,2450,206,0,1
436,1,2,143.5,112.0,152.0,125.0,4344,3840,3359,2855,985,985,1097,345,621,265,476,80,75,74,3825,2725,1450,2600,206,0,1
443,1,2,148.0,117.0,152.0,125.0,4266,3745,3303,2827,963,918,1363,578,771,390,592,188,77,74,4000,3300,1450,2750,231,0,1
450,1,2,148.0,125.0,160.0,125.0,4249,3818,3219,2855,1030,963,1877,343,1161,185,716,158,80,74,4050,3500,1800,3350,231,0,1
457,1,2,156.5,123.0,160.0,133.0,4394,3784,3275,2799,1119,985,1489,808,1241,530,248,278,82,76,4025,3700,2050,3350,256,100,1
464,1,2,158.5,126.0,160.0,133.0,4361,3918,3219,2911,1142,1007,1671,700,1291,460,380,240,82,76,3975,3500,2050,3500,306,300,1
471,1,2,158.5,127.0,160.0,141.0,4506,3874,3275,2911,1231,963,1968,1102,1586,750,382,352,82,77,3975,4025,2050,3750,306,300,1
479,1,2,158.5,129.0,160.0,141.0,4574,3818,3275,2855,1299,963,1673,1318,1231,850,442,468,81,78,3975,4325,2050,3750,306,300,1
486,1,2,158.5,129.0,176.0,156.0,4646,3454,3303,2491,1343,963,2228,613,1626,525,602,88,82,79,5025,4325,2050,3850,306,300,1
493,1,2,174.5,135.0,224.0,156.0,4585,3510,3331,2547,1254,963,1022,349,876,145,146,204,82,80,5025,4325,2050,3850,306,300,1
500,1,2,181.5,136.0,224.0,156.0,4378,3874,3079,2911,1299,963,867,775,561,455,306,320,82,80,5025,4625,2050,3850,306,300,1
507,1,2,180.5,136.0,224.0,156.0,4372,4008,3051,3023,1321,985,1308,751,846,315,462,436,81,80,5325,4625,2500,3850,306,300,1
514,1,2,191.5,140.0,224.0,156.0,4411,3918,3135,2911,1276,1007,1070,621,556,465,514,156,81,81,6425,4625,2500,4000,306,300,1
521,1,2,191.5,152.0,224.0,164.0,4473,4159,3219,2995,1254,1164,1611,416,941,270,670,146,81,81,6425,5725,2500,4000,306,300,1
529,1,2,189.5,152.0,232.0,172.0,4562,4518,3219,3219,1343,1299,2151,962,1321,660,830,302,81,81,6875,5725,2500,5050,406,300,1
536,1,2,199.5,142.0,232.0,172.0,4574,4327,3275,3051,1299,1276,1773,1468,791,1010,982,458,81,81,6675,5225,2500,5350,606,800,1
543,1,2,191.0,154.0,232.0,172.0,4327,4383,3051,3107,1276,1276,2130,1394,996,780,1134,614,76,81,6500,5725,2500,5350,781,800,1
550,1,2,189.5,158.0,232.0,172.0,4366,4372,3023,3051,1343,1321,2345,1025,1201,455,1144,570,80,81,6925,5825,2500,5350,856,800,1
557,1,2,189.5,164.0,232.0,172.0,4266,4506,2967,3163,1299,1343,2862,866,1566,590,1296,276,80,81,6925,6025,2500,5350,856,800,1
564,1,2,195.0,168.0,232.0,172.0,4193,4383,2939,3107,1254,1276,2849,579,1401,405,1448,174,80,81,6650,6225,3125,5350,1131,800,1
571,1,2,196.5,164.0,232.0,172.0,4126,4383,2827,3107,1299,1276,2589,607,1231,285,1358,322,90,81,6375,5725,3125,5350,1406,1300,1
579,1,2,196.5,172.0,238.0,180.0,4170,4215,2827,2939,1343,1276,2364,322,846,240,1518,82,90,81,6375,6175,3125,5500,1406,1300,1
586,1,2,199.5,173.0,238.0,180.0,3913,4109,2659,2855,1254,1254,2218,1088,756,825,1462,263,89,81,6575,6550,3125,5500,1406,1300,1
593,1,2,194.5,175.0,238.0,180.0,4070,4322,2771,3023,1299,1299,2713,813,1091,640,1622,173,84,81,6825,6350,3125,5500,1406,1500,1
600,1,2,188.5,187.0,238.0,188.0,4114,4282,2771,2939,1343,1343,3218,720,1436,395,1782,325,86,81,6625,7050,3125,5350,1606,1650,1
607,1,2,185.5,186.0,238.0,188.0,4327,4478,3051,3135,1276,1343,3446,1246,1516,765,1930,481,86,80,6475,7050,3125,5350,1756,1700,1
614,1,2,184.0,184.0,238.0,204.0,4417,4187,3163,2911,1254,1276,3677,434,1791,105,1886,329,83,80,6450,6950,3250,5350,1781,1800,1
621,1,2,182.5,185.0,238.0,204.0,4422,4159,3079,2883,1343,1276,3967,555,2071,295,1896,260,83,80,6325,6950,3250,5350,1906,1800,1
629,1,2,180.0,185.0,238.0,204.0,4618,4221,3275,2967,1343,1254,4182,797,2126,385,2056,412,83,80,5950,7610,3700,5350,2150,1800,1
636,1,2,184.0,195.0,238.0,204.0,4523,4322,3247,3023,1276,1299,4096,797,2096,225,2000,572,88,80,6150,8025,3700,5350,2350,1800,1
643,1,2,168.0,195.0,238.0,204.0,4568,4428,3247,3107,1321,1321,4151,1107,1991,375,2160,732,88,80,4950,8240,3700,5350,3700,2000,1
650,1,2,171.0,192.0,238.0,219.0,4518,4232,3219,2911,1299,1321,3603,1489,1591,605,2012,884,88,77,3850,8215,3575,5650,5268,2425,1
657,1,2,168.5,192.0,238.0,219.0,4473,3711,3219,2435,1254,1276,3730,1328,1766,300,1964,1028,88,68,4825,9290,4025,6750,5393,2975,1
664,1,2,163.0,192.0,238.0,219.0,4467,3465,3191,2211,1276,1254,4280,1711,2156,535,2124,1176,88,68,4400,9320,4025,6750,5818,2975,1
671,1,2,173.5,186.0,238.0,219.0,4366,3549,3023,2295,1343,1254,4240,1482,1956,400,2284,1082,88,69,5675,8835,4025,6750,5843,4275,1
679,1,2,169.0,175.0,238.0,219.0,4014,3442,2715,2211,1299,1231,3697,1815,1661,585,2036,1230,88,69,5250,8250,4025,6750,6268,4875,1
686,1,2,168.0,179.0,238.0,219.0,3986,3549,2687,2295,1299,1254,3864,1152,1676,370,2188,782,90,71,5250,8790,4025,6750,6268,5150,1
693,1,2,166.5,185.0,238.0,219.0,4226,3823,2883,2547,1343,1276,4139,1004,1791,320,2348,684,87,71,5475,8790,4025,7050,6443,5150,1
700,1,2,161.0,179.0,238.0,219.0,4322,3907,3023,2631,1299,1276,3906,1257,1706,575,2200,682,86,71,5150,8465,4025,7050,7218,5675,1
707,1,2,157.0,168.0,238.0,219.0,4389,3969,3135,2715,1254,1254,4353,1686,2001,860,2352,826,86,71,5050,6640,4150,7050,7868,6700,1
714,1,2,161.0,174.0,238.0,219.0,4333,4053,2967,2799,1366,1254,4342,983,1826,505,2516,478,84,71,5050,6540,4150,7050,7868,6800,1
721,1,2,171.0,180.0,238.0,219.0,4271,4002,2771,2771,1500,1231,3056,465,1031,210,2025,255,84,72,5150,7615,4150,7050,7868,6800,1
729,1,2,176.0,184.0,238.0,219.0,4030,4002,2463,2771,1567,1231,2975,522,766,415,2209,107,90,72,5900,9025,4300,7050,7868,6800,1
736,1,2,173.0,184.0,238.0,219.0,4154,3941,2519,2687,1635,1254,3261,880,956,625,2305,255,90,72,5800,9040,4300,7350,7968,6800,1
743,1,2,172.0,193.0,238.0,219.0,4182,4019,2547,2743,1635,1276,3702,483,1201,330,2501,153,88,72,5800,9505,4300,7350,7968,6800,1
750,1,2,193.0,193.0,238.0,219.0,4551,3935,2939,2659,1612,1276,1414,675,221,370,1193,305,88,72,7250,9920,4850,7600,7968,6800,1
757,1,2,199.0,193.0,238.0,219.0,4730,3997,3163,2743,1567,1254,1231,1043,296,665,935,378,89,72,7250,10580,4850,7600,7968,6800,1
764,1,2,195.0,194.0,238.0,227.0,4910,3918,3275,2687,1635,1231,1513,1516,536,990,977,526,89,72,8300,10695,4725,7600,8393,6800,1
771,1,2,199.0,200.0,238.0,227.0,4501,3952,3023,2743,1478,1209,1345,1074,246,800,1099,274,89,72,7850,10710,4725,7600,8843,6800,1
779,1,2,199.0,200.0,238.0,227.0,4344,3913,2911,2659,1433,1254,1775,1230,516,800,1259,430,89,72,9450,11385,4325,7850,9543,6800,1
786,1,2,197.0,191.0,238.0,227.0,4344,3986,2911,2687,1433,1299,2241,1557,831,975,1410,582,87,72,9450,11000,3875,7850,9993,7315,1
793,1,2,197.0,190.0,238.0,227.0,4243,3930,2855,2631,1388,1299,2755,1325,1181,595,1574,730,87,72,10800,9275,3875,7850,9993,9035,1
800,1,2,199.0,196.0,238.0,227.0,4238,4025,2827,2771,1411,1254,2776,1183,1026,555,1750,628,87,72,10800,9990,3875,7850,9993,9035,1
807,1,2,198.0,196.0,238.0,235.0,4210,3913,2799,2659,1411,1254,3279,1461,1361,785,1918,676,86,72,10800,10005,4000,7850,9993,9035,1
814,1,2,198.0,196.0,238.0,235.0,4310,4002,2855,2771,1455,1231,3701,1939,1661,1115,2040,824,88,72,10800,10005,4000,8000,9993,9035,1
821,1,2,195.0,196.0,238.0,235.0,4266,3890,2855,2659,1411,1231,4196,2386,1996,1410,2200,976,87,72,10800,10665,4000,8000,10093,9035,1
829,1,2,196.5,192.0,238.0,235.0,4344,3812,2911,2491,1433,1321,3783,2815,1761,1675,2022,1140,86,72,10625,10480,4000,8000,10268,9235,1
836,1,2,200.0,198.0,238.0,235.0,4238,3778,2827,2435,1411,1343,3835,2471,1641,1175,2194,1296,86,72,10500,10780,4000,8000,10393,9735,1
843,1,2,200.0,198.0,238.0,235.0,4243,3711,2855,2323,1388,1388,4338,2580,1976,1270,2362,1310,86,72,10800,10795,4150,8000,10393,9735,1
850,1,2,200.0,194.0,238.0,235.0,4249,3879,2883,2379,1366,1500,4831,2545,2301,1305,2530,1240,86,72,10800,10010,4150,8000,10393,10535,1
857,1,2,192.0,188.0,238.0,235.0,4338,3874,2883,2351,1455,1523,5347,2634,2641,1360,2706,1274,85,72,10150,9445,4600,8000,11043,11585,1
864,1,2,176.5,172.0,230.0,235.0,4226,3924,2771,2379,1455,1545,5825,2323,2951,1315,2874,1008,84,72,9075,8290,4300,8000,12449,13355,1
871,1,2,197.5,171.0,230.0,235.0,3487,3918,2211,2351,1276,1567,4941,2096,2031,1150,2910,946,84,72,9375,8335,4000,8000,12899,13755,1
879,1,2,197.5,175.0,224.0,235.0,3330,3952,2099,2407,1231,1545,5353,1245,2291,765,3062,480,84,73,9375,8165,4250,8000,13399,13955,1
886,1,2,182.5,171.0,224.0,235.0,3134,3784,2015,2239,1119,1545,5406,884,2216,220,3190,664,76,73,9725,7160,4250,7850,14699,15955,1
893,1,2,189.0,173.0,224.0,235.0,3157,3874,2015,2351,1142,1523,4275,750,1091,160,3184,590,71,73,9750,7310,4250,7850,15224,16155,1
900,1,2,173.0,179.0,224.0,235.0,2563,3644,1511,2099,1052,1545,3765,569,836,245,2929,324,54,73,9750,7675,4250,7850,15774,16155,1
907,1,2,175.0,181.0,224.0,235.0,2518,3610,1623,2043,895,1567,3611,626,686,410,2925,216,65,73,9750,8575,4250,7850,15924,16255,1
914,1,2,174.5,181.0,224.0,235.0,2429,3599,1623,2099,806,1500,3452,1042,431,650,3021,392,66,73,9725,8575,4250,7850,16024,16255,1
921,1,2,177.5,187.0,224.0,235.0,2098,3627,1315,2183,783,1444,2840,981,181,415,2659,566,68,73,9725,8075,4250,7850,16074,16755,1
929,1,2,178.5,188.0,224.0,235.0,2328,3454,1567,2043,761,1411,2841,1284,186,625,2655,659,67,73,9725,8575,4250,7850,16074,16755,1
936,1,2,178.5,182.0,224.0,235.0,2882,3599,2099,2211,783,1388,2737,1689,136,870,2601,819,67,73,9725,8515,5000,7850,16074,17475,1
943,1,2,174.5,192.0,224.0,235.0,2748,3571,1987,2183,761,1388,2879,854,186,500,2693,354,63,73,9725,9380,5125,7850,16074,17475,1
950,1,2,173.5,192.0,224.0,235.0,2742,3683,1959,2295,783,1388,2906,1282,121,760,2785,522,62,73,9725,9540,5125,7850,16074,17475,1
957,1,2,178.5,193.0,230.0,235.0,2843,3392,2015,2071,828,1321,3022,1042,141,435,2881,607,62,73,10475,10470,5400,7850,16074,17475,1
964,1,2,184.5,193.0,230.0,235.0,2854,3375,2071,1987,783,1388,3044,1423,71,640,2973,783,64,73,10475,10500,5900,7850,16074,17475,1
971,1,2,176.5,188.0,230.0,235.0,2821,3482,2015,2071,806,1411,3315,1366,246,640,3069,726,65,73,10025,11015,6375,7850,16849,17790,1
979,1,2,167.5,182.0,222.0,235.0,2933,3336,2127,1959,806,1377,3675,1344,506,610,3169,734,71,73,9025,9900,6300,7850,18224,19020,1
986,1,2,171.5,172.0,222.0,243.0,3297,3594,2491,2295,806,1299,3895,1766,626,880,3269,886,71,73,9025,9400,5750,7850,18899,19565,1
993,1,2,178.0,167.0,222.0,243.0,3325,3571,2519,2295,806,1276,3635,2084,266,1125,3369,959,71,73,9000,9130,5750,7850,18924,19865,1
1000,1,2,179.0,187.0,222.0,243.0,3420,3498,2547,2267,873,1231,3854,1197,381,90,3473,1107,77,73,9200,10175,5750,7850,18924,19865,1
1007,1,2,175.0,187.0,222.0,243.0,3420,3308,2547,2099,873,1209,4254,1595,681,340,3573,1255,75,73,8950,10275,5750,7850,19174,19865,1
1014,1,2,169.0,191.0,222.0,243.0,3493,3437,2687,2183,806,1254,4742,1661,1081,400,3661,1261,76,73,8400,10260,5750,7850,20024,19880,1
1021,1,2,167.0,197.0,228.0,243.0,3465,3594,2659,2295,806,1299,5131,1497,1416,330,3715,1167,74,73,8400,10625,5475,7850,20399,19880,1
1029,1,2,160.5,197.0,228.0,243.0,3487,3616,2659,2295,828,1321,5566,1495,1751,330,3815,1165,72,73,7975,10625,5475,7850,20924,19880,1
1036,1,2,156.0,189.0,228.0,258.0,3689,3571,2883,2295,806,1276,6016,1928,2101,615,3915,1313,69,73,8000,10225,5475,8000,21299,20280,1
1043,1,2,149.0,171.0,228.0,258.0,3190,3493,2407,2239,783,1254,5964,2322,2111,865,3853,1457,67,73,7450,9295,4450,8150,22974,21210,1
1050,1,2,127.0,181.0,222.0,258.0,2490,3582,1931,2351,559,1231,6245,2244,2336,635,3909,1609,51,73,6850,8860,4175,8150,24999,21210,1
7,0,2,13.0,13.0,15.0,15.0,335,293,335,293,0,0,40,35,40,35,0,0,12,12,0,0,0,0,0,0,1
14,0,2,14.0,14.0,15.0,15.0,671,671,671,671,0,0,70,70,70,70,0,0,13,13,0,0,0,0,0,0,1
21,0,2,14.0,14.0,15.0,15.0,699,699,699,699,0,0,0,50,0,50,0,0,13,13,0,0,0,0,0,0,1
29,0,2,15.0,15.0,15.0,15.0,643,727,643,727,0,0,80,90,80,90,0,0,14,14,0,0,0,0,0,0,1
36,0,2,15.0,16.0,15.0,23.0,755,811,755,811,0,0,130,145,130,145,0,0,14,15,0,0,0,0,0,0,1
43,0,2,16.0,16.0,23.0,23.0,755,811,755,811,0,0,70,35,70,35,0,0,15,15,0,0,0,0,0,0,1
50,0,2,16.0,17.0,23.0,23.0,811,867,811,867,0,0,40,10,40,10,0,0,15,16,0,0,0,0,0,0,1
57,0,2,17.0,18.0,23.0,23.0,727,867,727,867,0,0,85,70,85,70,0,0,16,17,0,0,0,0,0,0,1
64,0,2,18.0,19.0,23.0,23.0,895,951,895,951,0,0,140,175,140,175,0,0,17,18,0,0,0,0,0,0,1
71,0,2,18.0,19.0,23.0,23.0,878,945,811,923,67,22,237,289,225,285,12,4,17,18,0,0,0,0,0,0,1
79,0,2,19.0,20.0,23.0,23.0,990,995,811,951,179,44,347,358,315,350,32,8,18,19,0,0,0,0,0,0,1
86,0,2,19.0,20.0,23.0,23.0,911,990,755,923,156,67,453,471,405,455,48,16,18,19,0,0,0,0,0,0,1
93,0,2,20.0,20.0,23.0,23.0,883,1046,727,979,156,67,358,44,290,20,68,24,19,20,0,0,150,150,0,0,1
100,0,2,20.0,21.0,23.0,23.0,939,1012,783,923,156,89,468,116,380,80,88,36,19,20,0,0,150,150,0,0,1
107,0,2,20.0,22.0,23.0,23.0,883,1062,727,951,156,111,173,92,65,40,108,52,19,21,50,0,150,150,0,0,1
114,0,2,21.0,22.0,23.0,23.0,934,1085,755,951,179,134,138,103,60,35,78,68,19,21,50,0,150,150,0,0,1
121,0,2,21.0,23.0,23.0,31.0,911,1079,755,923,156,156,149,233,55,145,94,88,19,22,50,0,150,150,0,0,1
129,0,2,22.0,25.0,23.0,31.0,1079,1107,923,951,156,156,234,88,120,55,114,33,20,22,50,0,150,300,0,0,1
136,0,2,22.0,26.0,23.0,31.0,1135,1102,979,923,156,179,239,268,105,165,134,103,20,23,50,0,150,300,0,0,1
143,0,2,23.0,27.0,31.0,31.0,1247,1214,1091,923,156,291,334,303,180,185,154,118,21,24,50,0,150,300,0,0,1
150,0,2,25.0,30.0,31.0,31.0,1242,1208,1063,895,179,313,219,89,45,85,174,4,21,25,50,125,250,300,0,0,1
157,0,2,26.0,30.0,31.0,31.0,1331,1236,1175,923,156,313,310,199,120,155,190,44,22,25,50,125,250,300,0,0,1
164,0,2,27.0,31.0,31.0,46.0,1275,1258,1119,923,156,335,355,74,145,65,210,9,22,26,100,125,250,300,0,0,1
171,0,2,29.0,33.0,31.0,46.0,1387,1370,1231,1035,156,335,460,94,230,45,230,49,23,27,150,125,250,300,0,0,1
179,0,2,30.0,36.0,46.0,46.0,1331,1426,1175,1091,156,335,405,220,155,135,250,85,24,28,150,250,400,300,0,0,1
186,0,2,32.0,38.0,46.0,46.0,1214,1538,1035,1203,179,335,370,350,125,225,245,125,24,30,250,250,400,300,0,0,1
193,0,2,32.0,39.0,46.0,46.0,1387,1600,1231,1287,156,313,476,506,240,345,236,161,25,31,250,250,550,300,0,0,1
200,0,2,35.0,43.0,46.0,46.0,1471,1684,1315,1371,156,313,281,306,150,255,131,51,25,32,300,250,625,600,0,0,1
207,0,2,36.0,45.0,46.0,46.0,1611,1762,1455,1427,156,335,216,426,90,335,126,91,25,34,350,375,625,600,0,0,1
214,0,2,40.0,45.0,46.0,54.0,1779,1768,1623,1455,156,313,136,232,90,105,46,127,26,34,350,375,700,600,0,0,1
221,0,2,42.0,49.0,46.0,54.0,1970,1880,1791,1567,179,313,241,72,200,55,41,17,27,35,475,675,700,600,0,50,1
229,0,2,44.0,50.0,54.0,54.0,1919,1902,1763,1567,156,335,232,147,175,90,57,57,27,36,575,675,700,600,0,50,1
236,0,2,48.0,51.0,54.0,54.0,1835,1998,1679,1707,156,291,127,279,75,190,52,89,27,37,700,675,700,600,0,50,1
243,0,2,48.0,53.0,54.0,54.0,1863,2082,1707,1791,156,291,357,235,285,110,72,125,27,39,825,675,700,600,0,50,1
250,0,2,52.0,56.0,54.0,62.0,1779,2076,1623,1763,156,313,337,80,270,65,67,15,29,39,925,975,700,700,0,50,1
257,0,2,54.0,58.0,62.0,62.0,1746,2266,1567,1931,179,335,312,200,250,145,62,55,29,41,1050,975,825,850,0,50,1
264,0,2,54.0,59.0,62.0,70.0,1583,2126,1427,1791,156,335,403,390,325,295,78,95,29,42,1150,975,825,1000,0,50,1
271,0,2,58.0,62.0,62.0,70.0,1247,2255,1091,1763,156,492,328,498,255,385,73,113,29,43,1275,975,825,1000,0,50,1
279,0,2,60.0,66.0,70.0,78.0,1107,2244,951,1595,156,649,333,385,265,250,68,135,29,45,1400,1625,825,1000,0,50,1
286,0,2,64.0,66.0,70.0,78.0,1219,2250,1063,1623,156,627,163,266,100,55,63,211,29,45,1500,1625,825,1000,0,50,1
293,0,2,66.0,67.0,70.0,78.0,1410,2390,1231,1763,179,627,243,346,210,105,33,241,31,46,1625,1625,825,1000,0,50,1
300,0,2,58.0,65.0,78.0,86.0,1415,2390,1259,1763,156,627,424,581,375,260,49,321,27,45,1550,1675,825,1000,400,225,1
307,0,2,51.0,64.0,78.0,86.0,1667,2462,1511,1791,156,671,294,341,275,40,19,301,23,45,1300,1075,825,1000,950,825,1
314,0,2,48.0,66.0,78.0,86.0,1583,2518,1427,1847,156,671,484,687,445,310,39,377,22,47,1200,1425,825,1000,1225,825,1
7,1,1,13.0,13.0,14.0,14.0,377,335,377,335,0,0,45,40,45,40,0,0,12,12,0,0,0,0,0,0,1
14,1,1,13.0,13.0,14.0,14.0,671,671,671,671,0,0,20,20,20,20,0,0,13,13,0,0,0,0,0,0,1
21,1,1,14.0,14.0,14.0,14.0,727,727,727,727,0,0,55,55,55,55,0,0,13,13,0,0,0,0,0,0,1
29,1,1,14.0,14.0,14.0,14.0,727,783,727,783,0,0,150,150,150,150,0,0,13,13,0,0,0,0,0,0,1
36,1,1,16.0,16.0,22.0,22.0,783,783,783,783,0,0,150,150,150,150,0,0,14,14,0,0,0,0,0,0,1
43,1,1,16.0,16.0,22.0,22.0,867,783,867,783,0,0,250,235,250,235,0,0,14,14,0,0,0,0,0,0,1
50,1,1,15.0,15.0,22.0,22.0,839,839,839,839,0,0,35,45,35,45,0,0,15,15,0,0,0,0,0,0,1
57,1,1,17.0,17.0,22.0,22.0,923,867,923,867,0,0,50,50,50,50,0,0,15,15,0,0,0,0,0,0,1
64,1,1,18.0,18.0,22.0,22.0,923,895,923,895,0,0,95,75,95,75,0,0,16,16,0,0,0,0,0,0,1
71,1,1,17.0,17.0,22.0,22.0,923,867,923,867,0,0,185,180,185,180,0,0,17,17,0,0,0,0,0,0,1
79,1,1,17.0,17.0,22.0,22.0,951,867,951,867,0,0,50,40,50,40,0,0,16,16,0,0,0,0,0,0,1
86,1,1,18.0,18.0,22.0,22.0,951,951,951,951,0,0,105,110,105,110,0,0,16,16,0,0,0,0,0,0,1
93,1,1,19.0,19.0,22.0,22.0,895,906,895,839,0,67,165,162,165,150,0,12,18,18,0,0,0,0,0,0,1
100,1,1,19.0,20.0,22.0,22.0,1012,995,923,839,89,156,291,238,275,210,16,28,19,18,0,0,0,0,0,0,1
107,1,1,20.0,20.0,22.0,22.0,1079,1079,923,923,156,156,371,373,335,325,36,48,19,19,0,0,0,0,0,0,1
114,1,1,21.0,21.0,22.0,22.0,1079,1079,923,923,156,156,441,448,385,380,56,68,20,20,0,0,0,0,0,0,1
121,1,1,25.0,26.0,28.0,28.0,1130,1107,951,951,179,156,281,228,205,140,76,88,20,20,0,0,250,250,0,0,1
129,1,1,25.0,26.0,28.0,28.0,1135,1079,979,923,156,156,197,64,105,60,92,4,20,21,0,0,250,250,0,0,1
136,1,1,27.0,28.0,28.0,28.0,1135,1046,979,979,156,67,222,88,110,80,112,8,21,22,0,0,250,250,0,0,1
143,1,1,29.0,29.0,36.0,36.0,1163,1163,1007,1119,156,44,267,191,135,175,132,16,21,22,0,0,250,250,0,0,1
150,1,1,29.0,30.0,36.0,36.0,1186,1242,1007,1175,179,67,262,299,110,275,152,24,23,24,0,0,250,250,0,0,1
157,1,1,33.0,30.0,36.0,36.0,1303,1303,1147,1259,156,44,118,113,50,85,68,28,25,25,300,300,375,250,0,0,1
164,1,1,33.0,32.0,36.0,36.0,1359,1382,1203,1315,156,67,188,126,100,90,88,36,25,25,300,300,375,250,0,0,1
171,1,1,34.0,32.0,36.0,36.0,1415,1443,1259,1399,156,44,108,195,100,155,8,40,27,26,300,300,375,250,0,0,1
179,1,1,35.0,34.0,36.0,36.0,1415,1583,1259,1539,156,44,113,288,85,240,28,48,27,26,300,300,375,250,0,0,1
186,1,1,37.0,36.0,44.0,44.0,1527,1550,1371,1483,156,67,199,371,155,315,44,56,28,26,300,300,375,250,0,0,1
193,1,1,40.0,43.0,44.0,44.0,1555,1611,1399,1567,156,44,139,190,75,130,64,60,29,26,450,400,375,250,0,0,1
200,1,1,41.0,44.0,44.0,44.0,1639,1578,1483,1511,156,67,129,173,45,155,84,18,31,26,450,650,375,250,0,0,1
207,1,1,40.0,44.0,44.0,44.0,1695,1527,1539,1483,156,44,39,202,35,180,4,22,34,25,450,1000,500,250,0,0,1
214,1,1,41.0,44.0,52.0,44.0,1802,1499,1623,1455,179,44,129,370,105,340,24,30,34,25,450,1050,500,250,0,0,1
221,1,1,43.0,43.0,52.0,44.0,1835,1522,1679,1455,156,67,190,548,150,510,40,38,33,25,450,1000,500,250,0,50,1
229,1,1,43.0,48.5,60.0,58.0,1863,1499,1707,1455,156,44,190,367,130,325,60,42,32,25,350,975,500,250,150,125,1
236,1,1,46.0,53.5,60.0,58.0,1807,1550,1651,1483,156,67,195,245,115,195,80,50,32,25,500,925,500,250,150,175,1
243,1,1,47.0,53.0,60.0,58.0,1886,1415,1707,1371,179,44,210,354,110,300,100,54,31,25,500,1200,825,250,425,250,1
250,1,1,49.0,55.5,60.0,58.0,1751,1499,1595,1455,156,44,423,287,307,275,116,12,32,25,650,1375,825,450,318,275,1
257,1,1,52.0,57.5,60.0,58.0,1835,1410,1679,1343,156,67,198,355,62,335,136,20,32,25,850,1475,825,450,318,275,1
264,1,1,51.0,58.0,60.0,58.0,1751,1426,1595,1315,156,111,198,381,42,345,156,36,29,25,800,1700,825,450,368,300,1
271,1,1,51.0,57.5,60.0,58.0,1723,1415,1567,1259,156,156,413,541,237,485,176,56,29,25,850,1775,825,450,368,325,1
279,1,1,50.5,56.5,60.0,58.0,1606,1410,1427,1231,179,179,598,466,402,440,196,26,29,25,975,1725,825,450,393,425,1
286,1,1,46.5,52.5,60.0,66.0,1723,1415,1567,1259,156,156,609,597,447,555,162,42,29,25,775,1425,825,450,743,775,1
293,1,1,45.5,54.0,60.0,74.0,1667,1443,1511,1287,156,156,349,272,167,210,182,62,29,25,325,1150,825,450,1193,1200,1
300,1,1,39.5,50.0,60.0,74.0,1499,1443,1343,1287,156,156,474,382,272,300,202,82,29,25,75,900,825,450,1543,1425,1
307,1,1,39.0,55.5,60.0,74.0,1382,1410,1203,1231,179,179,599,267,377,165,222,102,29,25,250,1175,825,450,1618,1450,1
314,1,1,35.5,55.5,60.0,74.0,1639,1471,1483,1315,156,156,740,383,502,265,238,118,29,25,125,1325,825,450,1843,1475,1
321,1,1,37.5,58.5,60.0,74.0,1667,1471,1511,1315,156,156,700,308,442,195,258,113,29,25,75,1425,825,450,1943,1525,1
7,1,1,13.0,13.0,14.0,14.0,251,293,251,293,0,0,30,35,30,35,0,0,12,12,0,0,0,0,0,0,1
14,1,1,12.0,13.0,14.0,14.0,671,671,671,671,0,0,170,20,170,20,0,0,12,13,0,0,0,0,0,0,1
21,1,1,11.0,14.0,14.0,14.0,671,699,671,699,0,0,35,45,35,45,0,0,11,13,0,0,0,0,0,0,1
29,1,1,13.0,14.0,14.0,14.0,643,755,643,755,0,0,15,140,15,140,0,0,11,13,0,0,0,0,0,0,1
36,1,1,14.0,16.0,14.0,22.0,643,755,643,755,0,0,50,140,50,140,0,0,12,14,0,0,0,0,0,0,1
43,1,1,14.0,16.0,14.0,22.0,671,811,671,811,0,0,20,230,20,230,0,0,13,14,0,0,0,0,0,0,1
50,1,1,14.0,15.0,14.0,22.0,755,783,755,783,0,0,110,20,110,20,0,0,14,15,0,0,0,0,0,0,1
57,1,1,14.0,17.0,14.0,22.0,811,839,811,839,0,0,220,25,220,25,0,0,14,15,0,0,0,0,0,0,1
64,1,1,16.0,18.0,22.0,22.0,811,867,811,867,0,0,205,80,205,80,0,0,14,16,0,0,250,0,0,0,1
71,1,1,17.0,17.0,22.0,22.0,811,895,811,895,0,0,250,155,250,155,0,0,14,17,0,0,250,0,0,0,1
79,1,1,18.0,17.0,22.0,22.0,755,923,755,923,0,0,295,15,295,15,0,0,14,16,0,0,250,0,0,0,1
86,1,1,17.0,18.0,22.0,22.0,755,923,755,923,0,0,85,70,85,70,0,0,13,16,150,0,250,0,0,0,1
93,1,1,18.0,19.0,22.0,22.0,755,923,755,923,0,0,120,130,120,130,0,0,13,17,150,0,250,0,0,0,1
100,1,1,21.0,20.0,22.0,22.0,755,978,755,867,0,111,15,195,15,175,0,20,13,18,200,0,250,0,0,0,1
107,1,1,21.0,20.0,22.0,22.0,727,1023,727,867,0,156,100,306,100,270,0,36,13,19,250,0,250,0,0,0,1
114,1,1,21.0,20.0,22.0,22.0,755,1023,755,867,0,156,90,436,90,380,0,56,13,20,250,0,250,0,0,0,1
121,1,1,22.0,20.0,22.0,28.0,727,945,727,811,0,134,120,542,120,470,0,72,13,20,300,0,250,250,0,0,1
129,1,1,22.0,27.0,30.0,28.0,755,581,755,559,0,22,65,142,65,70,0,72,13,20,300,0,250,250,0,0,1
136,1,1,25.0,27.0,30.0,28.0,727,335,727,335,0,0,105,127,105,55,0,72,14,19,450,0,250,250,0,50,1
143,1,1,25.5,27.0,30.0,28.0,783,335,783,335,0,0,145,172,145,100,0,72,15,19,425,150,250,250,25,50,1
150,1,1,24.5,27.0,30.0,28.0,783,363,783,363,0,0,245,217,245,145,0,72,15,20,375,150,250,250,75,50,1
157,1,1,27.0,27.0,36.0,28.0,839,391,839,391,0,0,95,107,95,35,0,72,16,19,300,150,250,250,150,100,1
164,1,1,28.5,27.0,36.0,28.0,867,419,867,419,0,0,100,162,100,90,0,72,18,19,275,450,250,250,175,100,1
171,1,1,31.5,28.0,36.0,28.0,923,783,923,783,0,0,70,122,70,50,0,72,18,19,425,500,250,250,175,200,1
179,1,1,31.5,28.0,36.0,28.0,979,1051,979,1007,0,44,55,227,55,147,0,80,20,19,375,500,250,250,225,200,1
186,1,1,31.5,31.0,36.0,36.0,923,1018,923,951,0,67,70,110,70,22,0,88,22,20,375,500,250,250,225,200,1
193,1,1,32.5,33.0,36.0,36.0,1063,1130,1063,1063,0,67,160,148,160,52,0,96,24,20,525,500,250,250,225,200,1
200,1,1,33.5,34.0,36.0,44.0,1197,1158,1175,1091,22,67,154,236,150,132,4,104,25,24,525,500,250,250,225,200,1
207,1,1,37.5,36.0,36.0,44.0,1393,1186,1259,1119,134,67,139,79,115,67,24,12,25,26,525,500,250,250,325,200,1
214,1,1,36.5,38.0,36.0,44.0,1359,1331,1203,1287,156,44,119,43,75,27,44,16,25,26,525,500,250,250,325,200,1
221,1,1,37.5,40.0,44.0,44.0,1415,1494,1259,1427,156,67,254,116,190,92,64,24,29,28,525,500,250,250,325,200,1
229,1,1,39.5,42.0,52.0,52.0,1438,1494,1259,1427,179,67,124,199,40,167,84,32,29,30,525,500,250,250,325,200,1
236,1,1,40.5,41.0,52.0,52.0,1578,1550,1399,1483,179,67,274,77,170,37,104,40,29,31,525,500,250,250,325,200,1
243,1,1,44.5,44.0,52.0,52.0,1639,1662,1483,1595,156,67,65,135,45,87,20,48,33,33,525,500,375,250,325,200,1
250,1,1,46.5,43.0,52.0,52.0,1779,1757,1623,1623,156,134,90,175,50,107,40,68,35,33,525,500,375,250,325,200,1
257,1,1,50.5,47.0,52.0,52.0,1807,1835,1651,1679,156,156,100,195,40,107,60,88,36,35,525,500,375,250,325,200,1
264,1,1,51.5,51.0,60.0,52.0,1975,1975,1819,1819,156,156,195,125,115,17,80,108,36,35,575,500,375,250,325,200,1
271,1,1,54.5,54.0,60.0,60.0,1975,1942,1819,1763,156,179,270,150,170,22,100,128,36,35,675,700,575,375,325,200,1
279,1,1,53.5,54.0,60.0,60.0,1998,1970,1819,1791,179,179,205,295,85,147,120,148,35,38,925,750,575,375,325,200,1
286,1,1,55.5,58.0,68.0,68.0,1998,2031,1819,1875,179,156,145,116,105,52,40,64,35,39,1075,750,575,375,325,200,1
293,1,1,60.5,59.0,68.0,68.0,1975,2003,1819,1847,156,156,36,111,30,27,6,84,35,41,1075,750,575,375,325,200,1
300,1,1,61.5,58.0,68.0,76.0,1919,2003,1763,1847,156,156,216,316,190,212,26,104,35,41,1075,750,575,375,325,200,1
307,1,1,61.5,63.0,68.0,82.0,1975,2143,1819,1987,156,156,361,236,315,112,46,124,35,43,1325,900,575,375,325,200,1
314,1,1,67.5,65.0,68.0,82.0,1919,2082,1763,1903,156,179,226,326,160,182,66,144,35,43,1475,850,575,375,225,250,1
321,1,1,67.0,66.5,68.0,82.0,1975,2194,1819,2015,156,179,261,406,175,242,86,164,35,43,1450,1075,575,375,250,275,1
329,1,1,65.0,70.5,76.0,90.0,1970,2087,1791,1931,179,156,351,412,245,232,106,180,35,42,1650,1225,575,375,250,275,1
336,1,1,68.5,74.5,84.0,90.0,1863,2115,1707,1959,156,156,122,462,100,312,22,150,35,42,1625,1325,575,575,275,275,1
343,1,1,70.0,86.0,100.0,90.0,1975,2171,1819,2015,156,156,277,122,235,102,42,20,36,42,1600,1500,575,575,300,300,1
350,1,1,64.5,82.5,100.0,90.0,1947,2199,1791,2043,156,156,502,237,440,197,62,40,39,42,1325,1375,575,700,575,575,1
357,1,1,70.5,86.5,100.0,90.0,1902,2216,1679,2015,223,201,439,300,420,282,19,18,41,42,1325,1775,575,700,575,575,1
364,1,1,74.0,88.5,100.0,90.0,2042,2266,1595,1931,447,335,514,180,485,122,29,58,41,41,1300,2075,575,700,600,575,1
371,1,1,75.0,88.5,100.0,90.0,2255,2322,1763,1987,492,335,720,456,635,362,85,94,41,44,1300,2075,575,700,600,575,1
379,1,1,79.0,92.0,100.0,98.0,2255,2356,1763,2043,492,313,740,282,645,252,95,30,41,44,1550,2250,575,700,650,600,1
386,1,1,83.0,99.5,106.0,106.0,2283,2328,1791,2015,492,313,821,137,720,117,101,20,42,44,1750,2375,575,700,650,625,1
393,1,1,85.0,101.5,106.0,106.0,2283,2384,1791,2071,492,313,687,128,655,72,32,56,43,48,1950,2375,825,700,650,625,1
400,1,1,90.5,105.5,106.0,106.0,2205,2496,1735,2071,470,425,443,228,430,112,13,116,43,53,1925,2475,825,700,675,625,1
407,1,1,89.5,109.5,106.0,114.0,2037,2647,1567,2155,470,492,578,248,530,122,48,126,43,56,1975,2575,825,700,825,625,1
414,1,1,87.0,106.5,130.0,122.0,2177,2838,1707,2323,470,515,414,174,360,92,54,82,43,58,1500,2025,825,700,1400,1175,1
421,1,1,88.5,101.0,130.0,130.0,2423,3011,1931,2519,492,492,314,420,300,307,14,113,43,57,1475,1700,825,700,1725,1500,1
429,1,1,92.5,115.0,130.0,130.0,2423,3129,1931,2659,492,470,399,101,375,82,24,19,43,57,2025,1900,825,700,1725,1500,1
436,1,1,96.5,115.0,130.0,130.0,2451,3157,1959,2687,492,470,475,377,445,302,30,75,43,59,2125,2300,825,950,1725,1500,1
443,1,1,102.5,119.0,130.0,130.0,2451,3017,1959,2547,492,470,471,162,460,127,11,35,43,58,2525,2400,825,950,1725,1500,1
450,1,1,106.5,121.0,130.0,138.0,2485,3078,2015,2519,470,559,467,343,450,307,17,36,43,58,2725,3000,825,950,1725,1500,1
457,1,1,118.5,125.0,130.0,138.0,2429,3224,1959,2575,470,649,142,409,65,297,77,112,43,63,2925,3100,825,950,1725,1500,1
464,1,1,118.5,127.0,138.0,146.0,2395,3213,1903,2519,492,694,228,633,195,462,33,171,43,64,3225,3100,825,950,1725,1500,1
471,1,1,121.5,138.0,138.0,146.0,2395,3308,1903,2547,492,761,373,231,280,122,93,109,43,66,3725,3200,825,950,1725,1500,1
479,1,1,124.5,142.0,138.0,154.0,2479,3409,1987,2603,492,806,524,352,375,197,149,155,43,66,3925,3200,825,950,1725,1500,1
486,1,1,119.0,140.0,138.0,162.0,2446,3498,1931,2715,515,783,189,168,55,67,134,101,43,66,3200,3000,825,950,2600,2200,1
493,1,1,107.0,136.0,138.0,170.0,2373,3554,1903,2771,470,783,186,189,75,92,111,97,43,66,2400,2700,825,950,3500,2800,1
500,1,1,93.0,132.0,138.0,170.0,2401,3554,1931,2771,470,783,386,234,240,137,146,97,43,66,1950,2150,825,950,4300,3450,1
506,1,1,87.5,128.0,138.0,170.0,2457,3571,1987,2743,470,828,329,192,210,182,119,10,43,66,1675,2500,825,1100,4875,3800,1
7,0,0,13.0,13.0,15.0,15.0,293,251,293,251,0,0,35,30,35,30,0,0,12,12,0,0,0,0,0,0,1
14,0,0,14.0,14.0,15.0,15.0,671,671,671,671,0,0,70,70,70,70,0,0,13,13,0,0,0,0,0,0,1
21,0,0,14.0,14.0,15.0,15.0,727,699,727,699,0,0,50,50,50,50,0,0,13,13,0,0,0,0,0,0,1
29,0,0,15.0,15.0,15.0,15.0,727,671,727,671,0,0,85,10,85,10,0,0,14,14,0,0,0,0,0,0,1
36,0,0,15.0,15.0,15.0,15.0,783,727,783,727,0,0,135,55,135,55,0,0,14,14,0,0,0,0,0,0,1
43,0,0,16.0,16.0,23.0,23.0,783,727,783,727,0,0,70,140,70,140,0,0,15,15,0,0,0,0,0,0,1
50,0,0,16.0,16.0,23.0,23.0,811,811,811,811,0,0,45,35,45,35,0,0,15,15,0,0,0,0,0,0,1
57,0,0,17.0,17.0,23.0,23.0,839,850,839,783,0,67,70,87,70,75,0,12,16,16,0,0,0,0,0,0,1
64,0,0,18.0,18.0,23.0,23.0,783,934,783,755,0,179,100,192,100,160,0,32,17,17,0,0,0,0,0,0,1
71,0,0,18.0,18.0,23.0,23.0,827,962,783,783,44,179,198,257,190,205,8,52,17,17,0,0,0,0,0,0,1
79,0,0,19.0,19.0,23.0,23.0,805,990,671,811,134,179,244,357,220,285,24,72,18,18,0,0,0,0,0,0,1
86,0,0,19.0,19.0,23.0,23.0,911,967,643,811,268,156,354,478,290,390,64,88,18,18,0,0,0,0,0,0,1
93,0,0,20.0,20.0,23.0,23.0,900,1023,587,867,313,156,115,353,65,295,50,58,19,19,0,0,150,150,0,0,1
100,0,0,20.0,20.0,23.0,23.0,956,1079,643,923,313,156,235,473,145,395,90,78,19,19,0,0,150,150,0,0,1
107,0,0,20.0,20.0,23.0,23.0,934,1051,643,895,291,156,86,198,60,100,26,98,19,19,0,0,150,150,0,0,1
114,0,0,20.0,20.0,31.0,23.0,872,995,671,839,201,156,206,68,160,50,46,18,19,19,0,0,150,150,0,0,1
121,0,0,22.0,21.0,31.0,23.0,990,1018,811,839,179,179,176,138,160,100,16,38,19,19,100,0,150,150,0,0,1
129,0,0,23.0,21.0,31.0,23.0,1208,1186,1007,1007,201,179,265,128,225,120,40,8,20,19,100,100,150,150,0,0,1
136,0,0,23.0,22.0,31.0,23.0,1186,1219,1007,1063,179,156,415,94,355,70,60,24,20,20,100,100,150,150,0,0,1
143,0,0,24.0,23.0,31.0,23.0,1191,1051,1035,895,156,156,116,179,40,135,76,44,21,21,100,100,150,150,0,0,1
150,0,0,26.0,23.0,31.0,23.0,1214,1023,1035,867,179,156,169,304,65,240,104,64,21,21,100,100,400,150,0,0,1
157,0,0,27.0,24.0,31.0,31.0,1443,1079,1175,923,268,156,210,394,120,310,90,84,22,22,200,100,400,400,0,0,1
164,0,0,27.0,24.0,31.0,31.0,1454,1174,1119,951,335,223,70,302,40,290,30,12,22,22,200,100,400,500,0,0,1
171,0,0,28.0,29.0,31.0,31.0,1426,1359,1091,1091,335,268,130,145,60,130,70,15,23,23,300,100,400,500,0,0,1
179,0,0,30.0,29.0,31.0,46.0,1404,1494,1091,1203,313,291,186,121,105,70,81,51,24,23,300,100,400,500,0,0,1
186,0,0,31.0,30.0,31.0,46.0,1320,1348,1007,1035,313,313,276,256,155,165,121,91,24,24,300,100,400,500,0,0,1
193,0,0,33.0,34.0,39.0,46.0,1342,1264,1007,951,335,313,351,216,190,85,161,131,24,25,300,300,500,575,0,0,1
200,0,0,34.0,36.0,39.0,46.0,1510,1510,1175,1175,335,335,241,206,90,35,151,171,25,25,400,300,750,825,0,0,1
207,0,0,34.0,37.0,39.0,46.0,1460,1622,1147,1287,313,335,352,281,165,70,187,211,26,26,400,300,750,825,0,0,1
214,0,0,37.0,40.0,54.0,46.0,1566,1930,1231,1595,335,335,287,172,60,125,227,47,26,27,500,500,825,825,0,0,1
221,0,0,39.0,44.0,54.0,54.0,1628,2014,1315,1679,313,335,173,112,110,50,63,62,26,28,500,500,900,825,0,0,1
229,0,0,42.0,46.0,54.0,54.0,1734,2042,1399,1707,335,335,222,237,115,135,107,102,27,29,600,500,900,825,0,0,1
236,0,0,45.0,47.0,54.0,54.0,1774,2166,1371,1763,403,403,149,284,115,130,34,154,27,30,600,500,900,825,0,0,1
243,0,0,47.0,48.0,54.0,54.0,1690,2227,1175,1735,515,492,154,534,60,320,94,214,28,31,600,700,900,900,0,0,1
250,0,0,49.0,52.0,54.0,54.0,1835,2283,1343,1791,492,492,225,234,75,60,150,174,28,33,700,700,900,900,0,0,1
257,0,0,51.0,57.0,54.0,62.0,1863,2087,1371,1595,492,492,311,75,105,45,206,30,30,33,700,1000,900,900,0,0,1
264,0,0,50.0,59.0,62.0,62.0,2003,2138,1511,1623,492,515,421,350,205,260,216,90,31,35,1275,1000,900,900,100,0,1
271,0,0,46.0,58.0,62.0,62.0,2065,2283,1595,1791,470,492,672,601,400,455,272,146,32,36,1025,1000,900,900,350,100,1
279,0,0,49.0,60.0,62.0,70.0,2087,2205,1595,1735,492,470,297,352,90,150,207,202,33,37,925,1000,900,900,450,100,1
286,0,0,50.0,60.0,70.0,70.0,2149,2261,1679,1791,470,470,504,402,245,140,259,262,33,37,925,1000,900,900,450,100,1
293,0,0,50.0,64.0,70.0,70.0,1516,2227,1203,1735,313,492,301,202,110,80,191,122,32,39,925,1250,900,900,550,100,1
300,0,0,51.0,68.0,70.0,70.0,1410,2283,1231,1791,179,492,461,437,250,180,211,257,33,40,925,1550,900,900,550,100,1
307,0,0,52.0,69.0,70.0,78.0,1796,2423,1483,1931,313,492,434,678,175,365,259,313,35,41,1200,1650,900,900,550,100,1
314,0,0,57.0,75.0,70.0,78.0,1863,2362,1371,1735,492,627,220,363,80,270,140,93,35,42,1250,1650,900,900,550,100,1
321,0,0,57.0,78.0,70.0,78.0,2143,2418,1651,1791,492,627,381,195,185,30,196,165,35,43,1250,1650,900,900,600,100,1
329,0,0,61.0,78.0,70.0,78.0,2171,2222,1679,1595,492,627,471,195,215,75,256,120,36,43,1300,1925,1200,900,600,100,1
336,0,0,64.0,78.0,70.0,78.0,2149,2580,1679,1931,470,649,327,125,115,25,212,100,38,45,1300,1975,1325,900,600,100,1
343,0,0,66.0,78.0,70.0,78.0,2255,3134,1763,2463,492,671,427,380,155,200,272,180,39,45,1575,1975,1325,900,600,100,1
350,0,0,69.0,78.0,70.0,78.0,2334,2894,1819,2267,515,627,242,482,35,230,207,252,38,45,1625,1975,1325,900,800,100,1
357,0,0,73.0,86.0,78.0,109.0,2177,3022,1707,2351,470,671,109,372,50,115,59,257,39,45,1725,2575,1325,900,800,100,1
364,0,0,77.0,88.0,86.0,109.0,2395,2910,1903,2239,492,671,229,467,110,205,119,262,40,45,1725,2575,1325,900,800,100,1
371,0,0,78.0,90.0,86.0,109.0,2479,2950,1987,2323,492,627,84,619,5,285,79,334,40,47,1875,2575,1325,1200,800,100,1
379,0,0,82.0,93.0,86.0,109.0,2485,2894,2015,2267,470,627,200,724,65,410,135,314,42,49,2250,2625,1325,1200,800,100,1
386,0,0,86.0,93.0,86.0,109.0,2619,3078,2127,2407,492,671,180,309,110,165,70,144,43,49,2500,2625,1325,1450,800,100,1
393,0,0,86.0,98.0,102.0,109.0,2703,3140,2211,2491,492,649,526,255,375,210,151,45,44,51,2700,3400,1325,1450,800,100,1
400,0,0,91.0,100.0,102.0,109.0,2759,2692,2267,2043,492,649,416,366,305,245,111,121,44,51,2800,3400,1325,1450,800,100,1
407,0,0,95.0,105.0,102.0,109.0,3045,2658,2575,1987,470,671,457,251,415,175,42,76,44,52,2900,3400,1325,1550,800,100,1
414,0,0,98.0,109.0,102.0,109.0,2311,2776,1931,2127,380,649,372,327,290,175,82,152,43,54,2950,3450,1325,1750,850,100,1
421,0,0,100.0,109.0,102.0,109.0,1673,2670,1427,2043,246,627,276,268,245,115,31,153,42,55,3100,3900,1325,1850,900,100,1
429,0,0,102.0,117.0,102.0,117.0,1505,2860,1259,2211,246,649,364,263,305,30,59,233,44,55,3550,3900,1325,1850,900,100,1
436,0,0,102.0,117.0,102.0,117.0,1544,2854,1343,2183,201,671,459,503,380,190,79,313,44,55,3975,4375,1325,1850,900,100,1
443,0,0,102.0,117.0,110.0,117.0,1662,2832,1371,2183,291,649,618,514,495,250,123,264,44,58,3775,4375,1325,1850,1150,100,1
450,0,0,101.0,125.0,110.0,133.0,2194,2910,1791,2239,403,671,440,815,265,475,175,340,44,58,3725,4125,1325,1850,1250,400,1
457,0,0,103.0,123.0,110.0,133.0,2322,3078,1875,2407,447,671,611,1035,380,615,231,420,44,58,4100,4025,1325,1850,1250,500,1
464,0,0,106.0,130.0,110.0,133.0,2378,2838,1931,2211,447,627,338,852,180,560,158,292,44,61,4100,4625,1325,1850,1350,500,1
471,0,0,107.0,129.0,110.0,133.0,2294,2642,1847,2015,447,627,455,1077,245,705,210,372,44,61,4050,4425,1325,1850,1400,800,1
479,0,0,109.0,129.0,110.0,133.0,2306,2658,1903,1987,403,671,583,792,325,440,258,352,46,61,4150,4700,1325,1850,1400,800,1
486,0,0,110.0,133.0,110.0,133.0,2378,2636,1931,1987,447,649,654,478,340,275,314,203,47,61,4200,4950,1325,1850,1450,800,1
493,0,0,106.0,132.0,118.0,133.0,2401,2446,1931,1819,470,627,940,569,570,290,370,279,47,61,4025,5100,1325,1850,1950,1050,1
500,0,0,88.0,104.0,126.0,133.0,2423,2546,1931,1875,492,671,1175,779,745,420,430,359,48,60,2700,3450,1325,1850,3325,2800,1
507,0,0,81.0,100.0,126.0,141.0,2401,2468,1931,1819,470,649,586,245,425,135,161,110,48,60,1425,2675,1325,1850,4700,3575,1
514,0,0,83.0,109.0,126.0,141.0,2496,2328,1959,1679,537,649,275,186,150,100,125,86,48,60,1425,3150,1325,1850,4700,3575,1
521,0,0,87.0,112.0,126.0,141.0,2373,2048,1791,1399,582,649,367,182,170,20,197,162,50,62,1575,3200,1325,2000,4700,3575,1
529,0,0,88.0,114.0,141.0,141.0,2423,2188,1819,1539,604,649,405,267,140,75,265,192,50,62,1675,3400,1325,2150,4700,3575,1
536,0,0,93.0,117.0,141.0,141.0,2630,2474,1959,1847,671,627,465,413,120,195,345,218,52,64,1725,3450,1325,2400,4700,3575,1
543,0,0,98.0,119.0,141.0,141.0,2804,2664,2155,2015,649,649,316,268,95,145,221,123,52,64,2500,3850,1325,2625,4700,3575,1
550,0,0,103.0,122.0,141.0,141.0,2972,3202,2323,2463,649,739,252,136,80,100,172,36,54,66,2500,4275,1325,2625,4750,3575,1
557,0,0,108.0,124.0,141.0,141.0,2978,3650,2351,2911,627,739,418,526,170,410,248,116,56,66,2600,4375,1325,2625,4750,3575,1
564,0,0,110.0,129.0,141.0,141.0,3308,3745,2659,2939,649,806,308,190,80,70,228,120,56,66,2650,4375,1475,2725,4750,3575,1
571,0,0,111.0,137.0,141.0,141.0,3594,4215,2967,3275,627,940,524,281,320,170,204,111,59,69,3150,4475,1625,2825,4800,3625,1
579,0,0,101.0,134.0,141.0,141.0,3644,4137,2995,3219,649,918,954,719,670,500,284,219,60,68,2900,4375,1625,2825,5425,3875,1
586,0,0,91.0,129.0,141.0,149.0,3773,4025,3079,3107,694,918,1079,707,715,480,364,227,60,69,1750,3825,1625,2825,6625,4675,1
593,0,0,93.0,134.0,141.0,149.0,3834,3963,3163,3023,671,940,605,565,490,430,115,135,60,69,1225,3875,1750,2825,7150,4775,1
600,0,0,94.0,136.0,141.0,149.0,3538,3969,2911,3051,627,918,837,617,650,520,187,97,60,69,1275,4300,1750,2825,7150,4775,1
607,0,0,101.0,140.0,141.0,149.0,3476,3605,2827,2687,649,918,597,250,330,170,267,80,63,69,1475,4500,1950,2825,7150,4775,1
614,0,0,105.0,144.0,141.0,149.0,3476,3263,2827,2323,649,940,757,441,410,245,347,196,63,69,1475,4600,2200,2825,7150,4775,1
621,0,0,103.0,147.0,141.0,149.0,3493,3252,2799,2267,694,985,1070,632,635,320,435,312,66,69,1925,4700,2200,2825,7625,4825,1
629,0,0,112.0,149.0,141.0,149.0,3577,3263,2659,2323,918,940,216,739,165,315,51,424,66,69,1875,4900,2200,2825,7875,4825,1
636,0,0,106.0,152.0,141.0,157.0,3314,3230,2351,2267,963,963,448,434,285,90,163,344,66,69,1425,5625,2200,2825,8375,5125,1
643,0,0,81.0,139.0,141.0,157.0,2446,3280,1707,2295,739,985,504,359,265,20,239,339,48,69,925,4225,2200,3175,9875,6300,1
649,0,0,81.0,145.0,141.0,157.0,2149,3347,1455,2407,694,940,180,519,40,80,140,439,47,69,1025,4425,2200,3175,10025,6300,1
7,1,2,13.0,13.0,14.0,15.0,293,293,293,293,0,0,35,35,35,35,0,0,12,12,0,0,0,0,0,0,0
14,1,2,13.0,14.0,14.0,15.0,671,671,671,671,0,0,20,70,20,70,0,0,13,13,0,0,0,0,0,0,0
21,1,2,14.0,14.0,14.0,15.0,755,699,755,699,0,0,60,50,60,50,0,0,13,13,0,0,0,0,0,0,0
29,1,2,14.0,15.0,14.0,15.0,755,699,755,699,0,0,150,35,150,35,0,0,13,14,0,0,0,0,0,0,0
36,1,2,16.0,15.0,22.0,15.0,811,755,811,755,0,0,150,130,150,130,0,0,14,14,0,0,0,0,0,0,0
43,1,2,16.0,16.0,22.0,23.0,811,755,811,755,0,0,245,20,245,20,0,0,16,15,0,0,0,0,0,0,0
50,1,2,15.0,17.0,22.0,23.0,839,783,839,783,0,0,40,40,40,40,0,0,15,16,0,0,0,0,0,0,0
57,1,2,17.0,18.0,22.0,23.0,867,839,867,839,0,0,40,40,40,40,0,0,15,17,0,0,0,0,0,0,0
64,1,2,18.0,18.0,22.0,23.0,895,923,895,923,0,0,100,150,100,150,0,0,16,17,0,0,0,0,0,0,0
71,1,2,17.0,19.0,22.0,23.0,923,923,923,923,0,0,185,265,185,265,0,0,17,18,0,0,0,0,0,0,0
79,1,2,17.0,20.0,22.0,23.0,895,995,895,951,0,44,35,333,35,325,0,8,16,19,0,0,0,0,0,0,0
86,1,2,18.0,20.0,22.0,23.0,839,990,839,923,0,67,80,51,80,35,0,16,16,19,0,0,0,150,0,0,0
93,1,2,19.0,20.0,22.0,23.0,811,978,811,867,0,111,130,167,130,135,0,32,18,20,0,0,0,150,0,0,0
100,1,2,20.0,21.0,22.0,23.0,889,1023,867,867,22,156,194,92,190,40,4,52,19,20,0,0,0,150,0,0,0
107,1,2,20.0,21.0,22.0,23.0,928,1018,839,839,89,179,296,82,280,10,16,72,19,20,0,0,0,150,0,0,0
114,1,2,20.0,22.0,22.0,23.0,978,1046,867,867,111,179,68,117,40,25,28,92,19,21,0,0,0,150,0,0,0
121,1,2,22.0,23.0,28.0,23.0,1001,1023,867,867,134,156,49,188,5,80,44,108,19,22,0,0,250,150,0,0,0
129,1,2,23.0,23.0,28.0,23.0,1051,1107,895,951,156,156,124,268,60,140,64,128,20,22,0,0,250,150,0,0,0
136,1,2,25.0,26.0,28.0,31.0,978,1135,867,867,111,268,101,293,25,150,76,143,20,23,0,0,250,300,0,0,0
143,1,2,26.0,27.0,28.0,31.0,995,1242,951,951,44,291,179,89,95,60,84,29,20,24,50,0,250,300,0,0,0
150,1,2,28.0,28.0,28.0,31.0,1102,1186,1035,895,67,291,122,139,30,70,92,69,21,25,50,0,250,300,0,0,0
157,1,2,28.0,31.0,28.0,46.0,1158,1286,1091,951,67,335,255,64,155,30,100,34,21,25,200,125,250,300,0,0,0
164,1,2,29.0,32.0,36.0,46.0,1191,1320,1147,1007,44,313,159,75,155,5,4,70,23,26,200,125,250,300,0,0,0
171,1,2,33.0,33.0,36.0,46.0,1298,1454,1231,1119,67,335,67,140,55,30,12,110,23,27,350,125,250,300,0,0,0
179,1,2,36.0,35.0,36.0,46.0,1382,1510,1315,1175,67,335,75,265,55,115,20,150,23,29,350,125,250,300,0,0,0
186,1,2,38.0,41.0,42.0,46.0,1359,1572,1315,1259,44,313,84,96,60,60,24,36,26,31,400,250,250,600,0,0,0
193,1,2,38.0,41.0,42.0,46.0,1415,1684,1371,1371,44,313,157,201,125,125,32,76,28,31,400,250,250,600,0,0,0
200,1,2,42.0,43.0,42.0,46.0,1578,1762,1511,1427,67,335,145,151,105,35,40,116,28,33,400,250,250,600,0,0,0
207,1,2,42.0,43.0,42.0,46.0,1583,1706,1539,1371,44,335,324,201,280,45,44,156,31,33,550,250,250,600,0,0,0
214,1,2,47.0,45.0,50.0,46.0,1695,1796,1651,1483,44,313,277,72,225,30,52,42,32,35,550,600,250,600,0,0,0
221,1,2,45.0,50.0,50.0,54.0,1746,1846,1679,1511,67,335,245,242,185,160,60,82,30,36,700,600,250,600,0,0,0
229,1,2,45.0,51.0,42.0,54.0,1746,1958,1679,1623,67,335,238,487,170,365,68,122,35,37,700,600,250,600,100,0,0
236,1,2,44.0,52.0,42.0,54.0,1639,1992,1595,1679,44,313,342,183,270,25,72,158,34,39,700,600,250,600,100,0,0
243,1,2,49.0,53.0,66.0,54.0,1846,2076,1735,1763,111,313,283,228,195,30,88,198,34,39,700,600,500,600,100,0,0
250,1,2,54.0,54.0,66.0,54.0,1947,2070,1791,1735,156,335,248,178,140,40,108,138,37,41,700,600,500,750,100,0,0
257,1,2,58.0,56.0,66.0,62.0,1947,2126,1791,1791,156,335,303,238,175,60,128,178,41,42,700,950,500,750,100,0,0
264,1,2,59.5,56.0,66.0,70.0,2110,2132,1931,1819,179,313,253,304,205,90,48,214,46,42,675,950,625,750,125,0,0
271,1,2,64.5,60.0,66.0,70.0,2278,2182,2099,1847,179,335,43,379,25,150,18,229,47,44,675,950,625,750,125,0,0
279,1,2,64.5,63.0,66.0,70.0,2143,2188,1987,1875,156,313,139,420,105,180,34,240,45,45,825,1075,625,750,175,0,0
286,1,2,65.5,64.0,66.0,70.0,2367,2250,2211,1959,156,291,289,356,235,180,54,176,51,46,825,1200,625,750,175,0,0
293,1,2,65.5,66.0,66.0,70.0,2703,2317,2547,1959,156,358,514,224,440,150,74,74,52,48,825,1200,625,1150,175,0,0
300,1,2,65.5,67.0,74.0,70.0,2479,2406,2323,1847,156,559,449,411,355,265,94,146,51,49,825,1200,625,1150,225,0,0
307,1,2,65.0,68.0,82.0,85.0,1746,2574,1567,1903,179,671,494,467,380,345,114,122,48,50,800,1200,625,1150,350,0,0
314,1,2,74.0,70.0,82.0,93.0,1802,2608,1623,1959,179,649,239,268,105,70,134,198,48,51,900,1200,625,1150,400,0,0
321,1,2,75.5,72.0,82.0,93.0,2317,2580,2071,1931,246,649,301,328,135,150,166,178,46,53,1075,1200,825,1150,525,0,0
329,1,2,77.0,72.0,82.0,93.0,2278,2636,2099,1987,179,649,467,189,285,35,182,154,55,54,1200,1375,825,1150,550,125,0
336,1,2,79.0,71.0,82.0,93.0,2558,2776,2379,2127,179,649,416,429,310,270,106,159,58,54,1200,1250,825,1400,550,250,0
343,1,2,78.0,71.0,82.0,93.0,2866,2832,2575,2183,291,649,567,385,425,150,142,235,57,54,1150,1250,825,1400,600,250,0
350,1,2,79.5,73.0,82.0,93.0,2950,2854,2659,2183,291,671,423,630,245,315,178,315,59,54,1125,1250,825,1500,625,250,0
357,1,2,79.0,75.0,82.0,93.0,2922,2888,2631,2239,291,649,570,611,360,320,210,291,63,53,1100,1500,825,1500,650,300,0
364,1,2,84.5,79.0,98.0,93.0,3090,2860,2799,2211,291,649,447,702,205,335,242,367,63,56,1075,1500,825,1950,675,300,0
371,1,2,86.0,79.0,114.0,93.0,3140,2888,2827,2239,313,649,677,602,395,155,282,447,63,56,1000,1500,825,2250,750,300,0
379,1,2,91.0,79.0,136.0,93.0,3185,2922,2715,2295,470,627,820,459,470,140,350,319,67,58,1000,1500,825,2550,750,300,0
386,1,2,97.0,79.0,136.0,93.0,3448,3095,2799,2491,649,604,940,830,510,435,430,395,67,58,1000,1750,825,2550,750,300,0
393,1,2,99.0,87.0,136.0,93.0,3330,3252,2659,2603,671,649,1030,296,620,25,410,271,67,58,1300,2450,1075,2550,750,300,0
400,1,2,104.5,87.0,136.0,93.0,3532,3202,2659,2575,873,627,832,692,410,345,422,347,66,58,1575,2450,1075,2550,775,300,0
407,1,2,104.0,90.0,136.0,93.0,3672,3286,2687,2659,985,627,1163,683,625,360,538,323,66,58,1850,2450,1075,2550,800,300,0
414,1,2,103.5,91.0,136.0,109.0,3599,3196,2659,2547,940,649,1390,698,740,295,650,403,66,61,1925,2450,1075,2900,825,300,0
421,1,2,103.5,101.0,136.0,109.0,3655,3062,2715,2435,940,627,1640,154,870,125,770,29,66,61,2075,2450,1075,3350,825,300,0
429,1,2,121.5,101.0,160.0,109.0,3650,3039,2687,2323,963,716,330,331,90,210,240,121,66,62,2075,2975,1325,3500,825,300,0
436,1,2,121.5,101.0,168.0,125.0,3722,3073,2715,2155,1007,918,770,287,410,200,360,87,66,62,2375,3425,1325,3500,825,300,0
443,1,2,135.0,107.0,176.0,125.0,3734,3218,2771,2211,963,1007,163,152,45,95,118,57,66,62,2750,3425,1325,3650,850,300,0
450,1,2,135.0,111.0,176.0,141.0,3806,3224,2799,2239,1007,985,403,188,265,115,138,73,66,62,2750,3950,1325,3650,850,300,0
457,1,2,142.5,111.0,176.0,141.0,3700,3392,2715,2407,985,985,129,239,75,150,54,89,66,62,3775,3950,1325,3650,1175,650,0
464,1,2,146.0,111.0,176.0,149.0,3627,3280,2687,2295,940,985,256,285,190,180,66,105,66,62,4350,4325,1325,3650,1200,975,0
471,1,2,143.5,117.0,176.0,149.0,3605,3448,2687,2463,918,985,693,176,515,105,178,71,66,62,4625,4325,1325,3650,1375,975,0
479,1,2,144.5,99.0,176.0,149.0,3678,3370,2715,2407,963,963,424,582,130,395,294,187,66,62,3825,3325,1325,3650,1975,2500,0
486,1,2,139.5,93.0,176.0,149.0,3756,3314,2771,2351,985,963,876,668,470,515,406,153,66,62,4225,2800,1325,3650,2325,3025,0
493,1,2,147.0,101.0,176.0,149.0,3577,3308,2659,2323,918,985,625,268,265,195,360,73,66,62,4950,2800,1325,3650,2350,3025,0
500,1,2,149.5,101.0,176.0,149.0,3633,3258,2715,2295,918,963,872,650,400,465,472,185,66,62,4975,3500,1325,3650,2425,3025,0
507,1,2,150.5,105.0,176.0,149.0,3577,3202,2659,2239,918,963,1254,316,670,215,584,101,66,62,5275,3800,1325,3650,2425,3025,0
514,1,2,147.5,110.0,176.0,149.0,3493,3224,2575,2239,918,985,1515,701,815,480,700,221,66,61,4975,4100,1325,3650,2875,2975,0
521,1,2,149.0,116.0,176.0,141.0,3398,3224,2435,2239,963,985,1180,782,660,445,520,337,66,61,5150,4400,1325,3650,2950,2975,0
529,1,2,155.5,104.0,176.0,141.0,3028,3207,2155,2267,873,940,1066,1154,450,705,616,449,64,61,5275,3350,1325,3750,3075,4025,0
536,1,2,155.0,110.0,176.0,141.0,2507,3224,1791,2239,716,985,1216,854,520,485,696,369,64,61,5150,3950,1325,4050,3250,4125,0
543,1,2,152.0,114.0,176.0,141.0,2597,3246,1903,2239,694,1007,1515,439,735,300,780,139,64,61,5100,3850,1325,4050,3400,4225,0
550,1,2,158.0,112.0,176.0,141.0,2395,3196,1679,2211,716,985,1308,826,540,575,768,251,64,61,5500,3750,1325,4050,3500,4325,0
557,1,2,164.0,112.0,176.0,141.0,2602,3196,1819,2211,783,985,928,302,260,135,668,167,64,61,5600,3750,1325,4050,3500,4325,0
564,1,2,168.5,112.0,176.0,141.0,3101,3112,2183,2127,918,985,710,683,105,400,605,283,64,61,5575,3750,1325,4050,3525,4325,0
571,1,2,168.5,122.0,176.0,141.0,3246,3202,2239,2239,1007,963,895,249,270,200,625,49,64,61,6175,4275,1325,4050,3550,4325,0
579,1,2,164.5,128.0,176.0,141.0,3448,3174,2463,2211,985,963,1001,620,260,455,741,165,62,61,7275,5075,1325,4050,3725,4325,0
586,1,2,168.0,128.0,176.0,141.0,3403,3112,2463,2127,940,985,1158,590,305,505,853,85,62,61,7200,5075,1325,4050,3800,4325,0
593,1,2,169.0,138.0,176.0,141.0,3314,3168,2351,2183,963,985,1098,271,125,70,973,201,61,61,6850,5575,1325,4050,4200,4425,0
600,1,2,176.0,138.0,176.0,141.0,3280,3168,2295,2183,985,985,1154,642,65,325,1089,317,61,61,7100,5575,1325,4050,4200,4425,0
607,1,2,172.5,140.0,176.0,141.0,3342,3224,2379,2239,963,985,1550,818,345,385,1205,433,70,61,6925,5400,1325,4050,4375,4600,0
614,1,2,175.0,146.0,176.0,149.0,3426,3140,2463,2155,963,985,1261,279,90,230,1171,49,70,61,6650,5650,1575,4050,4650,4650,0
621,1,2,171.0,137.0,176.0,149.0,3582,2720,2575,1847,1007,873,1706,224,415,175,1291,49,70,50,6400,6925,1575,3900,5025,5425,0
629,1,2,170.0,133.0,176.0,149.0,3812,2194,2827,1455,985,739,867,333,60,200,807,133,70,45,6000,6425,1575,3900,5100,5775,0
636,1,2,170.0,133.0,192.0,164.0,3874,2278,2911,1539,963,739,1229,596,360,375,869,221,70,45,6450,6875,1575,3900,5100,5775,0
643,1,2,169.0,135.0,192.0,164.0,3918,2423,2911,1707,1007,716,1679,596,690,495,989,101,70,48,7600,7075,1575,3900,5225,5875,0
650,1,2,183.5,143.0,198.0,164.0,3896,2423,2911,1707,985,716,1345,114,240,75,1105,39,70,48,7675,7075,1575,3900,5350,5875,0
657,1,2,181.0,139.0,198.0,164.0,3879,2513,2939,1819,940,694,1467,168,400,45,1067,123,70,48,7400,7125,1575,3900,5625,6350,0
664,1,2,181.0,139.0,198.0,164.0,3778,2502,2771,1651,1007,851,1802,465,615,230,1187,235,70,48,7850,7125,1575,3900,5775,6350,0
671,1,2,183.0,142.0,198.0,164.0,3806,2530,2799,1567,1007,963,1267,262,260,115,1007,147,69,52,8050,7125,1575,3900,5775,6350,0
679,1,2,189.0,144.0,198.0,164.0,3711,2468,2771,1483,940,985,1145,458,130,195,1015,263,71,53,8150,7125,1575,3900,5775,6350,0
686,1,2,193.0,151.0,198.0,164.0,3706,2558,2743,1595,963,963,990,224,5,45,985,179,71,55,8050,7375,1575,3900,5875,6350,0
693,1,2,182.0,146.0,198.0,164.0,3778,2670,2771,1707,1007,963,1240,505,135,210,1105,295,71,56,7750,6875,1575,3900,6750,6850,0
700,1,2,179.0,145.0,190.0,149.0,3672,2888,2687,1903,985,985,1426,445,205,330,1221,115,71,56,7150,6725,1575,3900,7675,7650,0
707,1,2,178.0,147.0,190.0,149.0,3566,2804,2603,1819,963,985,1048,1071,115,640,933,431,71,56,7450,7025,1575,3900,7825,7650,0
714,1,2,179.5,149.0,190.0,149.0,3610,2692,2603,1707,1007,985,1342,842,232,395,1110,447,71,56,7500,7175,1575,3900,8111,7650,0
721,1,2,184.5,149.0,190.0,149.0,3728,2748,2743,1763,985,985,1631,1173,291,610,1340,563,71,58,7850,7175,1575,3900,8208,7650,0
729,1,2,183.5,149.0,190.0,149.0,3874,2692,2911,1707,963,985,1593,1479,391,800,1202,679,71,58,8050,7175,1925,3900,8258,7650,0
736,1,2,188.5,157.0,190.0,173.0,4042,2647,3079,1707,963,940,1178,1106,131,515,1047,591,71,58,8350,7675,1925,3900,8358,7650,0
743,1,2,177.5,165.0,190.0,166.0,4148,2182,3163,1399,985,783,759,729,196,450,563,279,71,58,7850,8375,1925,3900,9383,8050,0
750,1,2,178.5,165.0,196.0,166.0,4075,1936,3135,1175,940,761,181,589,156,210,25,379,71,58,8350,8975,1925,3900,9558,8050,0
757,1,2,177.5,165.0,196.0,166.0,3902,2104,2939,1343,963,761,306,805,161,350,145,455,68,58,8350,8975,1925,3900,9558,8050,0
764,1,2,183.5,165.0,196.0,166.0,3806,1628,2799,979,1007,649,456,1005,191,470,265,535,68,58,8350,8975,1925,3900,9558,8050,0
771,1,2,183.5,165.0,196.0,166.0,3700,1690,2715,951,985,739,902,708,521,85,381,623,70,58,10000,8975,1925,3900,9658,8050,0
779,1,2,195.0,166.0,196.0,166.0,3734,2026,2771,1287,963,739,754,966,261,330,493,636,70,58,10275,8975,2050,3900,9683,8050,0
786,1,2,177.0,127.0,196.0,166.0,3750,1751,2743,1035,1007,716,1204,1146,591,430,613,716,70,58,8275,5800,2050,3900,11683,11225,0
793,1,2,185.0,127.0,196.0,198.0,3644,1583,2659,867,985,716,1035,635,306,35,729,600,70,58,7875,5200,2050,3900,12083,11825,0
800,1,2,185.5,119.0,190.0,198.0,3403,1818,2463,1147,940,671,662,865,71,185,591,680,70,58,7650,5225,2050,3900,13183,12500,0
7,2,0,13.0,13.0,15.0,15.0,251,293,251,293,0,0,30,35,30,35,0,0,12,12,0,0,0,0,0,0,0
14,2,0,14.0,14.0,15.0,15.0,671,671,671,671,0,0,70,70,70,70,0,0,13,13,0,0,0,0,0,0,0
21,2,0,14.0,14.0,15.0,15.0,671,727,671,727,0,0,40,50,40,50,0,0,13,13,0,0,0,0,0,0,0
29,2,0,15.0,15.0,15.0,15.0,755,643,755,643,0,0,45,75,45,75,0,0,14,14,0,0,0,0,0,0,0
36,2,0,15.0,15.0,23.0,15.0,839,727,839,727,0,0,150,125,150,125,0,0,14,14,0,0,0,0,0,0,0
43,2,0,16.0,16.0,23.0,23.0,839,783,839,783,0,0,35,65,35,65,0,0,15,15,0,0,0,0,0,0,0
50,2,0,17.0,16.0,23.0,23.0,839,811,839,811,0,0,15,80,15,80,0,0,16,15,0,0,0,0,0,0,0
57,2,0,18.0,17.0,23.0,23.0,839,783,839,783,0,0,65,125,65,125,0,0,17,16,0,0,0,0,0,0,0
64,2,0,19.0,18.0,23.0,23.0,951,811,951,811,0,0,125,165,125,165,0,0,18,17,0,0,0,0,0,0,0
71,2,0,19.0,18.0,23.0,23.0,1001,883,979,839,22,44,244,278,240,270,4,8,18,17,0,0,0,0,0,0,0
79,2,0,20.0,19.0,23.0,23.0,984,911,895,755,89,156,356,333,340,305,16,28,19,18,0,0,0,0,0,0,0
86,2,0,20.0,19.0,23.0,23.0,990,990,811,811,179,179,271,448,235,400,36,48,19,18,0,0,150,0,0,0,0
93,2,0,20.0,20.0,23.0,23.0,967,962,811,783,156,179,437,313,385,295,52,18,20,19,0,0,150,150,0,0,0
100,2,0,20.0,20.0,23.0,23.0,1023,939,867,783,156,156,157,424,85,390,72,34,20,19,0,0,150,150,0,0,0
107,2,0,21.0,20.0,23.0,23.0,1051,911,895,755,156,156,127,129,35,75,92,54,20,19,0,0,150,150,0,0,0
114,2,0,21.0,21.0,23.0,23.0,1023,911,867,755,156,156,132,89,20,15,112,74,20,19,0,0,150,150,0,0,0
121,2,0,24.0,22.0,31.0,23.0,1057,911,923,755,134,156,128,154,25,60,103,94,21,19,0,100,300,150,0,0,0
129,2,0,24.0,23.0,31.0,23.0,1079,1051,923,895,156,156,108,239,35,125,73,114,21,20,0,100,300,150,0,0,0
136,2,0,25.0,23.0,31.0,31.0,1051,1186,895,1007,156,179,348,144,205,110,143,34,22,20,0,100,300,150,0,0,0
143,2,0,26.0,24.0,31.0,31.0,1046,1219,755,1063,291,156,123,30,90,30,33,0,23,21,125,150,300,150,0,0,0
150,2,0,29.0,24.0,31.0,31.0,1230,1191,895,1035,335,156,94,95,50,75,44,20,24,21,125,150,300,150,0,0,0
157,2,0,30.0,25.0,31.0,31.0,1208,1219,895,1063,313,156,95,180,65,140,30,40,25,22,125,150,300,150,0,0,0
164,2,0,30.0,26.0,31.0,31.0,1292,1191,979,1035,313,156,200,275,130,215,70,60,25,23,125,150,300,150,0,0,0
171,2,0,32.0,26.0,46.0,31.0,1264,1247,951,1091,313,156,120,420,35,340,85,80,26,23,125,150,300,250,0,0,0
179,2,0,35.0,27.0,46.0,46.0,1370,1331,1035,1063,335,268,185,271,60,255,125,16,27,24,250,150,300,600,0,0,0
186,2,0,40.0,29.0,46.0,46.0,1309,1230,951,895,358,335,40,101,25,70,15,31,29,24,250,150,600,600,0,0,0
193,2,0,41.0,29.0,46.0,46.0,1454,1454,1119,1119,335,335,171,122,120,55,51,67,30,25,250,50,600,600,0,100,0
200,2,0,42.0,31.0,46.0,46.0,1600,1404,1287,1091,313,313,257,198,170,95,87,103,31,25,250,150,600,675,0,100,0
207,2,0,46.0,35.0,46.0,46.0,1600,1488,1287,1175,313,313,187,83,85,40,102,43,33,26,375,150,600,675,0,100,0
214,2,0,46.0,36.0,46.0,54.0,1712,1488,1399,1175,313,313,162,213,20,130,142,83,33,26,375,150,600,925,0,100,0
221,2,0,48.0,38.0,54.0,54.0,1768,1852,1455,1539,313,313,62,213,30,90,32,123,35,28,375,250,600,925,0,100,0
229,2,0,51.0,42.0,54.0,54.0,1874,1925,1539,1567,335,358,197,118,125,30,72,88,35,28,675,250,600,925,0,100,0
236,2,0,53.0,44.0,54.0,54.0,1981,2065,1623,1707,358,358,237,158,125,30,112,128,37,30,800,500,600,925,0,100,0
243,2,0,54.0,47.0,54.0,54.0,2014,2020,1679,1707,335,313,468,115,320,80,148,35,38,31,800,500,600,925,0,100,0
250,2,0,56.0,49.0,62.0,54.0,2104,1908,1791,1595,313,313,269,230,85,155,184,75,40,32,800,600,600,925,0,100,0
257,2,0,56.0,51.0,62.0,54.0,2104,2160,1791,1847,313,313,209,180,85,65,124,115,40,33,800,825,750,925,0,100,0
264,2,0,57.0,53.0,62.0,62.0,2132,2216,1819,1903,313,313,304,200,140,45,164,155,42,34,1100,825,750,1075,0,100,0
271,2,0,61.0,57.0,62.0,62.0,2132,2042,1819,1707,313,335,139,245,85,50,54,195,42,36,1425,925,750,1075,0,100,0
279,2,0,62.0,57.0,62.0,62.0,2238,2093,1903,1735,335,358,209,400,115,165,94,235,43,36,1425,1200,750,1075,0,100,0
286,2,0,64.0,60.0,70.0,62.0,2272,2121,1847,1763,425,358,371,285,225,110,146,175,44,38,1425,1200,750,1075,0,100,0
293,2,0,64.0,62.0,70.0,62.0,2311,2261,1819,1791,492,470,577,100,375,40,202,60,44,38,1425,1300,750,1200,0,100,0
300,2,0,66.0,64.0,70.0,70.0,2289,2401,1819,1931,470,470,643,215,385,95,258,120,46,40,1425,1350,850,1350,0,100,0
307,2,0,67.0,66.0,70.0,70.0,2261,2317,1791,1847,470,470,358,295,290,140,68,155,47,40,1425,1450,1100,1425,0,100,0
314,2,0,68.0,68.0,70.0,70.0,2334,2261,1819,1791,515,470,171,170,135,55,36,115,48,42,1425,1450,1200,1425,0,100,0
321,2,0,73.0,70.0,93.0,70.0,2440,2468,1791,1931,649,537,361,160,245,60,116,100,49,42,1425,1450,1200,1425,0,100,0
329,2,0,75.0,74.0,93.0,78.0,2462,2502,1791,1875,671,627,252,271,160,95,92,176,50,44,1425,1575,1200,1525,0,100,0
336,2,0,77.0,80.0,101.0,86.0,2490,2614,1819,1987,671,627,308,278,140,105,168,173,51,44,1425,1675,1200,1525,0,100,0
343,2,0,79.0,81.0,101.0,86.0,2558,2614,1931,1987,627,627,265,313,125,60,140,253,52,46,1675,1625,1450,1525,0,150,0
350,2,0,82.0,83.0,101.0,94.0,2530,2748,1903,2099,627,649,240,498,120,190,120,308,53,46,2050,1750,1750,1525,0,150,0
357,2,0,84.0,89.0,101.0,94.0,2720,3006,2071,2379,649,627,480,269,280,110,200,159,56,46,2050,2175,1750,1525,0,150,0
364,2,0,91.0,95.0,101.0,102.0,2860,2972,2211,2323,649,649,235,374,155,160,80,214,56,46,2050,2175,1750,1425,0,175,0
371,2,0,92.0,99.0,109.0,110.0,3028,2961,2379,2267,649,694,431,354,275,110,156,244,58,47,2300,2300,1900,1425,0,175,0
379,2,0,95.0,101.0,109.0,118.0,3129,2418,2435,1791,694,627,216,487,130,175,86,312,60,48,2300,2400,2050,1425,0,175,0
386,2,0,96.0,103.0,109.0,118.0,3134,2026,2463,1511,671,515,532,452,370,130,162,322,62,45,2300,2950,2050,1425,0,375,0
393,2,0,104.0,105.0,109.0,126.0,3286,2345,2659,1763,627,582,324,433,90,60,234,373,63,45,2700,3200,2050,1425,0,475,0
400,2,0,105.0,108.0,109.0,126.0,3202,2110,2575,1595,627,515,649,553,335,145,314,408,64,46,2700,3200,2050,1425,0,475,0
407,2,0,105.0,110.0,109.0,126.0,3392,2401,2743,1931,649,470,564,463,370,45,194,418,64,43,3200,3500,2200,1425,0,675,0
414,2,0,110.0,103.0,117.0,126.0,3442,2194,2771,1679,671,515,919,543,645,90,274,453,65,42,3075,3150,2200,1425,125,1250,0
421,2,0,104.0,96.0,117.0,126.0,3364,1348,2715,811,649,537,910,548,560,35,350,513,65,42,2300,2825,2450,1425,900,1700,0
429,2,0,108.0,99.0,117.0,134.0,3470,1639,2799,1147,671,492,826,635,500,95,326,540,66,43,2700,3125,2450,1425,900,1700,0
436,2,0,109.0,104.0,117.0,134.0,3392,2345,2743,1875,649,470,622,481,320,85,302,396,67,44,2700,3250,2450,1425,950,1700,0
443,2,0,113.0,107.0,117.0,134.0,3431,2586,2827,2071,604,515,624,459,250,45,374,414,65,45,2700,3200,2450,1425,1150,1750,0
450,2,0,115.0,111.0,117.0,134.0,3286,2754,2771,2239,515,515,774,443,340,40,434,403,64,46,3350,3325,2450,1425,1200,1750,0
457,2,0,107.0,114.0,117.0,134.0,3235,2950,2631,2435,604,515,1159,491,645,70,514,421,66,46,3450,3375,2450,1425,1600,1800,0
464,2,0,113.0,120.0,117.0,134.0,3056,2927,2407,2323,649,604,1035,509,445,120,590,389,63,46,3550,3900,2450,1425,1950,1800,0
471,2,0,101.0,102.0,117.0,134.0,2804,2591,2155,1987,649,604,1222,517,560,110,662,407,56,48,3550,2950,2450,1425,2700,2375,0
479,2,0,95.0,97.0,117.0,134.0,2429,2586,1959,2071,470,515,1440,334,730,25,710,309,55,48,3000,2225,2700,1425,3300,3300,0
486,2,0,105.0,91.0,117.0,134.0,2210,2636,1875,2099,335,537,970,442,320,90,650,352,55,48,3500,2025,2750,1425,3550,3625,0
493,2,0,111.0,94.0,117.0,134.0,2160,2608,1847,2071,313,537,885,525,195,155,690,370,55,49,3700,2100,2750,1425,3600,3675,0
500,2,0,108.0,93.0,117.0,134.0,2266,2591,1931,1987,335,604,1160,625,430,200,730,425,54,49,3700,2350,2750,1425,3750,3925,0
507,2,0,106.0,91.0,117.0,134.0,2154,2552,1819,1903,335,649,1015,545,245,65,770,480,55,49,3850,2025,2750,1425,3850,4250,0
514,2,0,106.0,95.0,117.0,134.0,2451,2625,2183,1931,268,694,963,630,365,120,598,510,55,49,3850,2425,2750,1425,3850,4350,0
521,2,0,104.0,94.0,117.0,134.0,2653,2714,2407,2043,246,671,1310,757,680,225,630,532,55,49,3750,2325,2750,1425,3950,4500,0
529,2,0,106.0,93.0,117.0,134.0,2675,2754,2407,2127,268,627,936,449,270,20,666,429,55,49,3150,2150,2750,1425,4550,4775,0
536,2,0,105.0,93.0,117.0,134.0,2815,2838,2547,2211,268,627,1128,459,430,25,698,434,55,49,3750,2050,2750,1425,4650,5325,0
543,2,0,107.0,95.0,117.0,134.0,2843,2838,2575,2211,268,627,1214,564,480,75,734,489,56,49,3750,2050,2750,1425,4650,5325,0
550,2,0,117.0,92.0,117.0,134.0,2810,3090,2519,2463,291,627,646,844,480,275,166,569,56,48,3750,1950,3100,1425,4650,5475,0
557,2,0,115.0,97.0,125.0,134.0,2810,3022,2519,2351,291,671,968,789,770,240,198,549,56,49,4150,2575,3100,1725,4750,5625,0
564,2,0,109.0,97.0,125.0,134.0,2843,2647,2575,1931,268,716,1300,529,1070,50,230,479,56,49,4550,2450,3100,1725,5050,5975,0
571,2,0,102.0,83.0,125.0,149.0,2703,2244,2435,1595,268,649,1567,564,1305,42,262,522,56,48,4150,1850,3100,1800,5450,6775,0
579,2,0,101.0,83.0,125.0,149.0,2838,2278,2547,1651,291,627,1598,708,1300,135,298,573,57,45,3950,1900,3100,1800,5950,7175,0
586,2,0,109.0,87.0,140.0,149.0,2591,2110,2323,1483,268,627,1210,657,880,104,330,553,57,45,3550,2100,3100,1800,5950,7175,0
593,2,0,109.0,90.0,140.0,149.0,2653,2362,2295,1735,358,627,1523,711,1145,103,378,608,57,45,4400,2375,3100,1900,5950,7225,0
600,2,0,114.0,79.0,140.0,149.0,2815,2390,2211,1763,604,627,1509,851,1055,163,454,688,57,45,4300,1875,3100,1900,6050,8100,0
607,2,0,112.0,80.0,140.0,149.0,2787,2457,2183,1763,604,694,1837,762,1315,44,522,718,57,44,4350,1825,3100,1900,6300,8300,0
614,2,0,126.0,76.0,140.0,149.0,2765,1835,2183,1231,582,604,1174,777,780,24,394,753,58,39,4650,2200,3100,1900,6400,8700,0
7,0,2,13.0,13.0,15.0,15.0,251,293,251,293,0,0,30,35,30,35,0,0,12,12,0,0,0,0,0,0,1
14,0,2,14.0,14.0,15.0,15.0,671,671,671,671,0,0,70,70,70,70,0,0,13,13,0,0,0,0,0,0,1
21,0,2,14.0,14.0,15.0,15.0,727,727,727,727,0,0,50,45,50,45,0,0,13,13,0,0,0,0,0,0,1
29,0,2,15.0,15.0,15.0,15.0,727,727,727,727,0,0,85,85,85,85,0,0,14,14,0,0,0,0,0,0,1
36,0,2,15.0,15.0,15.0,15.0,783,755,783,755,0,0,135,175,135,175,0,0,14,14,0,0,0,0,0,0,1
43,0,2,16.0,16.0,23.0,23.0,811,755,811,755,0,0,75,170,75,170,0,0,15,15,0,0,0,0,0,0,1
50,0,2,16.0,17.0,23.0,23.0,783,839,783,839,0,0,40,45,40,45,0,0,15,16,0,0,0,0,0,0,1
57,0,2,17.0,18.0,23.0,23.0,755,839,755,839,0,0,85,0,85,0,0,0,16,17,0,0,0,0,0,0,1
64,0,2,18.0,18.0,23.0,23.0,839,895,839,895,0,0,190,105,190,105,0,0,17,18,0,0,0,0,0,0,1
71,0,2,18.0,18.0,23.0,23.0,833,923,811,923,22,0,284,220,280,220,4,0,17,18,0,0,0,0,0,0,1
79,0,2,19.0,18.0,23.0,31.0,978,956,867,867,111,89,355,341,335,325,20,16,18,18,0,0,0,0,0,0,1
86,0,2,19.0,18.0,23.0,31.0,962,995,783,839,179,156,470,452,430,420,40,32,18,18,0,0,0,0,0,0,1
93,0,2,20.0,18.0,23.0,31.0,1023,995,867,839,156,156,341,347,335,295,6,52,19,18,0,0,150,0,0,0,1
100,0,2,20.0,18.0,23.0,31.0,995,973,839,839,156,134,61,318,35,250,26,68,19,18,0,0,150,150,0,0,1
107,0,2,20.0,20.0,23.0,31.0,1023,1074,867,895,156,179,176,333,130,245,46,88,19,18,0,0,150,150,0,0,1
114,0,2,20.0,20.0,23.0,31.0,1023,1074,867,895,156,179,291,458,225,350,66,108,19,18,0,0,150,150,0,0,1
121,0,2,21.0,20.0,23.0,31.0,967,1012,811,811,156,201,261,472,175,340,86,132,19,18,0,0,150,150,0,0,1
129,0,2,21.0,20.0,23.0,31.0,1158,1012,979,699,179,313,296,592,240,420,56,172,20,18,100,0,150,150,0,0,1
136,0,2,22.0,20.0,23.0,31.0,1247,1006,1091,671,156,335,222,707,150,495,72,212,20,18,100,100,150,300,0,0,1
143,0,2,22.0,22.0,31.0,39.0,1107,1085,951,727,156,358,212,637,120,435,92,202,21,18,100,100,150,450,0,0,1
150,0,2,23.0,22.0,31.0,39.0,1051,1040,895,727,156,313,167,759,55,525,112,234,21,18,100,100,150,450,0,0,1
157,0,2,24.0,24.0,31.0,39.0,1107,1040,951,727,156,313,252,754,120,505,132,249,22,18,100,100,150,450,0,0,1
164,0,2,26.0,24.0,31.0,39.0,1079,1012,923,699,156,313,297,874,145,585,152,289,22,18,100,200,250,450,0,0,1
171,0,2,27.0,26.0,46.0,39.0,1158,956,979,643,179,313,237,769,65,465,172,304,23,18,100,200,250,450,0,0,1
179,0,2,27.0,26.0,46.0,39.0,1102,1012,923,699,179,313,232,899,40,555,192,344,23,18,200,200,525,450,0,0,1
186,0,2,28.0,26.0,46.0,39.0,1247,1085,1091,727,156,358,123,1024,40,640,83,384,24,18,200,325,675,450,0,0,1
193,0,2,30.0,29.0,46.0,47.0,1135,1062,979,727,156,335,88,960,10,565,78,395,25,18,200,325,675,450,0,0,1
200,0,2,32.0,29.0,46.0,47.0,1275,1040,1119,727,156,313,143,1046,45,615,98,431,25,18,200,325,675,450,0,0,1
207,0,2,34.0,32.0,46.0,47.0,1443,1040,1287,727,156,313,33,886,15,465,18,421,26,19,250,450,850,450,0,0,1
214,0,2,36.0,33.0,46.0,47.0,1891,1102,1735,811,156,291,143,967,130,510,13,457,27,20,300,450,925,450,0,0,1
221,0,2,36.0,35.0,46.0,47.0,1858,1068,1679,755,179,313,153,917,120,445,33,472,28,20,300,575,925,450,0,0,1
229,0,2,40.0,36.0,46.0,55.0,2082,1102,1903,811,179,291,198,898,170,390,28,508,28,21,350,575,925,450,0,0,1
236,0,2,44.0,36.0,46.0,55.0,1919,1090,1763,755,156,335,159,983,140,435,19,548,28,21,475,750,925,450,0,0,1
243,0,2,44.0,39.0,62.0,55.0,1947,1124,1791,811,156,313,289,984,250,425,39,559,28,22,475,750,925,450,0,0,1
250,0,2,50.0,40.0,62.0,55.0,1919,1096,1763,783,156,313,204,1069,170,470,34,599,30,23,700,875,925,450,0,0,1
257,0,2,50.0,39.0,62.0,55.0,2115,1124,1959,811,156,313,249,1169,245,530,4,639,30,22,825,1000,925,600,0,50,1
264,0,2,52.0,42.0,62.0,55.0,2082,1146,1903,811,179,335,399,1189,375,535,24,654,32,23,925,1125,925,600,0,50,1
271,0,2,57.0,42.0,70.0,55.0,1886,1174,1707,839,179,335,224,1334,205,640,19,694,32,24,1050,1125,925,600,0,50,1
279,0,2,59.0,44.0,70.0,55.0,1723,1202,1567,867,156,335,230,1355,195,650,35,705,34,24,1050,1250,925,600,0,50,1
286,0,2,63.0,44.0,70.0,55.0,1919,1286,1763,951,156,335,110,1520,105,775,5,745,34,24,1200,1250,925,600,0,50,1
293,0,2,67.0,44.0,78.0,55.0,1947,1208,1791,895,156,313,315,1661,290,880,25,781,36,24,1325,1250,925,600,0,50,1
300,0,2,69.0,44.0,86.0,55.0,2059,1264,1903,951,156,313,115,1821,70,1000,45,821,38,24,1325,1250,925,600,0,50,1
307,0,2,69.0,44.0,86.0,55.0,2283,1258,2127,923,156,335,150,1976,85,1115,65,861,38,24,1550,1250,925,600,0,50,1
314,0,2,75.0,44.0,86.0,55.0,2418,1342,2239,1007,179,335,120,2131,85,1230,35,901,40,24,1675,1250,925,600,0,50,1
321,0,2,77.0,44.0,86.0,55.0,2390,1286,2211,951,179,335,195,2277,140,1340,55,937,40,24,1675,1250,925,600,0,50,1
329,0,2,79.0,44.0,86.0,55.0,2367,1342,2211,1007,156,335,486,2437,415,1460,71,977,42,24,1675,1250,925,600,0,50,1
336,0,2,81.0,38.0,86.0,55.0,2496,1264,2295,951,201,313,334,2463,285,1475,49,988,44,24,1700,775,925,600,325,525,1
343,0,2,78.0,28.0,86.0,55.0,2513,1320,2155,1007,358,313,632,2438,535,1460,97,978,44,24,1525,125,925,600,500,1300,1
350,0,2,77.0,28.0,86.0,55.0,2602,1029,2043,783,559,246,683,2326,610,1370,73,956,46,23,1425,175,925,600,600,1475,1
357,0,2,83.0,28.0,86.0,55.0,2602,1012,1931,699,671,313,628,2446,525,1450,103,996,46,23,1775,175,925,600,600,1475,1
364,0,2,85.0,30.0,86.0,55.0,2714,1046,2043,755,671,291,644,2407,565,1425,79,982,46,24,1775,350,925,600,600,1475,1
371,0,2,85.0,30.0,86.0,55.0,2558,1202,1931,867,627,335,921,2557,770,1535,151,1022,46,24,1775,525,925,600,600,1475,1
379,0,2,91.0,30.0,101.0,55.0,2446,1286,1819,951,627,335,266,2702,135,1640,131,1062,48,24,2125,525,925,600,600,1475,1
386,0,2,91.0,33.0,101.0,55.0,2384,1230,1735,895,649,335,246,2528,135,1455,111,1073,48,24,2125,650,925,600,600,1475,1
393,0,2,93.0,33.0,101.0,55.0,2384,1130,1735,839,649,291,181,2005,140,900,41,1105,48,24,2225,650,1175,600,600,1475,1
400,0,2,99.0,35.0,117.0,55.0,2328,1214,1679,923,649,291,357,2035,240,915,117,1120,48,25,2475,775,1175,600,600,1475,1
407,0,2,99.0,37.0,117.0,63.0,2457,1292,1763,979,694,313,657,2080,460,920,197,1160,48,25,2475,775,1175,600,600,1475,1
414,0,2,101.0,37.0,117.0,63.0,2742,1264,2071,951,671,313,458,2230,285,1030,173,1200,50,25,2575,875,1175,600,600,1475,1
421,0,2,107.0,39.0,117.0,63.0,2670,1370,2043,1035,627,335,385,2045,190,905,195,1140,50,25,2825,875,1175,900,600,1475,1
429,0,2,109.0,31.0,117.0,63.0,2810,1286,2183,951,627,335,665,2195,390,1015,275,1180,52,25,2775,325,1425,900,675,2125,1
436,0,2,111.0,33.0,117.0,63.0,2888,1314,2239,979,649,335,630,1876,275,860,355,1016,54,25,2875,325,1425,900,675,2125,1
443,0,2,117.0,33.0,125.0,63.0,3442,1264,2771,951,671,313,380,1777,145,825,235,952,55,25,3125,500,1550,900,675,2125,1
450,0,2,117.0,35.0,125.0,63.0,3442,1258,2771,923,671,335,611,1762,300,820,311,942,57,25,3125,675,1550,900,675,2125,1
457,0,2,123.0,35.0,125.0,63.0,3358,1230,2687,895,671,335,397,1757,60,775,337,982,57,25,3225,675,1550,900,675,2125,1
464,0,2,125.0,37.0,125.0,63.0,3308,1264,2659,951,649,313,683,1588,270,620,413,968,57,25,3225,850,1800,1150,675,2125,1
471,0,2,130.0,42.0,149.0,78.0,3342,1107,2715,839,627,268,734,1356,445,535,289,821,57,25,3625,850,1800,1150,675,2125,1
479,0,2,133.0,43.0,157.0,78.0,3398,794,2771,503,627,291,334,1366,140,505,194,861,60,26,3975,1000,1800,1150,675,2125,1
486,0,2,135.0,46.0,157.0,78.0,3476,1230,2827,895,649,335,284,1217,85,445,199,772,60,27,3975,1000,1800,1700,675,2125,1
493,0,2,142.0,49.0,157.0,78.0,3644,1426,2995,1091,649,335,435,1247,185,435,250,812,63,29,3975,1275,1800,1700,675,2125,1
500,0,2,144.0,51.0,157.0,78.0,3403,1544,2687,1231,716,313,824,1103,490,305,334,798,65,29,3975,1275,1800,2000,675,2125,1
507,0,2,145.0,53.0,172.0,86.0,3554,1516,2659,1203,895,313,1131,1233,685,395,446,838,66,31,4600,1450,1800,2000,675,2125,1
514,0,2,150.0,56.0,172.0,86.0,3543,1650,2603,1315,940,335,559,1168,105,340,454,828,69,32,4725,1550,2300,2000,675,2125,1
521,0,2,154.0,57.0,172.0,86.0,3655,1572,2715,1259,940,313,714,1304,165,440,549,864,69,33,4725,1725,2300,2000,675,2125,1
529,0,2,157.0,60.0,172.0,94.0,3846,1656,2883,1343,963,313,549,1174,205,295,344,879,72,34,4725,1725,2375,2000,675,2125,1
536,0,2,165.0,61.0,172.0,94.0,4260,1678,3275,1343,985,335,419,1179,155,260,264,919,74,35,4950,1850,2375,2000,675,2125,1
543,0,2,172.0,63.0,172.0,94.0,4204,1796,3219,1483,985,313,135,1350,130,395,5,955,75,37,5075,1850,2375,2000,675,2125,1
550,0,2,172.0,63.0,172.0,94.0,4338,1802,3331,1511,1007,291,407,1506,290,515,117,991,78,37,5075,1850,2475,2000,675,2125,1
557,0,2,172.0,65.0,172.0,94.0,4400,1936,3415,1623,985,313,538,1701,305,670,233,1031,78,39,5175,1850,2475,2000,675,2125,1
564,0,2,172.0,65.0,172.0,94.0,4159,1936,3219,1623,940,313,735,1941,390,870,345,1071,78,40,5575,1850,2775,2300,675,2125,1
571,0,2,172.0,65.0,172.0,94.0,3907,1936,2967,1623,940,313,800,2172,510,1065,290,1107,78,41,6400,1850,2775,2300,675,2125,1
579,0,2,180.0,65.0,180.0,94.0,3902,2065,2939,1707,963,358,505,2417,370,1270,135,1147,78,41,6400,1850,2775,2300,675,2125,1
586,0,2,185.0,65.0,219.0,94.0,4142,2014,3135,1679,1007,335,625,2583,520,1400,105,1183,78,41,6400,1850,2850,2300,675,2125,1
593,0,2,187.0,65.0,219.0,94.0,4053,2020,3023,1707,1030,313,696,2754,475,1535,221,1219,81,41,6400,1850,2850,2300,675,2125,1
600,0,2,192.0,65.0,219.0,94.0,3918,1992,2911,1679,1007,313,558,3004,425,1745,133,1259,81,41,6600,1850,2850,2300,675,2125,1
607,0,2,192.0,67.0,219.0,94.0,3767,2020,2827,1707,940,313,841,3154,600,1855,241,1299,83,41,7000,1850,3200,2300,675,2125,1
614,0,2,200.0,68.0,219.0,94.0,3823,2020,2883,1595,940,425,861,3309,550,1950,311,1359,83,42,7325,1850,3500,2300,675,2125,1
621,0,2,200.0,70.0,219.0,94.0,3846,2121,2883,1539,963,582,1026,3530,745,2095,281,1435,83,44,7325,1850,3500,2300,675,2125,1
629,0,2,200.0,70.0,219.0,94.0,3840,2238,2855,1567,985,671,1466,3805,1065,2290,401,1515,83,45,7925,1850,3500,2300,675,2125,1
636,0,2,200.0,70.0,219.0,94.0,3896,2300,2911,1651,985,649,1362,4076,920,2485,442,1591,83,46,8175,1850,3500,2300,675,2125,1
643,0,2,200.0,70.0,219.0,94.0,3969,2356,2939,1707,1030,649,1683,4362,1125,2695,558,1667,83,46,8175,1850,3500,2300,675,2125,1
650,0,2,200.0,70.0,219.0,94.0,4142,2434,3135,1763,1007,671,2179,4647,1505,2900,674,1747,83,46,8175,1850,3500,2300,675,2125,1
657,0,2,200.0,74.0,219.0,94.0,4383,2440,3443,1791,940,649,2197,4003,1665,2480,532,1523,83,46,8175,1850,3875,2300,675,2125,1
664,0,2,200.0,74.0,234.0,94.0,4495,2306,3555,1679,940,627,2752,3724,2100,2375,652,1349,83,46,8175,1850,3875,2300,675,2125,1
671,0,2,200.0,76.0,234.0,94.0,4378,2272,3415,1623,963,649,3272,3699,2500,2370,772,1329,83,46,8175,1950,3975,2300,675,2125,1
679,0,2,200.0,74.0,234.0,94.0,4534,2278,3527,1651,1007,627,3822,3162,2930,2115,892,1047,83,46,8175,1775,3975,2300,675,2300,1
686,0,2,199.0,57.0,234.0,94.0,4400,2104,3415,1567,985,537,4353,2452,3345,1695,1008,757,83,45,8125,675,3975,2300,725,3825,1
693,0,2,199.0,57.0,234.0,102.0,4534,2171,3527,1567,1007,604,4858,2727,3744,1890,1114,837,83,45,8125,675,4125,2300,725,3825,1
700,0,2,199.0,59.0,234.0,102.0,4372,2294,3387,1623,985,671,5344,2902,4122,1985,1222,917,83,45,8125,825,4125,2300,725,3825,1
707,0,2,198.0,61.0,234.0,102.0,4243,2238,3303,1567,940,671,4222,3063,2895,2070,1327,993,83,45,8075,925,4125,2450,775,3825,1
714,0,2,196.0,59.0,249.0,102.0,3935,2261,2995,1567,940,694,3854,2558,2411,1635,1443,923,83,45,7800,775,4125,3100,1050,4075,1
720,0,2,196.0,52.0,249.0,102.0,4025,2138,2995,1511,1030,627,4226,2285,2691,1535,1535,750,83,44,7800,200,4125,2950,1050,5025,1
7,2,2,13.0,13.0,15.0,15.0,377,251,377,251,0,0,45,30,45,30,0,0,12,12,0,0,0,0,0,0,0
14,2,2,14.0,14.0,15.0,15.0,671,671,671,671,0,0,70,70,70,70,0,0,13,13,0,0,0,0,0,0,0
21,2,2,14.0,14.0,15.0,15.0,699,727,699,727,0,0,50,45,50,45,0,0,13,13,0,0,0,0,0,0,0
29,2,2,15.0,14.0,15.0,15.0,727,755,727,755,0,0,45,135,45,135,0,0,14,14,0,0,0,0,0,0,0
36,2,2,16.0,14.0,23.0,15.0,811,839,811,839,0,0,145,165,145,165,0,0,15,14,0,0,0,0,0,0,0
43,2,2,16.0,14.0,23.0,23.0,867,783,867,783,0,0,90,95,90,95,0,0,15,14,0,0,0,0,0,0,0
50,2,2,17.0,14.0,23.0,23.0,895,755,895,755,0,0,70,80,70,80,0,0,16,14,0,0,0,0,0,0,0
57,2,2,18.0,14.0,23.0,23.0,923,727,923,727,0,0,10,165,10,165,0,0,17,14,0,0,0,0,0,0,0
64,2,2,18.0,14.0,23.0,31.0,1007,799,1007,755,0,44,120,263,120,255,0,8,17,14,0,0,0,0,0,0,0
71,2,2,19.0,14.0,23.0,31.0,945,799,923,643,22,156,24,363,20,335,4,28,18,14,0,0,0,0,0,0,0
79,2,2,20.0,14.0,23.0,31.0,1018,799,951,643,67,156,102,374,90,330,12,44,19,14,0,0,0,0,0,0,0
86,2,2,21.0,15.0,23.0,31.0,1040,855,951,699,89,156,79,429,55,365,24,64,20,14,0,0,150,0,0,0,0
93,2,2,22.0,16.0,23.0,31.0,1057,850,923,671,134,179,145,319,105,235,40,84,21,15,0,0,150,150,0,0,0
100,2,2,22.0,17.0,23.0,31.0,1130,906,951,727,179,179,134,374,70,270,64,104,21,16,0,0,150,150,0,0,0
107,2,2,23.0,18.0,23.0,31.0,1191,799,923,531,268,268,276,415,180,275,96,140,22,17,0,0,150,150,0,0,0
114,2,2,23.0,18.0,31.0,31.0,1180,1006,867,671,313,335,362,485,230,305,132,180,22,17,0,0,150,150,0,0,0
121,2,2,28.0,19.0,31.0,31.0,1180,934,867,643,313,291,53,592,35,380,18,212,23,18,0,0,450,150,0,0,0
129,2,2,29.0,20.0,31.0,31.0,1236,1012,923,699,313,313,163,562,105,360,58,202,24,19,0,0,450,300,0,0,0
136,2,2,29.0,22.0,31.0,31.0,1208,1012,895,699,313,313,208,507,110,315,98,192,24,19,0,0,450,300,0,0,0
143,2,2,30.0,22.0,31.0,31.0,1208,1090,895,755,313,335,308,632,170,400,138,232,25,20,0,0,450,300,0,0,0
150,2,2,30.0,22.0,31.0,31.0,1258,1169,923,811,335,358,463,782,285,510,178,272,25,20,0,0,450,300,0,0,0
157,2,2,34.0,22.0,39.0,31.0,1309,1124,951,811,358,313,318,909,300,605,18,304,26,20,350,0,450,300,0,0,0
164,2,2,34.0,22.0,39.0,31.0,1286,1124,951,811,335,313,74,1044,20,700,54,344,26,20,350,175,450,300,0,0,0
171,2,2,35.0,22.0,39.0,31.0,1264,1124,951,811,313,313,175,1189,85,805,90,384,26,20,350,175,450,300,0,0,0
179,2,2,36.0,22.0,39.0,31.0,1292,1068,979,755,313,313,190,1319,60,895,130,424,27,20,350,175,450,300,0,0,0
186,2,2,38.0,22.0,39.0,31.0,1264,1146,951,811,313,335,90,1464,20,1000,70,464,27,20,650,175,450,300,0,0,0
193,2,2,39.0,22.0,39.0,31.0,1376,1118,1063,783,313,335,210,1590,100,1090,110,500,28,20,650,175,450,300,0,0,0
200,2,2,40.0,22.0,47.0,31.0,1376,1180,1063,867,313,313,71,1746,25,1210,46,536,29,20,650,175,450,300,0,0,0
207,2,2,40.0,22.0,47.0,31.0,1426,1152,1091,839,335,313,191,1871,105,1295,86,576,29,20,800,175,450,300,0,0,0
214,2,2,41.0,22.0,47.0,31.0,1432,1180,1119,867,313,313,257,2016,135,1400,122,616,30,20,800,175,550,300,0,0,0
221,2,2,42.0,22.0,47.0,31.0,1342,1174,1007,839,335,335,412,2151,250,1495,162,656,31,20,800,175,550,300,0,0,0
229,2,2,43.0,22.0,47.0,31.0,1258,1096,923,783,335,313,507,2277,305,1585,202,692,32,20,800,175,550,300,0,0,0
236,2,2,49.0,22.0,62.0,31.0,1432,1118,1119,783,313,335,233,2407,95,1675,138,732,33,20,1150,175,800,300,0,0,0
243,2,2,49.0,22.0,62.0,31.0,1510,1146,1175,811,335,335,48,2542,20,1770,28,772,33,20,1150,175,800,300,0,0,0
250,2,2,51.0,22.0,62.0,31.0,1650,1068,1315,755,335,313,218,2658,150,1850,68,808,35,20,1150,175,800,300,0,0,0
257,2,2,52.0,22.0,62.0,31.0,1830,1118,1539,783,291,335,230,2803,130,1955,100,848,36,20,1150,175,800,300,0,0,0
264,2,2,57.0,22.0,62.0,31.0,1936,1068,1623,755,313,313,120,2919,80,2035,40,884,37,20,1500,175,800,300,0,0,0
271,2,2,58.0,22.0,62.0,31.0,1936,1068,1623,755,313,313,260,3054,180,2130,80,924,38,20,1500,175,800,300,0,0,0
279,2,2,59.0,22.0,62.0,31.0,1992,1068,1679,755,313,313,400,3179,280,2215,120,964,39,20,1500,175,800,300,0,0,0
286,2,2,60.0,22.0,62.0,31.0,2048,1062,1735,727,313,335,200,3319,40,2315,160,1004,41,20,1500,175,950,300,0,0,0
293,2,2,61.0,22.0,70.0,31.0,2149,1141,1791,783,358,358,225,3444,125,2400,100,1044,41,20,1500,175,950,300,0,0,0
300,2,2,65.0,22.0,70.0,31.0,2238,1068,1903,755,335,313,196,3571,110,2495,86,1076,43,20,1675,175,950,300,0,0,0
307,2,2,68.0,22.0,70.0,31.0,2244,1012,1931,699,313,313,97,3701,25,2585,72,1116,44,20,1850,175,950,300,0,0,0
314,2,2,69.0,22.0,70.0,31.0,2272,1096,1959,783,313,313,377,3836,265,2680,112,1156,45,20,1850,175,950,300,0,0,0
321,2,2,70.0,22.0,78.0,31.0,2278,1068,1987,755,291,313,234,3961,90,2765,144,1196,46,20,1850,175,950,300,0,0,0
329,2,2,75.0,22.0,78.0,31.0,2250,1141,1959,783,291,358,159,4096,75,2860,84,1236,47,20,1850,175,950,300,0,0,0
336,2,2,77.0,24.0,78.0,31.0,2356,1090,2043,755,313,335,340,4027,220,2755,120,1272,49,20,2200,175,950,300,0,0,0
343,2,2,78.0,25.0,78.0,31.0,2356,962,2043,671,313,291,266,3829,110,2625,156,1204,50,20,2200,275,950,300,0,0,0
350,2,2,78.0,26.0,78.0,31.0,2395,1012,2127,699,268,313,243,3919,55,2675,188,1244,51,21,2200,275,950,300,0,0,0
357,2,2,81.0,27.0,93.0,39.0,2390,1068,2099,755,291,313,124,4004,0,2720,124,1284,52,22,2200,275,950,300,0,0,0
364,2,2,81.0,27.0,93.0,39.0,2580,1169,2267,811,313,358,290,4089,130,2765,160,1324,52,22,2200,275,950,300,0,0,0
371,2,2,83.0,26.0,93.0,39.0,2754,1174,2463,839,291,335,366,4085,170,2725,196,1360,55,23,2200,100,1250,300,0,175,0
379,2,2,84.0,27.0,93.0,39.0,3028,1180,2715,867,313,313,431,4226,195,2830,236,1396,55,24,2200,100,1250,300,0,175,0
386,2,2,87.0,27.0,93.0,39.0,3090,1264,2799,951,291,313,642,4381,370,2945,272,1436,58,25,2200,100,1400,550,0,175,0
393,2,2,93.0,30.0,101.0,47.0,2910,1264,2575,951,335,313,352,4326,190,2925,162,1401,58,25,2200,100,1700,550,0,175,0
400,2,2,95.0,30.0,101.0,47.0,3174,1286,2659,951,515,335,564,4486,380,3045,184,1441,61,25,2900,100,1850,550,0,175,0
407,2,2,101.0,30.0,101.0,47.0,3274,1236,2603,923,671,313,250,4532,90,3130,160,1402,61,25,3250,200,2100,550,0,175,0
414,2,2,103.0,31.0,109.0,47.0,3370,1342,2743,1007,627,335,97,4707,65,3265,32,1442,61,25,3250,300,2250,550,0,175,0
421,2,2,105.0,31.0,109.0,47.0,3448,1286,2799,951,649,335,342,4452,280,2970,62,1482,61,25,3600,300,2250,550,0,175,0
429,2,2,107.0,31.0,117.0,47.0,3526,1236,2855,923,671,313,583,4603,495,3085,88,1518,61,25,4025,300,2400,550,0,175,0
436,2,2,107.0,31.0,125.0,47.0,3448,1258,2799,923,649,335,879,4758,715,3200,164,1558,61,25,4025,400,2400,550,0,175,0
443,2,2,109.0,31.0,125.0,47.0,3342,1264,2715,951,627,313,785,4914,545,3320,240,1594,61,25,4025,400,2400,550,0,175,0
450,2,2,122.0,33.0,125.0,47.0,3280,1292,2631,979,649,313,90,4889,70,3305,20,1584,61,25,4900,400,2400,550,0,175,0
457,2,2,122.0,33.0,133.0,47.0,3392,1398,2743,1063,649,335,485,5054,385,3430,100,1624,64,25,5075,575,2400,550,0,175,0
464,2,2,125.0,33.0,133.0,47.0,3330,1258,2659,923,671,335,736,5194,560,3530,176,1664,64,25,5075,575,2400,550,0,175,0
471,2,2,133.0,33.0,133.0,47.0,3258,1286,2631,951,627,335,328,5335,280,3635,48,1700,64,25,5600,575,2400,550,0,175,0
479,2,2,133.0,31.0,133.0,47.0,3392,1236,2743,923,649,313,733,5206,605,3520,128,1686,67,25,5775,550,2400,550,0,775,0
486,2,2,133.0,23.0,133.0,47.0,3286,1191,2659,923,627,268,819,5298,615,3580,204,1718,67,20,5775,200,2400,550,0,1375,0
493,2,2,140.0,8.0,141.0,55.0,3062,822,2435,643,627,179,749,5323,565,3585,184,1738,67,5,5775,200,2400,550,0,2125,0
500,2,2,140.0,4.0,149.0,55.0,3134,127,2463,83,671,44,1134,5328,870,3590,264,1738,70,1,5975,200,2400,550,0,2375,0
7,1,1,13.0,13.0,14.0,14.0,377,377,377,377,0,0,45,45,45,45,0,0,12,12,0,0,0,0,0,0,1
14,1,1,13.0,13.0,14.0,14.0,699,671,699,671,0,0,25,20,25,20,0,0,13,13,0,0,0,0,0,0,1
21,1,1,14.0,14.0,14.0,14.0,727,727,727,727,0,0,55,55,55,55,0,0,13,13,0,0,0,0,0,0,1
29,1,1,14.0,14.0,14.0,14.0,755,811,755,811,0,0,155,155,155,155,0,0,13,13,0,0,0,0,0,0,1
36,1,1,16.0,16.0,22.0,22.0,755,783,755,783,0,0,145,145,145,145,0,0,14,14,0,0,0,0,0,0,1
43,1,1,16.0,16.0,22.0,22.0,811,783,811,783,0,0,245,235,245,235,0,0,16,16,0,0,0,0,0,0,1
50,1,1,15.0,15.0,22.0,22.0,811,811,811,811,0,0,35,35,35,35,0,0,15,15,0,0,0,0,0,0,1
57,1,1,17.0,17.0,22.0,22.0,839,839,839,839,0,0,45,40,45,40,0,0,15,15,0,0,0,0,0,0,1
64,1,1,18.0,18.0,22.0,22.0,895,923,895,923,0,0,95,90,95,90,0,0,16,16,0,0,0,0,0,0,1
71,1,1,17.0,17.0,22.0,22.0,923,895,923,895,0,0,185,175,185,175,0,0,17,17,0,0,0,0,0,0,1
79,1,1,17.0,17.0,22.0,22.0,923,951,923,951,0,0,45,40,45,40,0,0,16,16,0,0,0,0,0,0,1
86,1,1,18.0,18.0,22.0,22.0,979,979,979,979,0,0,115,100,115,100,0,0,16,16,0,0,0,0,0,0,1
93,1,1,19.0,19.0,22.0,22.0,917,979,895,979,22,0,169,165,165,165,4,0,18,18,0,0,0,0,0,0,1
100,1,1,20.0,20.0,22.0,22.0,978,1006,867,895,111,111,235,235,215,215,20,20,19,19,0,0,0,0,0,0,1
107,1,1,20.0,20.0,22.0,22.0,1051,1102,895,923,156,179,370,360,330,320,40,40,19,19,0,0,0,0,0,0,1
114,1,1,21.0,20.0,22.0,22.0,1079,1102,923,923,156,179,450,490,390,430,60,60,20,20,0,0,0,0,0,0,1
121,1,1,26.0,26.0,28.0,28.0,1135,1130,979,951,156,179,135,225,55,145,80,80,20,20,0,0,250,250,0,0,1
129,1,1,26.0,26.0,28.0,28.0,1186,1107,1007,951,179,156,275,261,175,165,100,96,21,20,0,0,250,250,0,0,1
136,1,1,28.0,28.0,28.0,28.0,1169,1163,1035,1007,134,156,107,101,95,85,12,16,21,21,0,0,250,250,0,0,1
143,1,1,30.0,30.0,36.0,36.0,1230,1141,1119,1007,111,134,144,137,120,105,24,32,23,22,50,50,250,250,0,0,1
150,1,1,30.0,30.0,36.0,36.0,1225,1258,1091,1147,134,111,300,299,260,255,40,44,23,23,50,50,250,250,0,0,1
157,1,1,30.0,32.0,36.0,36.0,1258,1230,1147,1119,111,111,92,340,40,280,52,60,24,24,350,350,250,250,0,0,1
164,1,1,33.0,32.0,36.0,36.0,1320,1309,1231,1175,89,134,109,151,45,75,64,76,24,24,350,400,250,250,0,0,1
171,1,1,32.0,31.0,36.0,36.0,1342,1314,1231,1203,111,111,120,58,90,20,30,38,24,24,350,400,250,250,0,0,1
179,1,1,33.0,33.0,36.0,36.0,1426,1398,1315,1287,111,111,142,139,100,85,42,54,26,25,400,400,250,250,0,0,1
186,1,1,35.0,36.0,36.0,36.0,1454,1505,1343,1371,111,134,218,110,160,40,58,70,26,25,400,400,250,250,0,0,1
193,1,1,39.0,40.0,44.0,44.0,1566,1561,1455,1427,111,134,200,91,130,5,70,86,27,27,400,400,250,250,0,0,1
200,1,1,41.0,41.0,44.0,44.0,1477,1555,1343,1399,134,156,166,136,80,30,86,106,30,28,400,400,250,250,0,0,1
207,1,1,42.0,43.0,44.0,44.0,1566,1746,1455,1567,111,179,143,231,45,105,98,126,30,30,400,500,250,250,0,0,1
214,1,1,45.0,44.0,52.0,44.0,1695,1695,1539,1539,156,156,203,287,85,145,118,142,32,31,500,500,450,450,0,0,1
221,1,1,47.5,48.0,52.0,52.0,1807,1779,1651,1623,156,156,259,252,125,90,134,162,34,31,475,700,450,450,25,0,1
229,1,1,51.5,52.0,58.0,52.0,1807,1807,1651,1651,156,156,79,262,25,80,54,182,35,32,475,700,575,450,25,0,1
236,1,1,53.5,51.0,58.0,58.0,1975,1863,1819,1707,156,156,124,212,50,110,74,102,41,37,475,700,575,450,25,0,1
243,1,1,56.5,51.0,58.0,58.0,2031,1835,1875,1679,156,156,224,127,130,105,94,22,42,40,625,700,575,575,25,0,1
250,1,1,57.5,52.0,58.0,58.0,2115,1914,1959,1735,156,179,314,107,200,65,114,42,45,39,625,700,575,575,25,0,1
257,1,1,59.5,57.0,66.0,66.0,2334,2026,2155,1847,179,179,59,102,25,40,34,62,46,39,625,700,575,575,25,0,1
264,1,1,59.5,58.0,66.0,66.0,2362,2132,2183,1931,179,201,94,141,40,55,54,86,45,41,625,700,575,575,25,0,1
271,1,1,62.5,61.0,74.0,66.0,2395,2188,2239,1875,156,313,235,261,165,135,70,126,49,45,625,700,575,575,25,0,1
279,1,1,66.5,63.0,74.0,66.0,2647,2356,2491,2043,156,313,275,347,185,185,90,162,50,48,675,700,575,575,25,0,1
286,1,1,70.0,62.0,82.0,74.0,2642,2440,2463,2127,179,313,389,487,275,310,114,177,52,50,650,700,575,775,50,0,1
293,1,1,74.0,64.0,82.0,82.0,2692,2496,2379,2183,313,313,148,437,90,320,58,117,56,50,650,650,775,1025,50,50,1
300,1,1,73.0,74.0,90.0,82.0,2843,2686,2351,2239,492,447,388,173,270,125,118,48,60,51,650,700,775,1025,50,50,1
307,1,1,74.0,80.0,90.0,82.0,3011,2726,2519,2211,492,515,318,179,140,150,178,29,62,54,650,700,775,1025,50,50,1
314,1,1,75.0,82.0,98.0,82.0,3185,2882,2715,2211,470,671,519,332,285,240,234,92,63,54,650,700,1025,1025,50,50,1
321,1,1,78.0,83.0,106.0,90.0,3297,3045,2715,2239,582,806,664,403,354,290,310,113,63,54,650,1200,1025,1025,50,50,1
329,1,1,78.5,88.5,106.0,90.0,3330,3101,2659,2295,671,806,758,140,414,124,344,16,64,53,625,1475,1025,1025,75,99,1
336,1,1,86.5,92.5,114.0,98.0,3353,2961,2435,2155,918,806,523,295,234,229,289,66,66,53,775,1575,1025,1025,75,99,1
343,1,1,96.5,100.5,114.0,114.0,3504,2989,2519,2183,985,806,393,156,84,94,309,62,66,53,875,1875,1150,1025,75,99,1
350,1,1,96.5,106.5,122.0,114.0,3666,3011,2659,2183,1007,828,744,201,319,114,425,87,66,53,875,1975,1150,1025,75,99,1
357,1,1,110.5,113.5,122.0,114.0,3722,3011,2715,2183,1007,828,470,172,104,89,366,83,66,52,1475,2375,1150,1025,75,149,1
364,1,1,118.0,119.0,130.0,122.0,3627,2961,2687,2155,940,806,413,214,39,114,374,100,66,52,1550,2600,1150,1375,100,149,1
371,1,1,122.0,121.0,130.0,122.0,3678,3045,2715,2239,963,806,598,124,204,24,394,100,66,52,1600,3000,1150,1375,200,149,1
379,1,1,127.0,120.5,138.0,122.0,3616,2966,2631,2183,985,783,423,386,109,194,314,192,65,52,2300,3175,1150,1375,200,174,1
386,1,1,129.0,119.0,138.0,122.0,3482,3106,2519,2323,963,783,545,602,194,389,351,213,61,52,2700,3400,1150,1525,331,249,1
393,1,1,116.5,122.0,138.0,138.0,2720,2910,1959,2127,761,783,730,140,324,39,406,101,60,52,2675,2850,1150,1525,1206,899,1
400,1,1,122.0,114.0,152.0,146.0,2558,3073,1931,2267,627,806,438,166,114,94,324,72,60,52,2450,2250,1150,1675,1531,1499,1
407,1,1,121.0,122.0,152.0,146.0,2350,2994,1903,2211,447,783,411,124,114,64,297,60,53,52,2750,2450,1150,1675,1881,1499,1
414,1,1,123.0,122.0,152.0,146.0,2104,3028,1791,2267,313,761,361,271,99,169,262,102,53,52,2750,2850,1300,1675,2081,1849,1
421,1,1,115.0,115.0,152.0,146.0,2076,3028,1763,2267,313,761,306,138,79,94,227,44,51,52,2450,2550,1300,1675,2881,2549,1
429,1,1,117.0,118.0,152.0,146.0,2294,2910,1959,2127,335,783,291,139,99,74,192,65,51,52,2650,2650,1300,1675,3081,2749,1
436,1,1,117.0,122.0,152.0,146.0,2742,3056,2407,2295,335,761,312,107,159,54,153,53,51,53,2650,2850,1300,1675,3456,3099,1
443,1,1,110.0,114.0,152.0,146.0,2854,3050,2519,2267,335,783,247,168,154,94,93,74,50,54,2150,2250,1300,1675,4206,3799,1
450,1,1,104.0,102.0,152.0,146.0,2356,3084,2043,2323,313,761,98,226,69,139,29,87,48,54,1800,1550,1300,1525,4956,4849,1
457,1,1,105.0,104.0,152.0,146.0,2048,3140,1735,2379,313,761,198,318,129,214,69,104,46,54,2400,1850,1300,1375,5056,5199,1
464,1,1,110.0,108.0,152.0,146.0,2126,3022,1791,2239,335,783,148,209,39,159,109,50,46,54,2700,2150,1300,1375,5056,5299,1
471,1,1,113.0,118.0,152.0,146.0,2065,3162,1707,2379,358,783,247,101,94,84,153,17,51,54,2900,2250,1300,1375,5056,5299,1
479,1,1,117.0,122.0,152.0,146.0,2479,3056,1987,2295,492,761,47,268,34,209,13,59,53,54,2900,2550,1300,1525,5056,5299,1
486,1,1,123.0,122.0,152.0,146.0,2664,3078,2127,2295,537,783,80,301,74,162,6,139,55,54,2900,3050,1300,1525,5056,5323,1
493,1,1,134.0,128.0,152.0,146.0,2866,3067,2239,2239,627,828,26,221,19,82,7,139,55,54,2900,3450,1300,1525,5056,5323,1
500,1,1,138.0,128.0,152.0,146.0,2938,2994,2267,2211,671,783,181,128,144,47,37,81,55,53,3550,3450,1300,1525,5056,5423,1
507,1,1,142.0,136.0,146.0,146.0,3000,3123,2351,2295,649,828,227,103,164,22,63,81,55,60,3800,3450,1300,1675,5406,5423,1
514,1,1,146.0,137.0,146.0,146.0,2972,3045,2323,2239,649,806,363,339,274,187,89,152,55,59,4200,3550,1300,1675,5406,5423,1
521,1,1,141.0,139.0,154.0,146.0,2972,3325,2323,2519,649,806,323,550,304,327,19,223,54,59,4100,3550,1300,1675,5606,5423,1
529,1,1,144.0,145.0,146.0,146.0,2888,3269,2239,2463,649,806,414,520,344,272,70,248,54,59,4250,3950,1300,1525,5806,5573,1
536,1,1,146.0,145.0,154.0,146.0,2961,3235,2267,2407,694,828,663,406,534,162,129,244,54,59,4450,4150,1300,1525,5806,5573,1
543,1,1,155.0,147.0,162.0,154.0,2922,3157,2183,2351,739,806,306,587,239,297,67,290,55,59,4450,4150,1300,1525,5806,5573,1
550,1,1,158.0,161.0,162.0,178.0,3101,3364,2183,2491,918,873,487,185,304,87,183,98,55,59,4750,4450,1300,1525,5806,5573,1
557,1,1,160.5,164.0,170.0,186.0,3050,3420,2155,2435,895,985,685,200,394,82,291,118,61,61,4825,4550,1300,1375,5831,5723,1
564,1,1,163.0,167.0,170.0,186.0,3157,3364,2239,2379,918,985,322,386,69,252,253,134,61,61,4800,4850,1300,1375,5856,5723,1
571,1,1,168.0,177.0,170.0,184.0,3342,3504,2379,2519,963,985,423,212,129,87,294,125,66,61,4800,5550,1300,1375,5856,5823,1
579,1,1,166.0,177.0,170.0,200.0,3297,3504,2379,2519,918,985,858,223,464,182,394,41,66,61,4950,5750,1300,1375,5856,5823,1
586,1,1,170.0,187.0,170.0,200.0,3526,3532,2631,2547,895,985,595,144,339,112,256,32,66,61,4950,5750,1300,1375,5856,5823,1
593,1,1,170.0,195.0,170.0,208.0,3577,3482,2659,2519,918,963,762,155,419,107,343,48,66,61,5250,6250,1300,1375,5856,5823,1
600,1,1,178.0,197.0,178.0,208.0,3521,3538,2603,2575,918,963,589,471,359,307,230,164,66,61,5450,6250,1300,1375,5856,5823,1
607,1,1,190.0,199.0,202.0,208.0,3403,3420,2463,2435,940,985,275,531,104,372,171,159,66,61,5350,6650,1300,1375,5956,5923,1
614,1,1,197.0,199.0,210.0,208.0,3420,3370,2435,2407,985,963,296,733,109,512,187,221,65,63,5550,6850,1300,1375,5956,6123,1
621,1,1,192.0,200.0,210.0,208.0,3414,3252,2407,2267,1007,985,602,523,299,407,303,116,64,62,5650,6850,1300,1525,6206,6123,1
629,1,1,191.0,200.0,210.0,208.0,2860,3392,1987,2407,873,985,613,910,289,682,324,228,61,62,6150,7050,1300,1525,6556,6123,1
636,1,1,185.0,198.0,210.0,208.0,2311,3364,1595,2379,716,985,292,1035,34,762,258,273,61,62,5550,6850,1300,1525,7556,6523,1
643,1,1,157.0,194.0,224.0,216.0,2373,3538,1567,2575,806,963,473,1252,144,917,329,335,55,62,4650,6550,1300,1525,9056,6923,1
650,1,1,141.0,200.0,218.0,216.0,2311,3532,1595,2547,716,985,353,772,44,542,309,230,50,62,3650,6050,1300,1525,10656,7523,1
7,2,1,13.0,13.0,15.0,14.0,419,377,419,377,0,0,50,45,50,45,0,0,12,12,0,0,0,0,0,0,1
14,2,1,14.0,13.0,15.0,14.0,643,671,643,671,0,0,65,20,65,20,0,0,13,13,0,0,0,0,0,0,1
21,2,1,14.0,14.0,15.0,14.0,671,727,671,727,0,0,45,55,45,55,0,0,13,13,0,0,0,0,0,0,1
29,2,1,15.0,14.0,15.0,14.0,615,727,615,727,0,0,70,150,70,150,0,0,14,13,0,0,0,0,0,0,1
36,2,1,15.0,16.0,15.0,22.0,727,755,727,755,0,0,125,145,125,145,0,0,14,14,0,0,0,0,0,0,1
43,2,1,16.0,16.0,23.0,22.0,727,783,727,783,0,0,10,235,10,235,0,0,15,16,0,0,0,0,0,0,1
50,2,1,17.0,17.0,23.0,22.0,727,755,727,755,0,0,20,280,20,280,0,0,16,16,0,0,0,0,0,0,1
57,2,1,18.0,17.0,23.0,22.0,811,839,811,839,0,0,30,45,30,45,0,0,17,16,0,0,0,0,0,0,1
64,2,1,19.0,18.0,23.0,22.0,867,839,867,839,0,0,90,90,90,90,0,0,18,16,0,0,0,0,0,0,1
71,2,1,19.0,17.0,23.0,22.0,895,895,895,895,0,0,200,180,200,180,0,0,18,17,0,0,0,0,0,0,1
79,2,1,20.0,17.0,23.0,22.0,939,839,895,839,44,0,323,35,315,35,8,0,19,16,0,0,0,0,0,0,1
86,2,1,20.0,18.0,23.0,22.0,990,783,923,783,67,0,31,80,15,80,16,0,19,16,0,0,0,0,0,0,1
93,2,1,20.0,19.0,23.0,22.0,1040,833,951,811,89,22,163,129,135,125,28,4,20,18,0,0,150,0,0,0,1
100,2,1,21.0,20.0,23.0,22.0,1090,906,979,839,111,67,90,192,50,180,40,12,20,19,0,0,150,0,0,0,1
107,2,1,21.0,20.0,23.0,22.0,1068,1051,979,895,89,156,92,327,40,295,52,32,20,19,0,0,150,0,0,0,1
114,2,1,22.0,20.0,23.0,22.0,1113,1102,979,923,134,179,72,357,0,305,72,52,21,20,0,0,150,0,0,0,1
121,2,1,23.0,22.0,23.0,22.0,1102,1023,923,867,179,156,202,313,110,245,92,68,22,20,0,0,150,250,0,0,1
129,2,1,23.0,26.0,23.0,36.0,1079,1023,923,867,156,156,278,198,170,110,108,88,22,20,0,0,150,250,0,0,1
136,2,1,26.0,27.0,31.0,36.0,1169,1062,923,951,246,111,149,70,80,70,69,0,23,20,0,0,300,250,0,0,1
143,2,1,26.0,28.0,31.0,36.0,1264,895,951,895,313,0,249,130,140,130,109,0,23,21,0,100,300,250,0,0,1
150,2,1,27.0,30.0,31.0,36.0,1314,1007,979,1007,335,0,234,160,135,160,99,0,24,22,0,100,300,250,0,0,1
157,2,1,31.0,31.0,46.0,36.0,1242,1175,951,1175,291,0,271,250,140,250,131,0,25,22,125,250,300,250,0,0,1
164,2,1,32.0,31.0,46.0,36.0,1253,1231,1007,1231,246,0,174,45,15,45,159,0,26,21,125,500,300,250,0,0,1
171,2,1,33.0,32.0,46.0,36.0,1443,1259,1175,1259,268,0,256,140,65,140,191,0,27,21,125,550,300,250,0,0,1
179,2,1,34.0,32.0,46.0,36.0,1510,1119,1287,1119,223,0,255,180,65,180,190,0,29,21,125,600,300,250,0,0,1
186,2,1,35.0,35.0,46.0,36.0,1337,1231,1091,1231,246,0,317,185,95,185,222,0,29,21,300,650,300,250,50,0,1
193,2,1,34.0,35.5,46.0,44.0,1113,1147,867,1147,246,0,295,170,45,170,250,0,29,23,175,625,300,250,175,25,1
200,2,1,33.0,39.5,46.0,44.0,1342,1203,1119,1203,223,0,328,20,50,20,278,0,29,24,175,575,300,250,175,75,1
207,2,1,37.0,40.5,54.0,44.0,1617,1259,1371,1259,246,0,305,130,20,130,285,0,29,27,300,575,450,250,175,75,1
214,2,1,37.0,41.0,54.0,52.0,1555,1343,1287,1343,268,0,482,140,165,140,317,0,29,29,300,550,450,250,175,100,1
221,2,1,39.0,45.0,54.0,52.0,1594,1427,1371,1427,223,0,411,70,170,70,241,0,31,29,300,550,700,250,175,100,1
229,2,1,39.0,48.0,54.0,60.0,1723,1595,1455,1595,268,0,303,120,130,120,173,0,31,30,300,550,700,250,175,100,1
236,2,1,41.0,51.0,54.0,66.0,1734,1707,1511,1707,223,0,502,75,305,75,197,0,33,32,425,700,700,250,175,100,1
243,2,1,47.0,52.5,54.0,66.0,1841,1785,1595,1763,246,22,205,179,55,175,150,4,33,36,800,675,700,250,175,125,1
250,2,1,49.0,55.5,54.0,74.0,1863,1925,1595,1791,268,134,382,119,200,95,182,24,35,40,800,675,700,250,175,125,1
257,2,1,49.0,59.5,54.0,74.0,1958,2087,1735,1931,223,156,466,174,360,130,106,44,37,40,800,825,950,250,175,125,1
264,2,1,55.0,62.0,62.0,74.0,2009,2311,1763,2155,246,156,322,294,255,230,67,64,37,40,800,950,950,250,175,150,1
271,2,1,55.0,68.0,62.0,74.0,2160,2311,1847,2155,313,156,293,224,190,140,103,84,37,40,1175,950,950,250,175,150,1
279,2,1,56.0,69.0,62.0,82.0,2115,2362,1847,2183,268,179,331,249,200,145,131,104,37,40,1175,1050,1200,250,175,150,1
286,2,1,58.0,73.0,62.0,82.0,2143,2334,1875,2155,268,179,323,269,160,145,163,124,37,40,1175,1400,1200,250,175,150,1
293,2,1,62.0,76.0,62.0,90.0,2132,2339,1819,2183,313,156,229,185,80,95,149,90,38,39,1175,1600,1200,250,175,150,1
300,2,1,62.0,79.0,62.0,98.0,2210,2227,1875,2071,335,156,290,295,105,185,185,110,38,39,1425,1700,1200,250,175,150,1
307,2,1,62.0,83.0,62.0,98.0,2076,2227,1763,2071,313,156,416,320,195,190,221,130,38,43,1425,1850,1200,250,175,150,1
314,2,1,64.0,87.0,78.0,98.0,2126,2311,1791,2155,335,156,576,245,315,95,261,150,38,43,1675,1950,1200,250,175,150,1
321,2,1,63.0,89.0,86.0,98.0,2070,2283,1735,2127,335,156,776,225,475,55,301,170,40,43,1550,2250,1500,250,300,150,1
329,2,1,73.0,92.0,86.0,98.0,2160,2446,1847,2267,313,179,377,310,215,120,162,190,40,43,1550,2300,1650,250,300,150,1
336,2,1,76.0,92.0,94.0,106.0,2048,2418,1735,2239,313,179,252,25,100,15,152,10,40,41,2300,2350,1650,450,300,150,1
343,2,1,76.0,96.0,94.0,106.0,2238,2283,1903,2127,335,156,527,196,335,170,192,26,40,41,2300,2650,1650,450,300,150,1
350,2,1,59.0,86.0,102.0,106.0,2210,2227,1875,2071,335,156,727,361,495,315,232,46,41,38,1275,2600,1650,450,1425,525,1
357,2,1,60.0,90.5,102.0,106.0,2244,1583,1931,1427,313,156,268,136,125,70,143,66,41,37,1150,2725,1650,700,2050,650,1
364,2,1,61.0,91.0,102.0,114.0,2278,1639,1875,1483,403,156,415,111,245,25,170,86,43,42,1275,2650,1650,700,2175,725,1
371,2,1,62.0,90.0,102.0,114.0,2250,2166,1735,1987,515,179,250,296,120,190,130,106,43,44,1025,2500,1650,700,2425,875,1
379,2,1,60.0,94.0,102.0,114.0,2395,2502,1903,2323,492,179,556,381,370,255,186,126,44,48,900,2650,1650,700,2550,875,1
386,2,1,68.0,96.0,102.0,114.0,2339,2563,1847,2407,492,156,321,227,175,185,146,42,45,53,1400,2650,1650,825,2550,875,1
393,2,1,70.0,97.0,102.0,114.0,2401,2507,1931,2351,470,156,383,222,285,160,98,62,45,51,1550,2650,1650,825,2550,975,1
400,2,1,74.0,100.0,102.0,122.0,2378,2479,1931,2323,447,156,299,272,245,190,54,82,45,54,1925,2650,1650,825,2550,975,1
407,2,1,72.0,106.0,102.0,122.0,2479,2927,1987,2771,492,156,604,157,490,55,114,102,45,57,1800,2650,1650,825,2675,975,1
414,2,1,82.0,105.0,102.0,122.0,2502,2938,1987,2715,515,223,269,334,220,200,49,134,45,60,2425,2650,1650,825,2675,975,1
421,2,1,82.0,106.0,102.0,130.0,2518,3157,1959,2687,559,470,472,664,355,470,117,194,45,63,2425,2650,1650,825,2675,975,1
429,2,1,84.0,110.5,94.0,138.0,2418,3314,1791,2799,627,515,623,804,455,550,168,254,45,63,2925,2625,1650,825,2675,1000,1
436,2,1,84.0,112.5,94.0,138.0,2496,3381,1847,2911,649,470,929,1001,685,695,244,306,45,63,2925,2725,1650,825,2675,1000,1
443,2,1,94.0,116.5,102.0,138.0,2412,3403,1763,2911,649,492,594,1216,395,850,199,366,45,63,2925,2975,1650,1075,2675,1000,1
450,2,1,96.0,124.5,102.0,138.0,2390,3403,1763,2799,627,604,646,721,400,575,246,146,45,63,3675,3075,1650,1275,2675,1000,1
457,2,1,96.0,127.5,102.0,146.0,2350,3426,1679,2799,671,627,931,587,605,565,326,22,45,63,3675,3225,1650,1275,2675,1000,1
464,2,1,96.0,132.5,102.0,154.0,2378,3482,1707,2855,671,627,1211,722,805,620,406,102,45,63,3675,3675,1650,1275,2675,1075,1
471,2,1,108.0,135.5,110.0,154.0,2334,3470,1707,2799,627,671,739,827,415,645,324,182,45,63,4425,4375,1650,1275,2675,1225,1
479,2,1,84.0,126.0,110.0,154.0,2446,3610,1819,2939,627,671,1029,898,625,665,404,233,45,63,2900,3500,1650,1275,4200,1950,1
486,2,1,66.0,116.5,110.0,154.0,2384,3582,1735,2911,649,671,1319,1079,835,820,484,259,45,63,1775,2525,1650,1275,5325,2550,1
493,2,1,70.0,122.0,110.0,154.0,2468,3700,1819,3051,649,649,845,815,435,555,410,260,45,63,2025,2450,1650,1275,5825,2800,1
500,2,1,70.0,117.5,110.0,154.0,2356,3594,1707,2967,649,627,1121,1121,635,810,486,311,45,63,2025,2325,1650,1275,5825,3225,1
507,2,1,74.0,125.5,110.0,154.0,2378,3538,1707,2911,671,627,1156,836,640,645,516,191,45,63,2025,2775,1650,1275,5825,3225,1
514,2,1,82.0,129.5,110.0,154.0,2300,3526,1651,2855,649,671,518,551,30,430,488,121,45,63,2775,3175,1650,1275,5825,3225,1
521,2,1,80.0,128.0,110.0,154.0,2306,3358,1679,2687,627,671,779,874,215,679,564,195,45,62,2650,3275,1650,1275,5950,3562,1
529,2,1,72.0,132.0,110.0,154.0,2328,2983,1679,2379,649,604,1074,553,430,394,644,159,45,59,2150,3225,1650,1275,6450,3962,1
536,2,1,70.0,140.0,110.0,154.0,2250,2944,1623,2407,627,537,1130,468,410,299,720,169,45,59,1900,3575,1650,1275,6200,3962,1
543,2,1,76.0,140.0,110.0,154.0,2171,2938,1567,2379,604,559,497,500,255,409,242,91,45,59,1650,4175,1650,1275,6450,3962,1
550,2,1,77.0,145.0,110.0,154.0,2300,2978,1651,2351,649,627,72,516,0,399,72,117,47,59,1875,4475,1650,1275,6825,3962,1
557,2,1,78.0,151.0,118.0,154.0,2244,3146,1595,2519,649,627,193,601,45,404,148,197,48,59,2225,4775,1650,1275,6825,3962,1
564,2,1,78.0,153.0,118.0,146.0,2194,3084,1567,2435,627,649,445,171,225,119,220,52,48,59,2225,5075,1650,1275,6825,4062,1
571,2,1,82.0,152.0,118.0,146.0,2278,3218,1651,2547,627,671,360,501,160,369,200,132,49,60,2225,5275,1650,1275,6825,4112,1
579,2,1,86.0,147.0,118.0,146.0,2322,3134,1651,2463,671,671,280,867,100,659,180,208,49,60,2575,5775,1650,1275,6825,4387,1
586,2,1,68.0,153.0,133.0,162.0,2238,3302,1567,2631,671,671,551,608,295,324,256,284,47,60,1475,5175,1750,1275,8025,4762,1
592,2,1,66.0,151.5,133.0,170.0,2272,3185,1623,2491,649,694,440,866,220,514,220,352,44,60,1550,5000,2050,1275,8450,4862,1
7,2,2,13.0,13.0,15.0,15.0,209,251,209,251,0,0,25,30,25,30,0,0,12,12,0,0,0,0,0,0,1
14,2,2,14.0,14.0,15.0,15.0,671,671,671,671,0,0,70,70,70,70,0,0,13,13,0,0,0,0,0,0,1
21,2,2,14.0,14.0,15.0,15.0,643,643,643,643,0,0,35,40,35,40,0,0,13,13,0,0,0,0,0,0,1
29,2,2,15.0,15.0,15.0,15.0,671,699,671,699,0,0,80,35,80,35,0,0,14,14,0,0,0,0,0,0,1
36,2,2,15.0,15.0,15.0,15.0,783,755,783,755,0,0,130,135,130,135,0,0,14,14,0,0,0,0,0,0,1
43,2,2,16.0,16.0,23.0,23.0,811,811,811,811,0,0,25,70,25,70,0,0,15,15,0,0,0,0,0,0,1
50,2,2,17.0,17.0,23.0,23.0,811,811,811,811,0,0,45,50,45,50,0,0,16,16,0,0,0,0,0,0,1
57,2,2,18.0,18.0,23.0,23.0,895,811,895,811,0,0,35,45,35,45,0,0,17,17,0,0,0,0,0,0,1
64,2,2,19.0,19.0,23.0,23.0,951,895,951,895,0,0,100,155,100,155,0,0,18,18,0,0,0,0,0,0,1
71,2,2,19.0,19.0,23.0,23.0,1001,951,979,951,22,0,159,145,155,145,4,0,18,18,0,0,0,0,0,0,1
79,2,2,20.0,20.0,23.0,23.0,973,1046,839,979,134,67,74,217,50,205,24,12,19,19,0,0,0,0,0,0,1
86,2,2,21.0,21.0,23.0,23.0,1062,1034,839,923,223,111,147,284,95,260,52,24,20,20,0,0,150,0,0,0,1
93,2,2,22.0,22.0,23.0,23.0,1040,1085,727,951,313,134,112,419,20,375,92,44,21,21,0,0,150,150,0,0,1
100,2,2,22.0,22.0,23.0,23.0,1040,1107,727,951,313,156,233,149,105,85,128,64,21,21,0,0,150,150,0,0,1
107,2,2,23.0,22.0,23.0,23.0,1090,1130,755,951,335,179,214,128,50,40,164,88,22,22,0,0,150,150,0,0,1
114,2,2,23.0,23.0,23.0,23.0,1146,1146,811,923,335,223,304,221,100,105,204,116,22,22,0,0,150,150,0,0,1
121,2,2,24.0,23.0,31.0,23.0,1208,1118,895,895,313,223,450,245,210,105,240,140,23,23,0,0,300,150,0,0,1
129,2,2,24.0,23.0,31.0,23.0,1208,1191,895,923,313,268,290,342,160,170,130,172,23,23,0,0,450,150,0,0,1
136,2,2,26.0,24.0,31.0,31.0,1236,1135,923,867,313,268,165,484,95,280,70,204,24,23,0,0,450,150,0,0,1
143,2,2,29.0,26.0,31.0,31.0,1286,1163,951,895,335,268,95,300,35,160,60,140,24,23,0,0,450,300,0,0,1
150,2,2,29.0,27.0,31.0,31.0,1258,1130,923,839,335,291,250,136,150,110,100,26,24,24,0,0,450,300,0,0,1
157,2,2,30.0,27.0,31.0,31.0,1258,1208,923,895,335,313,241,236,105,170,136,66,25,24,0,0,450,300,0,0,1
164,2,2,30.0,28.0,31.0,31.0,1230,1197,895,839,335,358,341,196,165,140,176,56,25,25,175,0,450,300,0,0,1
171,2,2,33.0,29.0,39.0,46.0,1208,1202,895,867,313,335,192,242,130,150,62,92,25,25,350,175,750,300,50,50,1
179,2,2,33.0,31.0,39.0,46.0,1230,1236,895,923,335,313,337,238,235,110,102,128,25,25,350,175,750,300,50,50,1
186,2,2,33.0,32.0,39.0,46.0,1258,1264,923,951,335,313,492,328,350,160,142,168,26,26,350,175,750,300,50,50,1
193,2,2,34.0,37.0,39.0,46.0,1292,1404,979,1091,313,313,203,58,25,0,178,58,26,28,350,350,750,600,50,50,1
200,2,2,34.0,38.0,39.0,46.0,1292,1488,979,1175,313,313,368,173,150,75,218,98,26,29,650,350,750,600,50,50,1
207,2,2,37.0,39.0,39.0,46.0,1314,1538,979,1203,335,335,123,258,15,120,108,138,27,29,650,350,750,700,50,50,1
214,2,2,38.0,37.0,39.0,46.0,1320,1298,1007,1007,313,291,194,196,50,30,144,166,27,27,650,350,750,700,50,200,1
221,2,2,39.0,35.0,47.0,46.0,1292,704,979,615,313,89,354,265,170,95,184,170,28,26,650,700,750,800,50,350,1
229,2,2,36.0,36.0,47.0,46.0,1370,581,1035,559,335,22,374,230,150,60,224,170,28,26,350,700,750,800,350,400,1
236,2,2,37.0,38.0,47.0,46.0,1398,1085,1063,1063,335,22,489,129,225,105,264,24,29,26,650,700,750,800,350,400,1
243,2,2,41.0,40.0,47.0,46.0,1404,1298,1091,1231,313,67,305,97,155,65,150,32,29,26,650,700,750,800,350,400,1
250,2,2,44.0,40.0,47.0,46.0,1454,1354,1119,1287,335,67,300,260,160,220,140,40,30,26,825,700,750,800,350,400,1
257,2,2,45.0,42.0,47.0,46.0,1454,1023,1119,979,335,44,245,269,115,225,130,44,29,28,1000,700,750,800,400,400,1
264,2,2,46.0,42.0,62.0,54.0,1208,867,895,867,313,0,376,344,210,300,166,44,30,28,1000,1050,850,950,400,400,1
271,2,2,50.0,44.0,62.0,54.0,984,1287,671,1287,313,0,226,264,70,220,156,44,31,30,1000,1050,850,950,400,400,1
279,2,2,50.0,46.0,62.0,54.0,1062,1494,727,1427,335,67,341,341,145,285,196,56,31,31,1525,1050,850,950,400,400,1
286,2,2,52.0,49.0,62.0,54.0,1202,1510,867,1399,335,111,221,298,35,280,186,18,33,32,1525,1150,850,950,400,400,1
293,2,2,52.0,50.0,62.0,54.0,1740,1589,1427,1455,313,134,347,389,125,355,222,34,33,32,1700,1325,850,950,400,400,1
300,2,2,53.0,51.0,62.0,54.0,2154,1701,1819,1567,335,134,431,490,219,440,212,50,32,33,1875,1325,850,1050,450,500,1
307,2,2,52.0,53.0,62.0,54.0,1987,1701,1674,1567,313,134,360,401,112,385,248,16,31,35,1875,1225,850,1150,500,600,1
314,2,2,51.0,53.0,62.0,54.0,1713,1701,1422,1455,291,246,558,402,274,350,284,52,30,36,1875,1400,850,1150,550,600,1
321,2,2,50.0,54.0,62.0,54.0,1763,1796,1450,1483,313,313,363,377,139,285,224,92,28,37,1700,1400,950,1150,1000,600,1
329,2,2,53.0,54.0,62.0,54.0,1718,1740,1383,1427,335,313,270,387,156,255,114,132,28,37,1875,1400,1050,1150,1000,600,1
336,2,2,53.0,55.0,62.0,62.0,1724,1734,1411,1399,313,335,490,187,340,115,150,72,28,38,1875,1050,1050,1150,1000,950,1
343,2,2,51.0,54.0,62.0,70.0,1757,1348,1422,1035,335,313,340,238,300,130,40,108,28,36,1700,1050,1050,1250,1175,1100,1
350,2,2,51.0,49.0,62.0,70.0,1718,1174,1383,839,335,335,384,378,354,230,30,148,28,36,1525,1050,1050,1350,1350,1500,1
357,2,2,58.0,51.0,62.0,70.0,1371,1202,1058,867,313,335,240,323,224,135,16,188,27,37,2050,1050,1350,1450,1400,1500,1
364,2,2,58.0,55.0,62.0,70.0,1292,1544,979,1231,313,313,360,179,304,55,56,124,27,37,2225,1225,1350,1550,1400,1500,1
371,2,2,59.0,56.0,62.0,70.0,1432,1796,1097,1483,335,313,418,279,322,115,96,164,28,38,2225,1225,1350,1550,1450,1500,1
379,2,2,62.0,57.0,62.0,70.0,1192,1762,879,1427,313,335,171,434,139,230,32,204,27,39,2400,1400,1350,1550,1500,1500,1
386,2,2,62.0,58.0,62.0,70.0,1270,1846,957,1511,313,335,272,219,200,75,72,144,28,40,2575,1400,1350,1550,1500,1500,1
393,2,2,62.0,60.0,62.0,70.0,1662,1992,1327,1679,335,313,378,286,266,160,112,126,29,41,2925,1400,1350,1550,1500,1600,1
400,2,2,64.0,56.0,70.0,70.0,1712,1600,1377,1287,335,313,531,281,379,165,152,116,29,38,2925,1400,1350,1550,1500,1975,1
407,2,2,70.0,58.0,70.0,70.0,1852,1191,1539,811,313,380,397,174,309,10,88,164,31,38,3275,1575,1350,1550,1500,1975,1
414,2,2,70.0,59.0,70.0,70.0,1751,1841,1416,1483,335,358,595,388,467,180,128,208,31,40,3275,1575,1350,1550,1500,1975,1
421,2,2,70.0,61.0,70.0,62.0,1718,2098,1383,1651,335,447,309,339,291,125,18,214,33,40,3275,1575,1350,1400,1500,2375,1
429,2,2,70.0,61.0,70.0,62.0,1712,2132,1399,1707,313,425,308,91,254,75,54,16,33,41,3275,1750,1350,1450,1500,2575,1
436,2,2,70.0,62.0,70.0,62.0,1836,2177,1478,1707,358,470,527,157,433,85,94,72,33,41,3275,1750,1350,1450,1500,2575,1
443,2,2,79.0,62.0,86.0,70.0,1914,2199,1556,1707,358,492,308,418,274,290,34,128,33,41,3275,1750,1350,1450,1500,2575,1
450,2,2,80.0,66.0,86.0,70.0,1852,2294,1539,1847,313,447,216,331,150,255,66,76,33,42,3525,2100,1350,1450,1800,2575,1
457,2,2,78.0,66.0,86.0,70.0,1908,2160,1595,1735,313,425,459,583,353,455,106,128,34,42,3350,2100,1350,1600,1975,2575,1
464,2,2,70.0,60.0,102.0,70.0,1976,2210,1663,1763,313,447,692,869,546,685,146,184,34,42,2650,1575,1350,1750,2675,3100,1
471,2,2,78.0,62.0,110.0,70.0,1931,2160,1618,1735,313,425,90,591,54,505,36,86,34,42,2650,1400,1350,1750,2675,3450,1
479,2,2,70.0,59.0,110.0,70.0,1920,2210,1607,1763,313,447,316,532,240,390,76,142,34,41,2925,1400,1350,1750,3375,3850,1
486,2,2,70.0,57.0,110.0,70.0,1925,2037,1567,1567,358,470,362,788,246,590,116,198,34,41,2750,1225,1350,1750,3550,4025,1
493,2,2,70.0,63.0,110.0,70.0,1796,2093,1461,1623,335,470,210,410,158,310,52,100,34,43,2750,1225,1350,1750,3550,4025,1
500,2,2,70.0,63.0,110.0,70.0,1870,2171,1579,1679,291,492,437,680,353,520,84,160,36,43,2750,1750,1350,1750,3550,4025,1
507,2,2,74.0,63.0,110.0,78.0,1931,2317,1618,1735,313,582,420,748,346,520,74,228,36,43,2750,1750,1550,1750,3550,4025,1
514,2,2,74.0,65.0,110.0,78.0,1936,2272,1601,1735,335,537,147,747,33,505,114,242,36,43,2750,1750,1550,1750,3550,4025,1
521,2,2,74.0,69.0,110.0,78.0,1880,2289,1545,1707,335,582,381,668,227,450,154,218,36,43,3000,2275,1650,1900,3550,4025,1
529,2,2,74.0,69.0,110.0,86.0,1858,2306,1545,1679,313,627,602,944,412,650,190,294,36,43,3000,2275,1900,1900,3550,4025,1
536,2,2,70.0,71.0,118.0,94.0,2059,2300,1679,1651,380,649,404,1035,316,715,88,320,36,43,2750,2450,1900,2000,3800,4025,1
543,2,2,70.0,77.0,118.0,94.0,2087,2272,1640,1623,447,649,646,782,506,540,140,242,36,43,2750,2800,1900,2000,3800,4025,1
550,2,2,70.0,77.0,118.0,94.0,2087,2272,1640,1623,447,649,740,1053,548,735,192,318,35,43,2750,2975,1900,2000,3850,4025,1
557,2,2,77.0,73.0,118.0,94.0,2071,2278,1601,1651,470,627,410,1334,308,940,102,394,35,43,2750,2625,1900,2000,3850,4375,1
564,2,2,75.0,73.0,118.0,94.0,2143,2194,1696,1567,447,627,675,1429,517,1005,158,424,36,43,2575,2625,1900,2000,4025,4550,1
571,2,2,75.0,79.0,118.0,94.0,2054,2244,1562,1595,492,649,570,934,452,680,118,254,37,43,3100,3150,2050,2000,4025,4550,1
579,2,2,73.0,75.0,118.0,94.0,2115,2322,1623,1651,492,671,665,1219,491,885,174,334,35,43,3100,2800,2150,2000,4125,4900,1
586,2,2,65.0,75.0,133.0,94.0,1505,2272,1080,1623,425,649,801,1476,583,1070,218,406,33,43,2650,2800,2150,2000,4675,4900,1
593,2,2,70.0,81.0,133.0,94.0,1130,2238,772,1567,358,671,184,641,126,355,58,286,33,43,3000,2625,2150,2000,5025,5075,1
600,2,2,67.0,81.0,117.0,94.0,1819,2300,1439,1651,380,649,381,722,275,360,106,362,33,43,2725,3325,2150,2000,5500,5075,1
607,2,2,67.0,83.0,117.0,94.0,1724,2222,1366,1595,358,627,573,523,423,235,150,288,34,43,2725,3325,2350,2000,5600,5075,1
614,2,2,67.0,83.0,117.0,94.0,1723,2194,1343,1567,380,627,305,788,157,420,148,368,35,43,2550,3325,2350,2000,5775,5075,1
621,2,2,71.0,91.0,117.0,110.0,1908,2294,1461,1623,447,671,197,428,93,130,104,298,35,45,2900,3850,2350,2250,5775,5075,1
629,2,2,73.0,92.0,117.0,110.0,1886,2266,1461,1595,425,671,267,589,115,290,152,299,34,45,3075,3850,2350,2250,5825,5075,1
636,2,2,68.0,91.0,117.0,110.0,1371,2294,991,1623,380,671,426,675,230,350,196,325,33,47,2725,3675,2350,2250,6225,5425,1
643,2,2,74.0,99.0,117.0,110.0,1578,2216,1243,1567,335,649,174,301,42,50,132,251,36,48,2725,3675,2350,2250,6225,5425,1
650,2,2,76.0,99.0,117.0,110.0,2060,1970,1635,1343,425,627,255,482,117,155,138,327,37,48,3075,4300,2350,2250,6225,5425,1
657,2,2,76.0,103.0,117.0,110.0,2284,2026,1881,1399,403,627,508,377,322,70,186,307,38,50,3250,4300,2400,2250,6325,5425,1
664,2,2,78.0,102.0,117.0,110.0,2267,1908,1842,1259,425,649,611,552,423,165,188,387,38,50,3425,4275,2450,2250,6425,5600,1
671,2,2,71.0,93.0,117.0,125.0,1819,2070,1349,1399,470,671,444,752,300,285,144,467,37,51,2975,3400,2300,2250,7425,6475,1
679,2,2,67.0,91.0,117.0,125.0,1852,2350,1405,1679,447,671,657,693,465,250,192,443,37,51,2625,3225,2300,2250,7775,7000,1
686,2,2,61.0,93.0,117.0,125.0,1790,2350,1343,1679,447,671,157,524,113,105,44,419,37,52,1400,3125,2300,2250,8825,7350,1
693,2,2,60.0,93.0,117.0,125.0,1662,2524,1215,1875,447,649,185,810,139,315,46,495,34,52,2100,3475,2200,2250,9075,7350,1
700,2,2,56.0,85.0,117.0,125.0,1118,2670,783,2043,335,627,141,1141,109,570,32,571,34,54,1750,2775,2200,2250,9600,8050,1
707,2,2,50.0,75.0,117.0,125.0,1118,2726,783,2099,335,627,270,1466,194,815,76,651,34,54,1400,1900,2200,2250,10125,8925,1
714,2,2,48.0,78.0,117.0,125.0,1146,2770,811,2099,335,671,55,1046,39,515,16,531,34,54,875,2075,2200,2250,10650,9450,1
721,2,2,48.0,83.0,117.0,125.0,1387,2742,1007,2071,380,671,129,661,69,150,60,511,34,54,1225,2075,2200,2250,10650,9450,1
729,2,2,50.0,83.0,117.0,125.0,1701,2692,1254,2043,447,649,153,538,87,105,66,433,34,56,1225,2075,2200,2250,10650,9450,1
736,2,2,52.0,85.0,117.0,125.0,1858,2580,1433,1931,425,649,200,574,136,115,64,459,34,56,1400,2075,2200,2250,10650,9450,1
743,2,2,56.0,89.0,117.0,125.0,1981,2558,1556,1931,425,627,84,555,68,120,16,435,34,56,1750,2425,2200,2250,10650,9450,1
750,2,2,58.0,92.0,117.0,125.0,1964,2726,1539,2099,425,627,167,610,149,220,18,390,34,56,1925,3150,2300,2250,10650,9450,1
757,2,2,61.0,92.0,117.0,125.0,2048,2972,1623,2323,425,649,169,965,99,495,70,470,34,56,2100,3150,2300,2400,10650,9450,1
764,2,2,62.0,100.0,117.0,125.0,1869,3056,1444,2295,425,761,287,636,165,270,122,366,37,56,2100,3500,2300,2400,10650,9450,1
771,2,2,64.0,100.0,117.0,125.0,2054,3129,1607,2323,447,806,140,988,116,530,24,458,37,56,2100,3950,2300,2700,10650,9450,1
779,2,2,65.0,100.0,117.0,125.0,2194,3050,1769,2267,425,783,354,1351,282,805,72,546,40,56,2100,3950,2100,2700,10850,9450,1
786,2,2,65.0,110.0,109.0,125.0,1908,2479,1528,1763,380,716,393,745,327,365,66,380,39,56,2275,4125,2000,2550,11150,9600,1
793,2,2,73.0,111.0,109.0,125.0,1662,1953,1371,1259,291,694,190,894,92,505,98,389,39,56,2675,4825,2000,2550,11150,9600,1
800,2,2,67.0,111.0,109.0,110.0,1679,2042,1411,1371,268,671,398,1123,264,650,134,473,39,56,2375,4825,2000,2850,11450,10000,1
807,2,2,69.0,109.0,109.0,110.0,1198,1678,907,1007,291,671,164,1317,94,760,70,557,39,56,2275,4575,2000,2850,11550,10250,1
814,2,2,69.0,109.0,109.0,110.0,1634,1673,1231,979,403,694,391,1127,269,490,122,637,39,56,2625,4675,2000,2850,11550,10250,1
821,2,2,73.0,109.0,86.0,110.0,2104,1790,1455,1119,649,671,297,1128,199,415,98,713,39,56,2975,4675,2000,2850,12050,10250,1
829,2,2,77.0,109.0,78.0,110.0,2110,2205,1483,1511,627,694,209,1163,139,370,70,793,39,56,3325,4675,2000,2850,12150,10250,1
836,2,2,77.0,109.0,78.0,110.0,2143,1930,1539,1259,604,671,256,1208,114,335,142,873,39,56,3325,4675,2000,2850,12150,10250,1
843,2,2,77.0,109.0,78.0,126.0,2143,1656,1539,1007,604,649,518,1404,304,455,214,949,39,56,3325,4675,2000,2850,12150,10250,1
850,2,2,77.0,117.0,78.0,126.0,2199,1992,1595,1343,604,649,366,663,84,130,282,533,39,56,3325,5675,2000,2850,12150,10250,1
857,2,2,75.0,119.0,94.0,126.0,2121,1757,1539,1063,582,694,623,608,269,120,354,488,39,56,3150,5925,2000,2850,12325,10250,1
864,2,2,67.0,115.0,94.0,126.0,2115,1846,1511,1175,604,671,869,843,439,275,430,568,39,56,2450,5575,2000,2850,13025,10600,1
871,2,2,75.0,115.0,94.0,126.0,2110,2133,1483,1439,627,694,425,831,119,187,306,644,39,56,3150,5575,2000,2850,13025,10600,1
7,2,2,13.0,13.0,15.0,15.0,251,293,251,293,0,0,30,35,30,35,0,0,12,12,0,0,0,0,0,0,1
14,2,2,14.0,14.0,15.0,15.0,671,671,671,671,0,0,70,70,70,70,0,0,13,13,0,0,0,0,0,0,1
21,2,2,14.0,14.0,15.0,15.0,699,699,699,699,0,0,50,50,50,50,0,0,13,13,0,0,0,0,0,0,1
29,2,2,15.0,15.0,15.0,15.0,671,671,671,671,0,0,85,30,85,30,0,0,14,14,0,0,0,0,0,0,1
36,2,2,15.0,15.0,15.0,15.0,811,811,811,811,0,0,135,145,135,145,0,0,14,14,0,0,0,0,0,0,1
43,2,2,16.0,16.0,23.0,23.0,811,755,811,755,0,0,185,25,185,25,0,0,15,15,0,0,0,0,0,0,1
50,2,2,17.0,17.0,23.0,23.0,895,811,895,811,0,0,285,0,285,0,0,0,16,16,0,0,0,0,0,0,1
57,2,2,17.0,18.0,23.0,23.0,923,839,923,839,0,0,400,110,400,110,0,0,17,17,0,0,0,0,0,0,1
64,2,2,17.0,19.0,23.0,23.0,923,951,923,951,0,0,100,170,100,170,0,0,17,18,0,0,0,0,0,0,1
71,2,2,18.0,19.0,23.0,23.0,1007,973,1007,951,0,22,20,154,20,150,0,4,17,18,0,0,0,0,0,0,1
79,2,2,18.0,20.0,23.0,23.0,951,967,951,923,0,44,55,268,55,260,0,8,17,19,0,0,0,0,0,0,1
86,2,2,19.0,20.0,23.0,23.0,979,984,979,895,0,89,110,325,110,305,0,20,18,19,0,0,0,150,0,0,1
93,2,2,19.0,23.0,23.0,23.0,951,1029,951,895,0,134,95,196,95,160,0,36,18,20,0,0,0,150,0,0,1
100,2,2,20.0,23.0,23.0,23.0,923,990,923,811,0,179,50,260,50,200,0,60,19,21,0,0,0,150,0,0,1
107,2,2,21.0,23.0,23.0,23.0,978,1085,867,839,111,246,120,292,100,200,20,92,20,21,0,100,0,150,0,0,1
114,2,2,21.0,23.0,23.0,23.0,967,1096,811,783,156,313,235,413,195,285,40,128,20,21,0,100,150,150,0,0,1
121,2,2,23.0,23.0,23.0,23.0,990,1068,811,755,179,313,110,540,50,380,60,160,21,21,0,100,150,150,0,0,1
129,2,2,23.0,26.0,23.0,31.0,990,1040,811,727,179,313,129,35,45,10,84,25,21,21,0,100,150,300,0,0,1
136,2,2,23.0,25.0,38.0,31.0,1074,1124,895,811,179,313,264,125,160,60,104,65,21,21,0,100,150,300,0,0,1
143,2,2,25.0,25.0,38.0,31.0,1046,1096,867,783,179,313,298,255,170,150,128,105,21,21,100,100,150,300,0,0,1
150,2,2,25.0,25.0,46.0,31.0,1023,1180,867,867,156,313,419,195,275,50,144,145,21,21,100,100,300,300,0,0,1
157,2,2,27.0,25.0,46.0,31.0,1102,1113,923,755,179,358,194,320,130,135,64,185,21,21,100,225,450,500,0,0,1
164,2,2,27.0,25.0,46.0,31.0,1102,1197,923,839,179,358,223,470,135,245,88,225,21,21,100,225,450,600,0,0,1
171,2,2,27.0,29.0,46.0,31.0,1102,1096,923,783,179,313,78,132,20,25,58,107,21,21,100,225,450,900,0,0,1
179,2,2,29.0,31.0,46.0,31.0,1096,1124,895,811,201,313,197,152,115,30,82,122,21,21,275,225,450,1100,0,0,1
186,2,2,29.0,31.0,46.0,31.0,1107,1152,951,839,156,313,128,292,80,130,48,162,21,21,275,225,450,1100,0,0,1
193,2,2,29.0,31.0,46.0,39.0,1079,1152,923,839,156,313,158,322,90,120,68,202,21,21,350,575,550,1100,100,0,1
200,2,2,31.0,35.0,62.0,39.0,1158,1158,979,867,179,291,117,104,75,20,42,84,21,21,350,575,650,1100,100,0,1
207,2,2,33.0,35.0,62.0,39.0,1186,1186,1007,895,179,291,157,145,95,25,62,120,23,21,525,700,650,1100,100,0,1
214,2,2,35.0,36.0,62.0,39.0,1242,1158,1063,867,179,291,136,222,100,70,36,152,23,21,525,700,650,1100,100,0,1
221,2,2,35.0,36.0,62.0,39.0,1270,1158,1091,867,179,291,131,363,75,175,56,188,25,21,700,700,650,1200,100,0,1
229,2,2,35.0,36.0,62.0,39.0,1326,1107,1147,839,179,268,196,295,120,75,76,220,25,22,700,1050,650,1200,100,0,1
236,2,2,35.0,36.0,62.0,39.0,1298,1130,1119,839,179,291,246,436,150,180,96,256,25,22,875,1050,650,1300,100,0,1
243,2,2,35.0,36.0,54.0,39.0,1242,1163,1063,895,179,268,391,228,275,90,116,138,25,22,875,1050,650,1300,200,0,1
250,2,2,35.0,38.0,46.0,39.0,1102,1208,923,895,179,313,425,274,285,100,140,174,25,22,875,950,650,1300,300,100,1
257,2,2,29.0,38.0,46.0,39.0,1074,1180,895,867,179,313,555,415,395,205,160,210,21,22,700,950,750,1500,775,100,1
264,2,2,25.0,38.0,46.0,47.0,480,1191,391,923,89,268,564,458,400,220,164,238,19,22,525,950,750,1500,1050,100,1
7,0,0,13.0,13.0,15.0,15.0,251,251,251,251,0,0,30,30,30,30,0,0,12,12,0,0,0,0,0,0,1
14,0,0,14.0,14.0,15.0,15.0,671,643,671,643,0,0,70,65,70,65,0,0,13,13,0,0,0,0,0,0,1
21,0,0,14.0,14.0,15.0,15.0,671,671,671,671,0,0,50,45,50,45,0,0,13,13,0,0,0,0,0,0,1
29,0,0,15.0,15.0,15.0,15.0,699,699,699,699,0,0,40,85,40,85,0,0,14,14,0,0,0,0,0,0,1
36,0,0,15.0,15.0,15.0,15.0,727,755,727,755,0,0,130,130,130,130,0,0,14,14,0,0,0,0,0,0,1
43,0,0,16.0,16.0,23.0,23.0,783,811,783,811,0,0,5,75,5,75,0,0,15,15,0,0,0,0,0,0,1
50,0,0,16.0,16.0,23.0,23.0,783,783,783,783,0,0,45,40,45,40,0,0,15,15,0,0,0,0,0,0,1
57,0,0,17.0,17.0,23.0,23.0,783,783,783,783,0,0,10,30,10,30,0,0,16,16,0,0,0,0,0,0,1
64,0,0,18.0,18.0,23.0,23.0,755,867,755,867,0,0,100,135,100,135,0,0,17,17,0,0,0,0,0,0,1
71,0,0,18.0,18.0,23.0,23.0,794,833,727,811,67,22,147,229,135,225,12,4,17,17,0,0,0,0,0,0,1
79,0,0,19.0,19.0,23.0,23.0,816,861,615,727,201,134,246,274,210,250,36,24,18,18,0,0,0,0,0,0,1
86,0,0,19.0,19.0,23.0,23.0,878,911,587,755,291,156,352,394,280,350,72,44,18,18,0,0,0,0,0,0,1
93,0,0,20.0,20.0,23.0,23.0,928,939,615,783,313,156,122,300,60,290,62,10,19,19,0,0,150,150,0,0,1
100,0,0,20.0,20.0,23.0,23.0,984,967,671,811,313,156,243,415,145,385,98,30,19,19,0,0,150,150,0,0,1
107,0,0,20.0,20.0,23.0,23.0,917,967,671,811,246,156,96,130,70,80,26,50,19,19,0,0,150,150,0,0,1
114,0,0,21.0,20.0,31.0,23.0,928,939,727,783,201,156,165,150,115,80,50,70,19,19,0,0,150,150,0,0,1
121,0,0,21.0,22.0,31.0,23.0,906,906,727,727,179,179,120,155,100,65,20,90,19,19,100,100,150,150,0,0,1
129,0,0,22.0,23.0,31.0,23.0,1225,1051,1091,895,134,156,281,241,245,135,36,106,20,20,100,100,150,150,0,0,1
136,0,0,22.0,23.0,31.0,31.0,1354,995,1175,839,179,156,440,126,380,100,60,26,20,20,100,100,150,150,0,0,1
143,0,0,23.0,24.0,31.0,31.0,1348,1051,1147,895,201,156,539,111,455,65,84,46,21,21,100,150,150,150,0,0,1
150,0,0,23.0,24.0,31.0,31.0,1354,1051,1175,895,179,156,39,31,35,15,4,16,22,21,100,150,400,150,0,0,1
157,0,0,24.0,25.0,31.0,31.0,1354,1242,1175,1063,179,179,139,196,115,160,24,36,22,22,100,150,500,150,0,0,1
164,0,0,28.0,26.0,31.0,31.0,1482,1331,1259,1175,223,156,107,307,55,255,52,52,22,23,100,150,500,150,0,0,1
171,0,0,29.0,26.0,31.0,31.0,1482,1275,1259,1119,223,156,120,447,40,375,80,72,23,23,100,150,500,250,0,0,1
179,0,0,29.0,29.0,31.0,46.0,1365,1449,1119,1203,246,246,288,323,180,215,108,108,23,24,100,150,500,500,0,0,1
186,0,0,30.0,31.0,31.0,46.0,1225,1348,979,1035,246,313,175,63,35,15,140,48,24,24,300,150,750,600,0,0,1
193,0,0,36.0,32.0,39.0,46.0,1527,1454,1259,1119,268,335,177,253,105,165,72,88,24,25,300,150,750,600,0,0,1
200,0,0,37.0,35.0,39.0,46.0,1522,1572,1231,1259,291,313,143,179,60,80,83,99,25,25,300,350,750,600,0,0,1
207,0,0,38.0,36.0,39.0,46.0,1566,1678,1231,1343,335,335,268,264,145,125,123,139,26,26,300,350,750,600,0,0,1
214,0,0,38.0,38.0,39.0,46.0,1572,1824,1259,1511,313,313,449,275,290,100,159,175,26,28,500,350,750,675,0,0,1
221,0,0,39.0,40.0,54.0,46.0,1594,2020,1259,1707,335,313,364,355,190,165,174,190,27,28,700,450,825,925,0,0,1
229,0,0,44.0,44.0,54.0,54.0,1678,2098,1343,1763,335,335,204,190,90,160,114,30,27,30,700,450,825,925,0,0,1
236,0,0,45.0,47.0,54.0,54.0,1785,2216,1427,1903,358,313,368,331,210,265,158,66,28,31,700,550,825,925,0,0,1
243,0,0,49.0,51.0,54.0,54.0,1734,2272,1287,1959,447,313,134,241,120,235,14,6,29,32,700,550,900,1000,0,0,1
250,0,0,49.0,53.0,54.0,54.0,1639,2154,1147,1819,492,335,114,366,40,320,74,46,29,34,800,550,900,1000,0,0,1
257,0,0,53.0,53.0,54.0,54.0,1942,2266,1427,1931,515,335,259,251,125,165,134,86,31,34,800,650,900,1000,0,0,1
264,0,0,53.0,55.0,54.0,62.0,1975,2210,1483,1875,492,335,156,152,70,30,86,122,31,36,1050,650,900,1000,0,0,1
271,0,0,58.0,55.0,62.0,62.0,2171,2104,1679,1791,492,313,161,158,140,50,21,108,33,36,1150,950,900,1000,0,0,1
279,0,0,60.0,57.0,62.0,62.0,2093,2132,1623,1819,470,313,102,138,25,90,77,48,33,38,1150,1200,900,1000,0,0,1
286,0,0,62.0,59.0,62.0,70.0,2373,2328,1903,2015,470,313,337,193,200,105,137,88,35,39,1450,1200,900,1000,0,0,1
293,0,0,62.0,60.0,62.0,70.0,2289,2188,1819,1875,470,313,492,303,295,175,197,128,36,40,1450,1200,900,1000,0,0,1
300,0,0,66.0,65.0,70.0,70.0,2418,2289,1903,1931,515,358,269,204,212,161,57,43,37,41,1550,1250,1150,1000,0,0,1
307,0,0,66.0,66.0,70.0,70.0,2339,2238,1847,1903,492,335,410,372,297,293,113,79,37,42,1825,1250,1150,1000,0,0,1
314,0,0,70.0,70.0,70.0,70.0,2070,2362,1511,1847,559,515,282,504,226,353,56,151,39,43,1825,1300,1150,1150,0,0,1
321,0,0,74.0,76.0,78.0,78.0,1908,2367,1259,1763,649,604,283,35,222,8,61,27,39,45,1825,1300,1150,1300,0,0,1
329,0,0,76.0,78.0,86.0,93.0,1998,2614,1371,1987,627,627,294,230,232,123,62,107,39,46,1875,1575,1150,1300,0,0,1
336,0,0,78.0,82.0,86.0,93.0,2194,2468,1567,1819,627,649,379,95,237,33,142,62,41,46,1875,1725,1150,1300,0,0,1
343,0,0,84.0,85.0,86.0,93.0,2261,2558,1567,1931,694,627,139,246,17,108,122,138,43,48,2450,1775,1150,1300,0,0,1
350,0,0,84.0,85.0,86.0,93.0,2373,2770,1679,2099,694,671,149,381,72,263,77,118,43,48,2675,2225,1150,1550,0,0,1
357,0,0,88.0,89.0,94.0,93.0,2334,2770,1707,2099,627,671,312,247,167,203,145,44,45,48,2900,2275,1150,1550,0,0,1
364,0,0,92.0,92.0,102.0,93.0,2384,2838,1735,2211,649,627,147,179,72,113,75,66,45,48,2950,2375,1150,1550,0,0,1
371,0,0,95.0,93.0,102.0,93.0,2418,2804,1791,2155,627,649,298,449,147,303,151,146,46,48,2950,2650,1150,1550,0,0,1
379,0,0,95.0,93.0,102.0,93.0,2474,2530,1847,1903,627,627,443,405,212,308,231,97,46,48,2950,2800,1150,1550,0,0,1
386,0,0,98.0,93.0,110.0,93.0,2474,2306,1847,1679,627,627,293,390,132,213,161,177,48,46,3250,2800,1150,1550,0,100,1
393,0,0,100.0,93.0,110.0,93.0,2597,2356,1903,1707,694,649,103,590,12,333,91,257,48,46,3750,3250,1150,1550,0,100,1
400,0,0,98.0,93.0,118.0,93.0,1992,2373,1455,1679,537,694,295,570,152,333,143,237,44,46,3975,3200,1150,1550,200,200,1
407,0,0,101.0,99.0,118.0,101.0,1443,2373,1063,1679,380,694,145,806,87,493,58,313,43,46,4025,3250,1150,1450,250,300,1
414,0,0,98.0,93.0,103.0,109.0,1510,2278,1175,1651,335,627,279,1089,177,708,102,381,43,47,3700,2950,1150,1750,1125,612,1
421,0,0,101.0,99.0,103.0,109.0,1538,2166,1203,1539,335,627,314,520,172,223,142,297,43,47,4200,2950,1150,1750,1125,662,1
429,0,0,98.0,100.0,103.0,109.0,1488,2054,1175,1427,313,627,864,685,557,323,307,362,44,47,4425,3000,750,1750,1525,762,1
436,0,0,103.0,102.0,103.0,109.0,1505,2054,1147,1427,358,627,594,855,397,413,197,442,45,47,4425,3150,675,1750,1600,762,1
443,0,0,99.0,95.0,103.0,101.0,1533,2026,1175,1399,358,627,774,1038,537,528,237,510,45,45,4025,3125,675,1750,2020,1362,1
450,0,0,86.0,77.0,103.0,117.0,1544,1466,1231,1063,313,403,1401,1044,982,498,419,546,46,31,3650,2900,325,1750,2994,2737,1
7,2,0,13.0,13.0,15.0,15.0,293,293,293,293,0,0,35,35,35,35,0,0,12,12,0,0,0,0,0,0,0
14,2,0,14.0,14.0,15.0,15.0,671,671,671,671,0,0,70,70,70,70,0,0,13,13,0,0,0,0,0,0,0
21,2,0,14.0,14.0,15.0,15.0,699,727,699,727,0,0,0,50,0,50,0,0,13,13,0,0,0,0,0,0,0
29,2,0,15.0,15.0,15.0,15.0,699,671,699,671,0,0,85,85,85,85,0,0,14,14,0,0,0,0,0,0,0
36,2,0,15.0,15.0,23.0,15.0,783,699,783,699,0,0,140,175,140,175,0,0,14,14,0,0,0,0,0,0,0
43,2,0,16.0,16.0,23.0,23.0,755,755,755,755,0,0,25,215,25,215,0,0,15,15,0,0,0,0,0,0,0
50,2,0,17.0,16.0,23.0,23.0,811,867,811,867,0,0,0,45,0,45,0,0,16,15,0,0,0,0,0,0,0
57,2,0,18.0,17.0,23.0,23.0,811,783,811,783,0,0,60,135,60,135,0,0,17,16,0,0,0,0,0,0,0
64,2,0,19.0,17.0,23.0,23.0,979,839,979,839,0,0,180,180,180,180,0,0,18,16,0,0,0,0,0,0,0
71,2,0,19.0,18.0,23.0,23.0,1001,839,979,839,22,0,239,275,235,275,4,0,18,17,0,0,0,0,0,0,0
79,2,0,20.0,19.0,23.0,23.0,967,894,923,783,44,111,353,330,345,310,8,20,19,18,0,0,0,0,0,0,0
86,2,0,20.0,19.0,23.0,23.0,1046,939,979,783,67,156,476,446,460,410,16,36,19,18,0,0,150,0,0,0,0
93,2,0,20.0,20.0,23.0,23.0,1046,883,979,727,67,156,49,291,25,285,24,6,20,19,0,0,150,150,0,0,0
100,2,0,21.0,20.0,23.0,23.0,1068,844,979,755,89,89,116,399,80,385,36,14,20,19,0,0,150,150,0,0,0
107,2,0,21.0,20.0,23.0,23.0,1062,911,951,867,111,44,92,107,40,85,52,22,20,19,0,0,150,150,0,0,0
114,2,0,22.0,20.0,23.0,23.0,1113,934,979,867,134,67,103,125,35,95,68,30,21,19,0,0,150,150,0,0,0
121,2,0,23.0,21.0,31.0,23.0,1107,883,951,839,156,44,228,179,140,145,88,34,22,19,0,0,150,150,0,0,0
129,2,0,25.0,22.0,31.0,23.0,1107,967,951,923,156,44,83,102,50,60,33,42,22,19,0,100,300,150,0,0,0
136,2,0,25.0,23.0,31.0,31.0,1102,1074,923,1007,179,67,213,185,160,135,53,50,22,20,0,100,300,150,50,0,0
143,2,0,25.0,23.0,31.0,31.0,1247,1191,979,1147,268,44,144,194,105,140,39,54,22,20,0,150,300,150,50,0,0
150,2,0,28.0,24.0,31.0,31.0,1258,1219,923,1175,335,44,234,237,155,225,79,12,23,21,125,150,300,150,50,0,0
157,2,0,29.0,24.0,31.0,31.0,1264,1314,951,1203,313,111,390,333,275,305,115,28,24,21,125,150,300,150,50,0,0
164,2,0,30.0,25.0,46.0,31.0,1236,1337,923,1203,313,134,245,89,190,45,55,44,25,22,125,150,300,150,50,0,0
171,2,0,32.0,25.0,46.0,31.0,1320,1331,1007,1175,313,156,295,229,200,165,95,64,26,23,125,150,300,250,50,0,0
179,2,0,31.0,23.0,46.0,46.0,1258,1275,923,1119,335,156,345,220,210,140,135,80,25,22,300,50,300,400,100,150,0
186,2,0,35.0,26.0,46.0,46.0,1370,1281,1035,1147,335,134,285,146,160,75,125,71,27,22,300,50,300,500,100,150,0
193,2,0,36.0,26.0,46.0,46.0,1538,1051,1203,895,335,156,421,271,260,180,161,91,28,22,300,50,300,500,100,150,0
200,2,0,37.0,27.0,46.0,46.0,1594,1079,1259,923,335,156,251,226,50,115,201,111,29,23,300,150,300,575,100,150,0
207,2,0,40.0,31.0,46.0,46.0,1656,1247,1343,1091,313,156,307,186,145,55,162,131,31,24,300,150,550,575,100,150,0
214,2,0,42.0,32.0,46.0,46.0,1628,1578,1315,1399,313,179,107,76,55,25,52,51,33,24,475,150,550,575,100,150,0
221,2,0,43.0,36.0,46.0,46.0,1768,1802,1455,1623,313,179,112,131,20,60,92,71,34,26,475,250,550,575,100,150,0
229,2,0,44.0,36.0,46.0,46.0,1818,1891,1483,1735,335,156,187,187,55,100,132,87,35,26,575,300,550,700,100,150,0
236,2,0,46.0,39.0,54.0,46.0,1964,1891,1651,1735,313,156,228,197,60,90,168,107,37,28,575,300,550,700,100,150,0
243,2,0,48.0,41.0,54.0,61.0,2154,2031,1819,1875,335,156,378,207,170,80,208,127,37,28,575,400,550,700,100,150,0
250,2,0,49.0,43.0,62.0,61.0,2048,1835,1735,1679,313,156,309,82,65,35,244,47,39,30,575,450,700,700,100,150,0
257,2,0,50.0,46.0,62.0,61.0,2020,1863,1707,1707,313,156,454,172,170,105,284,67,39,30,575,550,1150,700,100,150,0
264,2,0,49.0,47.0,70.0,61.0,2132,2110,1819,1931,313,179,509,352,285,265,224,87,41,31,450,550,1150,700,225,150,0
271,2,0,56.0,51.0,70.0,61.0,2182,1886,1847,1707,335,179,114,327,50,220,64,107,41,33,700,600,1150,700,225,150,0
279,2,0,57.0,52.0,70.0,61.0,2250,2003,1735,1847,515,156,326,148,190,125,136,23,42,34,700,700,1150,850,225,150,0
286,2,0,59.0,56.0,70.0,61.0,2272,2171,1623,2015,649,156,558,123,350,105,208,18,44,36,700,750,1150,850,225,150,0
293,2,0,61.0,59.0,70.0,69.0,2356,2367,1707,2211,649,156,233,203,45,165,188,38,45,38,700,750,1150,850,225,150,0
300,2,0,63.0,60.0,70.0,69.0,2474,2451,1847,2295,627,156,439,418,175,360,264,58,46,39,850,850,1150,925,225,150,0
307,2,0,69.0,66.0,70.0,69.0,2496,2574,1847,2239,649,335,234,171,90,65,144,106,47,41,1350,900,1150,925,225,150,0
314,2,0,71.0,66.0,78.0,69.0,2630,2759,1959,2267,671,492,339,221,115,155,224,66,48,43,1350,900,1150,925,225,150,0
321,2,0,71.0,69.0,78.0,77.0,2434,2765,1763,2295,671,470,225,282,25,160,200,122,49,44,1350,900,1150,1175,225,150,0
329,2,0,75.0,69.0,78.0,77.0,2580,2821,1931,2351,649,470,291,268,115,240,176,28,50,44,1500,1100,1150,1175,225,150,0
336,2,0,76.0,67.0,86.0,77.0,2580,3011,1931,2519,649,492,202,563,100,475,102,88,51,45,1500,1050,1150,1175,225,300,0
343,2,0,77.0,64.0,86.0,85.0,2580,2731,1931,2239,649,492,502,703,320,555,182,148,52,45,1500,800,1150,1175,225,550,0
350,2,0,84.0,57.0,86.0,85.0,2502,2664,1875,2127,627,537,258,841,200,650,58,191,54,46,2000,300,1150,1175,225,1050,0
357,2,0,85.0,59.0,86.0,85.0,2574,2714,1903,2155,671,559,468,619,330,435,138,184,54,48,2000,200,1550,1175,225,1200,0
364,2,0,87.0,57.0,101.0,85.0,2709,2485,2015,1903,694,582,148,672,30,445,118,227,55,47,2000,200,1550,1525,225,1300,0
371,2,0,88.0,62.0,101.0,85.0,2720,2462,2071,1903,649,559,130,741,90,475,40,266,56,47,2000,425,1550,1675,225,1300,0
379,2,0,90.0,61.0,101.0,85.0,2810,2619,2183,2015,627,604,466,923,350,610,116,313,59,48,2000,400,1550,1675,225,1450,0
386,2,0,92.0,65.0,101.0,85.0,3140,2440,2491,1791,649,649,351,448,155,380,196,68,60,48,2000,400,1550,1675,225,1450,0
393,2,0,94.0,72.0,101.0,85.0,3146,2446,2519,1819,627,627,552,574,330,455,222,119,63,48,2175,625,1550,1850,225,1450,0
400,2,0,100.0,74.0,101.0,85.0,3174,2502,2547,1875,627,627,372,809,170,635,202,174,63,48,2525,750,1550,2000,225,1450,0
407,2,0,100.0,78.0,109.0,85.0,3162,2602,2491,1931,671,671,747,469,465,265,282,204,63,49,3025,850,1550,2000,225,1450,0
414,2,0,107.0,85.0,109.0,85.0,3414,2608,2743,1959,671,649,618,385,460,305,158,80,65,50,3025,1500,1850,2075,225,1450,0
421,2,0,107.0,85.0,117.0,85.0,3392,2608,2743,1959,649,649,1024,576,790,420,234,156,65,49,3025,1625,1850,2175,225,1550,0
429,2,0,107.0,85.0,117.0,85.0,3392,2546,2743,1875,649,671,750,366,440,155,310,211,66,48,3025,1725,1850,2175,225,1650,0
436,2,0,104.0,93.0,117.0,93.0,3252,2496,2603,1847,649,649,1345,277,905,65,440,212,66,49,3025,1850,2150,2175,225,1650,0
443,2,0,114.0,93.0,117.0,93.0,3314,2418,2687,1791,627,627,701,553,485,265,216,288,66,52,2850,2200,2150,2175,400,1800,0
450,2,0,112.0,96.0,133.0,109.0,3364,2496,2715,1847,649,649,926,593,680,250,246,343,66,52,3550,1900,2150,2175,750,2100,0
457,2,0,115.0,102.0,133.0,117.0,3381,2602,2687,1931,694,671,680,428,350,155,330,273,66,55,3725,2275,2150,2175,750,2200,0
464,2,0,109.0,95.0,133.0,109.0,3420,2630,2547,1959,873,671,1083,394,645,95,438,299,67,55,3225,1875,2150,2175,1250,2700,0
471,2,0,115.0,96.0,133.0,109.0,3437,2692,2519,2043,918,649,425,450,175,100,250,350,69,55,3050,1975,2150,2175,1725,3075,0
479,2,0,107.0,93.0,133.0,109.0,3487,2776,2547,2127,940,649,842,401,480,25,362,376,69,55,3400,1825,2450,2175,2425,3375,0
486,2,0,106.0,83.0,141.0,109.0,3482,2670,2519,2043,963,627,948,517,620,90,328,427,69,55,3050,1300,2450,2175,2775,4150,0
493,2,0,97.0,82.0,141.0,109.0,3493,1824,2575,1287,918,537,1321,647,885,156,436,491,69,47,2175,1775,2450,2175,3650,4550,0
498,2,0,97.0,82.0,141.0,109.0,3493,1505,2575,1035,918,470,1321,617,885,111,436,506,69,47,2175,1875,2450,2175,3650,4550,0
7,2,0,13.0,13.0,15.0,15.0,293,377,293,377,0,0,35,45,35,45,0,0,12,12,0,0,0,0,0,0,0
14,2,0,14.0,14.0,15.0,15.0,643,671,643,671,0,0,65,70,65,70,0,0,13,13,0,0,0,0,0,0,0
21,2,0,14.0,14.0,15.0,15.0,671,727,671,727,0,0,40,5,40,5,0,0,13,13,0,0,0,0,0,0,0
29,2,0,15.0,15.0,15.0,15.0,699,699,699,699,0,0,80,5,80,5,0,0,14,14,0,0,0,0,0,0,0
36,2,0,15.0,15.0,15.0,15.0,755,755,755,755,0,0,130,55,130,55,0,0,14,14,0,0,0,0,0,0,0
43,2,0,16.0,16.0,23.0,23.0,755,783,755,783,0,0,65,140,65,140,0,0,15,15,0,0,0,0,0,0,0
50,2,0,17.0,16.0,23.0,23.0,783,811,783,811,0,0,45,25,45,25,0,0,16,15,0,0,0,0,0,0,0
57,2,0,18.0,17.0,23.0,23.0,783,788,783,699,0,89,95,41,95,25,0,16,17,16,0,0,0,0,0,0,0
64,2,0,19.0,18.0,23.0,23.0,923,855,923,699,0,156,155,42,155,10,0,32,18,17,0,0,0,0,0,0,0
71,2,0,19.0,18.0,23.0,23.0,917,855,895,699,22,156,219,142,215,90,4,52,18,17,0,0,0,0,0,0,0
79,2,0,20.0,19.0,23.0,23.0,1023,771,979,615,44,156,338,222,330,150,8,72,19,18,0,0,0,0,0,0,0
86,2,0,20.0,19.0,23.0,23.0,1090,799,979,531,111,268,74,337,50,225,24,112,19,18,0,0,150,0,0,0,0
93,2,0,21.0,20.0,23.0,23.0,1062,950,951,615,111,335,136,198,100,100,36,98,20,19,0,0,150,150,0,0,0
100,2,0,22.0,20.0,23.0,23.0,1107,962,951,671,156,291,76,60,20,30,56,30,21,19,0,0,150,150,0,0,0
107,2,0,22.0,20.0,23.0,23.0,1158,889,979,643,179,246,131,67,55,5,76,62,21,19,0,0,150,150,0,0,0
114,2,0,23.0,20.0,23.0,23.0,1158,911,979,755,179,156,111,183,15,105,96,78,21,19,0,0,150,150,0,0,0
121,2,0,23.0,21.0,23.0,23.0,1107,950,951,727,156,223,232,150,120,40,112,110,21,19,0,0,150,150,0,0,0
129,2,0,23.0,22.0,23.0,23.0,1152,1118,951,895,201,223,325,129,185,45,140,84,21,19,100,100,150,150,0,0,0
136,2,0,26.0,22.0,31.0,23.0,1158,1230,867,1007,291,223,236,272,85,160,151,112,21,19,100,100,300,150,0,50,0
143,2,0,26.0,25.0,31.0,31.0,1130,1303,839,1035,291,268,227,269,90,125,137,144,21,20,100,100,300,400,0,50,0
150,2,0,27.0,25.0,31.0,31.0,1130,1320,839,1119,291,201,373,484,200,320,173,164,22,20,100,100,300,400,0,50,0
157,2,0,27.0,26.0,46.0,31.0,1264,1449,951,1203,313,246,470,451,265,305,205,146,22,21,225,200,300,400,50,50,0
164,2,0,30.0,29.0,46.0,31.0,1107,1258,839,1035,268,223,358,545,175,375,183,170,22,21,225,300,300,400,50,50,0
171,2,0,31.0,29.0,46.0,31.0,917,1264,671,1063,246,201,425,213,210,15,215,198,24,22,225,300,400,400,50,50,0
179,2,0,32.0,30.0,46.0,31.0,1135,1303,867,1035,268,268,121,325,20,95,101,230,24,22,225,300,400,400,50,50,0
186,2,0,32.0,30.0,46.0,31.0,1275,1264,1007,1063,268,201,278,235,145,85,133,150,26,22,400,400,400,400,50,50,0
193,2,0,35.0,29.0,46.0,31.0,1253,1286,1007,1063,246,223,200,198,85,103,115,95,26,23,400,400,400,400,50,150,0
200,2,0,33.0,29.0,46.0,39.0,1186,1477,895,1231,291,246,236,351,85,228,151,123,27,23,175,400,400,400,275,150,0
207,2,0,34.0,30.0,46.0,39.0,1118,1488,783,1287,335,201,326,305,135,158,191,147,28,23,175,400,500,400,275,150,0
214,2,0,37.0,34.0,46.0,39.0,1516,1460,1203,1147,313,313,307,130,130,68,177,62,29,24,350,400,500,475,275,150,0
221,2,0,38.0,34.0,46.0,39.0,1544,1432,1231,1119,313,313,432,291,215,193,217,98,30,24,350,400,500,725,275,150,0
229,2,0,41.0,35.0,46.0,39.0,1684,1376,1371,1063,313,313,233,216,80,103,153,113,31,25,350,300,800,825,275,250,0
236,2,0,43.0,35.0,46.0,47.0,1656,1342,1343,1007,313,335,333,396,140,243,193,153,33,25,350,300,800,825,275,250,0
243,2,0,45.0,36.0,46.0,47.0,1824,1292,1511,979,313,313,259,257,130,68,129,189,33,26,775,575,800,825,275,250,0
250,2,0,47.0,41.0,54.0,47.0,1874,1449,1539,1091,335,358,414,241,245,164,169,77,35,26,775,675,800,825,275,250,0
257,2,0,48.0,44.0,54.0,47.0,1930,1236,1595,923,335,313,309,237,200,124,109,113,36,27,775,675,800,825,275,250,0
264,2,0,51.0,44.0,54.0,62.0,1936,1146,1623,811,313,335,315,376,170,219,145,157,37,27,1025,675,800,825,275,250,0
271,2,0,52.0,46.0,54.0,62.0,1998,1370,1707,1035,291,335,217,301,140,104,77,197,38,28,1025,775,800,825,275,250,0
279,2,0,53.0,48.0,54.0,62.0,1986,1522,1651,1119,335,403,258,288,145,139,113,149,39,28,1275,1250,800,825,275,250,0
286,2,0,57.0,52.0,62.0,62.0,2014,1723,1679,1231,335,492,203,119,150,14,53,105,41,28,1275,1250,800,825,275,250,0
293,2,0,58.0,55.0,62.0,62.0,2076,1673,1763,1203,313,470,404,176,315,19,89,157,42,28,1275,1350,800,825,275,250,0
300,2,0,61.0,56.0,70.0,62.0,2222,1645,1819,1175,403,470,325,231,280,14,45,217,43,29,1525,1350,800,825,275,250,0
307,2,0,62.0,59.0,70.0,62.0,2306,1897,1679,1427,627,470,191,446,70,169,121,277,44,30,1525,1650,800,825,275,250,0
314,2,0,64.0,60.0,70.0,62.0,2362,2003,1735,1511,627,492,218,551,100,214,118,337,45,31,1525,1900,1050,825,275,250,0
321,2,0,65.0,61.0,70.0,70.0,2395,1981,1791,1511,604,470,451,833,265,444,186,389,46,32,1775,1900,1050,825,275,250,0
329,2,0,65.0,58.0,78.0,70.0,2367,1667,1763,1287,604,380,729,613,475,184,254,429,47,31,1775,2000,1050,825,275,400,0
336,2,0,72.0,64.0,78.0,70.0,2423,1908,1819,1595,604,313,115,459,85,94,30,365,47,31,1875,2000,1050,825,500,400,0
343,2,0,72.0,64.0,78.0,70.0,2541,2160,1959,1847,582,313,418,679,320,274,98,405,47,31,1875,1950,1050,825,500,450,0
350,2,0,72.0,64.0,78.0,70.0,2406,2020,1847,1707,559,313,505,609,335,164,170,445,47,32,1875,2050,1050,825,500,450,0
357,2,0,74.0,63.0,78.0,70.0,2395,2042,1791,1707,604,335,316,604,120,119,196,485,47,33,2050,1700,1050,825,500,800,0
364,2,0,70.0,54.0,78.0,70.0,2423,2076,1819,1763,604,313,609,760,345,239,264,521,47,33,2050,1175,1050,825,850,1575,0
371,2,0,72.0,52.0,94.0,70.0,2367,2350,1763,2015,604,335,435,670,245,234,190,436,47,35,1700,650,1050,825,1200,2150,0
379,2,0,72.0,53.0,109.0,70.0,2451,2182,1847,1847,604,335,228,705,120,229,108,476,47,36,2075,600,1050,825,1200,2250,0
386,2,0,72.0,54.0,109.0,70.0,2367,2166,1763,1763,604,403,575,757,345,229,230,528,49,37,2075,600,1050,825,1200,2250,0
393,2,0,74.0,56.0,109.0,70.0,2429,2227,1847,1735,582,492,452,632,325,94,127,538,50,38,2075,650,1050,1050,1200,2300,0
400,2,0,76.0,57.0,109.0,85.0,2451,2289,1847,1819,604,470,454,803,255,209,199,594,52,39,2075,650,1050,1200,1200,2300,0
407,2,0,79.0,62.0,109.0,85.0,2479,2507,1875,2015,604,492,560,508,285,104,275,404,54,41,2325,950,1350,1200,1200,2300,0
414,2,0,79.0,63.0,109.0,85.0,2720,2513,2071,1931,649,582,836,429,485,74,351,355,54,42,2425,1000,1500,1325,1200,2300,0
421,2,0,80.0,66.0,117.0,85.0,2854,2658,2183,1987,671,671,816,504,485,69,331,435,57,42,2175,1000,1500,1325,1450,2300,0
429,2,0,87.0,69.0,117.0,85.0,3028,2625,2379,1931,649,694,98,389,45,49,53,340,58,42,2175,1175,2150,1400,1450,2300,0
436,2,0,89.0,72.0,117.0,85.0,3146,2776,2519,2127,627,649,484,696,355,259,129,437,60,42,2175,1350,2150,1500,1450,2300,0
443,2,0,88.0,78.0,117.0,85.0,3006,2670,2379,2043,627,627,279,457,70,144,209,313,62,42,2175,1350,2150,1600,1450,2300,0
450,2,0,94.0,82.0,125.0,85.0,3011,2692,2407,2043,604,649,311,377,130,34,181,343,62,43,2175,1400,2150,1600,1450,2300,0
457,2,0,94.0,84.0,125.0,85.0,3202,2972,2575,2323,627,649,206,457,45,9,161,448,62,45,2525,1575,2150,1600,1450,2300,0
464,2,0,100.0,85.0,125.0,85.0,3386,3022,2715,2351,671,671,112,568,75,44,37,524,62,47,3025,1850,2150,1600,1450,2300,0
471,2,0,100.0,93.0,125.0,93.0,3358,2966,2687,2295,671,671,498,434,385,34,113,400,62,49,3025,2425,2300,1600,1450,2300,0
479,2,0,106.0,93.0,125.0,93.0,3504,2944,2855,2295,649,649,504,485,315,9,189,476,62,49,3025,2425,2300,1600,1450,2300,0
486,2,0,108.0,97.0,125.0,101.0,3454,2894,2827,2267,627,627,470,636,405,134,65,502,62,51,3325,2425,2300,1700,1450,2300,0
493,2,0,108.0,101.0,125.0,101.0,3398,2748,2771,2099,627,649,350,526,205,94,145,432,62,51,3425,2525,2750,1700,1450,2300,0
500,2,0,112.0,106.0,133.0,109.0,3280,3022,2631,2351,649,671,690,466,465,4,225,462,62,53,4025,2725,2900,1700,1450,2300,0
507,2,0,126.0,107.0,133.0,117.0,3196,3146,2547,2519,649,627,361,608,60,174,301,434,62,53,4425,3100,3200,1850,1450,2300,0
514,2,0,126.0,110.0,133.0,117.0,3302,3056,2631,2407,671,649,766,623,385,109,381,514,62,55,4725,3050,3200,2000,1450,2350,0
521,2,0,132.0,112.0,149.0,125.0,3246,3106,2575,2435,671,671,642,718,185,149,457,569,62,56,5025,3450,3550,2000,1450,2400,0
529,2,0,140.0,116.0,149.0,133.0,3286,3252,2659,2603,627,649,629,704,100,159,529,545,62,59,5275,3450,3550,2000,1450,2400,0
536,2,0,142.0,121.0,149.0,133.0,3202,3246,2575,2575,627,671,904,599,295,174,609,425,62,59,5775,3625,3550,2075,1450,2450,0
543,2,0,148.0,126.0,165.0,133.0,3224,3543,2575,2715,649,828,894,438,205,159,689,279,62,62,6075,3675,3550,2275,1450,2450,0
550,2,0,152.0,129.0,165.0,133.0,3140,3689,2491,2771,649,918,879,355,410,89,469,266,62,62,6075,3725,3550,2375,1450,2450,0
557,2,0,162.0,129.0,165.0,141.0,3106,3823,2435,2883,671,940,445,306,350,49,95,257,62,63,6475,3725,3550,2600,1450,2450,0
564,2,0,168.0,135.0,173.0,141.0,3157,3924,2463,2939,694,985,380,346,205,94,175,252,62,64,7475,4225,3550,2600,1450,2450,0
571,2,0,158.0,134.0,173.0,149.0,3090,3314,2463,2351,627,963,738,624,495,264,243,360,62,63,7025,4625,3550,2600,2100,2650,0
579,2,0,128.0,100.0,173.0,149.0,2978,2485,2351,1679,627,806,893,347,570,149,323,198,62,51,4875,3350,3550,2375,4250,4518,0
586,2,0,130.0,98.0,173.0,149.0,3106,2244,2435,1595,671,649,576,287,165,41,411,246,62,50,4325,2975,3550,2375,5000,5049,0
593,2,0,132.0,102.0,173.0,149.0,3106,2524,2323,1875,783,649,852,412,345,86,507,326,62,50,5125,2975,3550,2375,5000,5049,0
600,2,0,130.0,100.0,173.0,157.0,2972,2810,2099,2183,873,627,890,298,425,46,465,252,62,52,5025,3000,3550,2375,5100,5574,0
7,2,0,13.0,13.0,15.0,15.0,335,335,335,335,0,0,40,40,40,40,0,0,12,12,0,0,0,0,0,0,1
14,2,0,14.0,14.0,15.0,15.0,671,671,671,671,0,0,70,70,70,70,0,0,13,13,0,0,0,0,0,0,1
21,2,0,14.0,14.0,15.0,15.0,699,671,699,671,0,0,45,45,45,45,0,0,13,13,0,0,0,0,0,0,1
29,2,0,15.0,15.0,15.0,15.0,699,671,699,671,0,0,85,30,85,30,0,0,14,14,0,0,0,0,0,0,1
36,2,0,15.0,15.0,23.0,15.0,755,755,755,755,0,0,135,130,135,130,0,0,14,14,0,0,0,0,0,0,1
43,2,0,16.0,16.0,23.0,23.0,839,783,839,783,0,0,30,65,30,65,0,0,15,15,0,0,0,0,0,0,1
50,2,0,17.0,16.0,23.0,23.0,839,839,839,839,0,0,55,40,55,40,0,0,16,15,0,0,0,0,0,0,1
57,2,0,18.0,17.0,23.0,23.0,811,755,811,755,0,0,100,35,100,35,0,0,17,16,0,0,0,0,0,0,1
64,2,0,19.0,18.0,23.0,23.0,867,811,867,811,0,0,155,125,155,125,0,0,18,17,0,0,0,0,0,0,1
71,2,0,19.0,18.0,23.0,23.0,895,855,895,811,0,44,215,213,215,205,0,8,18,17,0,0,0,0,0,0,1
79,2,0,20.0,19.0,23.0,23.0,951,967,951,811,0,156,325,338,325,310,0,28,19,18,0,0,0,0,0,0,1
86,2,0,20.0,19.0,23.0,23.0,995,939,951,783,44,156,293,439,285,395,8,44,19,18,0,0,150,0,0,0,1
93,2,0,20.0,20.0,23.0,23.0,962,911,895,755,67,156,411,339,395,275,16,64,20,19,0,0,150,150,0,0,1
100,2,0,21.0,20.0,23.0,23.0,1012,883,923,727,89,156,83,449,55,365,28,84,20,19,0,0,150,150,0,0,1
107,2,0,21.0,20.0,23.0,23.0,1006,911,895,755,111,156,104,154,60,50,44,104,20,19,0,50,150,150,0,0,1
114,2,0,22.0,20.0,23.0,23.0,1062,911,951,755,111,156,131,169,75,95,56,74,21,19,0,50,150,150,0,0,1
121,2,0,23.0,21.0,23.0,23.0,1057,934,923,755,134,179,131,129,55,35,76,94,22,19,0,50,150,150,0,0,1
129,2,0,25.0,22.0,31.0,23.0,1130,1074,951,895,179,179,36,214,15,100,21,114,22,20,0,50,300,150,0,0,1
136,2,0,26.0,22.0,31.0,23.0,1074,1051,895,895,179,156,121,95,80,65,41,30,23,20,0,50,300,150,0,0,1
143,2,0,25.0,23.0,31.0,31.0,1152,995,951,839,201,156,250,105,185,55,65,50,22,21,0,50,300,150,50,0,1
150,2,0,28.0,25.0,31.0,31.0,1214,1051,923,895,291,156,221,140,170,70,51,70,23,21,125,50,300,250,50,0,1
157,2,0,29.0,26.0,31.0,31.0,1236,1023,923,867,313,156,166,125,75,35,91,90,24,22,125,50,300,250,50,0,1
164,2,0,29.0,26.0,31.0,31.0,1236,1247,923,1091,313,156,71,245,40,135,31,110,24,22,125,50,300,250,50,0,1
171,2,0,31.0,29.0,46.0,31.0,1275,1314,1007,1091,268,223,78,288,15,150,63,138,25,23,125,150,300,250,50,0,1
179,2,0,33.0,29.0,46.0,46.0,1320,1348,1007,1035,313,313,128,284,25,110,103,174,27,24,300,150,300,500,50,0,1
186,2,0,34.0,30.0,46.0,46.0,1398,1292,1063,979,335,313,293,134,150,20,143,114,28,24,300,250,300,500,50,0,1
193,2,0,35.0,31.0,46.0,46.0,1544,1320,1231,1007,313,313,134,179,55,50,79,129,29,25,300,250,300,600,50,0,1
200,2,0,36.0,33.0,46.0,46.0,1600,1628,1287,1315,313,313,274,274,155,105,119,169,30,25,300,250,450,600,50,0,1
207,2,0,38.0,34.0,46.0,46.0,1684,1432,1371,1119,313,313,119,399,110,190,9,209,32,25,300,250,700,675,50,0,1
214,2,0,38.0,37.0,46.0,46.0,1734,1673,1399,1315,335,358,184,234,135,110,49,124,32,26,300,350,700,675,50,0,1
221,2,0,40.0,42.0,46.0,46.0,1830,1734,1539,1399,291,335,306,85,225,25,81,60,34,27,300,350,700,925,50,0,1
229,2,0,41.0,43.0,46.0,46.0,1802,1824,1511,1511,291,313,262,261,145,165,117,96,35,28,300,350,700,925,50,0,1
236,2,0,43.0,45.0,46.0,46.0,1802,1768,1511,1455,291,313,374,221,300,85,74,136,36,28,300,400,950,925,50,0,1
243,2,0,48.0,50.0,54.0,54.0,1930,1880,1595,1567,335,313,269,126,255,75,14,51,37,29,300,725,950,925,50,0,1
250,2,0,49.0,50.0,54.0,54.0,2020,1880,1707,1567,313,313,509,351,455,260,54,91,38,31,650,725,950,925,50,0,1
257,2,0,50.0,52.0,62.0,62.0,2014,2014,1679,1679,335,335,439,431,345,325,94,106,40,31,750,1025,950,925,50,0,1
264,2,0,51.0,54.0,62.0,62.0,2054,2093,1763,1735,291,358,496,471,445,325,51,146,41,31,750,1025,950,925,50,0,1
271,2,0,54.0,56.0,62.0,62.0,2138,1958,1847,1623,291,335,337,372,300,190,37,182,41,33,925,1075,950,925,50,0,1
279,2,0,56.0,58.0,70.0,62.0,2266,1964,1931,1651,335,313,312,508,285,290,27,218,42,33,1100,1400,950,1000,50,0,1
286,2,0,59.0,60.0,78.0,70.0,2238,1964,1903,1651,335,313,298,453,260,325,38,128,42,35,1100,1350,950,1000,50,50,1
293,2,0,59.0,59.0,78.0,70.0,2294,2020,1959,1707,335,313,573,560,495,471,78,89,42,35,1100,1450,950,1000,50,50,1
300,2,0,63.0,63.0,86.0,70.0,2328,2233,2015,1875,313,358,589,379,525,244,64,135,42,35,1225,1450,1050,1000,50,50,1
307,2,0,61.0,66.0,86.0,70.0,2300,2272,1987,1847,313,425,854,372,750,314,104,58,42,36,1175,1450,1050,1000,325,50,1
314,2,0,59.0,63.0,86.0,70.0,2272,2160,1959,1735,313,425,924,600,780,494,144,106,42,37,1000,1175,1100,1000,600,325,1
321,2,0,51.0,62.0,86.0,78.0,1930,2031,1595,1651,335,380,1129,720,945,574,184,146,40,36,1000,1175,1100,1150,1075,475,1
329,2,0,53.0,58.0,86.0,78.0,1264,2087,951,1707,313,380,645,679,575,612,70,67,34,38,1000,750,1100,1275,1375,912,1
336,2,0,53.0,58.0,94.0,78.0,1230,1981,895,1623,335,358,465,493,355,382,110,111,35,38,1525,1050,1100,1275,1300,912,1
343,2,0,55.0,63.0,94.0,78.0,1454,1807,1119,1427,335,380,555,406,405,347,150,59,36,38,1525,1425,1100,1275,1300,912,1
350,2,0,56.0,64.0,94.0,78.0,1880,2149,1567,1679,313,470,541,491,355,372,186,119,37,39,1525,1425,1100,1275,1300,912,1
357,2,0,60.0,67.0,94.0,78.0,1992,2300,1679,1763,313,537,236,401,210,322,26,79,39,40,1525,1425,1100,1275,1300,912,1
364,2,0,64.0,69.0,94.0,78.0,2048,2535,1735,2043,313,492,187,597,125,462,62,135,39,42,1900,1425,1100,1275,1400,912,1
371,2,0,63.0,71.0,94.0,78.0,1846,2395,1511,1903,335,492,192,368,90,252,102,116,38,42,1900,1750,1100,1275,1450,912,1
379,2,0,66.0,74.0,94.0,78.0,1992,2429,1455,1959,537,470,238,614,135,442,103,172,40,44,1900,1800,1100,1275,1450,912,1
386,2,0,67.0,75.0,94.0,78.0,2138,2653,1511,2183,627,470,389,394,210,162,179,232,41,44,1900,1800,1100,1275,1450,912,1
393,2,0,69.0,77.0,94.0,86.0,2306,2737,1679,2267,627,470,634,629,375,337,259,292,43,46,1900,1925,1100,1275,1450,912,1
400,2,0,70.0,82.0,94.0,86.0,2356,2647,1707,2043,649,604,814,677,475,371,339,306,44,48,2000,2025,1100,1425,1450,912,1
407,2,0,78.0,87.0,109.0,101.0,2496,2793,1847,2099,649,694,224,452,155,272,69,180,46,48,2000,2025,1400,1425,1450,912,1
414,2,0,81.0,91.0,109.0,109.0,2541,2938,1847,2267,694,671,210,529,165,302,45,227,48,50,2000,2025,1400,1425,1450,912,1
421,2,0,81.0,93.0,109.0,109.0,2541,2966,1847,2295,694,671,255,609,130,427,125,182,49,50,1900,2250,1400,1325,1550,912,1
429,2,0,83.0,100.0,109.0,109.0,2530,2978,1903,2351,627,627,518,376,325,247,193,129,51,52,1900,2250,1400,1400,1550,912,1
436,2,0,86.0,100.0,109.0,109.0,2698,3006,2071,2379,627,627,633,671,460,462,173,209,52,52,2050,2575,1400,1700,1550,912,1
443,2,0,93.0,105.0,109.0,109.0,2726,3034,2099,2407,627,627,108,611,55,447,53,164,55,54,2050,3000,1550,1700,1550,912,1
450,2,0,93.0,109.0,109.0,117.0,2860,3078,2211,2407,649,671,183,686,150,442,33,244,55,55,2350,3000,1550,1700,1550,912,1
457,2,0,96.0,113.0,109.0,117.0,3006,2910,2379,2239,627,671,249,437,140,317,109,120,58,55,2850,3000,1550,1775,1550,912,1
464,2,0,97.0,116.0,109.0,117.0,3073,3078,2379,2407,694,671,539,268,350,222,189,46,60,57,2850,3525,1700,1775,1550,912,1
471,2,0,98.0,117.0,109.0,117.0,3196,3336,2547,2687,649,649,876,254,615,207,261,47,62,58,2850,3575,1700,1775,1550,962,1
479,2,0,99.0,125.0,109.0,125.0,3146,3258,2519,2631,627,627,1062,275,725,177,337,98,62,60,2850,3575,1700,1875,1550,962,1
486,2,0,107.0,125.0,109.0,125.0,3179,3381,2463,2687,716,694,673,402,440,212,233,190,64,60,2850,4025,2100,1875,1550,962,1
493,2,0,107.0,135.0,109.0,141.0,3431,3431,2491,2603,940,828,703,277,350,137,353,140,64,61,2850,4075,2250,1875,1550,962,1
500,2,0,105.0,135.0,109.0,141.0,3258,3566,2295,2715,963,851,1079,712,610,472,469,240,66,63,2750,4325,2250,1875,1650,962,1
507,2,0,109.0,141.0,109.0,157.0,3353,3112,2323,2239,1030,873,769,232,330,92,439,140,66,63,2950,4425,2250,1875,1650,962,1
514,2,0,109.0,148.0,125.0,165.0,3353,3280,2323,2295,1030,985,1155,558,600,302,555,256,66,63,2950,4825,2250,1875,1650,962,1
521,2,0,105.0,147.0,141.0,165.0,3347,3370,2407,2407,940,963,1559,535,900,292,659,243,66,63,2675,4775,2400,1875,1925,1112,1
529,2,0,111.0,150.0,157.0,173.0,3342,3347,2379,2407,963,940,1254,601,475,292,779,309,66,63,3275,5525,2550,1875,2525,1162,1
536,2,0,115.0,145.0,157.0,173.0,3370,3370,2407,2407,963,963,1164,1003,465,578,699,425,66,63,3125,5275,2550,1875,2675,1537,1
543,2,0,114.0,145.0,157.0,173.0,3263,3414,2323,2407,940,1007,1470,1228,655,708,815,520,63,63,3225,5600,2400,1875,2975,1587,1
550,2,0,121.0,140.0,157.0,173.0,2558,3336,1707,2351,851,985,1040,1199,125,613,915,586,62,63,2925,5125,2400,1875,3325,2287,1
557,2,0,95.0,132.0,157.0,173.0,2306,3504,1455,2519,851,985,1311,546,300,223,1011,323,62,63,1900,4100,2400,1875,5050,3312,1
564,2,0,71.0,129.0,157.0,173.0,2233,3308,1427,2323,806,985,1574,517,475,128,1099,389,62,63,275,3825,2400,1875,6675,3737,1
7,2,2,13.0,13.0,15.0,15.0,251,293,251,293,0,0,30,35,30,35,0,0,12,12,0,0,0,0,0,0,1
14,2,2,14.0,14.0,15.0,15.0,671,671,671,671,0,0,70,70,70,70,0,0,13,13,0,0,0,0,0,0,1
21,2,2,14.0,14.0,15.0,15.0,699,699,699,699,0,0,50,50,50,50,0,0,13,13,0,0,0,0,0,0,1
29,2,2,15.0,15.0,15.0,15.0,699,643,699,643,0,0,80,80,80,80,0,0,14,14,0,0,0,0,0,0,1
36,2,2,16.0,15.0,23.0,23.0,839,783,839,783,0,0,150,140,150,140,0,0,15,14,0,0,0,0,0,0,1
43,2,2,16.0,16.0,23.0,23.0,839,783,839,783,0,0,85,30,85,30,0,0,15,15,0,0,0,0,0,0,1
50,2,2,17.0,17.0,23.0,23.0,839,811,839,811,0,0,60,5,60,5,0,0,16,16,0,0,0,0,0,0,1
57,2,2,18.0,18.0,23.0,23.0,839,783,839,783,0,0,40,40,40,40,0,0,17,17,0,0,0,0,0,0,1
64,2,2,19.0,19.0,23.0,23.0,979,895,979,895,0,0,110,100,110,100,0,0,18,18,0,0,0,0,0,0,1
71,2,2,19.0,19.0,23.0,23.0,923,951,923,951,0,0,55,10,55,10,0,0,18,18,0,0,0,0,0,0,1
79,2,2,20.0,20.0,23.0,23.0,995,995,951,951,44,44,83,83,75,75,8,8,19,19,0,0,0,0,0,0,1
86,2,2,21.0,21.0,23.0,23.0,978,1079,867,923,111,156,200,158,180,130,20,28,20,20,0,0,150,0,0,0,1
93,2,2,22.0,22.0,23.0,23.0,1029,1001,895,867,134,134,121,120,85,80,36,40,21,21,0,0,150,150,0,0,1
100,2,2,22.0,22.0,23.0,23.0,1062,1118,839,895,223,223,148,112,80,40,68,72,21,21,0,0,150,150,0,0,1
107,2,2,23.0,23.0,23.0,23.0,1118,1090,895,867,223,223,237,181,145,85,92,96,22,22,0,0,150,150,0,0,1
114,2,2,24.0,24.0,31.0,31.0,1118,1135,895,867,223,268,319,332,195,200,124,132,23,23,0,0,300,150,0,0,1
121,2,2,24.0,24.0,31.0,31.0,1186,1158,895,867,291,291,459,413,295,245,164,168,23,23,0,0,300,300,0,0,1
129,2,2,29.0,29.0,31.0,31.0,1152,1174,839,839,313,335,199,108,95,50,104,58,24,24,0,0,450,450,0,0,1
136,2,2,29.0,29.0,31.0,31.0,1180,1174,867,839,313,335,239,148,95,50,144,98,24,24,0,0,450,450,0,0,1
143,2,2,29.0,30.0,31.0,31.0,1225,1202,867,867,358,335,389,249,205,115,184,134,25,25,0,0,450,450,0,0,1
150,2,2,29.0,30.0,31.0,31.0,1202,1236,867,923,335,313,430,240,210,70,220,170,25,25,0,0,450,450,0,0,1
157,2,2,31.0,33.0,39.0,39.0,1236,1264,923,951,313,313,406,220,200,60,206,160,25,26,250,350,450,450,0,0,1
164,2,2,33.0,35.0,39.0,47.0,1236,1236,923,923,313,313,466,205,270,55,196,150,25,27,250,350,450,450,0,0,1
171,2,2,33.0,35.0,39.0,47.0,1208,1264,895,951,313,313,606,355,370,165,236,190,25,27,250,350,450,450,0,0,1
179,2,2,34.0,35.0,39.0,47.0,1208,1258,895,923,313,335,616,510,340,280,276,230,25,27,250,350,450,450,0,0,1
186,2,2,34.0,34.0,39.0,47.0,1208,1309,895,951,313,358,752,670,440,400,312,270,25,26,250,525,450,450,0,50,1
193,2,2,38.0,34.0,39.0,47.0,1258,1342,923,1007,335,335,567,421,315,115,252,306,26,26,600,700,450,450,0,50,1
200,2,2,38.0,37.0,47.0,47.0,1208,1292,895,979,313,313,449,272,265,30,184,242,26,26,600,700,450,450,0,50,1
207,2,2,39.0,37.0,47.0,39.0,1286,1264,951,951,335,313,568,327,340,45,228,282,26,26,600,700,450,450,0,150,1
214,2,2,39.0,38.0,47.0,39.0,1292,1292,979,979,313,313,325,307,65,85,260,222,27,26,600,700,450,450,0,200,1
221,2,2,39.0,37.0,47.0,39.0,1292,1202,979,867,313,335,375,407,75,45,300,362,27,26,950,700,450,450,0,200,1
229,2,2,44.0,37.0,47.0,47.0,1320,1292,1007,979,313,313,190,458,50,60,140,398,27,26,950,850,450,450,0,200,1
236,2,2,45.0,40.0,47.0,47.0,1264,1208,951,895,313,313,285,404,105,70,180,334,28,27,1250,1000,700,450,0,200,1
243,2,2,45.0,40.0,47.0,47.0,1236,1342,923,1007,313,335,85,324,15,50,70,274,28,27,1250,1000,700,550,0,200,1
250,2,2,46.0,43.0,47.0,47.0,1253,1320,895,1007,358,313,180,280,70,70,110,210,29,28,1250,1150,800,550,0,200,1
257,2,2,46.0,43.0,47.0,47.0,1404,1342,1091,1007,313,335,242,340,100,90,142,250,29,28,1250,1150,800,700,0,200,1
264,2,2,47.0,44.0,47.0,62.0,1348,1370,1035,1035,313,335,392,280,210,40,182,240,30,29,1250,1000,800,700,0,375,1
271,2,2,42.0,41.0,55.0,62.0,1264,1370,951,1035,313,335,437,426,215,150,222,276,31,29,825,875,800,700,425,650,1
279,2,2,46.0,42.0,55.0,62.0,1236,1370,923,1035,313,335,317,86,205,20,112,66,31,30,1150,875,800,950,425,650,1
286,2,2,48.0,43.0,70.0,62.0,1354,1292,1063,979,291,313,133,137,85,35,48,102,32,31,1150,875,800,950,425,650,1
293,2,2,49.0,46.0,70.0,62.0,1219,1488,951,1175,268,313,85,122,5,80,80,42,33,32,1150,875,800,950,425,650,1
300,2,2,50.0,48.0,70.0,62.0,1488,1684,1175,1371,313,313,221,277,105,195,116,82,34,34,1150,1025,800,950,425,650,1
307,2,2,51.0,51.0,70.0,62.0,1606,1734,1315,1399,291,335,323,152,175,80,148,72,35,35,1150,1200,800,950,425,650,1
314,2,2,52.0,52.0,70.0,62.0,1762,1790,1427,1455,335,335,498,237,310,125,188,112,36,36,1150,1200,800,950,425,650,1
321,2,2,53.0,53.0,70.0,62.0,1824,1902,1511,1567,313,335,664,263,440,115,224,148,37,37,1150,1200,800,950,425,650,1
329,2,2,54.0,56.0,70.0,62.0,1880,1936,1567,1623,313,313,339,269,75,135,264,134,38,38,1150,1200,1200,950,425,650,1
336,2,2,56.0,57.0,70.0,62.0,1858,1936,1567,1623,291,313,280,254,55,180,225,74,40,39,1150,1375,1200,950,425,650,1
343,2,2,56.0,61.0,70.0,62.0,1942,1992,1651,1679,291,313,432,124,175,60,257,64,40,41,1150,1375,1200,950,425,650,1
350,2,2,56.0,61.0,70.0,62.0,1986,2070,1651,1735,335,335,367,374,170,270,197,104,41,41,1250,1550,1200,950,425,650,1
357,2,2,58.0,61.0,70.0,70.0,2020,2126,1707,1791,313,335,478,219,245,75,233,144,41,43,1250,1550,1200,950,425,650,1
364,2,2,62.0,63.0,70.0,70.0,2132,2182,1819,1847,313,335,374,140,205,10,169,130,41,43,1600,1550,1200,1250,425,650,1
371,2,2,66.0,64.0,78.0,70.0,2154,2210,1819,1875,335,335,263,340,150,170,113,170,42,43,1600,1725,1200,1250,425,650,1
379,2,2,66.0,66.0,78.0,78.0,2199,2188,1819,1875,380,313,416,421,255,265,161,156,43,43,1600,1900,1350,1250,425,650,1
386,2,2,72.0,67.0,78.0,78.0,2216,2188,1791,1875,425,313,173,646,110,450,63,196,43,44,1600,1900,1500,1500,425,650,1
393,2,2,72.0,71.0,78.0,78.0,2362,2216,1847,1903,515,313,448,391,325,305,123,86,43,44,2125,1725,1500,1500,425,825,1
400,2,2,74.0,71.0,93.0,78.0,2261,2322,1791,1987,470,335,386,561,265,435,121,126,43,45,1950,2075,1500,1500,600,1000,1
407,2,2,77.0,72.0,93.0,78.0,2261,2143,1791,1763,470,380,361,404,180,380,181,24,43,46,2500,2075,1600,1500,600,1000,1
414,2,2,79.0,73.0,93.0,78.0,2317,2199,1847,1707,470,492,246,270,105,190,141,80,45,47,2500,2075,1600,1500,600,1000,1
421,2,2,80.0,77.0,93.0,78.0,2272,2261,1847,1791,425,470,318,81,125,45,193,36,46,49,2500,2075,1600,1500,600,1000,1
429,2,2,84.0,79.0,93.0,93.0,2294,2373,1847,1903,447,470,240,122,95,105,145,17,49,49,2500,2225,1600,1500,600,1000,1
436,2,2,85.0,82.0,93.0,101.0,2423,2485,1931,2015,492,470,490,378,285,305,205,73,49,52,2900,2225,1600,1500,600,1000,1
443,2,2,91.0,85.0,93.0,101.0,2591,2569,2099,2099,492,470,286,303,175,220,111,83,52,53,2900,2400,1600,1500,600,1000,1
450,2,2,91.0,87.0,101.0,101.0,2597,2815,2127,2323,470,492,607,638,440,495,167,143,52,55,3425,2500,1600,1600,600,1000,1
457,2,2,83.0,87.0,101.0,101.0,2709,2815,2239,2323,470,492,937,914,710,715,227,199,52,58,2625,2350,1600,1600,1400,1150,1
464,2,2,91.0,92.0,101.0,101.0,2759,3039,2267,2547,492,492,332,429,245,370,87,59,52,58,2625,2025,1900,1900,1575,1475,1
471,2,2,94.0,96.0,101.0,101.0,2821,2955,2351,2463,470,492,514,405,375,340,139,65,52,61,3150,2550,1900,2000,1575,1650,1
479,2,2,98.0,96.0,101.0,101.0,2815,3179,2323,2687,492,492,504,620,405,495,99,125,52,62,3500,2650,1900,2000,1575,1825,1
486,2,2,100.0,97.0,101.0,109.0,2843,3101,2351,2631,492,470,284,486,125,405,159,81,55,63,3500,2650,1900,2000,1575,1825,1
493,2,2,101.0,94.0,101.0,109.0,2597,3151,2127,2659,470,492,245,911,180,770,65,141,55,65,3750,2475,1900,2000,1575,2000,1
500,2,2,101.0,106.0,101.0,109.0,2703,3017,2211,2547,492,470,455,232,330,135,125,97,57,65,3750,3125,1900,2000,1575,2000,1
507,2,2,101.0,106.0,101.0,109.0,2647,3067,2155,2575,492,492,621,357,440,200,181,157,58,65,3750,3125,1900,2000,1575,2000,1
514,2,2,101.0,108.0,101.0,117.0,2843,3011,2351,2519,492,492,416,307,175,90,241,217,58,65,3750,3125,2050,2000,1575,2000,1
521,2,2,101.0,108.0,101.0,141.0,2765,2983,2295,2491,470,492,293,678,200,405,93,273,58,65,3750,3125,2050,2000,1575,2000,1
529,2,2,101.0,118.0,101.0,149.0,2815,3067,2323,2575,492,492,538,199,385,70,153,129,58,65,3750,3625,2200,2000,1575,2000,1
536,2,2,109.0,118.0,109.0,149.0,2843,3207,2351,2715,492,492,384,509,175,320,209,189,58,65,4150,3625,2350,2450,1575,2000,1
543,2,2,108.0,118.0,125.0,149.0,2927,3185,2435,2715,492,470,739,880,470,635,269,245,58,65,4050,3625,2500,2600,1675,2000,1
550,2,2,116.0,118.0,125.0,149.0,2933,3269,2463,2799,470,470,390,375,65,270,325,105,58,65,4050,3875,2650,2600,1675,2000,1
557,2,2,124.0,121.0,133.0,149.0,2955,3151,2463,2659,492,492,135,390,50,225,85,165,58,65,4450,3875,3000,2600,1675,2000,1
564,2,2,124.0,128.0,133.0,157.0,2871,3151,2379,2547,492,604,465,466,320,225,145,241,58,67,4650,4175,3000,2950,1675,2000,1
571,2,2,124.0,132.0,133.0,157.0,2955,3157,2463,2463,492,694,521,496,470,275,51,221,58,68,5100,4525,3000,2950,1675,2000,1
579,2,2,136.0,134.0,141.0,157.0,2950,3084,2435,2435,515,649,246,463,135,320,111,143,58,69,5100,4525,3000,2950,1675,2000,1
586,2,2,136.0,140.0,156.0,157.0,2843,3062,2351,2435,492,627,582,339,415,270,167,69,58,69,5700,4725,3200,3100,1675,2100,1
593,2,2,124.0,142.0,156.0,157.0,3073,3230,2603,2603,470,627,753,429,530,280,223,149,56,69,4850,5075,3050,3100,2750,2350,1
600,2,2,100.0,122.0,156.0,157.0,2765,3224,2295,2575,470,649,458,824,175,595,283,229,48,69,3425,4275,3050,3100,4775,3350,1
607,2,2,84.0,127.0,156.0,157.0,2507,3280,2015,2631,492,649,748,529,405,320,343,209,46,68,3250,4375,3050,3050,5650,3750,1
614,2,2,59.0,127.0,156.0,157.0,2541,3213,2071,2519,470,694,1074,515,675,230,399,285,43,68,1400,4125,3050,3050,7650,4400,1
621,2,2,56.0,126.0,156.0,172.0,2423,3252,1931,2603,492,649,889,847,430,490,459,357,42,68,725,4025,3050,3050,8575,4500,1
627,2,2,52.0,126.0,156.0,172.0,2317,3230,1847,2603,470,627,1089,1147,590,730,499,417,43,68,525,4025,3050,3050,8775,4500,1
7,0,2,13.0,13.0,15.0,15.0,293,251,293,251,0,0,35,30,35,30,0,0,12,12,0,0,0,0,0,0,0
14,0,2,14.0,14.0,15.0,15.0,643,671,643,671,0,0,65,70,65,70,0,0,13,13,0,0,0,0,0,0,0
21,0,2,14.0,14.0,15.0,15.0,671,727,671,727,0,0,45,50,45,50,0,0,13,13,0,0,0,0,0,0,0
29,0,2,15.0,15.0,15.0,15.0,671,783,671,783,0,0,75,95,75,95,0,0,14,14,0,0,0,0,0,0,0
36,0,2,15.0,15.0,15.0,23.0,643,839,643,839,0,0,115,140,115,140,0,0,14,14,0,0,0,0,0,0,0
43,0,2,16.0,16.0,23.0,23.0,699,867,699,867,0,0,50,40,50,40,0,0,15,15,0,0,0,0,0,0,0
50,0,2,16.0,17.0,23.0,23.0,699,839,699,839,0,0,10,80,10,80,0,0,15,16,0,0,0,0,0,0,0
57,0,2,17.0,18.0,23.0,23.0,643,867,643,867,0,0,50,60,50,60,0,0,16,17,0,0,0,0,0,0,0
64,0,2,18.0,19.0,23.0,23.0,727,811,727,811,0,0,140,105,140,105,0,0,17,18,0,0,0,0,0,0,0
71,0,2,18.0,19.0,23.0,23.0,743,951,699,951,44,0,108,170,100,170,8,0,17,18,0,0,0,0,0,0,0
79,0,2,19.0,20.0,23.0,23.0,827,973,671,951,156,22,163,329,135,325,28,4,18,19,0,0,0,0,0,0,0
86,0,2,19.0,20.0,23.0,23.0,883,1096,727,1007,156,89,283,306,235,290,48,16,18,19,0,0,0,150,0,0,0
93,0,2,20.0,20.0,23.0,23.0,939,1057,783,923,156,134,134,426,120,390,14,36,19,20,0,0,150,150,0,0,0
100,0,2,20.0,21.0,23.0,23.0,1079,1107,923,951,156,156,264,402,230,350,34,52,19,20,0,0,150,150,0,0,0
107,0,2,20.0,21.0,23.0,23.0,995,995,839,839,156,156,379,462,325,390,54,72,19,20,0,0,150,150,0,0,0
114,0,2,20.0,22.0,23.0,23.0,1023,1051,867,895,156,156,104,422,30,330,74,92,19,21,0,0,150,150,0,0,0
121,0,2,21.0,23.0,23.0,31.0,1074,939,895,783,179,156,174,472,80,360,94,112,19,22,100,0,150,300,0,0,0
129,0,2,22.0,25.0,23.0,31.0,1130,883,951,727,179,156,159,452,45,345,114,107,19,22,100,0,150,300,0,0,0
136,0,2,23.0,26.0,23.0,31.0,1107,962,951,783,156,179,245,507,115,380,130,127,20,23,100,0,150,300,0,0,0
143,0,2,23.0,26.0,23.0,31.0,1023,911,867,643,156,268,164,268,114,105,50,163,20,23,150,125,150,300,0,0,0
150,0,2,23.0,27.0,23.0,31.0,1051,950,895,615,156,335,194,74,124,25,70,49,21,24,150,125,150,300,0,0,0
157,0,2,25.0,26.0,31.0,31.0,1051,956,895,643,156,313,279,90,189,5,90,85,21,23,150,125,150,300,0,50,0
164,0,2,26.0,29.0,31.0,31.0,1079,1180,923,867,156,313,364,175,254,75,110,100,22,24,150,125,150,300,0,50,0
171,0,2,26.0,29.0,31.0,31.0,1158,1236,979,923,179,313,509,220,379,130,130,90,22,24,200,125,150,300,0,50,0
179,0,2,26.0,30.0,31.0,31.0,1242,1219,1063,951,179,268,264,167,114,45,150,122,23,25,200,125,250,300,0,50,0
186,0,2,27.0,31.0,31.0,31.0,1247,1219,1091,951,156,268,190,314,99,160,91,154,23,26,200,250,500,300,0,50,0
193,0,2,27.0,31.0,46.0,39.0,1275,1219,1119,951,156,268,200,411,89,225,111,186,24,26,200,250,500,600,0,50,0
200,0,2,28.0,35.0,46.0,39.0,1415,1214,1259,923,156,291,310,202,179,130,131,72,24,27,200,250,500,600,0,50,0
207,0,2,32.0,37.0,46.0,39.0,1471,1270,1315,979,156,291,190,148,139,65,51,83,25,27,200,250,575,600,0,50,0
214,0,2,32.0,38.0,46.0,39.0,1443,1303,1287,1035,156,268,105,204,34,85,71,119,25,28,200,250,575,600,0,50,0
221,0,2,36.0,39.0,46.0,54.0,1438,1382,1259,1091,179,291,135,225,44,70,91,155,26,28,200,250,675,600,0,50,0
229,0,2,37.0,40.0,46.0,62.0,1443,1432,1287,1119,156,313,121,455,14,260,107,195,27,29,200,550,675,600,0,50,0
236,0,2,38.0,44.0,46.0,62.0,1611,1650,1455,1315,156,335,166,315,39,180,127,135,28,31,450,675,675,600,0,50,0
243,0,2,42.0,44.0,46.0,62.0,1572,1684,1371,1371,201,313,114,416,59,245,55,171,30,31,550,675,675,600,0,50,0
250,0,2,44.0,48.0,54.0,62.0,1684,1768,1371,1455,313,313,189,231,94,120,95,111,30,33,450,925,675,600,100,50,0
257,0,2,45.0,49.0,69.0,62.0,1740,1874,1427,1539,313,335,219,406,84,255,135,151,32,34,450,925,675,600,100,50,0
264,0,2,47.0,50.0,69.0,62.0,2014,1852,1679,1539,335,313,184,422,34,235,150,187,33,35,450,925,950,600,100,50,0
271,0,2,49.0,54.0,69.0,62.0,2098,1992,1763,1679,335,313,234,357,44,230,190,127,34,37,550,1175,950,600,100,50,0
279,0,2,51.0,54.0,69.0,62.0,2238,1986,1903,1651,335,335,260,537,134,370,126,167,35,37,800,1175,950,600,100,50,0
286,0,2,53.0,56.0,69.0,62.0,2266,2014,1931,1679,335,335,120,277,54,70,66,207,36,39,800,1425,1125,600,100,50,0
293,0,2,54.0,58.0,69.0,62.0,2524,2076,2211,1763,313,313,216,183,164,40,52,143,37,39,900,1425,1125,600,100,50,0
300,0,2,56.0,59.0,69.0,70.0,2776,2126,2463,1791,313,335,236,293,144,110,92,183,39,40,900,1425,1125,600,100,50,0
307,0,2,59.0,60.0,69.0,70.0,2860,2070,2547,1735,313,335,241,163,134,40,107,123,40,41,900,1425,1125,600,100,50,0
314,0,2,61.0,62.0,69.0,70.0,2798,2003,2463,1735,335,268,191,206,144,55,47,151,42,43,900,1675,1225,900,100,50,0
321,0,2,63.0,64.0,69.0,70.0,2630,1970,2183,1679,447,291,186,301,104,110,82,191,43,45,900,1675,1225,900,100,50,0
329,0,2,68.0,67.0,77.0,70.0,2709,2121,2127,1763,582,358,239,264,164,125,75,139,44,46,1025,1675,1475,900,100,50,0
336,0,2,68.0,68.0,77.0,70.0,2916,2205,2267,1735,649,470,155,394,104,195,51,199,45,47,1025,1675,1475,900,100,50,0
343,0,2,70.0,69.0,85.0,78.0,3006,2317,2379,1847,627,470,306,579,179,320,127,259,46,48,1125,1675,1475,1050,100,50,0
350,0,2,76.0,70.0,85.0,86.0,3090,2440,2463,1903,627,537,271,374,114,255,157,119,47,49,1375,1925,1725,1300,100,50,0
357,0,2,77.0,73.0,85.0,101.0,2938,2384,2267,1847,671,537,351,249,114,70,237,179,48,51,1375,1925,1725,1300,100,50,0
364,0,2,79.0,76.0,85.0,101.0,3073,2485,2379,2015,694,470,471,282,204,55,267,227,51,54,1375,1925,1625,1400,100,50,0
371,0,2,85.0,78.0,85.0,101.0,3358,2709,2687,2239,671,470,138,127,49,40,89,87,52,56,1625,1925,1825,1400,100,50,0
379,0,2,94.0,83.0,101.0,101.0,3448,2737,2799,2267,649,470,139,48,124,5,15,43,53,58,1625,1925,1825,1400,100,50,0
386,0,2,96.0,84.0,101.0,101.0,3454,2961,2827,2491,627,470,45,223,29,120,16,103,54,59,1675,2175,2125,1400,100,50,0
393,0,2,98.0,85.0,101.0,101.0,3426,3162,2799,2603,627,559,170,295,74,120,96,175,55,60,1800,2175,2125,1400,100,50,0
400,0,2,101.0,88.0,101.0,109.0,3538,3364,2911,2715,627,649,295,250,169,95,126,155,57,60,2325,2175,2125,1400,100,50,0
407,0,2,108.0,91.0,117.0,109.0,3717,3252,3023,2603,694,649,330,431,224,200,106,231,58,63,2525,2425,2200,1700,100,50,0
414,0,2,113.0,92.0,125.0,117.0,3694,3392,3023,2743,671,649,451,447,369,240,82,207,61,64,2625,2425,2200,2050,100,50,0
421,0,2,120.0,91.0,125.0,117.0,3364,3280,2715,2631,649,649,318,687,214,400,104,287,63,64,2625,2300,2300,2200,100,175,0
429,0,2,124.0,101.0,125.0,117.0,3577,3364,2883,2715,694,649,336,228,269,165,67,63,64,65,2825,2500,2550,2200,100,175,0
436,0,2,125.0,103.0,125.0,133.0,3700,3330,2827,2659,873,671,348,523,194,380,154,143,66,66,3025,2600,2550,2600,150,175,0
443,0,2,125.0,104.0,125.0,141.0,3566,3566,2603,2827,963,739,298,795,74,560,224,235,66,66,3525,3150,2550,2600,200,175,0
450,0,2,125.0,112.0,125.0,141.0,3700,3549,2715,2743,985,806,353,551,34,220,319,331,67,67,3600,3425,2550,2600,250,300,0
457,0,2,125.0,112.0,125.0,149.0,3857,3162,2827,2379,1030,783,484,913,99,490,385,423,69,67,3450,3525,2775,2750,450,300,0
464,0,2,133.0,113.0,133.0,149.0,3924,2737,2939,2043,985,694,216,529,94,280,122,249,69,65,3250,3525,2775,3000,650,400,0
471,0,2,133.0,113.0,149.0,149.0,4042,3269,3079,2575,963,694,393,882,184,545,209,337,71,65,3250,3525,2775,3000,650,400,0
479,0,2,133.0,117.0,165.0,149.0,4187,3476,3247,2715,940,761,609,660,434,535,175,125,71,68,3350,3800,2975,3150,650,525,0
486,0,2,137.0,129.0,165.0,149.0,4131,3504,3191,2743,940,761,704,292,409,175,295,117,71,69,3725,3400,2975,3150,650,525,0
493,0,2,143.0,129.0,165.0,149.0,3874,3538,2911,2799,963,739,324,550,234,345,90,205,71,70,3725,4450,2975,3150,650,525,0
500,0,2,143.0,129.0,181.0,157.0,4002,3605,2995,2799,1007,806,549,480,339,175,210,305,71,70,4125,4450,2975,3150,650,525,0
507,0,2,151.0,130.0,181.0,157.0,3885,3515,2855,2575,1030,940,360,806,159,460,201,346,71,70,4275,4450,2975,3150,650,525,0
514,0,2,150.0,131.0,181.0,157.0,3818,3644,2855,2659,963,985,424,1187,194,725,230,462,71,70,4225,4450,2975,3700,750,525,0
521,0,2,157.0,141.0,197.0,157.0,3762,3532,2799,2547,963,985,299,609,74,435,225,174,71,71,5050,4450,2975,3700,750,625,0
529,0,2,161.0,142.0,213.0,157.0,3767,3420,2827,2435,940,985,425,804,184,510,241,294,71,71,5350,4450,2975,3850,750,625,0
536,0,2,169.0,142.0,213.0,165.0,3683,3291,2743,2351,940,940,430,416,119,160,311,256,74,72,5575,4450,2975,3850,800,625,0
543,0,2,171.0,143.0,213.0,165.0,3728,3314,2743,2351,985,963,200,461,44,235,156,226,74,72,5700,4450,2975,3850,800,625,0
550,0,2,175.0,149.0,221.0,165.0,3745,3218,2715,2211,1030,1007,601,456,329,110,272,346,77,72,6175,4350,2975,3850,800,725,0
557,0,2,179.0,149.0,221.0,173.0,3862,3280,2855,2295,1007,985,362,543,199,235,163,308,77,73,6500,4750,2975,4000,800,725,0
564,0,2,182.0,160.0,221.0,173.0,3874,3370,2911,2407,963,963,750,514,479,190,271,324,79,73,6625,6200,2975,4150,800,725,0
571,0,2,179.0,154.0,236.0,165.0,3790,3252,2827,2267,963,985,1020,890,654,450,366,440,79,73,6500,5900,2975,4150,1100,1275,0
579,0,2,180.0,142.0,236.0,165.0,3907,3398,2967,2435,940,963,1011,911,679,355,332,556,79,73,6425,5300,3225,4250,1400,2275,0
586,0,2,171.0,113.0,236.0,172.0,4042,3482,3079,2519,963,963,1251,917,824,245,427,672,79,73,5800,2450,3225,4250,2025,5225,0
593,0,2,170.0,101.0,236.0,172.0,4226,3594,3219,2631,1007,963,366,853,219,265,147,588,79,73,5625,1500,3525,4250,2375,6575,0
7,1,0,13.0,13.0,14.0,15.0,251,377,251,377,0,0,30,45,30,45,0,0,12,12,0,0,0,0,0,0,1
14,1,0,13.0,14.0,14.0,15.0,671,643,671,643,0,0,20,65,20,65,0,0,13,13,0,0,0,0,0,0,1
21,1,0,14.0,14.0,14.0,15.0,727,671,727,671,0,0,55,40,55,40,0,0,13,13,0,0,0,0,0,0,1
29,1,0,14.0,15.0,14.0,15.0,811,587,811,587,0,0,150,60,150,60,0,0,13,14,0,0,0,0,0,0,1
36,1,0,16.0,15.0,22.0,15.0,783,699,783,699,0,0,150,150,150,150,0,0,14,14,0,0,0,0,0,0,1
43,1,0,16.0,15.0,22.0,23.0,867,699,867,699,0,0,245,75,245,75,0,0,16,15,0,0,0,0,0,0,1
50,1,0,15.0,15.0,22.0,23.0,839,727,839,727,0,0,40,160,40,160,0,0,15,15,0,0,0,0,0,0,1
57,1,0,18.0,16.0,22.0,23.0,895,811,895,811,0,0,0,60,0,60,0,0,15,15,0,0,0,0,0,0,1
64,1,0,18.0,16.0,22.0,23.0,951,755,951,755,0,0,110,15,110,15,0,0,16,15,0,0,0,0,0,0,1
71,1,0,17.0,17.0,22.0,23.0,951,699,951,699,0,0,195,50,195,50,0,0,17,16,0,0,0,0,0,0,1
79,1,0,17.0,18.0,22.0,23.0,979,783,979,783,0,0,50,140,50,140,0,0,16,17,0,0,0,0,0,0,1
86,1,0,18.0,18.0,22.0,23.0,979,715,979,671,0,44,120,223,120,215,0,8,16,17,0,0,0,0,0,0,1
93,1,0,18.0,19.0,22.0,23.0,951,883,951,727,0,156,225,123,225,95,0,28,18,18,0,0,0,150,0,0,1
100,1,0,19.0,20.0,22.0,23.0,1046,934,979,755,67,179,297,93,285,45,12,48,18,18,0,0,0,300,0,0,1
107,1,0,19.0,21.0,22.0,23.0,1141,911,1007,755,134,156,428,149,400,85,28,64,18,18,0,50,0,300,0,0,1
114,1,0,20.0,21.0,22.0,23.0,1057,939,923,783,134,156,494,204,450,120,44,84,19,18,0,50,0,300,0,0,1
121,1,0,23.0,23.0,28.0,23.0,1107,911,951,755,156,156,184,159,120,55,64,104,18,18,0,100,250,300,0,0,1
129,1,0,23.0,24.0,28.0,31.0,995,1079,839,923,156,156,130,189,50,65,80,124,18,19,0,150,250,300,0,0,1
136,1,0,24.0,26.0,28.0,31.0,967,1107,811,951,156,156,120,179,20,35,100,144,17,19,0,200,250,300,0,0,1
143,1,0,24.0,26.0,28.0,31.0,967,1158,811,979,156,179,140,259,20,95,120,164,17,19,0,200,250,300,0,0,1
150,1,0,26.0,28.0,28.0,31.0,967,1158,811,979,156,179,165,99,25,15,140,84,18,20,50,250,250,400,0,0,1
157,1,0,26.0,28.0,28.0,31.0,995,1135,839,979,156,156,175,240,15,140,160,100,18,20,400,300,250,400,0,0,1
164,1,0,26.0,30.0,36.0,31.0,900,1051,699,895,201,156,289,160,105,40,184,120,20,21,400,300,600,500,0,0,1
171,1,0,25.5,30.0,36.0,31.0,984,1163,671,1007,313,156,424,315,200,175,224,140,20,22,375,350,600,500,25,0,1
179,1,0,31.5,31.0,44.0,31.0,1124,1107,811,951,313,156,265,405,80,245,185,160,20,22,375,350,600,500,25,0,1
186,1,0,33.5,31.0,44.0,31.0,1118,1163,783,1007,335,156,300,500,100,320,200,180,20,22,375,400,600,500,25,0,1
193,1,0,35.5,31.0,38.0,39.0,1152,1102,839,923,313,179,341,214,130,39,211,175,20,22,675,450,600,750,375,0,1
200,1,0,37.5,31.0,38.0,39.0,1096,1079,783,923,313,156,276,303,175,112,101,191,20,21,775,450,600,650,375,153,1
207,1,0,37.5,30.0,38.0,39.0,1152,1107,839,951,313,156,321,523,180,312,141,211,20,21,1075,400,600,550,375,228,1
214,1,0,37.5,34.0,38.0,39.0,1090,1079,755,923,335,156,441,258,260,127,181,131,20,22,1075,400,600,625,375,228,1
221,1,0,36.5,34.0,38.0,39.0,1096,1135,783,979,313,156,272,293,55,142,217,151,19,22,1075,400,600,625,375,228,1
229,1,0,39.5,35.0,46.0,39.0,1118,1219,783,1063,335,156,107,293,75,122,32,171,19,23,1075,400,600,625,375,228,1
236,1,0,40.5,34.0,46.0,39.0,1062,1186,839,1007,223,179,72,433,20,242,52,191,19,24,1375,300,600,625,375,328,1
243,1,0,41.0,34.0,46.0,39.0,1130,1214,951,1035,179,179,152,293,80,182,72,111,20,24,1350,550,600,725,400,328,1
250,1,0,41.0,38.0,46.0,39.0,1124,1242,923,1063,201,179,296,148,200,117,96,31,20,25,1350,550,600,725,400,328,1
257,1,0,40.0,38.0,46.0,47.0,1074,1146,895,923,179,223,321,279,205,220,116,59,21,25,1300,550,600,725,550,328,1
264,1,0,45.0,38.0,46.0,62.0,1107,1118,951,895,156,223,206,163,70,151,136,12,21,25,1300,550,600,725,550,378,1
271,1,0,45.0,39.0,46.0,62.0,1051,1102,895,811,156,291,231,143,75,91,156,52,23,26,1300,550,600,725,550,378,1
279,1,0,47.0,41.0,54.0,62.0,1158,1370,979,1035,179,335,221,204,45,141,176,63,26,26,1300,800,600,975,550,378,1
286,1,0,47.0,43.0,54.0,62.0,1242,1589,1063,1231,179,358,365,180,165,156,200,24,26,27,1300,800,600,1050,550,378,1
293,1,0,49.0,43.0,68.0,62.0,1242,1510,1063,1175,179,335,260,346,40,286,220,60,26,27,1100,800,600,1050,750,378,1
300,1,0,49.0,45.0,68.0,62.0,1404,1404,1203,1091,201,313,234,427,90,331,144,96,26,28,1100,800,600,1050,750,405,1
307,1,0,50.0,46.0,68.0,62.0,1303,1348,1147,1035,156,313,225,378,65,346,160,32,31,28,1100,850,600,1050,750,405,1
314,1,0,52.0,49.0,68.0,62.0,1583,1656,1427,1343,156,313,285,433,105,361,180,72,31,29,1250,1050,600,1050,750,405,1
321,1,0,57.0,51.0,68.0,62.0,1690,1908,1511,1595,179,313,244,83,40,21,204,62,32,31,1250,1150,600,1050,750,405,1
329,1,0,60.0,53.0,76.0,62.0,1970,2210,1791,1875,179,335,329,183,105,81,224,102,35,31,1250,1150,600,1050,750,405,1
336,1,0,61.0,55.0,76.0,62.0,1835,2126,1679,1791,156,335,489,173,245,31,244,142,37,33,1250,1200,600,1050,750,405,1
343,1,0,60.0,56.0,76.0,62.0,2014,1986,1791,1651,223,335,411,234,235,56,176,178,40,33,1250,1250,600,1050,750,405,1
350,1,0,60.0,57.0,76.0,62.0,2059,2014,1791,1679,268,335,668,434,460,216,208,218,40,35,1400,1350,600,1050,750,405,1
357,1,0,65.0,60.0,76.0,70.0,2255,1908,1987,1595,268,313,285,320,45,66,240,254,39,35,1400,1350,600,1050,750,405,1
364,1,0,69.0,66.0,76.0,70.0,2188,1992,1875,1679,313,313,341,130,65,36,276,94,39,37,1400,1400,725,1050,750,405,1
371,1,0,73.0,67.0,76.0,70.0,2272,2076,1959,1763,313,313,417,235,105,101,312,134,39,37,1600,1450,725,1300,750,405,1
379,1,0,75.0,71.0,76.0,78.0,2171,1953,1903,1595,268,358,375,259,35,81,340,178,42,39,1600,1450,725,1300,750,405,1
386,1,0,73.0,70.0,76.0,78.0,2082,1930,1791,1371,291,559,540,140,160,86,380,54,44,39,1600,1500,725,1300,750,405,1
393,1,0,76.0,71.0,76.0,86.0,2266,2037,1931,1343,335,694,485,321,65,191,420,130,47,40,1750,1500,725,1300,750,405,1
400,1,0,74.0,73.0,76.0,101.0,2266,2070,1931,1399,335,671,500,322,40,116,460,206,45,40,1750,2000,1100,1300,750,405,1
407,1,0,74.0,76.0,76.0,101.0,2406,2076,2071,1427,335,649,585,313,185,31,400,282,48,42,1750,2000,1225,1300,750,405,1
414,1,0,73.5,79.0,92.0,101.0,2406,2166,2071,1539,335,627,171,294,35,61,136,233,48,42,1725,2050,1350,1300,875,405,1
421,1,0,79.5,80.0,100.0,101.0,2490,2222,2155,1595,335,627,156,329,55,116,101,213,48,43,1725,2100,1350,1300,875,405,1
429,1,0,81.5,81.0,114.0,109.0,2485,2300,2015,1651,470,649,350,404,185,111,165,293,48,43,1825,2100,1350,1300,875,405,1
436,1,0,81.5,78.0,114.0,109.0,2597,2322,2015,1651,582,671,311,484,70,111,241,373,48,45,1375,1850,1350,1300,1325,655,1
443,1,0,75.5,73.0,114.0,109.0,2541,2294,1959,1623,582,671,418,500,105,51,313,449,48,45,1125,1450,1350,1300,1975,1123,1
450,1,0,78.5,73.0,106.0,109.0,2670,2468,2043,1819,627,649,474,537,85,141,389,396,48,45,1025,1575,1350,1300,2275,1373,1
457,1,0,80.5,76.0,106.0,109.0,2451,2524,1847,1875,604,649,616,522,155,46,461,476,48,46,1175,1575,1350,1300,2275,1373,1
464,1,0,83.5,77.0,106.0,109.0,2496,2614,1847,1987,649,627,421,638,155,86,266,552,47,47,1325,1625,1350,1300,2275,1373,1
471,1,0,88.5,81.0,106.0,109.0,2490,2860,1819,2211,671,649,462,818,120,186,342,632,47,48,1775,1725,1350,1300,2275,1373,1
479,1,0,90.5,83.0,106.0,109.0,2608,2916,1959,2267,649,649,623,958,205,296,418,662,48,50,1925,1775,1350,1450,2275,1373,1
486,1,0,90.5,90.0,106.0,117.0,2614,3022,1987,2351,627,671,949,749,455,136,494,613,53,51,1925,2150,1350,1450,2275,1373,1
493,1,0,96.5,91.0,106.0,117.0,2776,3168,2127,2519,649,649,784,615,210,26,574,589,53,52,2075,2150,1350,1450,2275,1373,1
500,1,0,96.5,94.0,106.0,117.0,2776,3336,2127,2687,649,649,809,711,155,46,654,665,53,54,2075,2200,1350,1450,2275,1373,1
507,1,0,95.5,98.0,122.0,117.0,2832,3538,2183,2911,649,627,1060,892,330,151,730,741,58,56,2075,2300,1550,1750,2275,1373,1
514,1,0,100.5,98.0,122.0,133.0,3073,3818,2379,3191,694,627,565,852,55,131,510,721,58,57,2225,2100,1550,1850,2275,1623,1
521,1,0,104.5,104.0,130.0,133.0,3218,3812,2547,3163,671,649,736,762,150,61,586,701,58,60,2225,2475,1550,1850,2275,1623,1
529,1,0,106.5,105.0,130.0,133.0,3286,3554,2659,2883,627,671,1028,1017,370,236,658,781,58,61,2725,2475,1550,1850,2300,1623,1
536,1,0,105.5,111.0,130.0,149.0,3370,3504,2743,2743,627,761,1218,929,580,181,638,748,57,63,2775,2575,1550,1850,2300,1673,1
543,1,0,112.0,112.0,130.0,157.0,3336,3683,2687,2855,649,828,508,1135,165,291,343,844,57,64,3050,2625,1400,2100,2475,1723,1
550,1,0,114.5,119.0,130.0,157.0,3224,3801,2575,2995,649,806,603,1176,180,311,423,865,56,65,2925,2675,1400,2300,2600,1773,1
557,1,0,116.0,119.0,130.0,157.0,3112,3717,2463,2911,649,806,819,912,320,301,499,611,56,65,3250,2825,1400,2300,2625,1773,1
564,1,0,111.5,123.0,130.0,165.0,3101,3577,2407,2771,694,806,1194,1123,615,416,579,707,61,67,2775,2875,1400,2300,3100,1773,1
571,1,0,114.5,128.0,130.0,165.0,3084,3577,2435,2771,649,806,206,873,55,241,151,632,61,67,2575,3125,1650,2550,3300,2048,1
579,1,0,117.5,128.0,136.0,165.0,2916,3526,2267,2631,649,895,401,1031,170,291,231,740,61,67,2575,3125,1650,2550,3300,2098,1
586,1,0,120.5,132.0,136.0,165.0,3056,3700,2295,2715,761,985,631,1282,300,426,331,856,61,67,3575,3325,1650,2550,3300,2098,1
593,1,0,123.5,136.0,136.0,165.0,3185,3689,2379,2771,806,918,866,1187,435,231,431,956,61,67,3875,3525,1650,2550,3300,2098,1
600,1,0,125.5,141.0,136.0,165.0,3207,3795,2379,2855,828,940,1137,1238,610,216,527,1022,61,67,4025,3950,1650,2550,3300,2098,1
607,1,0,132.5,146.0,136.0,165.0,3230,3857,2379,2939,851,918,1087,1495,460,361,627,1134,60,67,4125,4200,1650,2650,3400,2148,1
614,1,0,125.0,150.0,136.0,165.0,3095,3829,2267,2911,828,918,1444,1632,725,436,719,1196,60,67,3750,4200,1650,2650,3800,2198,1
621,1,0,127.0,159.0,136.0,173.0,3022,3342,2239,2379,783,963,1586,1453,775,341,811,1112,60,67,4100,4450,1650,2650,3900,2248,1
629,1,0,121.0,159.0,136.0,173.0,3050,2395,2267,1455,783,940,1776,1372,865,281,911,1091,59,67,3550,4550,1650,2650,4500,2298,1
636,1,0,90.5,153.0,136.0,173.0,3269,2653,2463,1735,806,918,1766,1274,755,71,1011,1203,59,67,1175,4075,1650,2650,6850,3123,1
7,0,2,13.0,13.0,15.0,15.0,293,251,293,251,0,0,35,30,35,30,0,0,12,12,0,0,0,0,0,0,0
14,0,2,14.0,14.0,15.0,15.0,671,671,671,671,0,0,70,70,70,70,0,0,13,13,0,0,0,0,0,0,0
21,0,2,14.0,14.0,15.0,15.0,699,699,699,699,0,0,50,50,50,50,0,0,13,13,0,0,0,0,0,0,0
29,0,2,15.0,15.0,15.0,15.0,671,671,671,671,0,0,80,35,80,35,0,0,14,14,0,0,0,0,0,0,0
36,0,2,15.0,15.0,15.0,23.0,783,699,783,699,0,0,190,25,190,25,0,0,14,14,0,0,0,0,0,0,0
43,0,2,16.0,16.0,23.0,23.0,783,699,783,699,0,0,0,60,0,60,0,0,15,15,0,0,0,0,0,0,0
50,0,2,16.0,17.0,23.0,23.0,811,755,811,755,0,0,40,30,40,30,0,0,15,16,0,0,0,0,0,0,0
57,0,2,17.0,17.0,23.0,23.0,811,811,811,811,0,0,90,75,90,75,0,0,16,16,0,0,0,0,0,0,0
64,0,2,18.0,18.0,23.0,23.0,839,923,839,923,0,0,190,185,190,185,0,0,17,17,0,0,0,0,0,0,0
71,0,2,18.0,18.0,23.0,23.0,900,951,811,951,89,0,236,200,220,200,16,0,17,17,0,0,0,0,0,0,0
79,0,2,19.0,19.0,23.0,23.0,878,973,699,951,179,22,331,304,295,300,36,4,18,18,0,0,0,0,0,0,0
86,0,2,19.0,19.0,23.0,23.0,827,1046,671,979,156,67,437,437,385,425,52,12,18,18,0,0,0,150,0,0,0
93,0,2,20.0,20.0,23.0,23.0,995,973,839,951,156,22,357,392,285,380,72,12,19,19,0,0,150,150,0,0,0
100,0,2,20.0,20.0,23.0,23.0,967,995,811,951,156,44,457,110,365,90,92,20,19,20,0,0,150,150,0,0,0
107,0,2,20.0,21.0,23.0,23.0,967,1034,811,923,156,111,477,81,415,45,62,36,19,20,50,0,150,150,0,0,0
114,0,2,21.0,21.0,23.0,23.0,939,1051,783,895,156,156,132,126,50,70,82,56,19,20,50,0,150,150,0,0,0
121,0,2,21.0,21.0,23.0,31.0,990,1018,811,839,179,179,202,201,100,125,102,76,19,20,50,0,150,150,0,50,0
129,0,2,22.0,23.0,23.0,31.0,1102,995,923,839,179,156,177,42,55,25,122,17,20,20,50,0,150,300,0,50,0
136,0,2,22.0,24.0,23.0,31.0,1023,1023,867,867,156,156,58,127,20,90,38,37,20,21,50,0,150,300,0,50,0
143,0,2,23.0,25.0,23.0,31.0,1051,1169,895,923,156,246,108,273,50,200,58,73,21,22,50,0,250,300,0,50,0
150,0,2,25.0,27.0,31.0,31.0,1079,1214,923,923,156,291,163,199,85,140,78,59,22,22,50,125,250,300,0,50,0
157,0,2,26.0,28.0,31.0,31.0,1023,1286,867,951,156,335,148,199,50,100,98,99,22,23,50,125,250,300,0,50,0
164,0,2,27.0,28.0,31.0,31.0,1275,1202,1119,867,156,335,233,40,115,5,118,35,22,23,150,125,250,300,0,50,0
171,0,2,28.0,30.0,31.0,46.0,1348,1264,1147,951,201,313,327,146,185,75,142,71,23,24,150,300,250,300,0,50,0
179,0,2,29.0,31.0,31.0,46.0,1382,1320,1091,1007,291,313,483,251,305,140,178,111,24,26,150,300,500,300,0,50,0
186,0,2,29.0,33.0,46.0,46.0,1292,1432,979,1119,313,313,233,276,115,125,118,151,24,27,200,300,600,300,0,50,0
193,0,2,32.0,34.0,46.0,46.0,1236,1516,923,1203,313,313,158,411,25,220,133,191,25,28,200,300,600,300,0,50,0
200,0,2,32.0,35.0,46.0,46.0,1510,1594,1175,1259,335,335,298,286,125,205,173,81,25,29,200,300,600,550,0,50,0
207,0,2,36.0,37.0,46.0,46.0,1566,1673,1231,1315,335,358,238,386,125,265,113,121,26,31,200,300,675,700,0,50,0
214,0,2,39.0,37.0,46.0,46.0,1594,1678,1259,1343,335,335,184,532,35,375,149,157,27,31,300,300,675,700,0,50,0
221,0,2,41.0,38.0,46.0,46.0,1874,1740,1539,1427,335,313,244,323,80,130,164,193,28,33,300,300,925,700,0,50,0
229,0,2,42.0,40.0,46.0,46.0,1908,1768,1595,1455,313,313,265,343,65,110,200,233,29,34,300,300,925,700,0,50,0
236,0,2,43.0,40.0,54.0,46.0,1852,1824,1539,1511,313,313,335,463,95,190,240,273,30,35,400,300,925,700,0,50,0
243,0,2,46.0,42.0,54.0,54.0,2132,1880,1819,1567,313,313,210,238,130,25,80,213,31,36,650,300,1000,700,0,50,0
250,0,2,49.0,43.0,54.0,54.0,2238,2014,1903,1679,335,335,205,483,85,230,120,253,32,37,650,300,1000,700,0,50,0
257,0,2,51.0,44.0,62.0,54.0,2238,2037,1903,1679,335,358,230,588,70,295,160,293,34,38,650,300,1000,700,0,50,0
264,0,2,55.0,50.0,62.0,54.0,2266,1986,1931,1651,335,335,111,374,40,145,71,229,35,40,750,650,1000,800,0,50,0
271,0,2,58.0,50.0,62.0,54.0,2272,2048,1959,1735,313,313,207,500,100,235,107,265,36,40,750,650,1000,800,0,50,0
279,0,2,59.0,52.0,70.0,54.0,2132,2020,1819,1707,313,313,287,695,140,390,147,305,37,42,750,650,1000,800,0,50,0
286,0,2,60.0,54.0,70.0,54.0,2160,2132,1847,1707,313,425,267,720,180,405,87,315,38,43,1050,650,1275,800,0,50,0
293,0,2,61.0,58.0,70.0,69.0,2328,2227,1903,1735,425,492,503,545,360,245,143,300,40,44,1425,825,1275,1050,0,50,0
300,0,2,64.0,58.0,78.0,69.0,2474,2300,1959,1763,515,537,448,179,345,65,103,114,40,44,1425,825,1275,1050,0,50,0
307,0,2,65.0,61.0,78.0,77.0,2698,2479,2183,1875,515,604,429,322,320,140,109,182,41,47,1425,825,1275,1050,0,50,0
314,0,2,65.0,63.0,78.0,93.0,2614,2490,2099,1931,515,559,389,471,220,225,169,246,42,49,1525,925,1275,1050,0,50,0
321,0,2,70.0,64.0,78.0,93.0,2401,2591,1931,1987,470,604,261,448,40,180,221,268,42,50,1575,975,1275,1050,0,175,0
329,0,2,74.0,66.0,86.0,93.0,2569,2653,2099,2071,470,582,246,675,90,335,156,340,43,53,1575,975,1275,1050,0,175,0
336,0,2,75.0,67.0,94.0,93.0,2653,2793,2183,2211,470,582,421,862,205,450,216,412,44,53,1675,975,1275,1050,0,175,0
343,0,2,80.0,69.0,94.0,93.0,2507,2950,2015,2323,492,627,336,1113,85,625,251,488,45,55,1725,975,1275,1350,0,175,0
350,0,2,84.0,77.0,94.0,93.0,2423,2950,1931,2323,492,627,251,455,140,95,111,360,46,58,1725,975,1275,1500,0,175,0
357,0,2,85.0,76.0,94.0,93.0,2670,2899,2155,2295,515,604,222,298,55,145,167,153,47,59,1825,875,1275,1650,0,275,0
364,0,2,88.0,79.0,94.0,93.0,2664,3084,2127,2435,537,649,301,134,120,55,181,79,47,60,2225,875,1275,1650,0,275,0
371,0,2,89.0,79.0,102.0,101.0,2815,3224,2211,2575,604,649,587,524,330,365,257,159,49,60,2225,875,1425,1650,0,275,0
379,0,2,92.0,83.0,102.0,101.0,2922,3224,2295,2575,627,649,747,410,435,375,312,35,49,63,2725,875,1425,1650,0,275,0
386,0,2,99.0,86.0,102.0,101.0,3034,3280,2407,2631,627,649,572,640,380,525,192,115,50,63,2725,1175,1425,1650,0,275,0
393,0,2,100.0,87.0,102.0,101.0,2888,3230,2239,2491,649,739,302,1032,130,825,172,207,51,63,2725,1675,1425,1650,0,275,0
400,0,2,102.0,87.0,117.0,109.0,2905,3482,2211,2631,694,851,298,552,200,245,98,307,52,66,2950,1675,1425,1650,0,275,0
407,0,2,107.0,93.0,117.0,109.0,2597,3319,1903,2491,694,828,163,434,85,235,78,199,53,66,3000,1775,1825,1750,0,275,0
414,0,2,113.0,97.0,125.0,109.0,2698,3269,2071,2463,627,806,156,300,85,155,71,145,54,66,3000,2100,1825,1750,0,275,0
421,0,2,114.0,97.0,141.0,124.0,2726,3246,2099,2463,627,783,196,586,70,345,126,241,55,66,3450,2100,1825,1750,50,275,0
429,0,2,116.0,97.0,141.0,124.0,2838,3493,2211,2687,627,806,366,1016,185,675,181,341,55,66,3575,2100,1800,1750,50,275,0
436,0,2,124.0,97.0,141.0,132.0,3224,3470,2575,2687,649,783,406,1427,220,990,186,437,55,66,3900,2100,1800,1750,50,275,0
443,0,2,131.0,97.0,141.0,148.0,3308,3610,2659,2827,649,783,111,1214,70,885,41,329,56,66,4000,2100,1900,1900,50,275,0
450,0,2,135.0,103.0,141.0,148.0,3437,3655,2743,2827,694,828,192,1500,100,1075,92,425,57,66,4125,2600,1900,2350,50,275,0
457,0,2,140.0,109.0,141.0,148.0,3666,3666,2995,2883,671,783,343,1639,200,1130,143,509,58,66,4400,2900,1900,2650,150,275,0
464,0,2,139.0,117.0,141.0,140.0,3538,3672,2911,2911,627,761,240,1346,75,895,165,451,59,66,4200,2725,1900,2650,400,550,0
471,0,2,143.0,117.0,149.0,140.0,3622,3622,2995,2883,627,739,355,934,160,645,195,289,59,66,4775,3450,1900,2650,450,550,0
479,0,2,148.0,123.0,157.0,140.0,3566,3538,2939,2799,627,739,615,535,340,450,275,85,59,66,5175,3450,1900,2800,450,550,0
486,0,2,153.0,125.0,165.0,148.0,3476,3700,2827,2939,649,761,210,572,155,395,55,177,59,66,5225,3800,1900,2800,450,725,0
493,0,2,153.0,128.0,165.0,164.0,3381,3610,2687,2827,694,783,490,694,355,575,135,119,60,66,5500,4300,1900,2950,450,725,0
500,0,2,153.0,132.0,181.0,164.0,3437,3638,2743,2855,694,783,431,1146,320,935,111,211,61,70,5725,4300,1900,2950,450,725,0
507,0,2,160.0,133.0,181.0,164.0,3476,3526,2827,2743,649,783,228,1299,95,1000,133,299,61,71,5725,4300,1900,2950,450,725,0
514,0,2,163.0,136.0,189.0,164.0,3286,3538,2659,2799,627,739,414,1632,230,1245,184,387,61,74,6125,4300,2025,2950,450,725,0
521,0,2,165.0,137.0,189.0,164.0,3174,3650,2547,2911,627,739,564,1884,325,1555,239,329,61,76,6225,4300,2125,3200,450,725,0
529,0,2,167.0,156.0,189.0,164.0,3263,3700,2547,2939,716,761,556,1425,225,1000,331,425,61,78,6525,4600,2350,3200,450,725,0
536,0,2,169.0,156.0,189.0,164.0,3129,3678,2323,2827,806,851,816,1274,410,745,406,529,62,78,6700,5500,2600,3200,450,725,0
543,0,2,172.0,157.0,189.0,164.0,3258,3924,2407,2827,851,1097,1047,1535,570,1020,477,515,62,78,6750,5500,2600,3200,450,825,0
550,0,2,172.0,160.0,189.0,172.0,3280,4131,2407,2967,873,1164,520,1433,368,1090,152,343,62,78,6875,5600,2600,3200,450,825,0
557,0,2,175.0,160.0,189.0,188.0,3218,4137,2435,2995,783,1142,619,1119,408,640,211,479,62,78,7050,5600,2600,3200,450,825,0
564,0,2,179.0,160.0,189.0,204.0,3162,4036,2379,2939,783,1097,354,1291,193,830,161,461,62,78,7175,5600,2600,3200,450,825,0
571,0,2,183.0,160.0,189.0,204.0,3246,3896,2463,2799,783,1097,189,1756,78,1155,111,601,62,78,7225,5600,2600,3200,450,825,0
579,0,2,183.0,179.0,189.0,220.0,3241,4025,2435,2883,806,1142,574,561,363,370,211,191,62,78,7350,7300,3000,3200,450,825,0
586,0,2,183.0,180.0,189.0,228.0,3157,3924,2351,2715,806,1209,935,646,628,515,307,131,62,78,7450,7425,3100,3200,450,1000,0
593,0,2,183.0,178.0,189.0,236.0,3230,3969,2379,2827,851,1142,1311,874,908,615,403,259,62,78,7575,7325,3175,3200,450,1100,0
600,0,2,183.0,172.0,189.0,236.0,3207,3913,2379,2771,828,1142,1642,731,1143,640,499,91,62,78,7975,7025,3175,3200,500,1400,0
607,0,2,182.0,160.0,204.0,236.0,3190,3913,2407,2771,783,1142,872,796,781,765,91,31,62,78,7600,6425,3175,3200,912,2000,0
614,0,2,182.0,157.0,204.0,236.0,3190,3756,2407,2659,783,1097,722,1248,531,1085,191,163,63,78,7600,6425,3425,3200,912,2300,0
621,0,2,186.0,160.0,204.0,236.0,3045,3812,2239,2715,806,1097,322,1313,181,1210,141,103,63,78,7600,6725,3425,3800,912,2300,0
629,0,2,185.0,168.0,204.0,236.0,3045,3795,2239,2631,806,1164,348,1368,261,1125,87,243,63,78,7500,6925,3425,3800,1012,2300,0
636,0,2,187.0,168.0,204.0,236.0,3739,4148,2911,2939,828,1209,824,1463,641,1305,183,158,63,78,8325,7125,3425,3800,1012,2300,0
643,0,2,187.0,168.0,204.0,251.0,4210,3935,3359,2771,851,1164,844,1621,661,1485,183,136,64,78,8325,7125,3425,3800,1012,2300,0
650,0,2,193.0,187.0,204.0,251.0,3689,4249,2883,3107,806,1142,576,1233,526,965,50,268,64,78,8775,7325,3425,3800,1012,2400,0
657,0,2,193.0,188.0,204.0,251.0,3577,4226,2771,3107,806,1119,612,1429,466,1175,146,254,64,78,8775,8525,3425,3800,1012,2400,0
664,0,2,191.0,188.0,204.0,251.0,3862,4232,3079,3135,783,1097,468,1930,326,1540,142,390,64,78,8950,8525,3750,3800,1112,2400,0
671,0,2,191.0,188.0,204.0,251.0,3930,4198,3079,3079,851,1119,731,2290,556,1760,175,530,64,78,8950,8525,4200,3800,1112,2400,0
679,0,2,191.0,191.0,204.0,251.0,4047,4126,3107,2939,940,1187,472,2760,356,2090,116,670,64,78,8950,8625,4200,4100,1112,2400,0
686,0,2,191.0,191.0,204.0,251.0,4086,3935,3079,2771,1007,1164,659,3037,581,2335,78,702,64,78,9625,8925,4425,4100,1112,2400,0
693,0,2,191.0,191.0,204.0,251.0,3840,3997,2855,2855,985,1142,1116,3505,926,2675,190,830,64,78,9625,8925,4650,4400,1112,2400,0
700,0,2,192.0,191.0,219.0,251.0,3342,4058,2267,2827,1075,1231,819,3911,751,2925,68,986,64,78,9625,8850,4650,4400,1112,2575,0
707,0,2,196.0,187.0,219.0,251.0,3252,4170,2155,2827,1097,1343,435,4410,356,3260,79,1150,64,78,9625,8650,4650,4400,1112,2775,0
714,0,2,198.0,185.0,219.0,251.0,3308,4338,2211,2883,1097,1455,585,4335,491,3305,94,1030,64,78,9625,8850,4650,4400,1112,2875,0
721,0,2,200.0,197.0,219.0,251.0,3386,4322,2267,2799,1119,1523,780,3640,621,2630,159,1010,64,76,9675,9150,4650,4400,1112,2975,0
729,0,2,191.0,195.0,219.0,251.0,3347,4249,2183,2771,1164,1478,895,3944,746,2870,149,1074,64,74,9250,9550,4650,4400,1637,3075,0
736,0,2,191.0,197.0,234.0,251.0,3202,3885,2015,2519,1187,1366,197,4280,166,3050,31,1230,64,74,9525,9650,4650,4400,1637,3075,0
743,0,2,191.0,199.0,249.0,251.0,3263,4030,2099,2687,1164,1343,594,4526,431,3140,163,1386,64,74,9800,9650,4650,4400,1637,3075,0
750,0,2,191.0,199.0,264.0,251.0,3112,3974,2015,2631,1097,1343,812,4310,521,2760,291,1550,64,74,10025,9650,4650,4400,1637,3075,0
757,0,2,189.0,197.0,264.0,251.0,3196,3952,2099,2631,1097,1321,897,4779,616,3065,281,1714,64,74,9925,9550,4650,4400,1737,3175,0
764,0,2,188.0,183.0,264.0,251.0,3213,4002,2071,2659,1142,1343,1242,5272,821,3390,421,1882,64,74,9825,8775,4650,5500,1837,3950,0
771,0,2,184.0,188.0,264.0,251.0,3218,4092,2099,2659,1119,1433,1549,3660,1029,2510,520,1150,64,74,9450,8075,4650,5500,2286,4650,0
779,0,2,192.0,188.0,279.0,259.0,3347,4103,2183,2715,1164,1388,1355,4156,799,2850,556,1306,65,74,9450,8325,4950,5500,2286,4650,0
786,0,2,198.0,188.0,279.0,275.0,3364,4137,2155,2771,1209,1366,759,3862,388,2400,371,1462,65,74,9450,8325,4950,5500,2286,4650,0
793,0,2,198.0,188.0,279.0,275.0,3162,3941,2043,2575,1119,1366,633,4341,238,2715,395,1626,65,74,9450,8325,4950,5500,2286,4650,0
800,0,2,198.0,188.0,279.0,275.0,3050,3840,1931,2519,1119,1321,880,3136,349,1350,531,1786,65,74,9950,8325,5050,5500,2286,4650,0
807,0,2,198.0,200.0,294.0,275.0,3224,3840,2127,2519,1097,1321,1291,2014,624,810,667,1204,65,74,10075,8325,5050,5500,2286,4650,0
814,0,2,185.0,198.0,294.0,275.0,3554,3801,2435,2435,1119,1366,1711,2442,904,1070,807,1372,65,74,9125,9725,5375,5500,3686,4750,0
821,0,2,192.0,198.0,294.0,275.0,3834,3952,2715,2519,1119,1433,1661,2916,814,1380,847,1536,65,74,9025,9725,5375,5500,3786,4750,0
829,0,2,200.0,198.0,294.0,290.0,3840,3717,2631,2351,1209,1366,1291,3333,679,1645,612,1688,65,74,9025,9725,5375,5600,3786,4750,0
836,0,2,198.0,195.0,294.0,290.0,4176,3885,2855,2519,1321,1366,1613,2858,849,1460,764,1398,65,74,8975,10805,5375,6600,3886,5650,0
843,0,2,198.0,195.0,294.0,306.0,3918,3689,2687,2323,1231,1366,1559,3246,909,1680,650,1566,65,74,9475,10850,5375,7200,3886,5650,0
850,0,2,200.0,195.0,294.0,306.0,3946,3840,2715,2519,1231,1321,1905,3671,1124,1945,781,1726,65,74,9475,10895,5375,7650,3886,5650,0
857,0,2,180.0,183.0,294.0,306.0,3868,3672,2659,2351,1209,1321,2347,4105,1414,2215,933,1890,65,74,8550,9870,5375,7800,5036,6675,0
864,0,2,194.0,181.0,294.0,306.0,3762,3795,2575,2407,1187,1388,1074,2413,708,1255,366,1158,65,74,8325,7815,5375,7800,5036,8775,0
871,0,2,196.0,200.0,294.0,306.0,3123,3728,1959,2295,1164,1433,877,1157,541,335,336,822,65,74,8950,8985,5375,7800,5136,8775,0
879,0,2,179.0,200.0,294.0,306.0,3134,3633,1903,2267,1231,1366,1239,1229,762,405,477,824,65,74,7850,9410,5375,7800,6336,9225,0
886,0,2,179.0,200.0,294.0,306.0,3370,3493,2183,2127,1187,1366,595,1288,382,475,213,813,65,74,7675,9380,5375,7800,6636,9300,0
893,0,2,174.0,198.0,294.0,306.0,3409,3504,2267,2183,1142,1321,705,1648,402,675,303,973,65,74,7875,9130,5375,7800,7261,9580,0
900,0,2,178.0,198.0,294.0,306.0,3381,3398,2295,2099,1086,1299,1110,2032,677,895,433,1137,65,74,8375,9175,5375,7800,7261,9580,0
907,0,2,187.0,198.0,294.0,306.0,3420,3549,2323,2183,1097,1366,337,2410,197,1105,140,1305,65,74,8975,9490,5375,7800,7261,9610,0
914,0,2,187.0,198.0,294.0,306.0,3454,3476,2379,2043,1075,1433,745,2828,477,1355,268,1473,65,74,9700,9775,5375,7800,7386,9640,0
921,0,2,190.0,200.0,294.0,306.0,3347,3431,2183,2043,1164,1388,580,3509,172,1755,408,1754,65,74,9700,10715,5375,7800,7386,9640,0
929,0,2,187.0,197.0,294.0,306.0,3392,3302,2071,2015,1321,1287,985,3831,417,1935,568,1896,66,74,9600,11780,5375,7800,7661,9940,0
936,0,2,187.0,197.0,294.0,306.0,2910,3202,1679,2015,1231,1187,1251,3550,562,1810,689,1740,68,74,10600,11310,5375,7800,7661,10455,0
943,0,2,187.0,181.0,279.0,306.0,2199,3157,1147,2015,1052,1142,1412,3905,616,2025,796,1880,68,74,11050,9815,5375,7800,8679,11995,0
950,0,2,184.0,166.0,279.0,306.0,2132,3095,1147,1931,985,1164,1498,3648,611,1920,887,1728,68,74,10675,8210,5375,7800,9054,13660,0
957,0,2,160.0,129.0,279.0,306.0,2244,3297,1259,2043,985,1254,974,4031,46,2155,928,1876,68,74,7725,4955,5375,7800,12004,16960,0
964,0,2,154.0,131.0,279.0,306.0,2188,3269,1203,2015,985,1254,1190,2595,146,1325,1044,1270,68,74,6950,3435,5375,7800,12779,18510,0
971,0,2,160.0,156.0,279.0,306.0,2244,3314,1259,2127,985,1187,1146,1056,136,200,1010,856,68,74,7125,5660,5375,7800,12779,18810,0
979,0,2,169.0,156.0,279.0,306.0,2636,3090,1539,1903,1097,1187,862,811,16,115,846,696,68,74,7700,5660,5375,7800,12779,18810,0
986,0,2,172.0,154.0,279.0,306.0,3353,3146,2211,1959,1142,1187,1065,1195,116,355,949,840,69,74,7750,5560,5375,7800,12779,18910,0
993,0,2,174.0,151.0,279.0,306.0,3532,3039,2323,1875,1209,1164,1336,1544,256,560,1080,984,69,71,7925,5560,5375,7800,12829,19060,0
1000,0,2,175.0,131.0,294.0,306.0,3706,2922,2463,1847,1243,1075,1262,1852,111,740,1151,1112,69,71,7225,3630,5375,7650,13529,21140,0
1007,0,2,174.0,131.0,294.0,306.0,3717,2922,2631,1847,1086,1075,1386,2185,136,945,1250,1240,69,71,7200,3450,5375,7650,13779,21950,0
7,1,2,13.0,13.0,14.0,15.0,335,335,335,335,0,0,40,40,40,40,0,0,12,12,0,0,0,0,0,0,0
14,1,2,13.0,14.0,14.0,15.0,671,615,671,615,0,0,20,60,20,60,0,0,13,13,0,0,0,0,0,0,0
21,1,2,14.0,14.0,14.0,15.0,699,615,699,615,0,0,50,30,50,30,0,0,13,13,0,0,0,0,0,0,0
29,1,2,14.0,15.0,14.0,15.0,755,615,755,615,0,0,150,65,150,65,0,0,13,14,0,0,0,0,0,0,0
36,1,2,16.0,15.0,22.0,15.0,755,699,755,699,0,0,140,100,140,100,0,0,14,14,0,0,0,0,0,0,0
43,1,2,16.0,16.0,22.0,23.0,755,727,755,727,0,0,225,35,225,35,0,0,16,15,0,0,0,0,0,0,0
50,1,2,15.0,17.0,22.0,23.0,755,783,755,783,0,0,25,85,25,85,0,0,15,16,0,0,0,0,0,0,0
57,1,2,17.0,18.0,22.0,23.0,783,811,783,811,0,0,20,50,20,50,0,0,15,17,0,0,0,0,0,0,0
64,1,2,18.0,18.0,22.0,23.0,839,895,839,895,0,0,75,115,75,115,0,0,16,17,0,0,0,0,0,0,0
71,1,2,17.0,19.0,22.0,23.0,839,979,839,979,0,0,160,235,160,235,0,0,17,18,0,0,0,0,0,0,0
79,1,2,17.0,20.0,22.0,23.0,923,945,923,923,0,22,20,284,20,280,0,4,16,19,0,0,0,0,0,0,0
86,1,2,18.0,20.0,22.0,23.0,923,1034,923,923,0,111,80,415,80,395,0,20,16,19,0,0,0,0,0,0,0
93,1,2,19.0,20.0,22.0,23.0,895,1029,895,895,0,134,140,131,140,95,0,36,18,20,0,0,0,150,0,0,0
100,1,2,20.0,20.0,22.0,23.0,990,1023,923,867,67,156,207,96,195,40,12,56,19,20,0,0,0,150,0,0,0
107,1,2,20.0,21.0,22.0,23.0,1079,1079,923,923,156,156,332,97,300,25,32,72,19,20,0,0,0,150,0,0,0
114,1,2,20.0,22.0,22.0,23.0,1102,1023,923,867,179,156,367,177,315,85,52,92,20,21,0,0,0,150,0,0,0
121,1,2,25.0,22.0,28.0,23.0,1130,1051,951,895,179,156,137,147,65,35,72,112,20,21,0,0,250,150,0,0,0
129,1,2,26.0,23.0,36.0,23.0,1107,1051,951,895,156,156,223,227,135,95,88,132,20,22,0,0,250,150,0,0,0
136,1,2,28.0,25.0,36.0,31.0,1085,1135,951,867,134,268,59,148,55,55,4,93,20,22,0,0,250,300,0,0,0
143,1,2,30.0,26.0,36.0,31.0,1023,1174,979,839,44,335,68,84,60,55,8,29,21,23,100,0,250,300,0,0,0
150,1,2,30.0,27.0,36.0,31.0,1001,1180,979,867,22,313,193,55,185,15,8,40,22,24,100,0,250,300,0,0,0
157,1,2,29.0,29.0,36.0,31.0,1091,1236,1091,923,0,313,33,51,25,25,8,26,23,24,400,125,250,300,0,0,0
164,1,2,31.0,31.0,36.0,46.0,1175,1264,1175,951,0,313,73,111,65,45,8,66,23,25,400,125,250,300,0,0,0
171,1,2,33.0,32.0,36.0,46.0,1259,1348,1259,1035,0,313,83,171,75,65,8,106,23,26,400,125,250,300,0,0,0
179,1,2,36.0,36.0,36.0,46.0,1343,1404,1343,1091,0,313,98,171,90,50,8,121,25,28,400,250,250,300,0,0,0
186,1,2,36.0,39.0,36.0,46.0,1371,1566,1371,1231,0,335,58,56,50,45,8,11,26,28,400,250,250,600,0,0,0
193,1,2,36.0,41.0,36.0,46.0,1477,1673,1455,1315,22,358,247,156,235,105,12,51,27,30,450,250,250,600,0,0,0
200,1,2,34.5,42.0,36.0,46.0,1303,1678,1259,1343,44,335,345,297,325,210,20,87,25,31,425,250,250,600,125,0,0
207,1,2,36.0,43.0,52.0,46.0,1130,1768,1063,1455,67,313,213,363,185,240,28,123,22,32,550,375,250,600,300,0,0
214,1,2,39.0,45.0,52.0,46.0,1186,1768,1119,1455,67,313,161,423,125,260,36,163,23,34,550,375,250,600,300,0,0
221,1,2,40.0,45.0,52.0,46.0,1382,1880,1315,1567,67,313,269,358,225,305,44,53,25,34,700,675,250,600,300,0,0
229,1,2,42.0,46.0,58.0,46.0,1354,1807,1287,1539,67,268,197,215,145,80,52,135,26,36,700,675,250,600,300,0,0
236,1,2,45.0,46.0,58.0,46.0,1438,1897,1371,1651,67,246,175,402,115,235,60,167,26,37,700,675,250,600,300,0,0
243,1,2,47.5,48.0,58.0,54.0,1482,2054,1371,1763,111,291,146,562,70,355,76,207,29,37,625,675,250,600,375,0,0
250,1,2,49.5,44.0,58.0,54.0,1583,2048,1427,1735,156,313,131,752,35,505,96,247,30,37,675,425,375,600,475,250,0
257,1,2,52.5,45.0,58.0,54.0,1695,2098,1539,1763,156,335,206,947,90,660,116,287,36,38,675,425,375,600,475,300,0
264,1,2,55.5,50.0,58.0,54.0,1919,2065,1763,1707,156,358,231,762,95,610,136,152,38,38,675,550,375,1000,475,300,0
271,1,2,57.5,52.0,58.0,54.0,2087,2182,1931,1847,156,335,261,178,105,90,156,88,40,40,825,550,375,1000,475,300,0
279,1,2,56.5,53.0,58.0,54.0,2222,2132,2043,1819,179,313,291,214,115,90,176,124,41,42,825,550,375,1300,475,300,0
286,1,2,57.5,52.0,58.0,54.0,2222,2048,2043,1735,179,313,401,509,205,345,196,164,43,42,825,550,375,1300,475,300,0
293,1,2,57.5,61.0,58.0,70.0,2255,2132,2099,1819,156,313,287,129,175,25,112,104,41,42,825,1050,500,1300,475,300,0
300,1,2,64.5,62.0,74.0,70.0,2087,2160,1931,1847,156,313,182,335,50,195,132,140,42,42,975,1050,500,1300,475,300,0
307,1,2,60.5,63.0,74.0,70.0,1779,2160,1623,1847,156,313,402,550,250,370,152,180,41,43,975,1350,500,1300,675,300,0
314,1,2,61.5,72.0,74.0,78.0,1740,2289,1539,1931,201,358,460,280,280,160,180,120,47,44,975,1850,500,1300,675,300,0
321,1,2,69.5,73.0,74.0,78.0,2272,2255,1847,1875,425,380,345,349,205,185,140,164,47,45,975,1850,700,1300,675,300,0
329,1,2,73.5,74.0,74.0,78.0,2530,2418,2015,1903,515,515,255,638,105,410,150,228,48,46,975,1850,700,1300,675,300,0
336,1,2,79.5,78.0,82.0,78.0,2670,2356,2155,1707,515,649,171,668,40,410,131,258,48,47,975,2100,700,1300,675,300,0
343,1,2,81.5,83.0,82.0,86.0,2703,2496,2211,1847,492,649,392,278,230,90,162,188,48,47,1375,2350,700,1300,675,300,0
350,1,2,89.5,85.0,106.0,101.0,2765,2451,2295,1847,470,604,128,475,110,215,18,260,48,48,1575,2350,950,1300,675,300,0
357,1,2,93.5,90.0,106.0,101.0,2709,2440,2239,1791,470,649,248,470,220,180,28,290,48,51,1875,2600,950,1300,675,300,0
364,1,2,93.0,90.0,106.0,101.0,2787,2630,2295,1959,492,671,373,650,335,380,38,270,46,51,1850,2475,950,1300,900,425,0
371,1,2,94.0,89.0,106.0,101.0,2670,2832,2155,2183,515,649,193,641,145,395,48,246,43,52,1950,2400,950,1300,1350,800,0
379,1,2,97.0,90.0,106.0,101.0,2423,2854,1931,2183,492,671,159,977,55,655,104,322,40,53,2150,2400,950,1450,1500,800,0
386,1,2,95.0,89.0,106.0,101.0,2171,2938,1679,2267,492,671,250,1287,90,885,160,402,39,55,2650,2275,950,1450,1750,925,0
393,1,2,98.0,98.0,106.0,101.0,2093,2894,1623,2267,470,627,341,564,125,440,216,124,39,56,2650,1975,950,1700,1750,1225,0
400,1,2,100.0,99.0,106.0,101.0,2177,2922,1707,2295,470,627,456,519,255,315,201,204,39,57,2950,2650,950,1700,1750,1225,0
407,1,2,106.0,99.0,106.0,101.0,2205,2698,1735,2071,470,627,221,445,110,165,111,280,39,58,3100,2650,950,1700,1750,1225,0
414,1,2,105.5,99.0,106.0,101.0,2255,2810,1763,2183,492,627,486,766,315,410,171,356,39,58,3525,2650,950,1700,1775,1225,0
421,1,2,101.5,99.0,106.0,101.0,2278,2261,1763,1791,515,470,451,644,220,315,231,329,39,56,3275,2850,950,1700,2225,1625,0
429,1,2,104.5,97.0,114.0,101.0,2222,2703,1707,2323,515,380,417,878,130,505,287,373,39,56,3125,2825,950,1800,2375,1900,0
436,1,2,100.5,97.0,114.0,101.0,2227,2983,1735,2603,492,380,673,842,330,525,343,317,39,57,2975,2525,950,2450,2575,2200,0
443,1,2,102.0,101.0,114.0,101.0,2205,2938,1735,2603,470,335,634,523,235,320,399,203,39,58,3300,2775,950,2100,2800,2550,0
450,1,2,100.5,85.0,114.0,101.0,2177,3017,1707,2659,470,358,659,887,200,640,459,247,39,58,2975,1550,950,2100,3125,3775,0
457,1,2,102.0,90.0,114.0,101.0,2233,2966,1763,2631,470,335,719,727,200,540,519,187,39,58,3150,1900,950,2100,3250,3775,0
464,1,2,94.0,98.0,114.0,101.0,2222,2916,1707,2603,515,313,929,837,350,660,579,177,39,59,2850,2275,950,1950,3800,3925,0
471,1,2,89.0,88.0,114.0,101.0,2227,2821,1735,2463,492,358,1050,1021,415,800,635,221,39,53,2450,2150,950,1950,4200,4650,0
479,1,2,82.0,74.0,114.0,101.0,2143,2479,1651,2099,492,380,1196,990,505,775,691,215,39,50,2250,1150,950,1950,4650,5900,0
486,1,2,77.0,76.0,114.0,101.0,2143,2345,1651,1987,492,358,1031,610,480,505,551,105,37,50,2250,1275,950,1950,4800,6075,0
493,1,2,83.0,81.0,114.0,93.0,2009,2350,1539,2015,470,335,792,695,185,550,607,145,37,51,1950,1900,950,2050,5100,6175,0
500,1,2,81.0,81.0,114.0,93.0,2065,2378,1595,2043,470,335,992,974,325,785,667,189,44,53,1900,1900,950,2050,5250,6175,0
507,1,2,70.5,81.0,114.0,78.0,1947,2322,1455,1987,492,335,1127,939,400,760,727,179,47,52,1225,1775,950,2050,5850,7000,0
514,1,2,69.0,77.0,114.0,78.0,2110,2300,1595,1987,515,313,1092,714,380,495,712,219,49,52,800,1400,950,2050,6275,7375,0
521,1,2,73.0,77.0,114.0,78.0,2098,2250,1539,1847,559,403,1065,867,360,600,705,267,50,53,650,1775,950,2050,6425,7375,0
529,1,2,83.0,78.0,106.0,78.0,2692,2429,2043,1847,649,582,731,813,175,645,556,168,50,53,950,1775,950,2050,6525,7375,0
536,1,2,81.0,80.0,106.0,86.0,2726,2367,2099,1763,627,604,1224,1041,478,805,746,236,50,53,950,1775,950,2050,6573,7375,0
543,1,2,81.0,80.0,106.0,94.0,2748,2261,2099,1679,649,582,1554,1208,728,900,826,308,50,53,1250,1875,950,2200,6573,7375,0
550,1,2,82.0,88.0,106.0,94.0,2720,2065,2071,1483,649,582,1819,729,913,545,906,184,50,55,1550,2025,950,2200,6573,7375,0
557,1,2,98.0,91.0,106.0,94.0,2720,1914,2071,1287,649,627,200,475,118,265,82,210,49,57,1550,2025,1400,2200,6573,7375,0
564,1,2,100.0,92.0,106.0,94.0,2692,2199,2043,1595,649,604,421,702,263,420,158,282,49,57,1700,2200,1400,2200,6573,7375,0
571,1,2,104.0,92.0,106.0,94.0,2686,2272,2015,1623,671,649,411,809,173,455,238,354,48,58,1700,2200,1400,2200,6573,7375,0
579,1,2,104.0,94.0,114.0,94.0,2664,2087,2015,1483,649,604,517,417,303,245,214,172,50,59,3500,2750,1400,2200,6573,7375,0
586,1,2,105.0,94.0,106.0,94.0,2698,2115,2071,1511,627,604,438,688,148,440,290,248,55,59,3450,2750,1400,2200,6723,7375,0
593,1,2,104.5,96.0,106.0,109.0,2703,2149,1987,1567,716,582,670,560,288,340,382,220,55,59,3425,2750,1525,2200,6748,7375,0
600,1,2,103.5,102.0,106.0,117.0,2938,2317,2155,1735,783,582,812,336,438,190,374,146,56,59,3425,3275,1525,2500,6748,7375,0
607,1,2,105.5,102.0,106.0,117.0,3045,2608,2127,1847,918,761,979,131,593,35,386,96,56,57,3425,3100,1525,2650,6748,7825,0
614,1,2,107.0,104.0,114.0,117.0,3123,2882,2183,2099,940,783,1201,235,703,155,498,80,56,57,3400,3700,1525,3000,6773,7825,0
621,1,2,114.0,104.0,114.0,117.0,2905,3022,1987,2239,918,783,609,436,303,260,306,176,56,57,3400,3700,1525,3150,6773,7825,0
629,1,2,114.0,104.0,114.0,117.0,2927,3034,1987,2183,940,851,450,401,128,125,322,276,56,57,3400,3700,1525,3150,6773,7825,0
636,1,2,114.0,103.0,114.0,117.0,2955,3073,2015,2155,940,918,816,717,378,325,438,392,57,55,3600,3950,1525,3150,6773,7925,0
643,1,2,124.0,103.0,138.0,117.0,3084,3022,2099,2127,985,895,146,826,88,430,58,396,56,55,4200,3800,1525,3150,6773,8075,0
650,1,2,128.0,107.0,138.0,117.0,3084,2922,2099,2071,985,851,297,671,123,475,174,196,56,56,4200,3800,1525,3300,6773,8075,0
657,1,2,131.0,107.0,138.0,117.0,3162,2983,2155,2043,1007,940,523,1022,233,710,290,312,57,56,4400,3800,1525,3300,6773,8075,0
664,1,2,135.0,109.0,138.0,117.0,3190,2950,2183,1987,1007,963,309,1110,103,790,206,320,63,56,4400,4500,1525,3300,6773,8075,0
671,1,2,139.0,113.0,144.0,125.0,3174,2922,2211,1959,963,963,276,1047,158,915,118,132,64,56,5400,4900,1525,3300,6773,8075,0
679,1,2,142.0,114.0,152.0,125.0,3364,2950,2267,1987,1097,963,345,1099,183,855,162,244,64,56,5400,4500,1525,3300,6773,8075,0
686,1,2,142.0,115.0,160.0,125.0,3549,2793,2295,1875,1254,918,777,1500,463,1148,314,352,65,55,5800,5200,1525,3300,6773,8012,0
693,1,2,153.0,117.0,160.0,125.0,3700,2681,2379,1875,1321,806,362,1585,188,1233,174,352,65,56,6000,5200,1525,3300,6773,8012,0
700,1,2,145.0,116.0,168.0,125.0,3650,2597,2351,1791,1299,806,800,1851,478,1403,322,448,65,58,5600,5025,1525,3300,7573,8187,0
707,1,2,154.5,124.0,168.0,125.0,3756,2675,2435,1847,1321,828,131,1256,78,708,53,548,65,58,5225,5225,1525,3300,8198,8187,0
714,1,2,150.5,129.0,174.0,140.0,3622,2614,2323,1763,1299,851,543,1267,338,723,205,544,61,61,5825,5575,1525,3300,8398,8187,0
721,1,2,154.5,130.0,174.0,140.0,3336,2597,2239,1791,1097,806,547,984,218,498,329,486,59,61,5725,5575,1525,3300,8598,8187,0
729,1,2,163.0,133.0,174.0,140.0,3067,2647,2127,1819,940,828,248,913,103,623,145,290,67,64,6800,5725,1525,3300,8623,8437,0
736,1,2,168.0,138.0,174.0,140.0,3028,2787,2043,1847,985,940,363,404,98,298,265,106,67,65,7200,6375,1525,3300,8623,8437,0
743,1,2,167.5,132.0,174.0,140.0,3325,2765,2295,1847,1030,918,682,1122,293,904,389,218,73,59,7175,5575,1525,3300,8648,8511,0
750,1,2,167.5,135.0,174.0,125.0,3745,2653,2603,1735,1142,918,1044,1184,523,954,521,230,77,62,7175,6475,1525,3300,8648,8911,0
757,1,2,173.5,135.0,174.0,125.0,3913,2726,2659,1763,1254,963,493,1101,153,759,340,342,77,63,6375,6475,1525,3300,9448,8911,0
764,1,2,179.5,135.0,182.0,125.0,4165,2670,2911,1707,1254,963,201,708,163,254,38,454,77,64,6375,6475,1525,3600,9448,8911,0
771,1,2,188.5,135.0,190.0,125.0,4114,2479,2883,1539,1231,940,243,751,53,289,190,462,77,64,6975,6725,1525,3600,9448,8911,0
779,1,2,188.5,135.0,206.0,125.0,4450,2485,3219,1567,1231,918,790,848,448,274,342,574,79,64,7675,6725,1525,3600,9448,8911,0
786,1,2,196.5,139.0,206.0,149.0,4406,2647,3107,1707,1299,940,431,924,308,334,123,590,78,64,7675,6725,1525,3600,9448,8911,0
793,1,2,199.0,139.0,206.0,149.0,4355,2698,3079,1735,1276,963,734,735,463,229,271,506,77,64,8500,6725,1525,3700,9473,8911,0
800,1,2,185.0,135.0,206.0,165.0,4355,2126,3079,1231,1276,895,1252,668,833,54,419,614,79,62,7500,5825,1525,3700,10573,10211,0
807,1,2,174.0,126.0,206.0,165.0,4495,1695,3219,979,1276,716,1775,855,1208,169,567,686,79,59,6950,6075,1650,3700,11323,10661,0
814,1,2,177.5,114.0,206.0,165.0,4338,2210,3107,1651,1231,559,683,824,368,74,315,750,79,59,4775,4175,1650,3600,13498,12911,0
821,1,2,174.5,100.0,206.0,165.0,4456,2362,3247,1847,1209,515,420,1108,153,294,267,814,79,59,3375,3275,1650,3600,14898,14111,0
829,1,2,181.5,98.0,206.0,180.0,4243,2014,2967,1455,1276,559,566,1326,143,444,423,882,79,59,3375,3025,1800,3600,14898,14361,0
836,1,2,191.5,106.0,206.0,180.0,4154,2294,2855,1735,1299,559,443,529,118,179,325,350,79,53,4975,3025,1800,4100,14898,14661,0
843,1,2,190.5,110.0,206.0,180.0,4210,2518,2911,1959,1299,559,851,323,378,109,473,214,78,53,5975,3325,1800,3950,14898,14811,0
850,1,2,191.0,103.0,206.0,180.0,4271,2821,2995,2239,1276,582,869,306,373,124,496,182,78,53,5750,3700,1800,3950,15573,15336,0
857,1,2,188.5,93.0,206.0,180.0,4473,2804,3219,2267,1254,537,877,631,358,389,519,242,78,53,5125,3025,1800,3950,16498,16011,0
864,1,2,189.0,74.0,206.0,180.0,4333,2160,3079,1623,1254,537,799,555,278,249,521,306,78,49,4900,1675,1800,3950,17223,18011,0
7,0,0,13.0,13.0,15.0,15.0,293,251,293,251,0,0,35,30,35,30,0,0,12,12,0,0,0,0,0,0,1
14,0,0,14.0,14.0,15.0,15.0,671,671,671,671,0,0,70,70,70,70,0,0,13,13,0,0,0,0,0,0,1
21,0,0,14.0,14.0,15.0,15.0,727,671,727,671,0,0,50,45,50,45,0,0,13,13,0,0,0,0,0,0,1
29,0,0,15.0,15.0,15.0,15.0,671,699,671,699,0,0,5,85,5,85,0,0,14,14,0,0,0,0,0,0,1
36,0,0,15.0,15.0,15.0,15.0,783,727,783,727,0,0,50,180,50,180,0,0,14,14,0,0,0,0,0,0,1
43,0,0,16.0,16.0,23.0,23.0,727,755,727,755,0,0,125,60,125,60,0,0,15,15,0,0,0,0,0,0,1
50,0,0,16.0,16.0,23.0,23.0,783,783,783,783,0,0,65,10,65,10,0,0,15,15,0,0,0,0,0,0,1
57,0,0,17.0,17.0,23.0,23.0,794,699,727,699,67,0,67,45,55,45,12,0,16,16,0,0,0,0,0,0,1
64,0,0,18.0,17.0,23.0,23.0,883,755,727,755,156,0,172,140,140,140,32,0,17,16,0,0,0,0,0,0,1
71,0,0,18.0,18.0,23.0,23.0,883,771,727,727,156,44,272,168,220,160,52,8,17,17,0,0,0,0,0,0,1
79,0,0,19.0,19.0,23.0,23.0,990,788,811,587,179,201,347,216,275,180,72,36,18,18,0,0,0,0,0,0,1
86,0,0,19.0,19.0,23.0,23.0,906,928,727,615,179,313,447,341,355,265,92,76,18,18,0,0,0,0,0,0,1
93,0,0,20.0,20.0,23.0,23.0,939,978,783,643,156,335,458,101,400,35,58,66,19,19,0,0,150,150,0,0,1
100,0,0,20.0,20.0,23.0,23.0,911,984,755,671,156,313,428,222,350,120,78,102,19,19,0,0,150,150,0,0,1
107,0,0,20.0,20.0,23.0,23.0,911,906,755,615,156,291,138,79,40,45,98,34,19,19,0,0,150,150,0,0,1
114,0,0,20.0,20.0,23.0,31.0,967,939,811,671,156,268,18,201,0,135,18,66,19,19,0,0,150,150,0,0,1
121,0,0,21.0,22.0,23.0,31.0,939,1029,783,783,156,246,88,169,50,125,38,44,19,19,0,100,150,150,0,0,1
129,0,0,21.0,22.0,23.0,31.0,1074,1225,895,979,179,246,23,322,15,250,8,72,19,19,100,100,150,150,0,0,1
136,0,0,22.0,23.0,23.0,31.0,1186,1387,1007,1119,179,268,103,429,75,325,28,104,20,20,100,100,150,150,0,0,1
143,0,0,22.0,23.0,23.0,31.0,1079,1202,923,979,156,223,104,163,60,35,44,128,20,21,100,100,150,150,0,0,1
150,0,0,23.0,24.0,31.0,31.0,1135,1275,979,1007,156,268,189,280,125,120,64,160,21,21,100,100,150,400,0,0,1
157,0,0,24.0,26.0,31.0,31.0,1191,1281,1035,1035,156,246,329,233,245,95,84,138,22,22,100,200,400,400,0,0,1
164,0,0,28.0,27.0,31.0,31.0,1292,1258,1091,1035,201,223,32,246,20,80,12,166,22,22,100,200,500,400,0,0,1
171,0,0,29.0,28.0,31.0,31.0,1426,1421,1091,1175,335,246,142,128,90,30,52,98,23,23,100,200,500,400,0,0,1
179,0,0,29.0,28.0,46.0,31.0,1286,1393,951,1147,335,246,157,166,65,65,92,101,23,23,100,300,500,400,0,0,1
186,0,0,31.0,29.0,46.0,31.0,1376,1275,1063,1007,313,268,163,262,60,125,103,137,24,24,300,300,500,400,0,0,1
193,0,0,32.0,32.0,46.0,39.0,1208,1370,895,1035,313,335,248,177,105,100,143,77,24,24,300,300,500,475,0,0,1
200,0,0,36.0,35.0,46.0,39.0,1432,1516,1119,1203,313,313,143,248,60,135,83,113,25,25,350,300,825,575,0,0,1
207,0,0,39.0,35.0,46.0,39.0,1482,1516,1147,1203,335,313,103,423,5,270,98,153,25,26,400,300,825,825,0,0,1
214,0,0,39.0,40.0,46.0,54.0,1734,1538,1399,1203,335,335,228,173,90,80,138,93,26,26,400,400,825,825,0,0,1
221,0,0,41.0,40.0,46.0,54.0,1790,1482,1455,1147,335,335,254,158,80,25,174,133,27,26,400,400,900,825,0,0,1
229,0,0,42.0,44.0,46.0,54.0,1874,1572,1539,1259,335,313,429,114,215,45,214,69,28,27,500,650,900,825,0,0,1
236,0,0,44.0,47.0,46.0,54.0,1880,1594,1567,1259,313,335,160,164,110,55,50,109,29,28,750,750,900,825,0,0,1
243,0,0,50.0,47.0,54.0,54.0,1958,1673,1623,1315,335,358,129,243,35,115,94,128,30,28,750,950,900,825,0,0,1
250,0,0,51.0,49.0,54.0,54.0,1981,1673,1623,1203,358,470,273,353,135,165,138,188,30,29,750,1000,900,825,0,0,1
257,0,0,53.0,51.0,54.0,54.0,2166,1617,1763,1147,403,470,496,299,310,55,186,244,32,29,800,1050,900,825,0,0,1
264,0,0,53.0,54.0,62.0,54.0,2199,1919,1819,1427,380,492,590,139,360,35,230,104,32,31,1075,1300,900,900,0,0,1
271,0,0,55.0,50.0,62.0,54.0,2334,2037,1931,1567,403,470,713,360,435,200,278,160,34,31,1350,950,900,900,0,350,1
279,0,0,55.0,56.0,62.0,62.0,2031,2115,1651,1623,380,492,292,245,170,150,122,95,34,32,1350,1050,900,900,0,350,1
286,0,0,57.0,58.0,62.0,70.0,1858,2138,1455,1623,403,515,289,390,165,235,124,155,36,34,1350,1050,900,900,0,350,1
293,0,0,61.0,59.0,62.0,70.0,2093,2311,1623,1819,470,492,179,616,120,405,59,211,36,35,1350,1050,900,900,0,350,1
300,0,0,62.0,62.0,62.0,70.0,2143,2261,1651,1791,492,470,349,571,230,307,119,264,38,36,1350,1150,900,900,0,350,1
307,0,0,64.0,65.0,70.0,70.0,2238,2339,1679,1847,559,492,517,482,330,370,187,112,39,37,1400,1450,900,900,0,350,1
314,0,0,64.0,66.0,70.0,70.0,2300,2479,1651,1987,649,492,693,762,430,600,263,162,38,38,1400,1825,1050,900,50,350,1
321,0,0,65.0,70.0,78.0,70.0,2160,2065,1511,1595,649,470,784,443,495,350,289,93,39,40,1675,1625,1300,900,50,550,1
329,0,0,72.0,72.0,78.0,78.0,2194,2115,1567,1623,627,492,295,248,80,95,215,153,41,41,1725,1625,1300,900,50,550,1
336,0,0,74.0,74.0,78.0,78.0,2390,2059,1763,1567,627,492,395,244,100,35,295,209,41,41,1725,1725,1300,900,50,550,1
343,0,0,76.0,76.0,78.0,78.0,2474,2115,1847,1623,627,492,390,504,115,235,275,269,43,43,1775,1725,1300,900,50,550,1
350,0,0,78.0,74.0,94.0,78.0,2574,2143,1903,1651,671,492,605,704,250,375,355,329,44,43,1875,2200,1300,900,50,650,1
357,0,0,80.0,77.0,94.0,78.0,2597,2278,1903,1651,694,627,660,369,300,285,360,84,44,45,2325,2300,1300,900,50,650,1
364,0,0,81.0,82.0,94.0,86.0,2608,2350,1959,1679,649,671,873,659,445,495,428,164,44,47,2375,2300,1300,900,50,650,1
371,0,0,86.0,82.0,94.0,86.0,2636,2434,1987,1763,649,671,748,835,365,595,383,240,44,47,2475,2200,1300,900,50,750,1
379,0,0,94.0,82.0,94.0,86.0,2642,2412,2015,1763,627,649,219,426,60,360,159,66,44,47,2525,2250,1300,900,50,750,1
386,0,0,98.0,84.0,102.0,86.0,2586,2300,1959,1651,627,649,424,422,185,280,239,142,44,49,2850,2250,1300,900,50,750,1
393,0,0,90.0,80.0,102.0,86.0,2608,2244,1959,1595,649,649,734,542,415,320,319,222,44,51,2400,2075,1300,900,500,1200,1
400,0,0,74.0,74.0,102.0,86.0,2569,2362,1875,1735,694,627,1024,823,625,525,399,298,46,51,1475,1675,1300,900,1475,1650,1
407,0,0,83.0,78.0,110.0,101.0,2401,2378,1707,1707,694,671,335,628,135,375,200,253,46,52,2075,1975,1300,900,1700,1650,1
414,0,0,87.0,78.0,110.0,109.0,2468,2384,1819,1735,649,649,172,909,50,580,122,329,46,52,2125,1975,1300,1025,1700,1650,1
421,0,0,89.0,79.0,110.0,109.0,2362,2356,1735,1707,627,649,458,1145,260,740,198,405,48,53,2525,1975,1300,1025,1700,1650,1
429,0,0,89.0,83.0,110.0,109.0,2418,2462,1791,1791,627,671,753,970,475,635,278,335,48,53,2525,1975,1300,1625,1700,1650,1
436,0,0,86.0,77.0,110.0,109.0,2474,2485,1847,1791,627,694,1048,1219,690,800,358,419,48,54,2975,1225,1300,1625,2025,2400,1
443,0,0,77.0,73.0,110.0,109.0,2518,2412,1847,1763,671,649,1103,940,665,695,438,245,48,55,2175,650,1300,1625,2925,3250,1
450,0,0,75.0,77.0,110.0,109.0,2541,2546,1847,1875,694,671,1048,614,530,435,518,179,48,55,1725,650,1300,1625,3425,3250,1
457,0,0,83.0,77.0,110.0,109.0,2518,2485,1847,1791,671,694,640,839,350,580,290,259,48,55,2125,725,1300,1625,3425,3625,1
464,0,0,83.0,78.0,110.0,109.0,2552,2406,1903,1735,649,671,941,584,575,445,366,139,50,56,2125,725,1300,1625,3425,3625,1
471,0,0,78.0,76.0,110.0,109.0,2530,1986,1903,1315,627,671,1187,809,745,590,442,219,50,55,1625,925,1300,1625,3975,3725,1
479,0,0,77.0,77.0,110.0,109.0,2530,2076,1903,1427,627,649,1247,315,725,270,522,45,50,46,1225,1475,1300,1625,4475,4175,1
486,0,0,70.0,80.0,110.0,109.0,2418,2154,1791,1483,627,671,1032,314,430,185,602,129,50,46,600,1925,1300,1625,5150,4175,1
493,0,0,76.0,80.0,110.0,109.0,2373,2138,1679,1511,694,627,642,580,85,375,557,205,52,46,650,1925,1300,1625,5200,4175,1
500,0,0,76.0,87.0,110.0,109.0,2490,2569,1819,1875,671,694,778,303,145,160,633,143,52,49,1250,2125,1300,2125,5200,4175,1
507,0,0,80.0,89.0,110.0,109.0,2384,2871,1735,2155,649,716,765,322,135,170,630,152,54,49,1300,2125,1300,2125,5200,4175,1
514,0,0,86.0,94.0,110.0,109.0,2642,3050,2015,2267,627,783,651,483,95,310,556,173,54,52,1400,2675,1300,2125,5200,4175,1
521,0,0,87.0,102.0,110.0,109.0,3034,3532,2407,2547,627,985,736,133,225,90,511,43,55,55,1450,2675,1300,2125,5200,4175,1
529,0,0,94.0,106.0,110.0,109.0,3090,3504,2463,2519,627,985,656,94,215,93,441,1,55,55,1825,3125,1425,2125,5200,4175,1
536,0,0,98.0,109.0,110.0,109.0,3162,3510,2491,2547,671,963,726,228,305,120,421,108,55,57,2050,3125,1425,2225,5200,4175,1
543,0,0,99.0,109.0,110.0,109.0,2821,3700,2127,2715,694,985,426,182,125,133,301,49,57,57,2325,3575,1725,2325,5200,4175,1
550,0,0,105.0,109.0,110.0,109.0,3050,3812,2379,2827,671,985,223,308,50,218,173,90,57,60,2650,3850,1725,2325,5200,4175,1
557,0,0,106.0,109.0,110.0,109.0,2972,3454,2323,2491,649,963,529,529,280,323,249,206,56,60,3200,4350,1725,2325,5250,4175,1
564,0,0,106.0,109.0,118.0,109.0,2922,3280,2295,2295,627,985,885,475,560,303,325,172,56,60,3525,4575,1875,2325,5250,4175,1
571,0,0,113.0,117.0,118.0,117.0,3090,3084,2463,2099,627,985,115,386,60,223,55,163,57,60,3475,4475,1875,2325,5300,4275,1
579,0,0,113.0,128.0,133.0,133.0,2586,3062,1959,2099,627,963,375,367,240,213,135,154,58,63,3525,4475,1875,2325,5300,4275,1
586,0,0,120.0,129.0,133.0,141.0,2182,3118,1511,2155,671,963,350,698,185,428,165,270,58,63,3975,4475,2375,2325,5300,4275,1
593,0,0,120.0,130.0,133.0,141.0,2871,3062,2155,2099,716,963,724,509,475,323,249,186,58,63,3975,4475,2375,2575,5300,4275,1
600,0,0,123.0,130.0,133.0,149.0,3532,3056,2659,2071,873,985,978,869,625,563,353,306,58,64,4475,5400,2375,2575,5300,4275,1
607,0,0,123.0,130.0,133.0,149.0,3627,3078,2687,2071,940,1007,1405,840,940,418,465,422,58,65,5000,5850,2375,2575,5300,4275,1
614,0,0,117.0,126.0,133.0,149.0,3627,3084,2687,2099,940,985,1822,1196,1245,658,577,538,58,65,4775,5675,2375,2575,5850,4725,1
621,0,0,88.0,111.0,133.0,149.0,3521,3174,2603,2211,918,963,1109,1578,420,928,689,650,58,65,2200,4425,2375,2575,8475,5975,1
629,0,0,75.0,113.0,133.0,149.0,3521,3342,2603,2379,918,963,1546,1219,745,703,801,516,58,65,900,3650,2375,2575,9775,6750,1
7,2,1,13.0,13.0,15.0,14.0,293,377,293,377,0,0,35,45,35,45,0,0,12,12,0,0,0,0,0,0,1
14,2,1,14.0,13.0,15.0,14.0,643,671,643,671,0,0,65,20,65,20,0,0,13,13,0,0,0,0,0,0,1
21,2,1,14.0,14.0,15.0,14.0,699,727,699,727,0,0,50,55,50,55,0,0,13,13,0,0,0,0,0,0,1
29,2,1,15.0,14.0,15.0,14.0,727,755,727,755,0,0,35,145,35,145,0,0,14,13,0,0,0,0,0,0,1
36,2,1,15.0,16.0,23.0,22.0,727,783,727,783,0,0,125,140,125,140,0,0,14,14,0,0,0,0,0,0,1
43,2,1,16.0,17.0,23.0,22.0,727,755,727,755,0,0,15,180,15,180,0,0,15,16,0,0,0,0,0,0,1
50,2,1,17.0,17.0,23.0,22.0,811,783,811,783,0,0,35,285,35,285,0,0,16,16,0,0,0,0,0,0,1
57,2,1,18.0,17.0,23.0,22.0,839,867,839,867,0,0,35,40,35,40,0,0,17,16,0,0,0,0,0,0,1
64,2,1,19.0,18.0,23.0,22.0,923,895,923,895,0,0,95,95,95,95,0,0,18,16,0,0,0,0,0,0,1
71,2,1,19.0,17.0,23.0,22.0,1001,923,979,923,22,0,219,180,215,180,4,0,18,17,0,0,0,0,0,0,1
79,2,1,20.0,17.0,23.0,22.0,939,923,895,923,44,0,318,45,310,45,8,0,19,16,0,0,0,0,0,0,1
86,2,1,20.0,18.0,23.0,22.0,967,895,923,895,44,0,46,95,30,95,16,0,19,16,0,0,150,0,0,0,1
93,2,1,20.0,19.0,23.0,22.0,1012,923,923,923,89,0,168,150,140,150,28,0,20,18,0,0,150,0,0,0,1
100,2,1,21.0,20.0,23.0,22.0,1085,1018,951,951,134,67,94,227,50,215,44,12,20,19,0,0,150,0,0,0,1
107,2,1,21.0,20.0,23.0,22.0,1034,1057,923,923,111,134,86,353,30,325,56,28,20,19,0,0,150,0,0,0,1
114,2,1,22.0,20.0,23.0,22.0,1107,1079,951,923,156,156,131,373,55,325,76,48,21,20,0,0,150,0,0,0,1
121,2,1,23.0,20.0,23.0,22.0,1046,1079,867,923,179,156,201,503,105,435,96,68,22,20,0,0,150,250,0,0,1
129,2,1,23.0,26.0,23.0,36.0,1152,1135,951,979,201,156,290,248,170,160,120,88,22,20,0,0,150,250,0,0,1
136,2,1,26.0,28.0,31.0,36.0,1130,1090,839,979,291,111,296,65,165,65,131,0,23,20,0,0,300,250,0,0,1
143,2,1,26.0,29.0,31.0,36.0,1208,1029,895,1007,313,22,97,140,80,140,17,0,23,21,0,100,300,250,0,0,1
150,2,1,27.0,30.0,31.0,36.0,1152,979,839,979,313,0,112,210,80,210,32,0,24,22,0,100,300,250,0,0,1
157,2,1,30.0,29.0,46.0,36.0,1264,1119,951,1119,313,0,67,55,45,55,22,0,24,23,125,100,300,250,0,0,1
164,2,1,31.0,31.0,46.0,36.0,1208,1203,895,1203,313,0,117,45,55,45,62,0,25,23,125,400,300,250,0,0,1
171,2,1,35.0,33.0,46.0,36.0,1370,1315,1035,1315,335,0,107,5,30,5,77,0,27,23,250,400,300,250,0,0,1
179,2,1,36.0,35.0,46.0,36.0,1454,1315,1119,1315,335,0,233,75,120,75,113,0,28,24,250,400,300,250,0,0,1
186,2,1,41.0,36.0,46.0,36.0,1538,1343,1203,1343,335,0,58,75,55,75,3,0,30,25,250,400,600,250,0,0,1
193,2,1,41.0,36.0,46.0,44.0,1600,1427,1287,1427,313,0,204,245,165,245,39,0,30,25,250,400,600,250,0,0,1
200,2,1,43.0,40.0,46.0,44.0,1628,1147,1315,1147,313,0,254,162,175,162,79,0,32,25,250,650,600,250,0,0,1
207,2,1,45.0,41.5,46.0,52.0,1740,1063,1427,1063,313,0,369,92,250,92,119,0,34,23,375,675,600,250,0,125,1
214,2,1,41.0,39.5,46.0,52.0,1818,1175,1483,1175,335,0,184,152,25,152,159,0,34,25,425,675,600,250,250,175,1
221,2,1,45.0,43.5,46.0,52.0,1846,1231,1511,1231,335,0,49,62,0,62,49,0,36,29,425,675,600,250,250,175,1
229,2,1,46.0,47.0,46.0,58.0,1930,1511,1595,1511,335,0,140,7,55,7,85,0,36,31,425,650,600,250,250,200,1
236,2,1,48.0,49.0,54.0,58.0,1958,1651,1623,1651,335,0,265,52,140,52,125,0,38,31,425,600,600,375,250,250,1
243,2,1,48.0,52.0,54.0,58.0,1936,1819,1623,1819,313,0,261,17,100,17,161,0,38,33,425,600,600,375,250,250,1
250,2,1,53.0,53.0,54.0,58.0,1992,1746,1679,1679,313,67,141,49,90,37,51,12,40,35,725,600,600,375,250,250,1
257,2,1,53.0,56.0,54.0,58.0,2026,1925,1735,1791,291,134,292,65,205,37,87,28,40,38,725,750,600,375,250,250,1
264,2,1,54.0,58.0,54.0,66.0,1986,1919,1651,1763,335,156,241,130,210,82,31,48,42,40,725,900,600,375,250,250,1
271,2,1,56.0,61.0,62.0,66.0,2177,2031,1595,1875,582,156,421,70,310,2,111,68,43,39,725,900,600,500,250,350,1
279,2,1,57.0,63.0,62.0,66.0,2378,2087,1707,1931,671,156,352,126,165,42,187,84,44,42,1025,900,600,500,250,350,1
286,2,1,60.0,64.0,77.0,66.0,2334,2199,1707,2043,627,156,469,141,260,37,209,104,45,45,1025,900,600,500,250,350,1
293,2,1,62.0,65.0,77.0,66.0,2468,2395,1819,2239,649,156,309,76,20,52,289,24,46,47,1200,1100,600,625,250,350,1
300,2,1,65.0,67.0,77.0,82.0,2496,2451,1847,2295,649,156,419,291,50,247,369,44,49,48,1200,1100,600,625,250,350,1
307,2,1,68.0,69.0,77.0,90.0,2558,2535,1931,2379,627,156,330,182,35,122,295,60,52,50,1200,1100,1150,625,250,350,1
314,2,1,69.0,74.0,77.0,98.0,2826,2171,2155,2015,671,156,225,82,50,2,175,80,53,48,1200,1150,1150,625,250,400,1
321,2,1,73.0,77.0,85.0,98.0,2776,2423,2127,2267,649,156,322,247,125,147,197,100,55,50,1200,1150,1150,625,250,400,1
329,2,1,73.0,77.0,85.0,98.0,2978,2675,2351,2519,627,156,598,248,325,232,273,16,57,56,1375,1150,1150,625,250,400,1
336,2,1,73.0,82.0,85.0,98.0,3006,2675,2379,2519,627,156,968,128,615,92,353,36,58,57,1375,1150,1150,625,250,400,1
343,2,1,75.0,84.0,85.0,98.0,3302,3011,2631,2855,671,156,1108,178,775,122,333,56,58,59,1375,1150,1300,625,250,400,1
350,2,1,78.0,83.0,93.0,98.0,3146,2955,2519,2799,627,156,826,384,425,362,401,22,58,61,1525,1150,1450,625,250,400,1
357,2,1,82.0,86.5,93.0,106.0,3168,2972,2519,2659,649,313,566,242,185,172,381,70,58,64,1525,1125,1450,625,250,425,1
364,2,1,83.0,87.5,93.0,106.0,3202,3207,2575,2603,627,604,792,517,335,367,457,150,61,63,1875,1125,1450,750,250,425,1
371,2,1,83.0,93.5,109.0,106.0,3174,3308,2547,2659,627,649,1068,514,535,292,533,222,61,67,1875,1275,1450,750,250,425,1
379,2,1,85.0,97.5,109.0,106.0,3202,3526,2575,2855,627,671,838,629,275,327,563,302,62,69,2050,1275,1450,750,250,425,1
386,2,1,88.0,102.5,117.0,112.0,3241,3476,2547,2827,694,649,1028,745,385,367,643,378,62,69,2050,1575,1450,1000,250,425,1
393,2,1,93.0,105.5,117.0,120.0,3134,3672,2463,3023,671,649,1004,1026,385,572,619,454,64,69,2050,1775,1450,1200,300,425,1
400,2,1,94.0,114.5,117.0,128.0,3118,3812,2491,3163,627,649,1261,702,570,322,691,380,64,71,2400,1875,1550,1200,300,475,1
407,2,1,98.0,114.5,117.0,128.0,3140,3756,2491,3107,649,649,1341,1042,620,582,721,460,67,73,2400,1875,1850,1200,300,475,1
414,2,1,101.0,119.5,117.0,128.0,3224,3952,2575,3303,649,649,1141,974,490,592,651,382,67,76,2750,1875,1850,1200,300,475,1
421,2,1,108.0,123.5,140.0,128.0,3252,3946,2603,3275,649,671,1012,689,435,227,577,462,69,75,2750,2325,2000,1200,300,475,1
429,2,1,105.0,131.0,140.0,136.0,3308,3980,2659,3331,649,649,1402,735,745,197,657,538,68,75,3275,2500,2300,1200,450,550,1
436,2,1,101.0,125.5,148.0,158.0,3470,3930,2799,3303,671,627,1823,1191,1090,577,733,614,68,76,2975,2225,2300,1200,750,825,1
443,2,1,115.0,132.5,148.0,158.0,3498,4098,2827,3471,671,627,1113,1097,550,507,563,590,68,76,3850,2425,2300,1200,750,825,1
450,2,1,116.0,139.5,148.0,158.0,3504,4232,2855,3583,649,649,730,1207,395,537,335,670,72,75,3850,2875,2300,1200,750,825,1
457,2,1,122.0,145.5,148.0,158.0,3582,4232,2911,3583,671,649,640,792,375,242,265,550,72,75,4025,3125,2300,1200,750,825,1
464,2,1,122.0,142.5,148.0,158.0,3790,4338,3163,3667,627,671,593,1263,260,637,333,626,73,78,4375,2925,2300,1200,750,1025,1
471,2,1,122.0,143.0,156.0,174.0,3846,4394,3219,3723,627,671,798,1189,385,662,413,527,73,77,4375,3500,2300,1200,750,1125,1
479,2,1,122.0,153.5,164.0,174.0,3812,4316,3163,3667,649,649,1153,740,660,337,493,403,73,77,4375,3925,2300,1450,750,1150,1
486,2,1,138.0,160.0,172.0,174.0,3924,4070,3275,3443,649,627,823,687,250,270,573,417,73,77,5175,4300,2300,1450,750,1199,1
493,2,1,134.0,154.5,164.0,180.0,3448,4008,2911,3359,537,649,1199,1152,570,655,629,497,73,77,4825,4125,2300,1575,1200,1249,1
500,2,1,132.0,157.0,164.0,180.0,2406,4282,2071,3611,335,671,1746,1337,1085,760,661,577,71,77,4825,4250,2550,1575,1000,1524,1
507,2,1,147.0,152.5,164.0,180.0,2216,4316,2015,3667,201,649,420,1238,135,585,285,653,68,77,6225,3725,2650,1575,1150,2249,1
514,2,1,148.0,168.0,164.0,180.0,2222,4316,2043,3667,179,649,620,554,315,175,305,379,68,77,6225,3850,2650,1575,1150,2324,1
521,2,1,148.0,170.0,164.0,180.0,1796,4316,1595,3667,201,649,734,415,405,260,329,155,70,77,6225,4500,2650,1575,1150,2324,1
529,2,1,148.0,179.0,164.0,188.0,2468,4131,2155,3527,313,604,938,302,565,225,373,77,71,77,6225,4650,2650,1575,1150,2324,1
536,2,1,145.0,176.5,172.0,188.0,3454,3986,3051,3359,403,627,1196,792,775,635,421,157,71,77,5925,4775,2650,1575,1450,2399,1
543,2,1,146.0,184.5,180.0,188.0,3549,4182,2967,3555,582,627,933,502,440,465,493,37,73,77,5925,6125,2650,1575,1450,2399,1
550,2,1,148.0,186.5,180.0,188.0,3717,4148,3135,3499,582,649,1280,573,715,510,565,63,74,77,5925,6525,2650,1575,1450,2449,1
557,2,1,149.0,186.0,180.0,188.0,3538,4338,2799,3667,739,671,1310,738,845,720,465,18,75,77,5925,7300,2650,1575,1450,2474,1
564,2,1,163.0,187.0,180.0,188.0,3605,4338,2687,3667,918,671,308,1114,85,1020,223,94,77,77,5925,7450,2650,1575,1450,2574,1
571,2,1,151.0,193.0,180.0,212.0,3717,4338,2799,3667,918,671,751,575,420,405,331,170,78,77,6425,6850,2750,1575,2250,3299,1
579,2,1,137.0,181.5,188.0,212.0,3941,4434,3023,3807,918,627,1438,717,995,475,443,242,77,77,5150,5425,2650,1575,3375,4874,1
586,2,1,122.0,182.0,188.0,212.0,3991,4406,3051,3779,940,627,1905,822,1350,500,555,322,77,77,3975,4800,2550,1575,4850,5499,1
593,2,1,136.0,186.5,180.0,212.0,4053,4512,3135,3863,918,649,763,317,450,290,313,27,77,77,5200,6025,2900,1575,4950,5674,1
600,2,1,136.0,190.5,180.0,212.0,3890,4400,2995,3751,895,649,521,418,450,415,71,3,77,77,5200,6475,2900,1575,4950,5674,1
607,2,1,136.0,199.5,180.0,212.0,4042,4484,3079,3835,963,649,907,404,720,375,187,29,77,77,5200,7525,2900,1575,4950,5724,1
614,2,1,136.0,199.5,180.0,212.0,3941,4282,3023,3611,918,671,1255,904,960,795,295,109,77,77,5200,7725,2900,1575,4875,5724,1
621,2,1,150.0,198.5,180.0,212.0,3801,4310,2883,3639,918,671,373,1420,320,1235,53,185,77,77,6250,8225,2900,1575,4875,5774,1
629,2,1,150.0,195.5,188.0,212.0,3851,4266,2911,3639,940,627,464,1097,345,1040,119,57,77,77,6425,7625,3300,1575,5050,6374,1
636,2,1,132.0,197.0,188.0,212.0,3997,4266,3079,3639,918,627,923,512,700,375,223,137,77,77,4850,6150,3300,1575,6725,7849,1
643,2,1,118.0,188.0,188.0,212.0,3969,4372,3051,3723,918,649,709,593,570,380,139,213,77,77,2925,5300,3150,1575,8900,8799,1
650,2,1,99.0,179.0,188.0,212.0,3437,4316,2519,3667,918,649,412,663,315,370,97,293,61,77,3100,5200,2900,1575,11000,9824,1
657,2,1,93.0,170.5,188.0,212.0,3174,4394,2323,3723,851,671,798,1194,605,825,193,369,61,77,2575,5125,2700,1575,11900,10299,1
7,,,13.0,13.0,15.0,15.0,293,293,293,293,0,0,35,35,35,35,0,0,12,12,0,0,0,0,0,0,0
14,,,14.0,14.0,15.0,15.0,671,643,671,643,0,0,70,65,70,65,0,0,13,13,0,0,0,0,0,0,0
21,,,14.0,14.0,15.0,15.0,699,699,699,699,0,0,40,40,40,40,0,0,13,13,0,0,0,0,0,0,0
29,,,15.0,15.0,15.0,15.0,671,671,671,671,0,0,80,75,80,75,0,0,14,14,0,0,0,0,0,0,0
36,,,15.0,15.0,15.0,15.0,755,699,755,699,0,0,45,110,45,110,0,0,14,14,0,0,0,0,0,0,0
43,,,16.0,16.0,23.0,23.0,811,755,811,755,0,0,90,50,90,50,0,0,15,15,0,0,0,0,0,0,0
50,,,17.0,16.0,23.0,23.0,867,727,867,727,0,0,40,15,40,15,0,0,16,15,0,0,0,0,0,0,0
57,,,18.0,17.0,23.0,23.0,889,727,867,727,22,0,104,105,100,105,4,0,17,16,0,0,0,0,0,0,0
64,,,18.0,18.0,23.0,23.0,900,755,811,755,89,0,156,150,140,150,16,0,17,17,0,0,0,0,0,0,0
71,,,19.0,18.0,23.0,23.0,1001,799,867,755,134,44,281,198,245,190,36,8,18,17,0,0,0,0,0,0,0
79,,,20.0,19.0,23.0,23.0,1018,967,839,811,179,156,346,318,290,290,56,28,19,18,0,0,0,0,0,0,0
86,,,20.0,19.0,23.0,23.0,995,911,839,755,156,156,472,413,400,365,72,48,19,18,0,0,0,0,0,0,0
93,,,20.0,20.0,23.0,23.0,995,939,839,783,156,156,192,278,100,260,92,18,20,19,0,0,0,150,0,0,0
100,,,21.0,20.0,23.0,23.0,1001,962,867,783,134,179,108,393,0,355,108,38,20,19,0,0,150,150,0,0,0
107,,,21.0,20.0,23.0,23.0,1001,1018,867,839,134,179,163,108,35,50,128,58,20,19,0,0,150,150,0,0,0
114,,,22.0,20.0,23.0,23.0,1051,911,895,755,156,156,239,109,95,35,144,74,21,19,0,0,150,150,0,0,0
121,,,22.0,22.0,23.0,23.0,1079,911,923,755,156,156,214,119,50,25,164,94,21,19,0,100,150,150,0,0,0
129,,,23.0,23.0,23.0,23.0,1079,1051,923,895,156,156,344,209,160,95,184,114,22,20,0,100,150,150,0,0,0
136,,,23.0,23.0,23.0,31.0,1118,1023,895,867,223,156,361,79,170,45,191,34,22,20,0,100,300,150,0,0,0
143,,,26.0,24.0,31.0,31.0,1158,1023,867,867,291,156,142,69,65,65,77,4,23,21,0,150,300,150,0,0,0
150,,,26.0,24.0,31.0,31.0,1309,1074,951,895,358,179,147,59,80,35,67,24,23,21,0,150,300,150,0,0,0
157,,,29.0,25.0,31.0,31.0,1258,1191,923,1035,335,156,118,135,40,95,78,40,24,22,125,150,300,150,0,0,0
164,,,30.0,25.0,46.0,31.0,1264,1163,951,1007,313,156,214,230,100,170,114,60,24,22,125,150,300,150,0,0,0
171,,,31.0,26.0,46.0,31.0,1292,1191,979,1035,313,156,269,365,115,285,154,80,25,23,125,150,300,150,50,0,0
179,,,34.0,28.0,46.0,46.0,1320,1242,1007,1063,313,179,254,409,85,305,169,104,26,24,250,150,300,600,50,0,0
186,,,39.0,29.0,46.0,46.0,1376,1270,1063,979,313,291,69,99,10,55,59,44,27,24,250,150,600,600,50,0,0
193,,,40.0,32.0,46.0,46.0,1477,1477,1119,1119,358,358,194,134,95,50,99,84,28,25,250,150,600,600,50,0,0
200,,,40.0,32.0,46.0,46.0,1533,1398,1175,1063,358,335,289,195,150,75,139,120,29,25,250,150,600,600,50,0,0
207,,,41.0,34.0,46.0,46.0,1544,1264,1231,951,313,313,61,299,40,144,21,155,30,25,375,350,600,600,50,50,0
214,,,45.0,35.0,54.0,46.0,1516,1292,1203,979,313,313,166,399,105,204,61,195,30,26,725,350,600,600,50,50,0
221,,,47.0,36.0,54.0,46.0,1600,1516,1287,1203,313,313,271,244,170,34,101,210,31,27,725,250,600,600,50,150,0
229,,,47.0,37.0,54.0,46.0,1572,1656,1259,1343,313,313,356,444,215,194,141,250,31,28,725,350,600,600,50,150,0
236,,,52.0,42.0,54.0,46.0,1538,1818,1203,1483,335,335,135,194,100,79,35,115,33,29,1075,350,600,925,50,150,0
243,,,52.0,44.0,62.0,46.0,1802,1925,1287,1567,515,358,369,219,270,64,99,155,33,29,1075,350,600,925,50,150,0
250,,,52.0,46.0,62.0,46.0,1886,1930,1371,1595,515,335,580,305,425,114,155,191,34,31,1075,400,600,1025,50,150,0
257,,,51.0,46.0,62.0,46.0,1785,1768,1315,1455,470,313,782,256,575,29,207,227,33,31,1075,300,600,1025,100,250,0
264,,,59.0,46.0,62.0,46.0,1785,1852,1315,1539,470,313,427,381,335,114,92,267,33,31,1425,625,600,1025,100,250,0
271,,,59.0,53.0,62.0,54.0,1818,2048,1371,1735,447,313,153,226,105,19,48,207,33,33,1425,875,600,1025,100,250,0
279,,,61.0,54.0,62.0,54.0,1869,2244,1399,1931,470,313,264,276,160,29,104,247,35,34,1550,875,600,1025,100,250,0
286,,,62.0,54.0,62.0,54.0,1919,2261,1427,1903,492,358,420,436,285,174,135,262,36,35,1550,875,600,925,100,275,0
293,,,68.0,58.0,78.0,62.0,1930,2289,1483,1931,447,358,113,416,80,114,33,302,36,36,2025,975,600,925,100,275,0
300,,,69.0,58.0,78.0,62.0,1880,2132,1455,1819,425,313,340,368,255,34,85,334,37,36,2025,1225,600,1000,100,275,0
307,,,67.0,60.0,78.0,62.0,1958,1712,1511,1399,447,313,566,458,425,84,141,374,38,35,1900,1325,850,1050,225,525,0
314,,,66.0,51.0,78.0,70.0,2020,1124,1595,811,425,313,778,593,585,179,193,414,39,32,1775,1125,850,1050,350,975,0
321,,,58.0,46.0,78.0,70.0,1986,1152,1539,839,447,313,1014,678,765,224,249,454,39,30,1075,825,850,1050,1050,1375,0
329,,,62.0,47.0,78.0,70.0,2177,1163,1707,783,470,380,820,521,665,119,155,402,40,30,1300,975,850,1200,1175,1375,0
336,,,65.0,49.0,78.0,70.0,2115,1208,1623,783,492,425,846,609,660,159,186,450,41,32,1300,975,850,1200,1175,1375,0
343,,,66.0,50.0,78.0,70.0,2115,1572,1623,1147,492,425,187,362,95,64,92,298,42,33,1425,975,850,1200,1175,1375,0
350,,,67.0,53.0,78.0,70.0,2149,1813,1567,1343,582,470,264,368,100,39,164,329,43,34,1425,975,850,1200,1175,1375,0
357,,,67.0,58.0,78.0,70.0,2339,2093,1735,1623,604,470,335,393,195,29,140,364,44,35,1775,975,850,1200,1175,1375,0
364,,,67.0,59.0,78.0,70.0,2384,2177,1735,1707,649,470,620,493,400,69,220,424,45,36,1775,975,850,1325,1175,1375,0
371,,,65.0,60.0,78.0,70.0,2406,2009,1735,1539,671,470,505,748,205,264,300,484,45,37,1650,1100,850,1425,1300,1375,0
379,,,61.0,69.0,78.0,70.0,2490,2031,1819,1539,671,492,801,614,425,149,376,465,45,39,1400,1325,850,1250,1550,1550,0
386,,,63.0,70.0,78.0,70.0,2468,2205,1819,1735,649,470,883,636,435,144,448,492,45,40,1400,1325,850,1250,1550,1550,0
393,,,63.0,70.0,78.0,70.0,2524,2205,1875,1735,649,470,838,598,410,54,428,544,45,41,1400,1425,1450,1250,1550,1550,0
400,,,65.0,70.0,78.0,70.0,2474,2289,1847,1819,627,470,1024,693,520,189,504,504,47,41,1400,1525,1600,1325,1550,1550,0
407,,,67.0,76.0,86.0,78.0,2502,2199,1875,1707,627,492,1125,557,545,114,580,443,49,41,1400,1725,1600,1325,1550,1550,0
414,,,77.0,80.0,86.0,94.0,2440,2250,1791,1623,649,627,155,527,120,104,35,423,49,41,1400,1725,1900,1325,1550,1550,0
421,,,79.0,82.0,86.0,102.0,2546,2300,1875,1651,671,649,315,518,200,169,115,349,51,43,1400,1825,1900,1325,1550,1550,0
429,,,79.0,86.0,94.0,102.0,2490,2378,1819,1707,671,671,606,434,415,34,191,400,51,42,2650,2175,1900,1325,1550,1600,0
436,,,81.0,80.0,102.0,102.0,2524,2020,1875,1483,649,537,812,615,545,159,267,456,53,40,2650,1925,1900,1325,1550,2050,0
443,,,81.0,67.0,102.0,102.0,2524,1505,1875,1147,649,358,812,789,545,289,267,500,53,40,2650,1225,1900,1325,1550,2750,0
7,0,1,13.0,13.0,15.0,14.0,167,293,167,293,0,0,20,35,20,35,0,0,12,12,0,0,0,0,0,0,0
14,0,1,14.0,13.0,15.0,14.0,671,615,671,615,0,0,70,10,70,10,0,0,13,13,0,0,0,0,0,0,0
21,0,1,14.0,14.0,15.0,14.0,699,755,699,755,0,0,40,45,40,45,0,0,13,13,0,0,0,0,0,0,0
29,0,1,15.0,14.0,15.0,14.0,699,671,699,671,0,0,20,130,20,130,0,0,14,13,0,0,0,0,0,0,0
36,0,1,15.0,16.0,15.0,22.0,727,755,727,755,0,0,120,120,120,120,0,0,14,14,0,0,0,0,0,0,0
43,0,1,16.0,16.0,23.0,22.0,755,783,755,783,0,0,50,215,50,215,0,0,15,14,0,0,0,0,0,0,0
50,0,1,16.0,16.0,23.0,22.0,755,783,755,783,0,0,65,5,65,5,0,0,15,16,0,0,0,0,0,0,0
57,0,1,17.0,16.0,23.0,22.0,671,811,671,811,0,0,45,55,45,55,0,0,16,15,0,0,0,0,0,0,0
64,0,1,17.0,18.0,23.0,22.0,755,839,755,839,0,0,145,50,145,50,0,0,16,15,0,0,0,0,0,0,0
71,0,1,18.0,18.0,23.0,22.0,721,839,699,839,22,0,224,150,220,150,4,0,17,17,0,0,0,0,0,0,0
79,0,1,19.0,16.0,23.0,22.0,861,951,727,951,134,0,284,50,260,50,24,0,18,16,0,0,0,0,0,0,0
86,0,1,19.0,18.0,23.0,22.0,827,923,671,923,156,0,379,40,335,40,44,0,18,16,0,0,0,0,0,0,0
93,0,1,20.0,19.0,23.0,22.0,911,923,755,923,156,0,239,105,225,105,14,0,19,17,0,0,150,0,0,0,0
100,0,1,20.0,20.0,23.0,22.0,1018,939,839,895,179,44,364,168,330,160,34,8,19,18,0,0,150,0,0,0,0
107,0,1,20.0,20.0,23.0,22.0,1018,1057,839,923,179,134,79,294,25,270,54,24,19,19,0,0,150,0,0,0,0
114,0,1,20.0,20.0,23.0,22.0,967,1130,811,951,156,179,90,329,20,285,70,44,19,20,0,0,150,0,0,0,0
121,0,1,21.0,20.0,23.0,22.0,911,1102,755,923,156,179,90,454,0,390,90,64,19,20,0,0,150,0,0,0,0
129,0,1,22.0,26.0,23.0,36.0,967,1107,811,951,156,156,210,185,100,105,110,80,19,20,100,0,150,250,0,0,0
136,0,1,23.0,28.0,31.0,36.0,1023,1051,867,895,156,156,30,210,0,110,30,100,20,20,100,0,150,250,0,0,0
143,0,1,23.0,29.0,31.0,36.0,995,995,839,951,156,44,85,80,35,80,50,0,20,20,150,100,150,250,0,0,0
150,0,1,24.0,30.0,31.0,36.0,1074,1007,895,1007,179,0,70,145,50,145,20,0,21,22,150,100,150,250,0,0,0
157,0,1,24.0,30.0,31.0,36.0,1079,1203,923,1203,156,0,211,300,175,300,36,0,21,24,150,100,150,250,0,0,0
164,0,1,25.0,29.0,31.0,36.0,1079,1203,923,1203,156,0,296,140,240,140,56,0,22,23,150,400,150,250,0,0,0
171,0,1,25.0,31.0,31.0,36.0,1141,1259,895,1259,246,0,392,35,300,35,92,0,22,23,150,400,150,250,0,0,0
179,0,1,26.0,34.0,46.0,36.0,1180,1315,867,1315,313,0,297,50,265,50,32,0,23,23,150,400,400,250,0,0,0
186,0,1,27.0,36.0,46.0,36.0,1264,1315,951,1315,313,0,187,105,140,105,47,0,24,24,150,400,500,250,0,0,0
193,0,1,31.0,36.0,46.0,44.0,1342,1315,1007,1315,335,0,162,265,75,265,87,0,24,27,150,400,500,250,0,0,0
200,0,1,31.0,42.0,46.0,44.0,1510,1483,1175,1483,335,0,187,85,60,85,127,0,24,28,150,400,500,250,0,0,0
207,0,1,33.0,44.0,46.0,44.0,1510,1567,1175,1567,335,0,303,85,140,85,163,0,25,28,150,550,575,250,0,0,0
214,0,1,36.0,44.0,46.0,44.0,1482,1639,1147,1595,335,44,153,33,50,25,103,8,25,34,350,550,825,250,0,0,0
221,0,1,40.0,44.0,54.0,44.0,1684,1785,1371,1651,313,134,154,239,15,215,139,24,27,34,350,550,825,250,0,0,0
229,0,1,42.0,49.0,54.0,60.0,1852,1835,1539,1679,313,156,159,169,55,125,104,44,27,34,400,550,825,250,0,0,0
236,0,1,45.0,51.0,54.0,66.0,1908,1891,1595,1735,313,156,229,394,85,330,144,64,29,34,500,700,825,250,0,0,0
243,0,1,47.0,58.5,54.0,66.0,1986,1919,1651,1763,335,156,264,234,80,150,184,84,29,34,600,825,825,250,0,25,0
250,0,1,51.0,61.5,54.0,66.0,2009,2054,1651,1875,358,179,304,274,80,170,224,104,31,34,600,825,825,250,0,25,0
257,0,1,52.0,61.5,54.0,66.0,2070,1998,1735,1819,335,179,250,299,90,175,160,124,31,42,650,825,825,250,0,25,0
264,0,1,56.0,63.5,62.0,66.0,2188,2059,1875,1903,313,156,181,395,85,255,96,140,33,43,975,975,825,250,0,25,0
271,0,1,58.0,65.5,62.0,82.0,1992,2199,1679,2043,313,156,226,165,90,105,136,60,33,43,1075,1125,825,250,0,25,0
279,0,1,62.0,62.5,62.0,82.0,1964,2451,1651,2295,313,156,276,385,100,305,176,80,35,40,1125,1125,825,250,0,25,0
286,0,1,62.0,70.5,62.0,74.0,2238,2227,1903,2071,335,156,491,145,275,45,216,100,35,42,1125,1275,825,250,0,125,0
293,0,1,63.0,70.5,70.0,74.0,2266,2339,1931,2183,335,156,361,135,105,65,256,70,36,47,1425,1275,825,250,0,125,0
300,0,1,67.0,70.5,70.0,74.0,2266,2418,1931,2239,335,179,432,430,140,340,292,90,36,47,1575,1425,825,250,0,125,0
307,0,1,64.0,79.5,70.0,98.0,2294,2558,1959,2379,335,179,337,280,180,170,157,110,37,48,1575,1425,1075,250,0,125,0
314,0,1,65.0,82.5,70.0,98.0,2328,2446,2015,2155,313,291,353,170,260,20,93,150,37,46,1575,1425,1075,250,0,125,0
321,0,1,66.0,82.5,70.0,98.0,2132,2462,1819,1903,313,559,313,467,180,245,133,222,39,46,1575,2025,1075,250,0,125,0
329,0,1,67.0,85.5,78.0,98.0,2160,2552,1847,1903,313,649,548,628,375,330,173,298,39,51,1575,2025,1150,500,0,125,0
336,0,1,67.0,85.5,78.0,106.0,2322,2670,1987,2043,335,627,688,653,550,275,138,378,40,51,1575,1725,1150,700,0,425,0
343,0,1,66.0,77.0,86.0,106.0,2070,2832,1735,2183,335,649,688,998,510,540,178,458,41,51,1475,1200,1150,700,100,950,0
350,0,1,62.0,72.0,86.0,106.0,2042,2882,1707,2211,335,671,729,839,515,305,214,534,42,51,1175,450,1150,700,400,1850,0
356,0,1,62.0,65.0,86.0,106.0,2042,2804,1707,2155,335,649,729,1132,515,530,214,602,42,51,1175,0,1150,700,400,2300,0
7,2,0,13.0,13.0,15.0,15.0,293,293,293,293,0,0,35,35,35,35,0,0,12,12,0,0,0,0,0,0,0
14,2,0,14.0,14.0,15.0,15.0,671,671,671,671,0,0,70,70,70,70,0,0,13,13,0,0,0,0,0,0,0
21,2,0,14.0,14.0,15.0,15.0,727,727,727,727,0,0,5,50,5,50,0,0,13,13,0,0,0,0,0,0,0
29,2,0,15.0,15.0,15.0,15.0,755,643,755,643,0,0,95,80,95,80,0,0,14,14,0,0,0,0,0,0,0
36,2,0,15.0,15.0,15.0,15.0,811,755,811,755,0,0,145,135,145,135,0,0,14,14,0,0,0,0,0,0,0
43,2,0,16.0,16.0,23.0,23.0,811,783,811,783,0,0,30,70,30,70,0,0,15,15,0,0,0,0,0,0,0
50,2,0,17.0,16.0,23.0,23.0,867,783,867,783,0,0,60,35,60,35,0,0,16,15,0,0,0,0,0,0,0
57,2,0,18.0,17.0,23.0,23.0,783,755,783,755,0,0,60,35,60,35,0,0,17,16,0,0,0,0,0,0,0
64,2,0,19.0,18.0,23.0,23.0,979,839,979,839,0,0,175,125,175,125,0,0,18,17,0,0,0,0,0,0,0
71,2,0,19.0,18.0,23.0,23.0,895,878,895,811,0,67,275,232,275,220,0,12,18,17,0,0,0,0,0,0,0
79,2,0,20.0,19.0,23.0,23.0,923,962,923,783,0,179,340,337,340,305,0,32,19,18,0,0,0,0,0,0,0
86,2,0,20.0,19.0,23.0,23.0,962,906,895,727,67,179,317,447,305,395,12,52,19,18,0,0,150,0,0,0,0
93,2,0,20.0,20.0,23.0,23.0,950,883,839,727,111,156,424,343,400,275,24,68,20,19,0,0,150,150,0,0,0
100,2,0,20.0,20.0,23.0,23.0,1023,827,867,671,156,156,49,438,5,350,44,88,20,19,0,0,150,150,0,0,0
107,2,0,21.0,20.0,23.0,23.0,995,911,839,755,156,156,124,153,60,45,64,108,20,19,0,50,150,150,0,0,0
114,2,0,21.0,21.0,23.0,23.0,1051,911,895,755,156,156,179,118,95,40,84,78,20,19,0,50,150,150,0,0,0
121,2,0,24.0,21.0,31.0,23.0,1107,911,951,755,156,156,134,118,55,20,79,98,21,19,0,50,300,150,0,0,0
129,2,0,24.0,22.0,31.0,23.0,1074,1018,895,839,179,179,109,213,60,95,49,118,21,20,0,50,300,150,0,0,0
136,2,0,25.0,22.0,31.0,23.0,1130,1046,951,867,179,179,199,98,130,60,69,38,22,20,0,50,300,150,0,0,0
143,2,0,28.0,23.0,31.0,23.0,1090,1135,867,979,223,156,197,94,125,40,72,54,23,21,125,50,300,150,0,0,0
150,2,0,29.0,25.0,31.0,31.0,1236,1107,923,951,313,156,297,124,185,50,112,74,24,21,125,50,300,250,0,0,0
157,2,0,30.0,26.0,31.0,31.0,1264,1219,951,1063,313,156,102,149,100,55,2,94,25,22,125,50,300,250,0,0,0
164,2,0,30.0,26.0,31.0,31.0,1258,1219,923,1063,335,156,152,174,110,60,42,114,25,22,125,50,300,250,0,0,0
171,2,0,34.0,29.0,46.0,31.0,1342,1303,1007,1147,335,156,87,284,30,150,57,134,26,23,250,150,300,350,0,0,0
179,2,0,35.0,29.0,46.0,46.0,1342,1354,1007,1175,335,179,193,279,100,125,93,154,27,24,250,150,300,600,0,0,0
186,2,0,37.0,30.0,46.0,46.0,1460,1320,1147,1119,313,201,269,383,140,205,129,178,29,24,250,250,300,600,0,0,0
193,2,0,39.0,34.0,46.0,46.0,1544,1432,1231,1231,313,201,304,358,135,160,169,198,31,25,250,250,300,600,0,0,0
200,2,0,41.0,34.0,46.0,46.0,1600,1376,1287,1175,313,201,199,286,90,160,109,126,31,25,250,250,600,600,0,0,0
207,2,0,45.0,36.0,46.0,46.0,1656,1415,1343,1147,313,268,174,372,50,210,124,162,33,25,375,250,600,600,0,0,0
214,2,0,45.0,37.0,46.0,46.0,1734,1628,1399,1315,335,313,289,362,125,160,164,202,33,26,625,450,600,600,0,0,0
221,2,0,46.0,42.0,46.0,46.0,1818,1762,1483,1427,335,335,230,367,105,175,125,192,35,27,625,450,600,600,0,0,0
229,2,0,46.0,43.0,46.0,46.0,1846,1841,1511,1483,335,358,250,487,85,255,165,232,36,28,625,450,600,600,0,0,0
236,2,0,48.0,46.0,54.0,46.0,1908,1796,1595,1483,313,313,122,329,25,190,97,139,36,29,625,450,600,850,0,0,0
243,2,0,48.0,52.0,62.0,54.0,1992,1936,1679,1623,313,313,362,169,225,40,137,129,36,31,750,650,750,850,125,0,0
250,2,0,49.0,52.0,62.0,54.0,1964,1992,1651,1679,313,313,187,409,110,240,77,169,38,31,750,650,750,925,125,0,0
257,2,0,53.0,54.0,62.0,54.0,1992,1964,1679,1651,313,313,97,444,80,235,17,209,39,33,1000,650,950,925,125,0,0
264,2,0,54.0,55.0,62.0,62.0,2070,1986,1735,1651,335,335,132,584,75,335,57,249,40,34,1000,1050,950,925,125,0,0
271,2,0,55.0,61.0,62.0,62.0,2182,2121,1847,1763,335,358,353,409,260,270,93,139,41,35,1000,1050,950,925,125,0,0
279,2,0,56.0,63.0,62.0,70.0,2115,2378,1735,2043,380,335,581,610,440,435,141,175,43,37,1000,1050,950,925,125,0,0
286,2,0,59.0,63.0,70.0,70.0,2255,2300,1651,1987,604,313,556,376,435,165,121,211,43,37,1250,1050,950,925,125,0,0
293,2,0,60.0,63.0,70.0,70.0,2356,2384,1707,2071,649,313,496,656,395,405,101,251,44,39,1250,1050,950,1000,125,100,0
300,2,0,62.0,62.0,70.0,70.0,2412,2636,1763,2323,649,313,731,761,550,470,181,291,46,40,1250,850,1200,1000,125,300,0
307,2,0,65.0,64.0,70.0,70.0,2462,2636,1791,2323,671,313,117,776,85,570,32,206,47,41,1500,1025,1200,1000,125,400,0
314,2,0,66.0,65.0,70.0,78.0,2569,2681,1875,2323,694,358,352,671,240,425,112,246,48,42,1500,1125,1200,1000,125,400,0
321,2,0,67.0,70.0,70.0,78.0,2446,2457,1819,2099,627,358,495,516,315,305,180,211,49,43,1750,1125,1200,1000,125,400,0
329,2,0,71.0,72.0,78.0,78.0,2530,2440,1903,2127,627,313,460,578,300,335,160,243,50,45,1850,1125,1200,1000,125,400,0
336,2,0,71.0,73.0,78.0,78.0,2496,2496,1847,2183,649,313,500,778,360,495,140,283,51,46,1850,1225,1200,1000,125,400,0
343,2,0,73.0,76.0,86.0,86.0,2395,2384,1791,2071,604,313,398,593,190,295,208,298,52,47,1850,1500,1200,1000,125,400,0
350,2,0,76.0,77.0,86.0,86.0,2451,2580,1847,2267,604,313,439,733,255,395,184,338,53,48,2250,1725,1200,1000,125,400,0
357,2,0,78.0,76.0,86.0,101.0,2502,2440,1875,2127,627,313,631,805,375,431,256,374,55,47,2250,1825,1500,1275,125,500,0
364,2,0,84.0,79.0,86.0,101.0,2664,2513,2015,2155,649,358,401,349,265,188,136,161,55,49,2250,1825,1500,1500,125,500,0
371,2,0,86.0,84.0,94.0,101.0,2474,2384,1847,2071,627,313,362,145,300,80,62,65,57,49,2250,1825,1750,1500,125,500,0
379,2,0,88.0,86.0,109.0,101.0,2602,2563,1931,2183,671,380,157,342,115,250,42,92,59,49,2250,1875,1900,1500,125,500,0
386,2,0,89.0,86.0,109.0,101.0,2815,2709,2211,2127,604,582,405,722,295,564,110,158,59,51,2250,1975,1900,1600,125,525,0
393,2,0,90.0,87.0,109.0,101.0,2882,3112,2211,2463,671,649,354,827,260,689,94,138,62,50,2250,1975,1900,1600,125,575,0
400,2,0,92.0,93.0,109.0,101.0,3084,3123,2435,2519,649,604,226,829,60,669,166,160,62,50,2000,2375,1900,1600,375,575,0
407,2,0,98.0,94.0,109.0,101.0,3224,2994,2575,2323,649,671,106,814,60,699,46,115,63,52,2700,2275,1900,1750,375,675,0
414,2,0,99.0,96.0,117.0,101.0,3308,2854,2659,2183,649,671,477,939,355,794,122,145,63,52,2700,2275,1900,1750,375,675,0
421,2,0,101.0,99.0,117.0,101.0,3336,3190,2687,2519,649,671,408,661,210,544,198,117,63,54,2700,2525,1900,1900,375,775,0
429,2,0,106.0,101.0,117.0,101.0,3258,3476,2631,2827,627,649,604,617,330,499,274,118,64,54,2900,2525,2300,1900,375,775,0
436,2,0,106.0,101.0,125.0,101.0,3308,3510,2659,2883,649,627,700,508,350,439,350,69,66,57,2900,2800,2300,1900,375,775,0
443,2,0,112.0,111.0,141.0,125.0,3358,3286,2687,2547,671,739,660,643,230,474,430,169,67,57,3100,2800,2300,1975,375,775,0
450,2,0,118.0,113.0,141.0,125.0,3358,3661,2687,2855,671,806,561,704,255,514,306,190,67,57,3600,3125,2600,2075,375,775,0
457,2,0,118.0,122.0,141.0,133.0,3560,3655,2911,2827,649,828,735,365,353,279,382,86,69,60,3600,3225,2600,2075,375,775,0
464,2,0,118.0,131.0,141.0,141.0,3336,3846,2687,2995,649,851,1125,329,663,214,462,115,69,63,3600,3350,2600,2075,375,775,0
471,2,0,130.0,133.0,141.0,149.0,3554,4103,2771,3163,783,940,605,601,243,374,362,227,69,63,4200,3850,2600,2075,375,775,0
479,2,0,130.0,133.0,141.0,157.0,3532,4232,2659,3247,873,985,1023,1086,553,739,470,347,69,66,4200,3900,2600,2075,375,775,0
486,2,0,130.0,146.0,141.0,157.0,3728,4154,2855,3191,873,963,1062,378,488,269,574,109,69,66,4200,4600,2750,2075,375,775,0
493,2,0,130.0,148.0,149.0,165.0,3683,4232,2743,3247,940,985,1389,653,703,424,686,229,69,66,4200,4725,2750,2075,375,775,0
500,2,0,140.0,147.0,157.0,173.0,3823,4294,2883,3331,940,963,1132,1130,338,789,794,341,69,66,4475,4775,2900,2075,600,825,0
507,2,0,140.0,156.0,157.0,173.0,3610,4198,2715,3191,895,1007,1441,730,543,444,898,286,69,66,5175,5025,3250,2075,600,825,0
514,2,0,143.0,163.0,165.0,189.0,3582,3930,2687,2967,895,963,1209,803,453,459,756,344,69,66,5175,5875,3250,2075,600,825,0
521,2,0,139.0,154.0,165.0,189.0,3493,3762,2575,2799,918,963,1020,1028,148,639,872,389,69,69,4375,5125,3250,2075,1400,1400,0
529,2,0,121.0,143.0,173.0,197.0,3515,3599,2575,2659,940,940,1237,1034,253,579,984,455,69,69,4025,4275,3250,2075,2550,2500,0
536,2,0,98.0,124.0,173.0,197.0,3353,3470,2435,2463,918,1007,1629,944,533,369,1096,575,68,69,2725,3175,3250,2075,3900,3825,0
543,2,0,92.0,120.0,173.0,197.0,3403,3420,2463,2435,940,985,1136,1340,128,649,1008,691,68,69,1475,2925,3250,2075,5150,4175,0
550,2,0,102.0,119.0,173.0,197.0,3319,3476,2379,2491,940,985,729,1012,213,459,516,553,68,69,2750,2900,3400,2075,5375,5050,0
557,2,0,98.0,116.0,173.0,197.0,3302,3454,2407,2491,895,963,808,878,338,409,470,469,68,69,1600,2525,3400,2075,5725,5550,0
564,2,0,106.0,116.0,173.0,197.0,3235,3448,2295,2463,940,985,804,1159,218,574,586,585,68,69,2500,2625,3400,2075,5725,5550,0
571,2,0,109.0,121.0,188.0,197.0,3213,3706,2295,2743,918,963,1052,1230,358,629,694,601,68,69,2900,2975,3400,2075,5725,5550,0
579,2,0,111.0,125.0,188.0,197.0,3196,3790,2323,2827,873,963,1041,1231,343,589,698,642,69,69,2900,3425,3400,2075,5725,5550,0
586,2,0,121.0,129.0,188.0,197.0,3246,3560,2351,2575,895,985,84,974,78,463,6,511,71,69,2900,3475,3400,2075,5725,5550,0
593,2,0,127.0,136.0,188.0,197.0,3291,3386,2351,2379,940,1007,496,882,378,369,118,513,75,69,3800,3725,3400,2200,5725,5550,0
600,2,0,137.0,140.0,188.0,197.0,3487,3616,2547,2631,940,985,414,1169,188,544,226,625,75,69,4250,3950,3400,2200,5725,5550,0
607,2,0,137.0,140.0,188.0,212.0,3302,3930,2407,2967,895,963,488,1310,308,744,180,566,75,72,4700,3950,3400,2550,5725,5550,0
614,2,0,137.0,135.0,188.0,212.0,3543,4210,2603,3247,940,963,914,1046,618,739,296,307,77,72,4700,3950,3400,3075,5725,6200,0
621,2,0,151.0,135.0,188.0,212.0,3661,4266,2743,3303,918,963,302,857,198,534,104,323,77,72,5600,4150,3400,3175,5725,6200,0
629,2,0,153.0,139.0,188.0,212.0,3504,3958,2631,2995,873,963,450,828,238,539,212,289,77,72,5600,4150,3650,3175,5725,6200,0
636,2,0,156.0,138.0,188.0,212.0,3756,3896,2771,2911,985,985,601,1283,423,874,178,409,77,72,6100,4100,3650,3175,5725,6250,0
643,2,0,154.0,138.0,188.0,212.0,3739,3980,2799,2995,940,985,1054,1250,768,979,286,271,77,72,5600,4925,3650,3400,5825,6250,0
650,2,0,170.0,146.0,188.0,212.0,3829,4512,2911,3527,918,985,711,625,313,484,398,141,77,72,6050,5125,3650,3400,5825,6250,0
657,2,0,170.0,146.0,188.0,212.0,4019,4154,2855,3191,1164,963,1189,978,643,729,546,249,77,72,7100,5125,3650,3400,5825,6250,0
664,2,0,173.0,152.0,188.0,212.0,4137,4154,2883,3191,1254,963,1387,923,843,704,544,219,77,72,7400,5175,3650,3400,5825,6250,0
671,2,0,173.0,154.0,188.0,212.0,4109,4327,2855,3387,1254,940,1174,1234,628,999,546,235,77,72,7400,5325,3650,3550,5825,6250,0
679,2,0,169.0,156.0,188.0,212.0,4210,4372,2911,3387,1299,985,1676,1029,978,999,698,30,77,70,7200,5875,3950,3750,6025,6450,0
686,2,0,160.0,151.0,188.0,212.0,4232,4383,2911,3443,1321,940,1572,1452,968,1314,604,138,77,70,6600,5825,3950,3750,6625,6700,0
693,2,0,160.0,154.0,188.0,212.0,4170,4383,2939,3331,1231,1052,1907,1830,1163,1564,744,266,77,70,6600,5825,3950,3750,6625,6700,0
700,2,0,163.0,157.0,196.0,212.0,4047,4193,2771,3163,1276,1030,1239,2174,843,1784,396,390,77,73,6900,6225,3950,3925,6625,6700,0
707,2,0,163.0,164.0,196.0,212.0,4002,4574,2771,3387,1231,1187,1722,2237,1178,1799,544,438,77,73,6900,6775,3950,4025,6625,6700,0
714,2,0,173.0,170.0,196.0,212.0,4086,4450,2855,3219,1231,1231,1219,1824,1023,1484,196,340,77,76,8100,6775,3950,4125,6725,6700,0
721,2,0,181.0,174.0,196.0,212.0,4058,4394,2827,3163,1231,1231,1301,1717,953,1529,348,188,77,76,8100,6825,3950,4200,6725,6700,0
729,2,0,178.0,178.0,196.0,227.0,4098,4400,2799,3191,1299,1209,1492,2249,1138,1909,354,340,77,79,8050,7200,3950,4200,7475,6700,0
736,2,0,178.0,178.0,196.0,227.0,4075,4299,2799,3023,1276,1276,1975,2121,1473,1629,502,492,77,79,8050,7375,3950,4200,7475,6700,0
743,2,0,192.0,190.0,196.0,227.0,4002,4322,2771,3023,1231,1299,1044,1954,898,1414,146,540,77,79,7950,7500,4100,4200,7575,6700,0
750,2,0,186.0,190.0,211.0,227.0,4131,4198,2855,2967,1276,1231,1555,2119,1253,1489,302,630,77,78,9050,7850,4250,4200,8175,6925,0
757,2,0,180.0,178.0,211.0,227.0,4109,3958,2855,2771,1254,1187,1838,2608,1388,1834,450,774,77,77,8550,7225,4100,4300,8712,7600,0
764,2,0,180.0,180.0,211.0,227.0,4086,4092,2855,2883,1231,1209,1130,2610,728,1759,402,851,71,75,8600,7400,4100,4550,9462,8225,0
771,2,0,172.0,173.0,196.0,227.0,3482,4120,2295,2911,1187,1209,1521,2399,983,1504,538,895,71,71,8750,7150,4100,4550,10412,8900,0
779,2,0,163.0,174.0,196.0,227.0,3101,4064,2071,2855,1030,1209,1751,2373,1093,1584,658,789,71,71,8100,7300,4100,4550,11062,8900,0
786,2,0,154.0,186.0,196.0,227.0,3112,3885,2127,2631,985,1254,2108,1917,1338,1284,770,633,72,71,7150,7525,4100,4550,12012,9175,0
793,2,0,173.0,186.0,196.0,227.0,3039,3756,2099,2547,940,1209,1165,2017,283,1419,882,598,73,71,7150,7800,4100,4550,12012,9175,0
800,2,0,173.0,196.0,188.0,227.0,3330,3599,2323,2435,1007,1164,1588,1382,578,794,1010,588,73,71,8550,7850,4100,4550,12112,9175,0
807,2,0,178.0,200.0,180.0,227.0,3543,3767,2603,2603,940,1164,1401,1526,583,919,818,607,73,71,8550,8225,4100,4550,12262,9175,0
814,2,0,178.0,200.0,180.0,242.0,3952,3750,2967,2519,985,1231,1890,2408,948,1499,942,909,73,71,8550,9425,4100,4550,12262,9175,0
821,2,0,176.0,198.0,180.0,242.0,3806,3762,2799,2575,1007,1187,2036,2997,1128,1919,908,1078,73,71,8300,9550,4100,4550,12512,9300,0
829,2,0,176.0,198.0,180.0,242.0,3997,3745,2967,2491,1030,1254,2520,3331,1488,2109,1032,1222,73,71,8300,9800,4100,4550,12512,9300,0
836,2,0,178.0,198.0,180.0,242.0,3784,3846,2799,2547,985,1299,2163,3789,1273,2419,890,1370,73,71,8550,9800,4100,4550,12762,9300,0
843,2,0,176.0,200.0,180.0,242.0,3728,3588,2743,2379,985,1209,2214,3291,1408,1789,806,1502,73,71,8900,9800,4100,4550,13012,9300,0
850,2,0,180.0,200.0,180.0,242.0,3840,3297,2855,2155,985,1142,2180,3681,1508,2039,672,1642,73,71,9400,9800,4100,4650,13012,9300,0
857,2,0,186.0,200.0,204.0,242.0,3762,3347,2799,2183,963,1164,2031,4108,1543,2314,488,1794,73,71,9400,9900,4100,4650,13012,9300,0
864,2,0,196.0,200.0,204.0,242.0,3700,3700,2715,2491,985,1209,1606,3852,1248,2064,358,1788,73,71,9400,9900,4100,4650,13012,9300,0
871,2,0,200.0,200.0,219.0,242.0,3829,3644,2799,2435,1030,1209,1565,4275,1333,2339,232,1936,73,71,10275,9900,4100,4650,13012,9300,0
879,2,0,200.0,195.0,219.0,242.0,3784,3739,2687,2463,1097,1276,1718,4714,1508,2634,210,2080,73,71,10775,9625,4100,4650,13012,9575,0
886,2,0,200.0,199.0,219.0,242.0,3734,3577,2659,2323,1075,1254,2161,4583,1823,2609,338,1974,73,71,10775,9625,4100,4650,13012,9575,0
893,2,0,199.0,199.0,219.0,242.0,3554,3426,2435,2239,1119,1187,2482,4749,1983,2739,499,2010,73,71,11325,9625,4100,4650,13012,9575,0
900,2,0,197.0,199.0,219.0,242.0,3437,3062,2295,1875,1142,1187,2908,4503,2273,2649,635,1854,73,71,11225,9475,4100,4650,13112,9725,0
907,2,0,195.0,193.0,219.0,242.0,3414,3028,2295,1819,1119,1209,3315,4575,2548,2725,767,1850,71,70,11225,9175,4100,4650,13212,10075,0
914,2,0,193.0,196.0,219.0,257.0,3403,2894,2239,1707,1164,1187,3111,4562,2508,2728,603,1834,71,70,10225,9725,4100,4650,14212,10075,0
921,2,0,189.0,196.0,219.0,272.0,3409,3034,2323,1847,1086,1187,3528,4879,2803,2911,725,1968,71,70,9875,9725,4100,4650,14562,10075,0
929,2,0,199.0,197.0,219.0,272.0,3202,3151,2295,1875,907,1276,2651,4926,2443,2969,208,1957,71,70,11125,9600,4100,4425,14562,10425,0
936,2,0,199.0,190.0,219.0,272.0,3370,2642,2407,1567,963,1075,3071,5154,2743,3092,328,2062,71,69,11125,9250,4100,4550,14562,10925,0
943,2,0,191.0,183.0,219.0,287.0,3314,2194,2351,1231,963,963,3362,5396,2768,3216,594,2180,71,69,9575,9150,3850,4550,16362,11325,0
950,2,0,183.0,182.0,219.0,287.0,3454,2199,2491,1259,963,940,3778,5152,3068,2931,710,2221,71,69,9875,8425,3850,4850,16762,12112,0
957,2,0,158.0,139.0,219.0,287.0,3286,2065,2323,1203,963,862,4155,5389,3333,3066,822,2323,71,69,8150,5350,3850,4850,18387,15487,0
964,2,0,162.0,154.0,219.0,287.0,3448,2143,2463,1315,985,828,3086,3848,2398,2021,688,1827,71,69,8525,5050,3850,4850,18887,15937,0
971,2,0,168.0,156.0,219.0,287.0,3202,2098,2295,1203,907,895,2443,4101,1853,2166,590,1935,71,69,8525,5500,3850,4850,18887,16162,0
979,2,0,168.0,163.0,219.0,287.0,3034,2423,2239,1483,795,940,2299,2285,1813,896,486,1389,71,69,8525,5425,3850,4850,18887,16387,0
986,2,0,176.0,169.0,219.0,287.0,2899,2692,2071,1707,828,985,1649,2315,1563,906,86,1409,71,69,9525,5825,3850,4850,18887,16387,0
993,2,0,187.0,174.0,219.0,287.0,2933,3134,2127,2015,806,1119,1456,2250,1278,851,178,1399,71,69,10025,6175,3850,4850,18887,16387,0
1000,2,0,187.0,182.0,219.0,287.0,2888,3263,2127,2099,761,1164,1809,1940,1543,501,266,1439,71,69,10025,6400,3850,4625,18887,16612,0
1007,2,0,181.0,183.0,227.0,287.0,3084,3302,2323,2183,761,1119,2190,2002,1828,481,362,1521,72,72,9400,6850,3850,4950,19512,17412,0
1014,2,0,197.0,177.0,227.0,287.0,3269,3118,2463,2043,806,1075,1335,1340,1248,116,87,1224,72,60,9400,7175,4000,4950,19512,18012,0
1021,2,0,191.0,165.0,227.0,287.0,3330,2569,2547,1651,783,918,1737,1620,1558,296,179,1324,72,58,10350,6825,4450,4850,19812,19162,0
1029,2,0,173.0,165.0,227.0,272.0,3403,2703,2575,1875,828,828,2147,1782,1868,391,279,1391,72,56,9300,6950,4950,4850,21362,19987,0
1036,2,0,185.0,169.0,227.0,272.0,3521,2586,2715,1791,806,795,1513,1372,1438,91,75,1281,72,55,9650,6950,4950,4625,21362,20587,0
1043,2,0,183.0,170.0,227.0,272.0,3358,2642,2575,1959,783,683,1736,1552,1573,216,163,1336,72,54,10100,7075,4950,4525,21612,20737,0
1050,2,0,183.0,174.0,227.0,272.0,3101,2418,2295,1791,806,627,2117,1847,1858,431,259,1416,72,54,10100,7925,4950,4525,21612,20737,0
1057,2,0,173.0,168.0,242.0,272.0,3039,2530,2211,1903,828,627,1598,2162,1493,666,105,1496,72,51,9225,8500,4950,4525,23362,21062,0
1064,2,0,189.0,168.0,242.0,272.0,3325,2569,2519,1875,806,694,1199,2457,998,881,201,1576,72,51,10025,8625,4950,4525,23362,21062,0
1071,2,0,179.0,145.0,242.0,272.0,3364,2675,2603,1959,761,716,1616,2362,1323,756,293,1606,72,51,9525,6850,4950,4525,23862,23037,0
1079,2,0,179.0,151.0,242.0,272.0,3386,2580,2603,1931,783,649,1422,2317,1333,693,89,1624,72,51,8925,7150,4950,4525,24462,23037,0
1086,2,0,199.0,151.0,242.0,272.0,3465,2530,2659,1903,806,627,833,2603,648,903,185,1700,72,51,9925,7150,4950,4525,24462,23037,0
1093,2,0,183.0,156.0,242.0,272.0,3549,2502,2743,1875,806,627,1269,2188,988,508,281,1680,72,51,8975,7225,4950,4525,25412,23462,0
1100,2,0,179.0,154.0,242.0,272.0,3650,2446,2799,1819,851,627,1718,1926,1333,245,385,1681,72,49,8700,6875,4950,4525,25687,24162,0
1107,2,0,195.0,149.0,242.0,257.0,3633,2048,2771,1399,862,649,945,1592,458,85,487,1507,72,46,9200,6625,4950,4525,26387,25524,0
1114,2,0,171.0,123.0,242.0,257.0,3465,2003,2771,1287,694,716,1358,1562,793,0,565,1562,72,44,8225,4775,4950,4525,27862,27999,0
1121,2,0,166.0,127.0,242.0,257.0,3319,1953,2771,1259,548,694,853,1783,678,145,175,1638,72,44,7250,5125,4950,4525,28837,27999,0
1129,2,0,174.0,127.0,242.0,242.0,3392,1802,2855,1175,537,627,167,1981,128,275,39,1706,72,44,6475,5175,4950,4525,29612,28549,0
1136,2,0,174.0,130.0,242.0,242.0,3213,1718,2631,1091,582,627,534,1841,423,105,111,1736,72,44,7575,5425,4950,4525,29612,28699,0
1143,2,0,171.0,115.0,242.0,242.0,3297,1718,2491,1091,806,627,978,2046,613,230,365,1816,72,44,7475,4925,4950,4525,29712,29599,0
1150,2,0,167.0,114.0,242.0,242.0,3280,1718,2407,1091,873,627,873,2086,408,215,465,1871,72,44,7275,4975,4950,4525,30412,29824,0
1157,2,0,163.0,118.0,242.0,242.0,3498,1790,2603,1119,895,671,841,2076,493,150,348,1926,72,44,7675,5325,4950,4525,30612,29824,0
1164,2,0,171.0,117.0,242.0,242.0,3571,1695,2519,979,1052,716,583,1981,103,125,480,1856,72,41,7225,5325,4950,4525,31062,30024,0
1171,2,0,171.0,116.0,242.0,242.0,3778,1656,2659,1007,1119,649,1043,1994,423,95,620,1899,72,37,8175,5550,4950,4525,31062,30224,0
1179,2,0,161.0,109.0,242.0,242.0,3818,1690,2631,1063,1187,627,1516,2020,748,70,768,1950,72,37,7600,5075,4950,4525,31437,30824,0
1186,2,0,175.0,107.0,242.0,242.0,3756,1578,2547,951,1209,627,201,2110,168,80,33,2030,72,37,7600,4800,4950,4425,31437,31249,0
1193,2,0,175.0,103.0,242.0,227.0,3879,1634,2715,1007,1164,627,426,2315,378,205,48,2110,70,37,9350,4700,4600,4425,31887,32024,0
1200,2,0,167.0,89.0,242.0,227.0,3694,1690,2575,1063,1119,627,856,2520,688,330,168,2190,70,37,8600,3900,4600,4425,32887,32774,0
7,0,2,13.0,13.0,15.0,15.0,251,335,251,335,0,0,30,40,30,40,0,0,12,12,0,0,0,0,0,0,0
14,0,2,13.0,14.0,15.0,15.0,643,671,643,671,0,0,65,70,65,70,0,0,12,13,0,0,0,0,0,0,0
21,0,2,14.0,14.0,15.0,15.0,643,671,643,671,0,0,40,45,40,45,0,0,13,13,0,0,0,0,0,0,0
29,0,2,15.0,15.0,15.0,15.0,671,699,671,699,0,0,80,45,80,45,0,0,14,14,0,0,0,0,0,0,0
36,0,2,15.0,16.0,15.0,23.0,699,755,699,755,0,0,125,135,125,135,0,0,14,15,0,0,0,0,0,0,0
43,0,2,16.0,16.0,23.0,23.0,783,783,783,783,0,0,60,25,60,25,0,0,15,15,0,0,0,0,0,0,0
50,0,2,16.0,17.0,23.0,23.0,811,811,811,811,0,0,35,55,35,55,0,0,15,16,0,0,0,0,0,0,0
57,0,2,17.0,18.0,23.0,23.0,755,783,755,783,0,0,40,55,40,55,0,0,16,17,0,0,0,0,0,0,0
64,0,2,17.0,19.0,23.0,23.0,755,923,755,923,0,0,80,165,80,165,0,0,16,18,0,0,0,0,0,0,0
71,0,2,18.0,19.0,23.0,23.0,771,917,727,895,44,22,118,229,110,225,8,4,17,18,0,0,0,0,0,0,0
79,0,2,19.0,20.0,23.0,23.0,743,990,587,923,156,67,208,352,180,340,28,12,18,19,0,0,0,0,0,0,0
86,0,2,19.0,20.0,23.0,23.0,799,1074,531,1007,268,67,314,480,250,460,64,20,18,19,0,0,0,0,0,0,0
93,0,2,20.0,20.0,23.0,23.0,788,1012,475,923,313,89,56,442,10,410,46,32,19,20,0,0,150,150,0,0,0
100,0,2,20.0,20.0,23.0,23.0,872,1062,559,951,313,111,166,164,80,120,86,44,19,20,0,0,150,150,0,0,0
107,0,2,20.0,21.0,23.0,23.0,900,1085,587,951,313,134,276,145,150,85,126,60,19,20,0,0,150,150,0,0,0
114,0,2,20.0,21.0,23.0,23.0,883,1034,615,923,268,111,139,132,85,60,54,72,19,20,0,0,150,150,0,0,0
121,0,2,21.0,22.0,31.0,31.0,1001,1085,755,951,246,134,206,262,120,170,86,92,19,21,100,0,150,150,0,0,0
129,0,2,22.0,24.0,31.0,31.0,1113,1079,867,923,246,156,189,72,125,60,64,12,20,21,100,0,150,300,0,0,0
136,0,2,22.0,25.0,31.0,31.0,1141,1068,895,867,246,201,291,195,195,155,96,40,20,22,100,0,150,300,0,0,0
143,0,2,23.0,26.0,31.0,31.0,1202,1152,979,839,223,313,440,101,320,75,120,26,21,23,100,0,150,300,0,0,0
150,0,2,23.0,28.0,31.0,31.0,1253,1236,1007,923,246,313,192,257,40,195,152,62,21,23,100,175,150,300,0,0,0
157,0,2,23.0,29.0,31.0,31.0,1365,1264,1119,951,246,313,375,348,195,250,180,98,22,24,100,175,400,300,0,0,0
164,0,2,28.0,29.0,31.0,31.0,1471,1214,1203,923,268,291,297,245,110,215,187,30,22,24,100,175,500,300,0,0,0
171,0,2,27.0,30.0,31.0,46.0,1477,1242,1231,951,246,291,305,351,90,285,215,66,22,25,0,350,500,300,100,0,0
179,0,2,29.0,30.0,31.0,46.0,1421,1214,1175,923,246,291,168,387,25,285,143,102,23,25,100,350,500,300,100,0,0
186,0,2,30.0,32.0,31.0,46.0,1197,1236,951,923,246,313,245,192,70,150,175,42,23,26,200,350,500,300,100,0,0
193,0,2,33.0,32.0,39.0,46.0,1258,1314,923,979,335,335,260,267,70,185,190,82,24,26,200,350,500,300,100,0,0
200,0,2,36.0,34.0,39.0,46.0,1309,1449,951,1091,358,358,275,382,45,260,230,122,25,28,300,350,500,300,100,0,0
207,0,2,36.0,36.0,39.0,46.0,1348,1482,1035,1147,313,335,282,513,20,355,262,158,25,30,300,350,500,650,100,0,0
214,0,2,39.0,36.0,39.0,46.0,1516,1516,1203,1203,313,313,287,404,85,360,202,44,26,30,450,350,750,650,100,0,0
221,0,2,40.0,38.0,54.0,46.0,1488,1600,1175,1287,313,313,332,134,115,50,217,84,26,32,500,350,750,650,100,0,0
229,0,2,41.0,38.0,54.0,46.0,1460,1656,1147,1343,313,313,452,289,195,165,257,124,27,32,500,350,750,900,100,0,0
236,0,2,42.0,42.0,54.0,46.0,1432,1818,1119,1483,313,335,417,209,120,45,297,164,27,34,500,350,825,900,100,0,0
243,0,2,47.0,43.0,54.0,46.0,1561,1874,1203,1539,358,335,252,309,65,105,187,204,28,35,750,350,925,900,100,0,0
250,0,2,48.0,44.0,54.0,46.0,1510,1930,1175,1595,335,335,268,340,45,100,223,240,29,36,800,350,925,900,100,0,0
257,0,2,48.0,45.0,54.0,46.0,1376,1880,1063,1567,313,313,334,296,75,20,259,276,29,37,850,600,925,900,100,0,0
264,0,2,52.0,46.0,54.0,54.0,1516,2009,1203,1651,313,358,124,491,25,175,99,316,29,38,850,600,1000,1050,100,0,0
271,0,2,52.0,48.0,54.0,62.0,1600,2014,1287,1679,313,335,234,687,95,335,139,352,29,40,1175,600,1000,1200,100,0,0
279,0,2,54.0,48.0,62.0,62.0,1572,1986,1259,1651,313,335,254,807,75,415,179,392,30,40,1175,600,1000,1200,100,0,0
286,0,2,59.0,56.0,62.0,62.0,1701,2098,1343,1539,358,559,139,277,45,180,94,97,32,42,1225,1350,1000,1500,100,0,0
293,0,2,59.0,57.0,62.0,62.0,1673,2300,1315,1651,358,649,179,362,45,185,134,177,32,43,1225,1350,1000,1500,100,50,0
300,0,2,58.0,58.0,62.0,62.0,1740,2362,1427,1735,313,627,281,634,115,385,166,249,31,45,1225,1350,1000,1500,250,50,0
307,0,2,54.0,56.0,70.0,62.0,631,2440,475,1791,156,649,193,419,15,90,178,329,26,46,1525,1100,1000,1500,500,300,0
314,0,2,53.0,52.0,70.0,62.0,99,1936,55,1287,44,649,207,615,25,210,182,405,25,42,1850,1100,1000,1500,675,500,0
321,0,2,49.0,49.0,70.0,62.0,55,1751,55,1147,0,604,212,342,30,15,182,327,26,42,1650,600,1000,1500,875,1000,0
329,0,2,51.0,51.0,70.0,62.0,699,2121,699,1539,0,582,107,485,50,90,57,395,26,43,1650,600,1000,1500,875,1000,0
336,0,2,53.0,55.0,70.0,62.0,1203,2334,1203,1707,0,627,172,275,115,50,57,225,26,44,1650,600,1000,1500,875,1000,0
343,0,2,54.0,57.0,70.0,70.0,1320,2345,1231,1763,89,582,133,404,60,115,73,289,27,45,1650,600,1150,1650,875,1000,0
350,0,2,58.0,58.0,70.0,70.0,1835,2423,1679,1819,156,604,178,296,85,35,93,261,28,46,1650,1050,1150,1650,875,1000,0
357,0,2,59.0,60.0,70.0,70.0,2059,2451,1903,1847,156,604,23,477,10,140,13,337,29,48,1650,1050,1150,1800,875,1000,0
364,0,2,59.0,61.0,70.0,70.0,1958,2558,1735,1931,223,627,196,598,155,185,41,413,29,49,1925,1050,1150,1800,875,1000,0
371,0,2,60.0,63.0,70.0,70.0,2014,2479,1679,1875,335,604,416,680,335,195,81,485,31,51,2075,1050,1150,2100,875,1000,0
379,0,2,64.0,70.0,70.0,70.0,2188,2586,1875,1959,313,627,163,432,100,75,63,357,31,52,2075,1050,1150,2100,875,1000,0
386,0,2,67.0,67.0,78.0,70.0,2054,2524,1651,1875,403,649,324,743,205,310,119,433,33,53,2125,600,1150,2100,875,1450,0
393,0,2,70.0,69.0,78.0,93.0,2289,2513,1819,1931,470,582,80,442,30,195,50,247,33,54,2125,600,1150,2200,875,1450,0
400,0,2,73.0,70.0,78.0,93.0,2255,2591,1763,1987,492,604,105,458,20,135,85,323,35,56,2225,600,1150,2350,875,1450,0
407,0,2,76.0,72.0,78.0,93.0,2390,2675,1875,2071,515,604,100,149,5,50,95,99,35,57,2275,750,1150,2350,875,1450,0
414,0,2,78.0,79.0,78.0,93.0,2110,2871,1595,2267,515,604,226,366,125,195,101,171,37,58,2275,1250,1150,2350,875,1450,0
421,0,2,84.0,87.0,86.0,93.0,2143,3101,1651,2519,492,582,117,329,60,90,57,239,38,58,2325,1350,1300,2350,875,1450,0
429,0,2,85.0,88.0,86.0,93.0,2070,3207,1511,2603,559,604,284,515,155,200,129,315,39,59,2775,1550,1300,2350,875,1450,0
436,0,2,86.0,93.0,86.0,101.0,2272,3174,1623,2547,649,627,124,401,40,110,84,291,41,61,2775,1550,1300,2350,875,1450,0
443,0,2,90.0,97.0,94.0,101.0,2166,3263,1539,2659,627,604,235,484,75,125,160,359,41,62,2825,2000,1300,2350,875,1450,0
450,0,2,92.0,97.0,94.0,101.0,2160,3185,1511,2603,649,582,365,687,150,310,215,377,42,61,3225,2100,1300,2650,875,1550,0
457,0,2,94.0,99.0,94.0,109.0,2216,2726,1567,2099,649,627,101,738,35,335,66,403,43,60,3225,2950,1300,2650,875,1600,0
464,0,2,98.0,106.0,110.0,117.0,2238,2782,1567,2155,671,627,351,424,180,195,171,229,43,59,3400,2950,1300,2650,875,1650,0
471,0,2,100.0,112.0,110.0,117.0,2244,3286,1595,2659,649,627,298,497,105,200,193,297,43,60,3525,3125,1300,2650,875,1650,0
479,0,2,103.0,110.0,110.0,117.0,2300,3230,1651,2603,649,627,248,883,50,510,198,373,43,62,3525,3225,1300,2800,875,1750,0
486,0,2,105.0,110.0,110.0,117.0,2278,3123,1651,2519,627,604,375,1076,88,635,287,441,43,62,3950,3225,1300,2800,875,1750,0
493,0,2,106.0,115.0,110.0,117.0,2244,3129,1595,2547,649,582,470,1143,128,630,342,513,44,61,4175,3525,1425,2800,875,1800,0
500,0,2,110.0,119.0,110.0,125.0,2272,2479,1623,1987,649,492,600,318,178,245,422,73,44,59,4300,3425,1500,2800,875,2000,0
507,0,2,109.0,119.0,118.0,117.0,2294,2322,1623,1875,671,447,871,499,373,370,498,129,45,59,4300,4175,1500,2800,975,2450,0
514,0,2,110.0,120.0,118.0,125.0,2328,2765,1679,2295,649,470,577,714,28,525,549,189,46,59,4350,4175,1500,2800,975,2450,0
521,0,2,110.0,118.0,118.0,125.0,2216,3174,1567,2659,649,515,783,984,158,735,625,249,46,61,4375,4425,1500,2800,1125,2700,0
529,0,2,99.0,111.0,118.0,125.0,2356,3056,1707,2631,649,425,658,1298,28,1005,630,293,47,63,3300,3950,1500,2800,2200,3175,0
536,0,2,97.0,123.0,118.0,133.0,2362,3056,1735,2631,627,425,1019,376,238,335,781,41,47,64,3350,3850,1500,2800,2200,3275,0
543,0,2,101.0,125.0,118.0,133.0,2300,2860,1651,2435,649,425,809,513,73,420,736,93,47,66,3400,4900,1500,2800,2200,3275,0
550,0,2,101.0,123.0,118.0,133.0,2266,2748,1595,2323,671,425,809,400,18,255,791,145,47,64,3475,4900,1500,2800,2250,3425,0
557,0,2,103.0,123.0,118.0,133.0,2266,2742,1595,2295,671,447,1075,591,208,390,867,201,47,66,3525,4900,1500,2800,2250,3425,0
564,0,2,107.0,124.0,118.0,133.0,2014,2770,1343,2211,671,559,921,568,103,445,818,123,47,67,3700,4900,1500,2800,2250,3425,0
571,0,2,111.0,130.0,118.0,133.0,1908,2860,1259,2099,649,761,942,408,73,185,869,223,48,67,3700,4900,1500,2800,2250,3425,0
579,0,2,114.0,132.0,118.0,133.0,2082,2899,1455,1959,627,940,923,290,103,155,820,135,48,68,3800,5200,1500,2800,2250,3425,0
586,0,2,117.0,132.0,141.0,133.0,2216,3202,1567,2239,649,963,923,471,48,220,875,251,49,68,3800,5375,1500,2950,2250,3425,0
593,0,2,118.0,134.0,141.0,149.0,2188,3174,1539,2211,649,963,858,207,28,90,830,117,50,65,4375,5275,1900,2950,2250,3675,0
600,0,2,116.0,130.0,141.0,149.0,2210,3090,1539,2127,671,963,944,577,63,340,881,237,50,65,4375,5425,1900,2950,2250,3875,0
607,0,2,119.0,132.0,149.0,165.0,2210,3314,1539,2351,671,963,918,738,10,510,908,228,50,65,4400,5425,1900,2950,2550,3875,0
614,0,2,120.0,134.0,149.0,165.0,2188,3190,1539,2183,649,1007,1005,378,32,330,973,48,50,65,4450,5675,1900,2950,2550,3875,0
621,0,2,122.0,134.0,149.0,165.0,2692,3112,2043,2127,649,985,1195,400,167,240,1028,160,51,65,4450,5850,2075,2950,2550,3875,0
629,0,2,124.0,137.0,149.0,180.0,2726,3252,2099,2267,627,985,1176,636,147,360,1029,276,51,65,4450,6150,2175,2950,2600,3875,0
636,0,2,129.0,143.0,149.0,180.0,3308,3342,2659,2379,649,963,1101,357,42,165,1059,192,52,65,4900,6600,2275,2950,2600,4125,0
643,0,2,135.0,148.0,149.0,188.0,3330,3426,2659,2463,671,963,946,423,32,165,914,258,52,65,5025,6775,2275,2950,2600,4125,0
650,0,2,138.0,149.0,149.0,188.0,3442,3594,2771,2631,671,963,1057,814,67,440,990,374,54,65,5150,6775,2275,3200,2600,4125,0
657,0,2,140.0,158.0,149.0,188.0,3661,3426,2967,2463,694,963,1171,625,222,235,949,390,56,68,5200,7225,2275,3350,2650,4125,0
664,0,2,144.0,165.0,149.0,188.0,3885,3594,3079,2631,806,963,1092,296,197,140,895,156,57,69,5150,7525,2475,3600,2700,4125,0
671,0,2,144.0,167.0,157.0,188.0,3801,3644,2995,2659,806,985,663,436,72,160,591,276,58,72,5600,7775,2475,3600,2700,4125,0
679,0,2,149.0,174.0,157.0,188.0,3493,3728,2687,2743,806,985,733,232,42,90,691,142,59,74,6000,8225,2475,3600,2700,4125,0
686,0,2,153.0,177.0,157.0,188.0,3101,3862,2295,2855,806,1007,824,393,162,285,662,108,59,75,6250,8525,2700,3600,2700,4125,0
693,0,2,157.0,177.0,157.0,188.0,3263,3958,2435,2995,828,963,739,605,177,385,562,220,62,75,6250,8425,2700,3600,2700,4225,0
700,0,2,157.0,177.0,157.0,188.0,3174,3902,2323,2939,851,963,949,821,237,485,712,336,62,75,6250,8425,2600,3600,2762,4225,0
707,0,2,162.0,177.0,165.0,188.0,3179,3840,2239,2855,940,985,846,436,147,330,699,106,64,77,6525,8425,2600,3850,2762,4225,0
714,0,2,164.0,188.0,165.0,188.0,3028,3868,2043,2883,985,985,630,217,68,195,562,22,64,77,7075,9075,2600,3850,2762,4225,0
721,0,2,164.0,188.0,165.0,196.0,2978,3924,2015,2939,963,985,846,298,52,160,794,138,64,77,7300,9725,2800,3850,2762,4225,0
729,0,2,163.0,188.0,173.0,196.0,3062,3812,2099,2827,963,985,1212,589,302,335,910,254,64,77,7250,9725,2800,3850,2812,4225,0
736,0,2,167.0,188.0,181.0,196.0,3090,3935,2127,2883,963,1052,842,682,37,300,805,382,64,77,7250,9725,2800,3850,2812,4225,0
743,0,2,169.0,188.0,181.0,204.0,3168,4008,2183,2911,985,1097,938,1183,142,665,796,518,64,77,8025,9725,2800,3850,2812,4225,0
750,0,2,173.0,189.0,189.0,204.0,3146,4075,2183,2911,963,1164,929,1602,217,940,712,662,66,77,8025,10025,2800,4150,2812,4225,0
757,0,2,175.0,189.0,189.0,204.0,3196,4154,2211,2855,985,1299,1035,1848,332,1030,703,818,66,77,8025,10025,2800,4600,2812,4225,0
764,0,2,182.0,189.0,189.0,204.0,3224,4126,2239,2827,985,1299,776,2335,132,1365,644,970,66,78,8300,10025,2925,4600,2812,4225,0
771,0,2,183.0,185.0,189.0,204.0,3258,4182,2295,2883,963,1299,1052,2856,317,1730,735,1126,68,78,8525,9600,2925,4600,2862,4650,0
779,0,2,183.0,191.0,189.0,204.0,3146,4148,2183,2827,963,1321,1103,2722,252,1740,851,982,68,78,8925,9600,2925,4600,2862,4650,0
786,0,2,183.0,189.0,189.0,204.0,3056,4204,2071,2883,985,1321,1218,3228,372,2090,846,1138,68,78,9100,9425,3175,4600,3087,4825,0
793,0,2,185.0,185.0,181.0,204.0,3168,4232,2183,2911,985,1321,559,3440,72,2300,487,1140,68,78,9225,9075,3175,4850,3187,5175,0
800,0,2,184.0,184.0,196.0,204.0,3084,4215,2099,2939,985,1276,740,3837,137,2620,603,1217,68,78,9050,8975,3175,4850,3637,5275,0
807,0,2,188.0,198.0,196.0,219.0,3112,4299,2127,3023,985,1276,881,2613,187,2115,694,498,68,78,9050,10725,3175,4850,3637,5275,0
814,0,2,187.0,200.0,196.0,219.0,2866,4187,1903,2911,963,1276,1168,2354,312,1550,856,804,70,78,9175,11325,3175,4850,3637,5275,0
821,0,2,195.0,198.0,212.0,219.0,2726,4019,1763,2743,963,1276,764,2975,117,2015,647,960,71,78,9175,11075,3175,4850,3637,5525,0
829,0,2,195.0,196.0,212.0,219.0,2586,4086,1623,2743,963,1343,754,2840,87,1720,667,1120,73,79,9175,10975,3175,4850,3637,5625,0
836,0,2,184.0,186.0,212.0,227.0,2944,4176,1959,2855,985,1321,805,3332,172,2060,633,1272,72,79,8350,10200,3475,4850,4862,6500,0
843,0,2,172.0,180.0,212.0,227.0,2916,4322,1931,3023,985,1299,1025,3849,297,2425,728,1424,64,79,7950,9450,3475,4850,5787,7250,0
850,0,2,166.0,164.0,212.0,243.0,2888,4210,1903,2911,985,1299,807,4255,17,2675,790,1580,61,79,7025,7850,3700,5300,6962,8850,0
857,0,2,160.0,155.0,212.0,243.0,2569,4126,1651,2827,918,1299,911,4761,92,3025,819,1736,62,79,6475,7050,3700,5450,7560,9650,0
864,0,2,153.0,153.0,212.0,243.0,2334,4288,1483,2967,851,1321,1100,4662,152,3070,948,1592,64,79,6475,6300,3700,5450,8285,10400,0
871,0,2,157.0,173.0,212.0,243.0,2546,4210,1763,2911,783,1299,1072,3224,82,2080,990,1144,65,79,6675,8050,3700,5450,8285,10400,0
879,0,2,159.0,173.0,204.0,243.0,2944,4316,2183,2995,761,1321,1145,3735,42,2435,1103,1300,67,79,6675,8050,3700,5750,8385,10400,0
886,0,2,160.0,174.0,204.0,251.0,2938,3851,2155,2575,783,1276,1387,3567,192,2115,1195,1452,68,79,6675,8050,3800,5900,8385,10400,0
893,0,2,165.0,199.0,204.0,251.0,3034,3616,2071,2295,963,1321,1217,2756,77,1140,1140,1616,71,79,7025,9250,3875,5900,8385,10400,0
900,0,2,169.0,199.0,204.0,259.0,3280,3974,2295,2407,985,1567,1428,3097,172,1285,1256,1812,73,81,7025,9850,4075,5900,8385,10400,0
907,0,2,175.0,199.0,204.0,259.0,3314,4193,2351,2603,963,1590,1224,3594,152,1590,1072,2004,75,81,7025,9850,4075,5900,8385,10400,0
914,0,2,177.0,199.0,204.0,259.0,3498,4355,2491,2743,1007,1612,1537,4120,362,1920,1175,2200,77,81,7150,9850,4150,6350,8385,10400,0
921,0,2,179.0,197.0,204.0,251.0,3734,4546,2547,2911,1187,1635,1900,4769,577,2373,1323,2396,77,81,7425,9750,4150,6350,8385,10600,0
929,0,2,161.0,193.0,204.0,251.0,3930,4512,2631,2855,1299,1657,1207,5295,32,2703,1175,2592,77,81,5750,9400,4150,6350,10060,10950,0
936,0,2,156.0,178.0,204.0,251.0,4047,4383,2771,2827,1276,1556,1225,5794,52,3028,1173,2766,77,81,4950,8050,4150,6350,11085,12300,0
943,0,2,152.0,169.0,204.0,251.0,3706,4310,2519,2855,1187,1455,1326,6312,42,3378,1284,2934,73,81,4725,7250,4150,6350,11510,13100,0
950,0,2,162.0,191.0,204.0,251.0,3498,4333,2379,2855,1119,1478,1367,4898,97,2338,1270,2560,74,81,5850,9175,4150,6350,11510,13100,0
957,0,2,172.0,191.0,204.0,251.0,3644,4282,2547,2827,1097,1455,1239,4769,37,2033,1202,2736,75,81,6075,9175,4150,6350,11510,13100,0
964,0,2,175.0,191.0,204.0,251.0,3806,3958,2631,2547,1175,1411,1561,5236,217,2328,1344,2908,75,81,6175,9175,4150,6350,11510,13100,0
971,0,2,175.0,181.0,204.0,251.0,3834,4333,2715,2855,1119,1478,1517,5591,287,2753,1230,2838,76,81,6950,8975,4150,6350,11510,13500,0
979,0,2,185.0,191.0,204.0,251.0,3728,4361,2687,2883,1041,1478,1270,4888,47,2228,1223,2660,76,81,7125,9925,4150,6350,11560,13775,0
986,0,2,162.0,186.0,204.0,251.0,3470,4417,2631,2939,839,1478,1506,5399,212,2563,1294,2836,73,81,5925,9450,4150,6350,13010,14250,0
993,0,2,154.0,179.0,204.0,251.0,3431,4310,2715,2855,716,1455,1705,5906,352,2898,1353,3008,72,81,5475,8800,4150,6200,13560,14937,0
1000,0,2,160.0,173.0,204.0,251.0,3448,4333,2799,2855,649,1478,1411,6432,82,3248,1329,3184,72,81,6225,8275,4150,6200,14085,15462,0
1007,0,2,165.0,173.0,204.0,259.0,3498,4277,2827,2799,671,1478,1381,6513,172,3153,1209,3360,72,81,6275,8275,4150,6200,14085,15462,0
1014,0,2,166.0,170.0,204.0,259.0,3515,4198,2799,2743,716,1455,1270,7006,152,3478,1118,3528,72,81,6325,7975,4150,6200,14085,15762,0
1021,0,2,168.0,196.0,204.0,259.0,3381,4333,2687,2855,694,1478,1375,4651,227,1893,1148,2758,72,81,6925,10250,4150,6200,14085,15762,0
1029,0,2,177.0,196.0,204.0,259.0,3336,4165,2687,2687,649,1478,1226,5123,102,2193,1124,2930,72,81,7025,10250,4150,6200,14085,15762,0
1036,0,2,177.0,194.0,204.0,259.0,3342,3935,2603,2603,739,1332,1498,4842,307,1758,1191,3084,72,79,7525,10250,4150,6200,14085,15862,0
1043,0,2,182.0,183.0,204.0,259.0,3605,3650,2687,2351,918,1299,1584,5253,377,2013,1207,3240,72,76,7650,9850,4150,6200,13785,16412,0
1050,0,2,191.0,190.0,204.0,259.0,3521,3314,2603,2015,918,1299,1192,4300,152,1508,1040,2792,72,76,7900,9675,4050,6200,14110,16587,0
1057,0,2,191.0,192.0,204.0,259.0,3549,3633,2631,2379,918,1254,848,4592,17,1648,831,2944,72,76,7625,9675,4050,6200,14385,16587,0
1064,0,2,184.0,181.0,204.0,251.0,3504,3706,2631,2407,873,1299,918,5567,12,2459,906,3108,72,81,7225,8475,4050,6200,15135,17811,0
1071,0,2,176.0,194.0,204.0,251.0,3386,3678,2603,2267,783,1411,1381,4089,387,1359,994,2730,69,74,7225,10225,4050,6800,15485,18636,0
1079,0,2,178.0,185.0,204.0,251.0,3084,3627,2323,2239,761,1388,953,4529,42,1639,911,2890,61,75,7425,9400,3950,6800,16085,19461,0
1086,0,2,182.0,188.0,204.0,251.0,3078,3661,2295,2295,783,1366,1010,4659,7,1759,1003,2900,61,75,7700,9700,3950,6800,16085,19461,0
1093,0,2,186.0,188.0,204.0,251.0,3078,3655,2295,2267,783,1388,1306,4705,207,1649,1099,3056,63,75,8300,9700,3950,6800,16085,19461,0
1100,0,2,189.0,200.0,204.0,251.0,2614,3756,1875,2435,739,1321,1339,3655,152,1189,1187,2466,63,75,8800,9700,3950,6800,16085,19461,0
1107,0,2,191.0,200.0,204.0,251.0,2261,3722,1455,2379,806,1343,1324,3904,137,1274,1187,2630,63,75,9175,11500,3950,6800,16085,19461,0
1114,0,2,196.0,196.0,204.0,251.0,2345,3515,1539,2295,806,1220,1591,3816,162,1244,1429,2572,66,75,9175,11000,4050,6800,16085,19961,0
1121,0,2,198.0,188.0,204.0,259.0,2524,3644,1651,2435,873,1209,1680,4060,168,1444,1512,2616,66,75,9625,10300,4050,6800,16085,20961,0
1129,0,2,200.0,188.0,219.0,259.0,2625,3560,1707,2351,918,1209,1406,4475,32,1719,1374,2756,68,75,9500,10300,4150,6800,16210,20961,0
1136,0,2,189.0,180.0,219.0,267.0,2625,3694,1707,2575,918,1119,1708,4922,222,2034,1486,2888,63,75,9150,9600,4150,6800,17160,21661,0
1143,0,2,189.0,174.0,219.0,267.0,2311,3504,1371,2295,940,1209,1584,5319,107,2279,1477,3040,59,75,9225,9075,4150,6800,17510,22186,0
1150,0,2,170.0,152.0,219.0,267.0,2423,3538,1483,2351,940,1187,1807,5458,222,2424,1585,3034,59,75,7950,6850,4150,6800,18785,24411,0
1157,0,2,172.0,152.0,219.0,267.0,2317,3454,1399,2267,918,1187,1580,3729,87,1109,1493,2620,59,75,8375,6275,4150,7300,18910,26911,0
1164,0,2,164.0,130.0,219.0,282.0,2563,3543,1623,2323,940,1220,1762,4151,182,1389,1580,2762,59,75,7975,4775,4150,7300,19485,28611,0
1171,0,2,159.0,102.0,219.0,282.0,2821,3594,1903,2463,918,1131,1729,4568,62,1674,1667,2894,59,73,7325,2500,4150,7300,20435,30986,0
1179,0,2,149.0,117.0,219.0,282.0,3101,3504,2183,2407,918,1097,1941,2301,162,179,1779,2122,59,73,6650,1225,4150,7050,21160,32511,0
1186,0,2,138.0,106.0,219.0,274.0,3230,3622,2267,2547,963,1075,1972,2129,77,179,1895,1950,59,73,6175,2400,4150,6900,22060,33986,0
1193,0,2,137.0,89.0,219.0,266.0,3269,3409,2351,2379,918,1030,2024,2318,75,244,1949,2074,59,66,5800,1350,4150,6750,22797,35736,0
1200,0,2,133.0,90.0,219.0,266.0,3202,3185,2239,2267,963,918,2095,2325,80,139,2015,2186,60,66,5325,825,4150,6500,23322,36561,0
1207,0,2,139.0,82.0,219.0,258.0,3235,2832,2295,1959,940,873,2317,2344,215,54,2102,2290,60,66,5725,275,4150,6500,23372,37561,0
1214,0,2,144.0,64.0,219.0,258.0,3129,2070,2267,1399,862,671,2255,2750,55,84,2200,2666,60,47,5950,575,4150,6500,23372,38811,0
1221,0,2,150.0,53.0,219.0,250.0,3213,1986,2407,1315,806,671,2176,2791,5,49,2171,2742,60,46,6175,300,4150,6500,23372,39961,0
1229,0,2,153.0,51.0,219.0,250.0,3420,2020,2659,1371,761,649,2395,2992,165,174,2230,2818,61,48,6300,0,4150,6350,23647,40411,0
1234,0,2,153.0,51.0,219.0,250.0,3420,2076,2659,1427,761,649,2395,3182,165,304,2230,2878,61,50,6300,0,4150,6350,23647,40411,0
7,2,1,13.0,13.0,15.0,14.0,293,293,293,293,0,0,35,35,35,35,0,0,12,12,0,0,0,0,0,0,1
14,2,1,14.0,13.0,15.0,14.0,643,671,643,671,0,0,65,20,65,20,0,0,13,13,0,0,0,0,0,0,1
21,2,1,14.0,14.0,15.0,14.0,643,727,643,727,0,0,40,55,40,55,0,0,13,13,0,0,0,0,0,0,1
29,2,1,15.0,14.0,15.0,14.0,615,755,615,755,0,0,65,145,65,145,0,0,14,13,0,0,0,0,0,0,1
36,2,1,15.0,16.0,15.0,22.0,727,755,727,755,0,0,110,145,110,145,0,0,14,14,0,0,0,0,0,0,1
43,2,1,16.0,16.0,23.0,22.0,699,699,699,699,0,0,40,220,40,220,0,0,15,15,0,0,0,0,0,0,1
50,2,1,17.0,17.0,23.0,22.0,755,727,755,727,0,0,85,260,85,260,0,0,16,16,0,0,0,0,0,0,1
57,2,1,18.0,17.0,23.0,22.0,783,755,783,755,0,0,55,10,55,10,0,0,17,15,0,0,0,0,0,0,1
64,2,1,18.0,18.0,23.0,22.0,867,867,867,867,0,0,160,65,160,65,0,0,17,16,0,0,0,0,0,0,1
71,2,1,19.0,17.0,23.0,22.0,923,867,923,867,0,0,225,140,225,140,0,0,18,16,0,0,0,0,0,0,1
79,2,1,19.0,17.0,23.0,22.0,945,895,923,895,22,0,284,5,280,5,4,0,18,16,0,0,0,0,0,0,1
86,2,1,20.0,18.0,23.0,22.0,995,951,951,951,44,0,408,70,400,70,8,0,19,16,0,0,0,0,0,0,1
93,2,1,20.0,19.0,23.0,22.0,967,979,923,979,44,0,121,130,105,130,16,0,20,17,0,0,150,0,0,0,1
100,2,1,20.0,20.0,23.0,22.0,1034,1018,923,951,111,67,92,202,60,190,32,12,20,19,0,0,150,0,0,0,1
107,2,1,21.0,20.0,23.0,22.0,1029,1113,895,979,134,134,93,333,45,305,48,28,20,19,0,0,150,0,0,0,1
114,2,1,21.0,20.0,23.0,22.0,1023,1079,867,923,156,156,108,353,40,305,68,48,20,20,0,0,150,0,0,0,1
121,2,1,22.0,20.0,23.0,22.0,1051,1074,895,895,156,179,188,483,100,415,88,68,21,20,0,0,150,0,0,0,1
129,2,1,22.0,25.0,23.0,36.0,1074,1130,895,951,179,179,322,268,210,180,112,88,21,20,0,0,150,250,0,0,1
136,2,1,25.0,27.0,31.0,36.0,1135,1079,867,923,268,156,234,99,115,95,119,4,22,20,0,0,300,250,0,0,1
143,2,1,26.0,28.0,31.0,36.0,1197,1096,839,1007,358,89,369,177,210,165,159,12,23,20,0,50,300,250,0,0,1
150,2,1,26.0,30.0,31.0,36.0,1146,1018,811,951,335,67,80,200,60,180,20,20,23,21,0,100,300,250,0,0,1
157,2,1,29.0,31.0,31.0,36.0,1236,1107,923,1063,313,44,186,284,130,260,56,24,24,23,125,100,300,250,0,0,1
164,2,1,30.0,31.0,46.0,36.0,1236,1242,923,1175,313,67,226,77,130,45,96,32,24,23,125,400,300,250,0,0,1
171,2,1,32.0,33.0,46.0,36.0,1320,1298,1007,1231,313,67,116,95,55,55,61,40,26,24,125,400,300,250,0,0,1
179,2,1,35.0,33.0,46.0,36.0,1432,1326,1119,1259,313,67,246,203,145,155,101,48,28,24,250,400,300,250,0,50,1
186,2,1,36.0,35.0,46.0,36.0,1561,1354,1203,1287,358,67,371,166,230,110,141,56,28,24,250,400,300,250,0,50,1
193,2,1,40.0,36.0,46.0,36.0,1650,1326,1315,1259,335,67,62,289,35,225,27,64,29,24,250,450,600,250,0,50,1
200,2,1,40.0,37.0,46.0,44.0,1460,1331,1147,1287,313,44,363,298,300,230,63,68,30,26,250,450,600,250,0,50,1
207,2,1,42.0,39.0,46.0,44.0,1572,1494,1259,1427,313,67,323,386,220,310,103,76,31,26,375,650,600,250,0,50,1
214,2,1,43.0,40.5,46.0,44.0,1712,1466,1399,1399,313,67,408,464,265,380,143,84,32,26,375,625,600,250,0,75,1
221,2,1,44.0,42.5,46.0,52.0,1824,1270,1511,1203,313,67,423,412,240,320,183,92,33,25,675,775,600,250,0,125,1
229,2,1,45.0,42.5,46.0,52.0,1818,1018,1483,951,335,67,488,175,265,75,223,100,34,25,675,775,600,250,0,125,1
236,2,1,46.0,44.5,46.0,58.0,1958,1326,1623,1259,335,67,264,243,155,135,109,108,35,26,675,775,600,250,0,125,1
243,2,1,46.0,46.5,46.0,58.0,1902,1331,1567,1287,335,44,284,302,135,190,149,112,37,28,675,775,600,250,0,125,1
250,2,1,46.0,48.5,46.0,66.0,2026,1471,1623,1427,403,44,481,185,280,65,201,120,37,29,675,775,600,500,0,125,1
257,2,1,51.0,48.0,54.0,66.0,1953,1522,1483,1455,470,67,671,378,410,250,261,128,36,31,675,900,750,500,50,150,1
264,2,1,50.0,49.0,62.0,66.0,2115,1438,1623,1371,492,67,916,491,595,355,321,136,38,34,375,900,850,500,350,150,1
271,2,1,50.0,51.0,62.0,66.0,2031,1550,1539,1483,492,67,807,344,530,200,277,144,38,32,375,900,850,500,350,150,1
279,2,1,56.0,54.0,62.0,66.0,2065,1673,1595,1539,470,134,454,199,325,35,129,164,40,33,375,900,850,500,350,150,1
286,2,1,56.0,60.0,62.0,66.0,2143,1779,1651,1623,492,156,614,264,425,80,189,184,40,33,975,900,850,700,350,150,1
293,2,1,57.0,57.5,62.0,58.0,2115,1919,1623,1763,492,156,519,299,420,95,99,204,42,34,725,775,850,700,600,375,1
300,2,1,59.0,57.5,70.0,58.0,2255,1863,1763,1707,492,156,705,309,550,85,155,224,43,40,725,775,850,700,600,375,1
307,2,1,59.0,57.5,70.0,58.0,2250,2020,1735,1819,515,201,115,397,50,145,65,252,44,40,725,1075,1100,700,600,375,1
314,2,1,61.0,61.5,70.0,82.0,2255,2166,1763,1763,492,403,296,418,175,110,121,308,45,40,725,1225,1100,700,600,375,1
321,2,1,65.0,63.5,70.0,90.0,2278,2289,1763,1819,515,470,75,545,40,185,35,360,45,40,1075,1225,1400,700,600,375,1
329,2,1,66.0,67.5,78.0,98.0,2294,2266,1735,1819,559,447,213,397,110,35,103,362,46,40,1075,1225,1400,700,600,375,1
336,2,1,71.0,72.5,78.0,98.0,2418,2205,1791,1735,627,470,254,572,75,150,179,422,47,40,1175,1225,1400,700,600,375,1
343,2,1,76.0,78.5,78.0,114.0,2446,2261,1819,1791,627,470,150,547,45,140,105,407,48,40,1275,1225,1400,700,600,375,1
350,2,1,76.0,82.5,78.0,114.0,2384,2283,1735,1791,649,492,81,612,50,170,31,442,49,51,1625,1425,1400,700,600,375,1
357,2,1,76.0,83.5,78.0,114.0,2502,2390,1875,1875,627,515,292,597,185,195,107,402,50,51,1625,1425,1400,700,600,375,1
364,2,1,77.0,86.0,78.0,114.0,2524,2530,1875,2015,649,515,232,758,45,300,187,458,50,54,1625,1800,1400,700,600,400,1
371,2,1,78.0,93.0,78.0,114.0,2597,2647,1903,2155,694,492,427,724,160,235,267,489,51,54,1975,1800,1550,700,600,400,1
379,2,1,83.0,97.0,86.0,114.0,2412,2569,1763,2099,649,470,359,705,170,160,189,545,51,62,1975,1800,1700,700,600,400,1
386,2,1,89.0,98.0,109.0,114.0,2636,2765,1987,2295,649,470,580,835,315,230,265,605,53,60,1975,1800,1700,700,600,400,1
393,2,1,90.0,101.0,109.0,114.0,2524,3011,1875,2519,649,492,820,1000,475,335,345,665,53,61,1975,1900,2100,700,600,400,1
400,2,1,96.0,106.0,109.0,114.0,2614,3095,1987,2603,627,492,546,910,375,185,171,725,55,62,2825,1900,2200,700,600,400,1
407,2,1,97.0,106.0,109.0,114.0,2810,3235,2183,2743,627,492,516,991,365,210,151,781,56,71,2825,1900,2200,700,600,400,1
414,2,1,98.0,106.0,109.0,122.0,2994,3370,2323,2743,671,627,541,1296,310,435,231,861,58,71,2825,2200,2200,950,600,400,1
421,2,1,98.0,105.0,109.0,130.0,2882,3532,2211,2659,671,873,477,1714,170,745,307,969,59,70,3175,2200,2200,950,600,400,1
429,2,1,106.0,104.0,109.0,138.0,3022,3622,2351,2659,671,963,143,1745,60,860,83,885,60,69,3175,2200,2200,950,600,400,1
436,2,1,109.0,129.0,117.0,138.0,3084,3678,2435,2715,649,963,314,986,155,135,159,851,60,70,3175,2200,2200,950,600,400,1
443,2,1,110.0,131.0,125.0,138.0,3056,3734,2295,2771,761,963,334,1182,225,240,109,942,61,70,3175,2200,2200,950,600,400,1
450,2,1,113.0,134.0,133.0,138.0,3230,3784,2267,2799,963,985,479,1187,375,175,104,1012,63,70,2925,2150,2450,950,600,450,1
457,2,1,116.0,133.5,133.0,138.0,3314,3784,2351,2799,963,985,135,1539,40,415,95,1124,65,70,4325,3025,2450,950,600,475,1
464,2,1,117.0,133.5,133.0,146.0,3358,3706,2351,2743,1007,963,330,1980,115,740,215,1240,65,70,4325,3325,2450,950,600,475,1
471,2,1,117.0,149.5,133.0,154.0,3364,3739,2379,2799,985,940,721,1831,390,625,331,1206,66,70,3825,3775,2750,950,600,475,1
479,2,1,117.0,153.5,133.0,154.0,3448,3728,2463,2743,985,985,683,1691,190,390,493,1301,67,70,3825,3775,2750,950,600,475,1
486,2,1,121.0,153.5,133.0,154.0,3510,3790,2547,2827,963,963,799,2123,390,710,409,1413,67,70,4275,3775,2750,950,600,475,1
493,2,1,126.0,160.0,133.0,160.0,3482,3756,2519,2771,963,985,465,2238,140,705,325,1533,67,70,4875,4350,2900,950,600,500,1
500,2,1,127.0,176.0,133.0,176.0,3370,3784,2407,2799,963,985,220,984,150,535,70,449,67,70,4875,4450,2900,950,600,500,1
507,2,1,131.0,176.0,141.0,176.0,3392,3728,2407,2743,985,985,326,1225,140,660,186,565,68,70,5075,6350,3050,950,600,500,1
514,2,1,131.0,176.0,165.0,176.0,3386,3566,2379,2603,1007,963,581,1531,275,850,306,681,68,70,5175,6850,3350,950,600,500,1
521,2,1,133.0,186.5,165.0,200.0,3504,3560,2519,2575,985,985,708,1367,290,570,418,797,68,70,5275,6775,3350,950,800,575,1
529,2,1,134.0,182.5,165.0,200.0,3504,3840,2519,2855,985,985,312,1827,278,910,34,917,67,70,5725,6575,3500,950,1150,775,1
536,2,1,140.0,159.0,165.0,216.0,3510,3790,2547,2827,963,963,79,1769,58,865,21,904,67,70,5525,4600,3500,950,1600,2750,1
543,2,1,136.0,154.0,165.0,216.0,3622,3840,2659,2855,963,985,509,1934,368,1060,141,874,67,70,5950,4750,3850,950,1825,3100,1
550,2,1,110.0,148.5,180.0,216.0,3398,3706,2435,2743,963,963,810,1966,553,1080,257,886,67,70,3700,4175,3850,950,4175,3975,1
557,2,1,111.0,152.0,180.0,216.0,3532,3734,2547,2771,985,963,1200,1832,823,905,377,927,67,70,3700,4450,3850,950,4175,4350,1
564,2,1,126.0,160.0,180.0,216.0,3588,3655,2603,2715,985,940,876,1373,383,780,493,593,67,70,4400,4300,3850,950,4175,4500,1
571,2,1,128.0,170.0,180.0,216.0,3588,3728,2603,2743,985,985,1043,1323,438,735,605,588,68,70,3400,4800,3850,950,4175,4500,1
579,2,1,128.0,181.0,180.0,216.0,3504,3644,2519,2659,985,985,773,423,48,290,725,133,69,70,4300,5600,3850,950,4175,4500,1
586,2,1,128.0,185.0,180.0,216.0,3286,3476,2323,2491,963,985,1145,625,308,430,837,195,69,70,4300,6400,3850,950,4175,4500,1
593,2,1,134.0,194.5,180.0,216.0,3375,3644,2435,2659,940,985,896,766,243,530,653,236,63,70,4600,7275,3850,950,4475,4525,1
600,2,1,119.0,186.0,180.0,216.0,3179,3784,2351,2799,828,985,972,1217,223,865,749,352,60,70,3900,6950,3850,950,5775,5150,1
607,2,1,107.0,189.0,180.0,216.0,3134,3762,2351,2799,783,963,1224,963,383,670,841,293,58,70,4000,6750,4150,950,6525,5850,1
614,2,1,105.0,185.0,180.0,200.0,3123,3756,2407,2771,716,985,1308,1419,383,1010,925,409,58,70,3750,6100,4100,950,7075,6500,1
621,2,1,81.0,179.0,180.0,192.0,3207,3840,2491,2855,716,985,1337,779,453,525,884,254,58,70,1650,4800,4000,950,9487,8500,1
629,2,1,76.0,176.0,180.0,192.0,3157,3762,2463,2799,694,963,806,511,213,420,593,91,60,70,1450,4550,4000,950,10437,9050,1
636,2,1,71.0,171.0,180.0,192.0,2955,3812,2239,2827,716,985,209,686,53,550,156,136,56,70,1600,4350,4150,950,11037,9800,1
643,2,1,70.0,175.0,180.0,192.0,2647,3616,1931,2631,716,985,517,587,273,560,244,27,55,70,1850,5150,4150,950,11087,10100,1
650,2,1,79.0,179.0,180.0,192.0,2843,3364,2127,2379,716,985,121,738,43,645,78,93,55,70,600,5450,4150,950,11087,10100,1
657,2,1,81.0,191.0,180.0,192.0,3067,3286,2351,2323,716,963,390,344,228,185,162,159,57,70,1800,5950,4150,950,11087,10100,1
664,2,1,89.0,190.0,180.0,192.0,3095,3476,2379,2491,716,985,109,110,13,60,96,50,60,68,2250,6250,4150,950,11087,10100,1
671,2,1,91.0,187.0,180.0,192.0,3207,3672,2491,2687,716,985,298,545,268,375,30,170,60,67,2650,6650,4150,950,11087,10200,1
679,2,1,83.0,181.0,180.0,192.0,3291,3644,2575,2659,716,985,297,782,183,550,114,232,60,67,1850,6350,4150,950,12387,10700,1
7,0,2,13.0,13.0,15.0,15.0,293,293,293,293,0,0,35,35,35,35,0,0,12,12,0,0,0,0,0,0,0
14,0,2,14.0,14.0,15.0,15.0,643,671,643,671,0,0,65,70,65,70,0,0,13,13,0,0,0,0,0,0,0
21,0,2,14.0,14.0,15.0,15.0,671,699,671,699,0,0,40,50,40,50,0,0,13,13,0,0,0,0,0,0,0
29,0,2,15.0,15.0,15.0,15.0,699,671,699,671,0,0,80,85,80,85,0,0,14,14,0,0,0,0,0,0,0
36,0,2,15.0,16.0,15.0,23.0,699,811,699,811,0,0,115,145,115,145,0,0,14,15,0,0,0,0,0,0,0
43,0,2,16.0,16.0,23.0,23.0,783,783,783,783,0,0,65,35,65,35,0,0,15,15,0,0,0,0,0,0,0
50,0,2,16.0,17.0,23.0,23.0,699,839,699,839,0,0,25,60,25,60,0,0,15,16,0,0,0,0,0,0,0
57,0,2,17.0,18.0,23.0,23.0,755,811,755,811,0,0,70,115,70,115,0,0,16,17,0,0,0,0,0,0,0
64,0,2,18.0,18.0,23.0,23.0,811,951,811,951,0,0,175,230,175,230,0,0,17,17,0,0,0,0,0,0,0
71,0,2,18.0,19.0,23.0,23.0,805,973,783,951,22,22,224,294,220,290,4,4,17,18,0,0,0,0,0,0,0
79,0,2,19.0,20.0,23.0,23.0,883,1018,727,951,156,67,333,362,305,350,28,12,18,19,0,0,0,0,0,0,0
86,0,2,19.0,20.0,23.0,23.0,855,995,699,951,156,44,434,336,390,320,44,16,18,19,0,0,0,150,0,0,0
93,0,2,20.0,20.0,23.0,23.0,883,1046,727,979,156,67,289,49,275,25,14,24,19,20,0,0,150,150,0,0,0
100,0,2,20.0,21.0,23.0,23.0,939,1062,783,951,156,111,399,130,365,90,34,40,19,20,0,0,150,150,0,0,0
107,0,2,20.0,21.0,23.0,23.0,911,1062,755,951,156,111,114,152,60,100,54,52,19,21,0,0,150,150,0,0,0
114,0,2,20.0,22.0,23.0,23.0,962,1090,783,979,179,111,129,154,55,90,74,64,19,21,0,0,150,150,0,0,0
121,0,2,22.0,23.0,23.0,31.0,934,1085,755,951,179,134,129,239,35,155,94,84,19,22,100,0,150,300,0,0,0
129,0,2,23.0,25.0,23.0,31.0,1107,1079,951,923,156,156,225,94,115,65,110,29,20,22,100,0,150,300,0,0,0
136,0,2,23.0,26.0,31.0,31.0,1079,1074,923,895,156,179,110,223,80,170,30,53,20,23,100,0,150,300,0,0,0
143,0,2,24.0,29.0,31.0,31.0,1079,1174,923,951,156,223,15,146,15,115,0,31,21,24,150,125,150,300,0,0,0
150,0,2,24.0,29.0,31.0,31.0,1219,1236,1063,923,156,313,135,296,115,225,20,71,21,25,150,125,150,300,0,0,0
157,0,2,25.0,30.0,31.0,31.0,1275,1314,1119,979,156,335,190,406,150,295,40,111,22,25,150,125,150,300,0,0,0
164,0,2,25.0,32.0,31.0,46.0,1292,1264,1091,951,201,313,274,207,210,160,64,47,22,26,150,125,150,300,0,0,0
171,0,2,26.0,32.0,31.0,46.0,1348,1348,1035,1035,313,313,384,277,280,190,104,87,23,26,150,125,150,300,0,0,0
179,0,2,27.0,34.0,46.0,46.0,1264,1510,951,1175,313,335,375,62,235,35,140,27,24,28,150,300,500,300,0,0,0
186,0,2,27.0,35.0,46.0,46.0,1258,1538,923,1203,335,335,265,192,185,125,80,67,24,29,150,300,500,300,0,0,0
193,0,2,27.0,37.0,46.0,46.0,1124,1712,811,1399,313,313,341,248,225,145,116,103,25,31,100,300,600,300,50,0,0
200,0,2,31.0,36.0,46.0,46.0,1208,1846,895,1511,313,335,241,508,85,365,156,143,25,32,100,175,600,550,50,125,0
207,0,2,33.0,37.0,46.0,46.0,1460,1824,1147,1511,313,313,386,64,190,35,196,29,26,33,100,175,600,550,50,125,0
214,0,2,34.0,38.0,46.0,54.0,1734,1846,1399,1511,335,335,261,234,50,165,211,69,27,34,100,175,600,550,50,125,0
221,0,2,41.0,39.0,46.0,54.0,1908,1824,1595,1511,313,313,267,245,120,140,147,105,28,35,300,175,850,550,50,125,0
229,0,2,42.0,42.0,46.0,54.0,2014,2020,1679,1707,335,313,342,195,155,50,187,145,29,36,300,175,850,800,50,125,0
236,0,2,43.0,44.0,46.0,54.0,2070,2014,1735,1679,335,335,342,260,115,125,227,135,30,36,300,350,925,800,50,125,0
243,0,2,46.0,46.0,46.0,54.0,2104,2177,1791,1819,313,358,538,320,275,145,263,175,31,38,500,350,925,800,50,125,0
250,0,2,48.0,44.0,54.0,54.0,2300,1818,1987,1483,313,335,768,511,465,300,303,211,32,37,400,600,925,950,150,225,0
257,0,2,45.0,45.0,54.0,62.0,2406,1768,2071,1455,335,313,683,522,340,350,343,172,33,36,400,600,925,1100,350,325,0
264,0,2,46.0,48.0,54.0,62.0,2350,1964,2015,1651,335,313,818,472,460,310,358,162,34,37,500,600,925,1250,350,325,0
271,0,2,47.0,53.0,54.0,62.0,2322,2104,1987,1791,335,313,724,302,330,200,394,102,35,38,600,1125,925,1250,350,325,0
279,0,2,51.0,56.0,62.0,62.0,2126,2098,1791,1763,335,335,599,332,165,240,434,92,37,39,600,1400,1000,1250,350,325,0
286,0,2,57.0,56.0,62.0,62.0,2104,2154,1791,1819,313,335,230,487,85,355,145,132,38,40,600,1400,1000,1250,350,325,0
293,0,2,60.0,62.0,62.0,62.0,2356,2182,2043,1847,313,335,335,158,150,140,185,18,39,41,700,1400,1100,1250,350,325,0
300,0,2,61.0,62.0,70.0,62.0,2412,2199,2099,1819,313,380,460,296,235,230,225,66,40,40,700,1925,1100,1250,350,300,0
307,0,2,61.0,54.0,70.0,70.0,2322,1628,1987,1203,335,425,265,354,125,240,140,114,41,32,700,1925,1200,1250,350,700,0
314,0,2,65.0,57.0,70.0,70.0,1566,1090,1231,867,335,223,415,129,235,95,180,34,42,32,1025,2100,1000,1250,600,750,0
321,0,2,64.0,53.0,70.0,78.0,1197,732,839,643,358,89,190,197,95,155,95,42,42,29,875,2175,1300,1250,750,1000,0
329,0,2,64.0,51.0,78.0,86.0,1281,906,923,839,358,67,235,330,100,280,135,50,40,27,1275,2175,1300,1250,850,1100,0
336,0,2,62.0,45.0,78.0,86.0,1180,1018,867,951,313,67,121,343,25,285,96,58,40,19,1075,2175,1300,1250,1050,1500,0
343,0,2,60.0,43.0,78.0,86.0,1208,939,895,895,313,44,166,397,30,335,136,62,40,17,975,2175,1300,1250,1250,1600,0
350,0,2,65.0,40.0,78.0,86.0,1264,911,951,867,313,44,204,505,28,435,176,70,40,19,1350,1825,1300,1250,1250,1950,0
357,0,2,64.0,39.0,78.0,86.0,1258,990,923,923,335,67,275,523,59,445,216,78,40,19,1150,1650,1300,1250,1550,2125,0
364,0,2,64.0,40.0,78.0,86.0,1348,1051,1035,1007,313,44,516,492,264,410,252,82,40,20,1475,1650,1200,1250,1575,2125,0
371,0,2,65.0,42.0,78.0,86.0,1706,1023,1371,979,335,44,371,155,229,65,142,90,40,22,1475,1650,1200,1250,1575,2125,0
379,0,2,62.0,42.0,78.0,86.0,1740,1158,1427,1091,313,67,567,298,389,200,178,98,40,24,1650,1400,1200,1250,1725,2375,0
386,0,2,67.0,44.0,78.0,86.0,1964,1107,1651,1063,313,44,432,317,239,215,193,102,40,26,1700,1400,1200,1250,1725,2375,0
393,0,2,69.0,44.0,78.0,86.0,2121,1275,1763,1231,358,44,340,375,174,265,166,110,40,26,1700,1400,1200,1250,1725,2375,0
400,0,2,72.0,46.0,78.0,86.0,2429,1410,1959,1343,470,67,421,548,199,430,222,118,42,28,1700,1400,1200,1250,1725,2375,0
407,0,2,74.0,48.0,78.0,86.0,2591,1494,2099,1427,492,67,531,346,274,320,257,26,42,30,1825,1400,1200,1250,1725,2375,0
414,0,2,76.0,49.0,78.0,86.0,2843,1544,2351,1455,492,89,452,138,239,100,213,38,44,31,2050,1400,1325,1250,1725,2375,0
421,0,2,78.0,50.0,78.0,86.0,2703,1555,2211,1399,492,156,428,233,184,175,244,58,46,32,2050,1400,1325,1250,1725,2375,0
429,0,2,84.0,51.0,94.0,86.0,2838,1606,2323,1315,515,291,272,443,164,345,108,98,46,33,2050,1400,1325,1250,1725,2375,0
436,0,2,84.0,56.0,94.0,86.0,2759,1841,2155,1483,604,358,327,113,139,50,188,63,46,35,2050,1400,1525,1250,1725,2375,0
443,0,2,85.0,59.0,94.0,101.0,2860,1746,2211,1455,649,291,258,225,119,130,139,95,46,37,2225,1500,1525,1250,1775,2375,0
450,0,2,86.0,66.0,102.0,101.0,3000,1958,2351,1623,649,335,494,64,279,25,215,39,46,38,2225,1750,1525,1250,1775,2375,0
457,0,2,94.0,69.0,102.0,101.0,2782,2121,2155,1763,627,358,95,124,29,45,66,79,46,41,2675,1950,1525,1250,1775,2375,0
464,0,2,98.0,72.0,102.0,101.0,2440,2205,1791,1847,649,358,191,238,99,115,92,123,48,42,2900,2050,1525,1550,1775,2375,0
471,0,2,98.0,80.0,102.0,101.0,2524,2294,1875,1959,649,335,411,223,239,60,172,163,48,44,2900,2150,1525,1550,1775,2375,0
479,0,2,100.0,83.0,118.0,101.0,2636,2350,1987,2015,649,335,392,268,169,115,223,153,48,46,3025,2350,1525,1550,1775,2375,0
486,0,2,102.0,83.0,118.0,101.0,2720,2485,2071,2127,649,358,543,572,319,375,224,197,48,47,3250,2525,1825,1850,1775,2375,0
493,0,2,104.0,89.0,118.0,101.0,2748,2541,2099,2183,649,358,744,572,469,335,275,237,48,48,3650,2825,1825,1850,1775,2375,0
500,0,2,108.0,87.0,134.0,101.0,2748,2625,2099,2267,649,358,409,891,204,610,205,281,48,48,3875,2650,1925,1850,1775,2550,0
507,0,2,114.0,98.0,134.0,101.0,2658,2602,1987,2267,671,335,415,611,209,365,206,246,48,48,3875,3150,2000,1850,1775,2550,0
514,0,2,115.0,96.0,134.0,101.0,2552,2703,1903,2323,649,380,626,930,344,640,282,290,48,48,3950,3050,2000,1850,1825,2650,0
521,0,2,106.0,94.0,142.0,101.0,2614,2602,1987,2267,627,335,752,1251,494,925,258,326,48,48,3050,2950,2100,1850,2950,2750,0
529,0,2,104.0,66.0,142.0,101.0,2636,2658,1987,2323,649,335,682,1580,544,1210,138,370,48,48,3175,1350,2100,1850,3150,4450,0
536,0,2,114.0,81.0,142.0,101.0,2580,2709,1931,2351,649,358,332,574,214,260,118,314,48,48,3400,1700,2100,1850,3150,4900,0
543,0,2,118.0,81.0,142.0,101.0,2714,2658,2043,2323,671,335,228,339,159,185,69,154,48,48,3400,1700,2100,1850,3150,4900,0
550,0,2,120.0,86.0,142.0,101.0,2972,2591,2323,2211,649,380,569,301,424,95,145,206,48,48,3700,1700,2100,1850,3150,4900,0
557,0,2,120.0,90.0,150.0,101.0,2776,2642,2127,2239,649,403,865,205,644,155,221,50,48,48,4150,1925,2100,1850,3150,5175,0
564,0,2,118.0,81.0,150.0,109.0,2776,2647,2127,2267,649,380,1180,429,879,335,301,94,48,47,4250,2150,2100,1850,3475,5875,0
570,0,2,118.0,57.0,150.0,109.0,2776,2619,2127,2239,649,380,1180,645,879,515,301,130,48,47,4250,850,2100,1850,3475,7275,0
7,0,0,13.0,13.0,15.0,15.0,251,251,251,251,0,0,30,30,30,30,0,0,12,12,0,0,0,0,0,0,0
14,0,0,14.0,14.0,15.0,15.0,671,671,671,671,0,0,70,70,70,70,0,0,13,13,0,0,0,0,0,0,0
21,0,0,14.0,14.0,15.0,15.0,699,727,699,727,0,0,40,40,40,40,0,0,13,13,0,0,0,0,0,0,0
29,0,0,15.0,15.0,15.0,15.0,671,643,671,643,0,0,75,70,75,70,0,0,14,14,0,0,0,0,0,0,0
36,0,0,15.0,15.0,15.0,15.0,727,699,727,699,0,0,70,40,70,40,0,0,14,14,0,0,0,0,0,0,0
43,0,0,16.0,16.0,23.0,23.0,783,699,783,699,0,0,55,115,55,115,0,0,15,15,0,0,0,0,0,0,0
50,0,0,16.0,16.0,23.0,23.0,783,727,783,727,0,0,15,50,15,50,0,0,15,15,0,0,0,0,0,0,0
57,0,0,17.0,17.0,23.0,23.0,755,721,755,699,0,22,40,24,40,20,0,4,16,16,0,0,0,0,0,0,0
64,0,0,18.0,18.0,23.0,23.0,755,777,755,643,0,134,75,64,75,40,0,24,17,17,0,0,0,0,0,0,0
71,0,0,18.0,18.0,23.0,23.0,749,805,727,671,22,134,104,160,100,120,4,40,17,17,0,0,0,0,0,0,0
79,0,0,19.0,19.0,23.0,23.0,749,827,615,671,134,156,149,215,125,155,24,60,18,18,0,0,0,0,0,0,0
86,0,0,19.0,19.0,23.0,23.0,855,889,587,643,268,246,305,326,245,230,60,96,18,18,0,0,0,0,0,0,0
93,0,0,20.0,19.0,23.0,23.0,922,950,587,615,335,335,160,291,110,155,50,136,19,19,0,0,150,150,0,0,0
100,0,0,20.0,20.0,23.0,23.0,956,1006,643,671,313,335,176,61,90,35,86,26,19,19,0,0,150,150,0,0,0
107,0,0,20.0,20.0,23.0,23.0,934,984,643,671,291,313,37,173,15,115,22,58,19,19,0,0,150,150,0,0,0
114,0,0,21.0,20.0,23.0,23.0,894,984,671,783,223,201,91,298,45,220,46,78,19,19,0,0,150,150,0,0,0
121,0,0,22.0,21.0,31.0,23.0,906,978,727,867,179,111,51,260,35,170,16,90,19,19,100,0,150,150,0,0,0
129,0,0,23.0,22.0,31.0,23.0,1046,1158,867,1091,179,67,195,244,155,200,40,44,20,19,100,100,150,150,0,0,0
136,0,0,23.0,23.0,31.0,23.0,1102,1309,923,1175,179,134,330,354,270,290,60,64,20,20,100,100,150,150,0,0,0
143,0,0,24.0,23.0,31.0,23.0,1242,1348,1063,1147,179,201,454,393,370,305,84,88,21,21,100,100,150,400,0,0,0
150,0,0,24.0,26.0,31.0,31.0,1376,1348,1175,1147,201,201,213,547,105,435,108,112,21,21,100,100,150,400,0,0,0
157,0,0,27.0,27.0,31.0,31.0,1376,1393,1175,1147,201,246,122,250,40,110,82,140,22,22,200,100,400,400,0,0,0
164,0,0,28.0,27.0,31.0,31.0,1398,1275,1175,1007,223,268,126,216,20,90,106,126,23,22,200,200,400,400,0,0,0
171,0,0,28.0,28.0,31.0,31.0,1466,1214,1175,923,291,291,252,237,110,100,142,137,23,23,200,300,400,400,0,0,0
179,0,0,31.0,28.0,31.0,31.0,1443,1270,1175,979,268,291,314,103,165,30,149,73,24,23,300,300,400,400,0,0,0
186,0,0,31.0,32.0,39.0,39.0,1354,1214,1063,923,291,291,155,19,70,10,85,9,24,24,300,300,400,475,0,0,0
193,0,0,33.0,33.0,39.0,39.0,1376,1314,1063,979,313,335,206,124,85,75,121,49,25,25,300,300,500,475,0,0,0
200,0,0,35.0,35.0,39.0,39.0,1544,1482,1231,1147,313,335,202,125,70,40,132,85,26,25,400,300,500,575,0,0,0
207,0,0,35.0,36.0,39.0,39.0,1516,1488,1203,1175,313,313,317,241,145,120,172,121,26,26,400,300,500,575,0,0,0
214,0,0,38.0,36.0,39.0,39.0,1320,1488,1007,1175,313,313,387,331,175,195,212,136,27,26,500,300,575,825,0,0,0
221,0,0,40.0,39.0,54.0,39.0,1449,1488,1091,1175,358,313,221,136,65,85,156,51,27,27,500,650,825,825,0,0,0
229,0,0,43.0,42.0,54.0,54.0,1572,1544,1147,1231,425,313,168,106,60,15,108,91,28,27,500,650,825,825,0,0,0
236,0,0,46.0,42.0,54.0,54.0,1639,1712,1147,1287,492,425,228,313,60,170,168,143,28,27,600,650,825,900,0,0,0
243,0,0,46.0,43.0,54.0,54.0,1690,1723,1175,1231,515,492,338,354,110,155,228,199,28,28,600,750,825,900,0,0,0
250,0,0,49.0,47.0,54.0,54.0,1645,1695,1175,1203,470,492,270,141,65,90,205,51,29,28,900,1025,825,900,0,0,0
257,0,0,52.0,49.0,54.0,54.0,1477,1617,1007,1147,470,470,290,172,25,65,265,107,29,29,1150,1025,825,900,0,0,0
264,0,0,53.0,53.0,62.0,62.0,1555,1589,1063,1119,492,470,440,42,115,0,325,42,30,30,1150,1025,825,900,0,0,0
271,0,0,57.0,55.0,62.0,62.0,2003,1701,1511,1231,492,470,385,122,125,20,260,102,31,31,1250,1125,825,900,0,0,0
279,0,0,60.0,56.0,62.0,62.0,2093,1869,1623,1399,470,470,491,257,175,95,316,162,32,32,1475,1025,825,900,0,100,0
286,0,0,61.0,56.0,62.0,62.0,2166,2026,1651,1511,515,515,576,517,225,295,351,222,33,33,1475,1075,825,900,0,100,0
293,0,0,60.0,56.0,62.0,70.0,2222,1572,1707,1035,515,537,841,687,430,405,411,282,34,34,1475,1425,825,900,100,100,0
300,0,0,62.0,57.0,62.0,70.0,2205,1393,1735,923,470,470,308,675,45,345,263,330,35,34,1750,1600,900,900,100,200,0
307,0,0,62.0,63.0,62.0,70.0,2233,2233,1763,1763,470,470,488,205,165,140,323,65,36,34,1750,1600,900,900,100,200,0
314,0,0,69.0,65.0,70.0,70.0,2311,2261,1819,1791,492,470,433,475,175,350,258,125,36,35,1750,1650,900,900,100,200,0
321,0,0,70.0,66.0,70.0,70.0,2283,2149,1791,1679,492,470,463,220,145,35,318,185,38,36,1850,1700,900,900,100,200,0
329,0,0,73.0,68.0,78.0,70.0,2115,2031,1623,1539,492,492,654,415,280,170,374,245,38,37,1850,1700,900,900,100,200,0
336,0,0,73.0,66.0,78.0,78.0,1970,1964,1455,1427,515,537,799,550,365,245,434,305,40,35,1800,1750,900,900,200,350,0
343,0,0,70.0,67.0,86.0,78.0,1981,1891,1511,1399,470,492,1016,777,530,420,486,357,40,36,1600,2075,900,900,450,350,0
350,0,0,71.0,74.0,86.0,78.0,2009,1953,1539,1483,470,470,996,328,575,240,421,88,42,38,1725,2375,900,900,600,350,0
357,0,0,72.0,76.0,86.0,78.0,2087,1897,1595,1427,492,470,781,278,300,130,481,148,42,38,2025,2375,900,900,600,350,0
364,0,0,77.0,77.0,86.0,78.0,2031,1841,1539,1371,492,470,511,383,120,188,391,195,43,40,2025,2375,900,900,600,350,0
371,0,0,78.0,78.0,86.0,78.0,2065,1869,1595,1399,470,470,562,437,215,199,347,238,45,40,2025,2475,900,900,600,350,0
379,0,0,79.0,80.0,101.0,86.0,2166,2048,1651,1511,515,537,632,561,225,273,407,288,46,41,2025,2475,900,900,600,350,0
386,0,0,85.0,83.0,101.0,86.0,2367,2490,1763,1819,604,671,493,596,135,353,358,243,47,41,2300,2800,900,900,600,350,0
393,0,0,89.0,85.0,101.0,86.0,2782,2552,2155,1903,627,649,326,798,50,483,276,315,47,43,2750,3100,900,900,600,350,0
400,0,0,91.0,87.0,101.0,109.0,2754,2810,2127,2183,627,627,621,749,265,458,356,291,49,45,2800,3100,900,900,600,350,0
407,0,0,92.0,89.0,101.0,109.0,2860,3034,2211,2407,649,627,906,609,470,388,436,221,50,45,2800,2850,1200,900,600,600,0
414,0,0,77.0,74.0,101.0,109.0,2916,3084,2267,2435,649,649,1271,974,755,673,516,301,51,46,2125,1975,1200,900,1550,1800,0
421,0,0,77.0,78.0,101.0,109.0,2916,3140,2267,2491,649,649,447,574,155,318,292,256,52,47,2025,1875,1200,900,2100,1900,0
429,0,0,79.0,78.0,101.0,109.0,2681,3134,1987,2463,694,671,527,965,155,633,372,332,53,47,2025,1875,1200,900,2100,1900,0
436,0,0,84.0,83.0,101.0,109.0,2468,2994,1819,2323,649,671,444,701,75,368,369,333,54,49,2025,2375,1200,900,2100,1900,0
443,0,0,85.0,85.0,101.0,109.0,2978,2782,2351,2155,627,627,686,433,247,228,439,205,56,49,2025,2375,1200,900,2100,1900,0
450,0,0,87.0,91.0,101.0,109.0,3286,2614,2659,1987,627,627,711,643,208,358,503,285,57,51,2525,2650,1450,900,2100,1900,0
457,0,0,90.0,93.0,101.0,109.0,3308,3000,2659,2351,649,649,343,868,69,526,274,342,59,52,2575,2700,1650,900,2100,1900,0
464,0,0,93.0,95.0,101.0,109.0,3230,3112,2603,2463,627,649,294,1138,44,728,250,410,60,54,2800,2700,1650,1150,2100,1900,0
471,0,0,103.0,99.0,117.0,109.0,3633,3414,2939,2743,694,671,254,1094,49,758,205,336,62,56,2850,3200,1950,1150,2100,1900,0
479,0,0,99.0,96.0,117.0,109.0,3829,3661,3135,2967,694,694,614,1479,429,1063,185,416,63,57,2675,2750,2175,1450,2325,2350,0
486,0,0,105.0,99.0,117.0,109.0,4126,3784,3499,3135,627,649,517,1756,464,1268,53,488,65,58,2600,3025,2175,1450,2550,2350,0
493,0,0,109.0,103.0,117.0,109.0,4098,3454,3471,2827,627,627,547,606,414,529,133,77,66,58,2650,3025,2175,1450,2550,2350,0
500,0,0,112.0,107.0,117.0,109.0,4120,3342,3471,2715,649,627,387,282,174,205,213,77,66,58,2750,3300,2175,1450,2550,2350,0
507,0,0,117.0,109.0,117.0,109.0,3700,3728,3051,3079,649,649,682,407,389,350,293,57,68,61,3175,3625,2175,1450,2550,2350,0
514,0,0,117.0,109.0,117.0,109.0,3958,3812,3331,3163,627,649,1308,707,939,570,369,137,70,61,3575,3625,2375,1450,2600,2350,0
521,0,0,125.0,113.0,125.0,117.0,3890,3442,3107,2771,783,671,969,583,729,470,240,113,70,61,3725,3900,2375,1450,2600,2350,0
529,0,0,125.0,113.0,125.0,117.0,3806,3190,3023,2519,783,671,622,749,519,560,103,189,70,61,3825,3900,2375,1450,2600,2350,0
536,0,0,133.0,117.0,133.0,117.0,3398,2922,2659,2295,739,627,520,391,429,280,91,111,71,64,3875,4350,2375,1450,2600,2350,0
543,0,0,140.0,122.0,149.0,141.0,3370,2782,2631,2155,739,627,632,731,449,540,183,191,71,66,4075,4400,2375,1950,2600,2350,0
550,0,0,142.0,124.0,149.0,141.0,3414,2894,2631,2267,783,627,933,996,654,725,279,271,72,67,4075,4400,2375,1950,2600,2350,0
557,0,0,140.0,108.0,157.0,141.0,3364,3034,2603,2295,761,739,985,872,614,605,371,267,74,69,3975,2775,2375,1950,3150,4025,0
564,0,0,142.0,111.0,157.0,141.0,3403,3409,2575,2491,828,918,987,735,524,585,463,150,74,70,4500,2725,2375,1950,3150,4300,0
571,0,0,147.0,117.0,157.0,141.0,3711,3308,2771,2323,940,985,788,485,209,415,579,70,74,70,5025,3050,2375,1950,3150,4300,0
579,0,0,152.0,120.0,157.0,156.0,3571,3174,2631,2211,940,963,751,562,314,530,437,32,74,71,5225,3200,2375,1950,3150,4300,0
586,0,0,157.0,120.0,157.0,156.0,3599,3263,2659,2323,940,940,601,863,169,715,432,148,74,73,5225,3200,2625,2175,3150,4300,0
593,0,0,157.0,124.0,157.0,156.0,3302,3454,2295,2491,1007,963,881,933,329,765,552,168,74,73,5825,3675,2625,2375,3150,4300,0
600,0,0,157.0,128.0,157.0,156.0,3442,3750,2435,2743,1007,1007,1306,858,634,570,672,288,76,75,5775,3825,2625,2375,3200,4625,0
7,1,0,13.0,13.0,14.0,15.0,377,335,377,335,0,0,45,40,45,40,0,0,12,12,0,0,0,0,0,0,0
14,1,0,13.0,14.0,14.0,15.0,643,643,643,643,0,0,15,65,15,65,0,0,13,13,0,0,0,0,0,0,0
21,1,0,14.0,14.0,14.0,15.0,727,615,727,615,0,0,50,30,50,30,0,0,13,13,0,0,0,0,0,0,0
29,1,0,14.0,15.0,14.0,15.0,755,587,755,587,0,0,150,50,150,50,0,0,13,14,0,0,0,0,0,0,0
36,1,0,16.0,15.0,22.0,15.0,783,615,783,615,0,0,140,130,140,130,0,0,14,14,0,0,0,0,0,0,0
43,1,0,17.0,15.0,22.0,23.0,839,671,839,671,0,0,190,60,190,60,0,0,14,15,0,0,0,0,0,0,0
50,1,0,17.0,15.0,22.0,23.0,867,699,867,699,0,0,40,145,40,145,0,0,15,15,0,0,0,0,0,0,0
57,1,0,17.0,16.0,22.0,23.0,811,727,811,727,0,0,135,35,135,35,0,0,16,15,0,0,0,0,0,0,0
64,1,0,17.0,16.0,22.0,23.0,951,755,951,755,0,0,245,80,245,80,0,0,17,15,0,0,0,0,0,0,0
71,1,0,16.0,17.0,22.0,23.0,951,727,951,727,0,0,50,35,50,35,0,0,16,16,0,0,0,0,0,0,0
79,1,0,17.0,18.0,22.0,23.0,951,755,951,755,0,0,115,135,115,135,0,0,16,17,0,0,0,0,0,0,0
86,1,0,17.0,18.0,22.0,23.0,951,783,951,783,0,0,225,230,225,230,0,0,17,17,0,0,0,0,0,0,0
93,1,0,20.0,19.0,22.0,23.0,895,867,895,867,0,0,180,130,180,130,0,0,17,18,0,0,250,150,0,0,0
100,1,0,21.0,20.0,22.0,23.0,699,827,699,783,0,44,80,33,80,25,0,8,16,18,0,0,250,300,0,0,0
107,1,0,21.0,21.0,22.0,23.0,867,906,867,839,0,67,85,146,85,130,0,16,16,18,0,50,250,300,0,0,0
114,1,0,22.0,21.0,22.0,23.0,923,906,923,839,0,67,140,244,140,220,0,24,16,18,150,50,250,300,0,0,0
121,1,0,23.0,22.0,30.0,31.0,643,878,643,811,0,67,229,47,229,15,0,32,17,18,150,100,250,300,0,0,0
129,1,0,24.0,24.0,30.0,31.0,307,827,307,783,0,44,79,181,79,145,0,36,18,18,150,150,250,300,0,0,0
136,1,0,27.0,25.0,30.0,31.0,447,855,447,811,0,44,84,184,84,140,0,44,18,18,300,200,250,300,0,0,0
143,1,0,28.0,27.0,36.0,31.0,699,1018,699,951,0,67,129,67,129,15,0,52,18,19,350,250,250,300,0,0,0
150,1,0,31.0,27.0,36.0,31.0,1007,1169,1007,1035,0,134,44,217,44,145,0,72,18,20,350,250,250,300,0,0,0
157,1,0,32.0,29.0,36.0,31.0,979,1247,979,1091,0,156,104,267,104,175,0,92,18,20,400,300,250,300,0,0,0
164,1,0,33.5,30.0,36.0,31.0,503,1275,503,1119,0,156,59,352,59,240,0,112,18,20,475,350,250,300,25,50,0
171,1,0,33.5,31.0,36.0,39.0,699,1303,699,1147,0,156,154,497,154,365,0,132,18,20,675,400,250,300,25,50,0
179,1,0,35.0,33.0,36.0,39.0,895,1354,895,1175,0,179,54,252,54,200,0,52,18,21,650,450,250,300,50,50,0
186,1,0,35.0,32.0,36.0,39.0,951,1326,951,1147,0,179,189,297,189,225,0,72,18,21,900,400,250,300,50,100,0
193,1,0,35.0,33.0,44.0,39.0,1063,1275,1063,1119,0,156,49,442,49,354,0,88,18,22,800,400,250,400,250,150,0
200,1,0,32.5,33.0,44.0,39.0,1007,1051,1007,895,0,156,14,476,14,368,0,108,18,22,525,400,250,300,525,277,0
207,1,0,32.0,33.0,44.0,39.0,1007,1107,1007,951,0,156,59,511,59,383,0,128,18,22,400,400,250,300,700,327,0
214,1,0,31.5,34.0,52.0,39.0,1007,1107,1007,951,0,156,124,496,124,348,0,148,18,23,475,400,250,300,775,377,0
221,1,0,34.5,34.0,52.0,39.0,839,1107,839,951,0,156,59,571,59,403,0,168,18,23,575,400,250,550,775,377,0
229,1,0,35.0,38.0,52.0,39.0,923,1186,923,1007,0,179,84,244,84,156,0,88,18,24,600,450,250,550,850,377,0
236,1,0,32.0,37.0,52.0,39.0,1063,1163,1063,1007,0,156,114,315,114,211,0,104,18,25,550,350,250,550,1100,527,0
243,1,0,33.5,36.0,52.0,31.0,1007,1051,1007,895,0,156,29,185,29,61,0,124,18,25,575,350,250,550,1175,677,0
250,1,0,34.0,36.0,52.0,31.0,1063,995,1063,839,0,156,109,255,109,161,0,94,18,26,650,500,250,550,1200,677,0
257,1,0,33.0,36.0,52.0,31.0,979,1023,979,867,0,156,104,375,104,261,0,114,17,26,550,500,250,550,1300,677,0
264,1,0,36.0,37.0,52.0,47.0,1035,1191,1035,1035,0,156,24,575,24,441,0,134,17,26,650,500,250,800,1300,677,0
271,1,0,38.0,37.0,52.0,47.0,951,1270,951,1091,0,179,39,315,39,161,0,154,17,26,750,500,250,800,1300,677,0
279,1,0,40.0,38.0,52.0,47.0,1035,1270,1035,1091,0,179,64,465,64,291,0,174,17,27,900,500,250,800,1300,677,0
286,1,0,40.0,41.0,52.0,55.0,962,1191,895,1035,67,156,176,251,164,211,12,40,20,27,950,500,250,900,1300,677,0
293,1,0,43.0,46.0,52.0,55.0,1051,1387,895,1231,156,156,101,186,69,126,32,60,21,28,900,500,250,900,1350,677,0
300,1,0,44.0,47.0,52.0,55.0,1163,1387,1007,1231,156,156,96,281,44,201,52,80,21,29,1000,500,250,900,1400,677,0
307,1,0,46.0,47.0,52.0,55.0,1219,1359,1063,1203,156,156,131,466,59,366,72,100,25,29,1000,500,250,900,1400,677,0
314,1,0,46.0,48.0,52.0,55.0,1331,1387,1175,1231,156,156,206,186,114,66,92,120,26,30,1000,700,250,900,1400,677,0
321,1,0,48.0,52.0,52.0,55.0,1410,1578,1231,1399,179,179,116,191,4,51,112,140,26,30,1000,700,250,900,1400,677,0
329,1,0,48.0,53.0,60.0,55.0,1342,1645,1231,1399,111,246,64,273,44,126,20,147,27,31,1000,1000,250,900,1400,677,0
336,1,0,49.5,53.0,60.0,55.0,1494,1622,1427,1287,67,335,152,414,124,231,28,183,29,31,1125,1000,250,900,1425,677,0
343,1,0,55.5,54.0,60.0,55.0,1494,1706,1427,1371,67,335,70,524,34,351,36,173,30,32,1125,1200,250,900,1425,677,0
350,1,0,55.5,56.0,60.0,70.0,1555,1740,1511,1427,44,313,259,280,219,171,40,109,33,33,1125,1200,250,975,1425,677,0
357,1,0,56.5,56.0,68.0,70.0,1667,1600,1623,1287,44,313,72,375,24,276,48,99,36,33,1125,1200,250,975,1425,677,0
364,1,0,56.5,58.0,68.0,70.0,1774,1902,1707,1567,67,335,240,215,184,76,56,139,36,34,1075,1250,250,975,1475,677,0
371,1,0,58.0,58.0,68.0,70.0,1774,1874,1707,1539,67,335,173,335,109,156,64,179,37,34,1050,1250,250,975,1500,677,0
379,1,0,61.0,60.0,68.0,70.0,1902,1880,1791,1567,111,313,139,366,59,151,80,215,38,35,1050,1250,250,825,1500,827,0
386,1,0,63.0,62.0,68.0,85.0,2087,1762,1931,1427,156,335,184,476,84,271,100,205,39,37,1050,1300,250,825,1500,827,0
393,1,0,63.0,62.0,68.0,85.0,2115,1964,1959,1651,156,313,334,387,214,146,120,241,44,37,1050,1300,375,925,1500,827,0
400,1,0,66.0,65.0,68.0,93.0,2143,1908,1987,1595,156,313,234,357,94,76,140,281,43,38,1050,1350,500,925,1500,827,0
407,1,0,66.0,66.0,84.0,93.0,2166,2216,1987,1903,179,313,89,602,29,281,60,321,41,39,1200,1350,500,1075,1500,827,0
414,1,0,67.0,70.0,84.0,93.0,2199,2210,2043,1875,156,335,300,562,224,201,76,361,45,40,1200,1350,500,1225,1500,827,0
421,1,0,68.0,73.0,84.0,101.0,2255,2294,2099,1959,156,335,410,337,314,136,96,201,47,41,1200,1400,500,1475,1500,827,0
429,1,0,72.0,77.0,90.0,101.0,2199,2317,2043,1959,156,358,375,337,259,96,116,241,48,43,1200,1500,500,1475,1500,827,0
436,1,0,72.0,81.0,98.0,109.0,2451,2513,2295,2043,156,470,570,287,434,36,136,251,51,44,1200,1650,500,1475,1500,827,0
443,1,0,74.0,84.0,98.0,109.0,2552,2451,2239,1959,313,492,508,438,324,131,184,307,51,44,1200,1650,700,1475,1500,827,0
450,1,0,79.0,90.0,106.0,109.0,2670,2317,2155,1847,515,470,483,204,289,41,194,163,50,46,1200,1750,700,1475,1500,827,0
457,1,0,89.0,92.0,114.0,109.0,2860,2681,2323,2099,537,582,318,189,164,46,154,143,54,46,1200,1950,700,1475,1500,827,0
464,1,0,93.0,95.0,114.0,109.0,2838,2938,2323,2267,515,671,464,294,304,71,160,223,54,48,1400,2050,950,1475,1500,827,0
471,1,0,94.5,99.0,114.0,109.0,2877,3034,2407,2407,470,627,556,311,344,41,212,270,54,49,1775,2100,1200,1475,1525,827,0
479,1,0,99.5,104.0,114.0,109.0,2787,3084,2295,2435,492,649,45,536,44,186,1,350,54,51,1775,2550,1200,1475,1525,827,0
486,1,0,101.5,109.0,114.0,117.0,3011,3196,2407,2547,604,649,320,482,264,81,56,401,60,53,2125,2600,1200,1475,1525,827,0
493,1,0,108.5,113.0,114.0,125.0,3224,3392,2575,2743,649,649,350,722,239,266,111,456,61,54,2125,2800,1200,1475,1525,827,0
500,1,0,114.5,116.0,122.0,125.0,3213,3454,2407,2827,806,627,125,563,89,31,36,532,66,55,2225,2900,1200,1475,1525,827,0
507,1,0,120.5,120.0,122.0,133.0,3409,3498,2379,2827,1030,671,135,678,54,66,81,612,66,57,2325,3050,1200,1475,1525,827,0
514,1,0,125.5,121.0,130.0,141.0,3538,3330,2575,2659,963,671,193,898,54,256,139,642,66,58,2425,3150,1200,1475,1525,827,0
521,1,0,127.5,125.0,138.0,141.0,3487,3056,2547,2407,940,649,419,865,214,251,205,614,64,59,2725,3400,1200,1475,1556,827,0
529,1,0,131.5,131.0,138.0,141.0,3319,3112,2491,2463,828,649,409,750,254,156,155,594,65,60,3025,3400,1200,1675,1556,827,0
536,1,0,140.5,132.0,146.0,141.0,3347,3000,2519,2351,828,649,239,706,159,136,80,570,67,61,3225,3450,1200,1675,1556,827,0
543,1,0,138.5,134.0,146.0,149.0,3560,3034,2687,2407,873,627,624,967,452,321,172,646,67,62,3525,3550,1200,1825,1680,827,0
550,1,0,134.5,136.0,154.0,149.0,3694,3034,2687,2407,1007,627,995,868,707,254,288,614,67,62,3775,3650,1200,1975,1930,989,0
557,1,0,147.5,136.0,154.0,157.0,3588,3162,2603,2491,985,671,347,803,97,109,250,694,67,63,3775,3600,1200,1975,1930,1089,0
564,1,0,146.5,141.0,154.0,157.0,3375,3140,2435,2491,940,649,499,734,237,64,262,670,65,64,3775,3850,1200,2125,1930,1089,0
571,1,0,153.5,146.0,162.0,157.0,3403,3280,2463,2631,940,649,424,705,192,159,232,546,66,64,4375,4000,1200,2225,1930,1089,0
579,1,0,158.5,148.0,170.0,165.0,3627,3610,2687,2939,940,671,429,590,127,64,302,526,67,64,4375,3900,1200,2225,1930,1239,0
586,1,0,167.5,152.0,178.0,165.0,3610,3560,2603,2911,1007,649,254,911,82,309,172,602,66,64,4675,4500,1200,2675,1930,1239,0
593,1,0,167.5,152.0,186.0,165.0,3728,3538,2743,2911,985,627,306,517,172,214,134,303,67,64,4975,4500,1200,2675,1930,1239,0
600,1,0,170.5,165.0,186.0,165.0,3666,3610,2659,2939,1007,671,487,392,237,59,250,333,67,64,5175,5100,1450,2900,1930,1239,0
607,1,0,169.5,165.0,194.0,165.0,3672,3526,2687,2855,985,671,363,172,247,59,116,113,69,64,5575,5225,1575,2900,1930,1239,0
614,1,0,170.5,157.0,202.0,165.0,3571,3538,2631,2911,940,627,635,209,407,74,228,135,67,65,5575,4425,1575,2900,2030,2039,0
621,1,0,176.5,166.0,202.0,173.0,3431,3448,2491,2799,940,649,305,364,182,74,123,290,67,65,5575,5075,1575,2900,2030,2039,0
629,1,0,176.5,170.0,202.0,173.0,3504,3728,2519,3079,985,649,715,415,472,99,243,316,71,65,5575,5125,1575,2900,2030,2039,0
636,1,0,186.5,173.0,200.0,181.0,3498,3728,2491,3079,1007,649,640,565,352,194,288,371,76,65,5575,5275,1825,2900,2130,2039,0
643,1,0,187.5,177.0,200.0,189.0,3661,3622,2631,2995,1030,627,627,646,377,224,250,422,75,66,5575,6050,1825,2900,2130,2039,0
650,1,0,186.5,185.0,200.0,197.0,3700,3767,2715,3051,985,716,944,589,582,304,362,285,77,66,5575,6225,1825,2900,2130,2039,0
657,1,0,186.5,189.0,200.0,205.0,3683,3790,2743,3051,940,739,991,397,517,49,474,348,79,66,5875,6325,1825,2900,2130,2039,0
664,1,0,193.5,190.0,208.0,213.0,3823,3801,2883,3107,940,694,866,758,472,334,394,424,79,66,5875,6550,1825,2900,2130,2039,0
671,1,0,193.5,195.0,208.0,221.0,3907,3767,2967,3051,940,716,1456,896,942,434,514,462,79,66,5875,6775,1825,2900,1905,2039,0
679,1,0,193.5,200.0,216.0,221.0,4170,3851,3163,3135,1007,716,1976,1095,1342,599,634,496,79,66,5875,7450,2175,2900,1905,2039,0
686,1,0,190.5,200.0,224.0,221.0,3812,3521,2827,2827,985,694,2073,1479,1377,899,696,580,76,66,6475,7500,2175,2900,1905,2039,0
693,1,0,188.5,200.0,224.0,221.0,3028,3157,2043,2463,985,694,2415,1543,1607,879,808,664,74,66,6475,7750,2175,2900,2005,2039,0
700,1,0,197.5,196.0,224.0,221.0,2518,3034,1623,2295,895,739,1854,1461,1342,709,512,752,74,66,6575,7700,2175,2900,2005,2339,0
707,1,0,198.5,200.0,224.0,221.0,2815,2933,1987,2239,828,694,2262,1446,1654,664,608,782,75,66,6575,7600,2425,2900,2005,2439,0
714,1,0,198.5,199.0,224.0,221.0,3627,2989,2799,2295,828,694,2125,1605,1559,789,566,816,80,66,6575,7350,2425,2900,2005,2689,0
721,1,0,191.5,195.0,224.0,221.0,3750,3006,2855,2267,895,739,2573,1958,1899,1054,674,904,79,66,6875,7150,2425,2900,2305,2889,0
729,1,0,189.5,168.0,224.0,221.0,4030,3067,3135,2351,895,716,2256,2327,1674,1339,582,988,79,66,5375,6075,2425,2900,3805,4314,0
736,1,0,191.5,164.0,224.0,236.0,4086,3022,3191,2351,895,671,2441,1992,1884,1099,557,893,79,66,5375,5550,2425,2900,3805,5039,0
743,1,0,189.5,163.0,224.0,236.0,4165,2894,3247,2155,918,739,2429,940,2039,509,390,431,79,66,5375,5350,2425,3350,3805,5239,0
750,1,0,189.5,166.0,224.0,236.0,3896,2810,3023,2071,873,739,2179,1133,1789,664,390,469,75,69,5775,5350,2425,3350,3805,5314,0
757,1,0,189.5,171.0,224.0,236.0,4014,2681,2939,1987,1075,694,2074,1019,1844,599,230,420,75,69,6375,5825,2425,3350,3805,5314,0
764,1,0,196.5,171.0,224.0,236.0,3991,2709,2827,2015,1164,694,1847,1342,1769,834,78,508,75,70,6375,6125,2425,3350,3805,5314,0
771,1,0,196.5,179.0,224.0,236.0,4036,2759,2715,2043,1321,716,2032,1241,1944,724,88,517,76,71,6375,6125,2425,3775,3805,5314,0
779,1,0,199.5,186.0,224.0,236.0,4053,2966,2687,2295,1366,671,1907,351,1759,129,148,222,76,71,6675,6375,2425,3925,3805,5314,0
786,1,0,193.5,187.0,224.0,236.0,3997,2742,2631,2071,1366,671,2285,439,1989,154,296,285,74,72,6925,6275,3025,3925,4005,5464,0
793,1,0,191.5,186.0,230.0,236.0,4120,2950,2799,2211,1321,739,2847,812,2499,439,348,373,75,73,6875,6550,3025,3925,4099,5514,0
800,1,0,196.5,193.0,230.0,236.0,4025,3381,2771,2687,1254,694,2730,282,2634,229,96,53,74,73,7175,6600,3025,3925,4099,5564,0
807,1,0,196.5,193.0,230.0,236.0,3941,3465,2687,2771,1254,694,3195,531,2939,394,256,137,74,73,7175,7550,3150,3925,4099,5564,0
814,1,0,187.5,190.0,222.0,236.0,3907,3426,2631,2687,1276,739,3660,939,3244,714,416,225,69,73,7075,7400,3350,3925,4630,5714,0
821,1,0,191.5,198.0,208.0,236.0,4002,3683,2659,2967,1343,716,3080,773,2904,639,176,134,69,73,6775,7525,3350,3925,5380,5714,0
829,1,0,194.5,200.0,208.0,236.0,3946,3554,2603,2883,1343,671,3097,378,2769,314,328,64,69,73,7375,8350,3350,3925,5380,5714,0
836,1,0,193.5,200.0,208.0,236.0,3862,3846,2519,2883,1343,963,3134,856,2854,664,280,192,71,73,7375,8400,3350,3925,5380,5714,0
843,1,0,193.5,200.0,208.0,236.0,3739,3762,2463,2687,1276,1075,3572,1294,3144,974,428,320,71,73,7975,8750,3350,3925,5380,5714,0
850,1,0,195.5,200.0,208.0,251.0,3829,3745,2575,2715,1254,1030,3843,940,3559,504,284,436,72,73,7825,9075,3350,3925,5255,5714,0
857,1,0,193.5,199.0,208.0,251.0,3857,3655,2603,2603,1254,1052,4213,1379,3819,819,394,560,72,73,7725,9025,3350,3925,5355,5764,0
864,1,0,194.5,196.0,208.0,251.0,3952,3767,2631,2715,1321,1052,4553,1828,4099,1144,454,684,72,73,8325,8875,3350,3925,5355,5914,0
871,1,0,194.5,196.0,208.0,251.0,4030,3582,2687,2575,1343,1007,5028,1433,4414,629,614,804,72,73,8425,8875,3350,3925,5355,5914,0
879,1,0,194.5,196.0,208.0,251.0,4086,3358,2743,2351,1343,1007,5526,1192,4764,514,762,678,72,73,8425,8875,3350,3925,5355,5914,0
886,1,0,196.5,194.0,208.0,251.0,4064,3482,2743,2407,1321,1075,5383,1610,4569,804,814,806,72,73,8475,8775,3350,3925,5455,6014,0
893,1,0,195.5,192.0,208.0,251.0,4053,3431,2799,2379,1254,1052,5871,1999,4909,1069,962,930,71,73,8475,8675,3350,3925,5455,6114,0
900,1,0,195.5,200.0,208.0,266.0,3829,3302,2575,2295,1254,1007,6311,1765,5189,894,1122,871,71,73,8475,8675,3350,3925,5455,6114,0
907,1,0,199.5,200.0,208.0,266.0,3857,3314,2603,2239,1254,1075,6351,1618,5069,619,1282,999,71,73,8475,8675,3350,3925,5455,6114,0
914,1,0,196.5,200.0,208.0,266.0,3834,2933,2491,1903,1343,1030,6796,1748,5354,629,1442,1119,68,73,8775,8775,3350,3925,5455,6114,0
921,1,0,192.5,193.0,208.0,281.0,3857,2832,2491,1847,1366,985,7256,2198,5654,959,1602,1239,72,72,8575,8700,3350,4125,5655,6489,0
929,1,0,159.5,158.0,208.0,296.0,3862,2765,2519,1735,1343,1030,7695,2546,5949,1179,1746,1367,72,72,6325,6600,3350,4125,7905,8864,0
936,1,0,174.5,167.0,208.0,296.0,3784,2871,2463,1819,1321,1052,6386,840,4934,299,1452,541,72,72,5825,6175,3600,4225,8130,9289,0
943,1,0,174.5,168.0,208.0,326.0,3745,2742,2491,1735,1254,1007,6319,750,4819,214,1500,536,72,70,5825,6175,3600,4325,8130,9389,0
950,1,0,177.5,169.0,208.0,326.0,3605,2899,2351,1847,1254,1052,6324,654,4864,119,1460,535,72,69,6075,6175,3750,4325,8230,9439,0
957,1,0,176.5,169.0,208.0,326.0,3756,2961,2435,1987,1321,974,6784,1004,5164,359,1620,645,71,70,7425,6175,3750,4425,8230,9439,0
964,1,0,171.5,171.0,208.0,326.0,3890,2642,2547,1791,1343,851,7499,489,5719,119,1780,370,71,70,7025,7675,3750,4525,8599,9989,0
971,1,0,192.5,174.0,208.0,326.0,3784,2670,2463,1819,1321,851,6072,488,4944,139,1128,349,71,70,7475,7950,3750,4525,8599,9989,0
979,1,0,191.5,176.0,208.0,326.0,3806,2804,2463,1931,1343,873,6248,426,4964,119,1284,307,70,70,7475,8225,3750,4525,8599,9989,0
986,1,0,189.5,178.0,208.0,326.0,3661,2916,2407,2043,1254,873,6907,490,5479,204,1428,286,70,71,9175,8225,3750,4525,8749,9989,0
993,1,0,185.5,179.0,208.0,326.0,3689,3000,2435,2127,1254,873,6752,305,5364,169,1388,136,70,70,8275,9050,3750,4525,9649,10139,0
1000,1,0,190.5,181.0,208.0,326.0,3633,3302,2379,2407,1254,895,6392,338,4994,219,1398,119,70,70,7975,9325,3750,4525,9949,10139,0
1007,1,0,190.5,183.0,214.0,326.0,3784,3420,2463,2547,1321,873,6552,468,4994,374,1558,94,70,70,7975,9325,3750,4525,9949,10139,0
1014,1,0,190.5,184.0,214.0,326.0,3549,3482,2183,2631,1366,851,6812,433,5094,389,1718,44,67,70,8375,9350,3750,4425,9949,10489,0
1021,1,0,178.5,182.0,222.0,326.0,3610,3510,2267,2659,1343,851,7216,851,5354,699,1862,152,70,70,8075,9625,3750,4425,10849,10864,0
1029,1,0,194.0,170.0,222.0,326.0,3308,3476,1987,2603,1321,873,6102,1005,4584,874,1518,131,70,70,7700,8850,3750,4425,11224,11914,0
1036,1,0,192.5,176.0,222.0,326.0,3437,3510,2183,2659,1254,851,6270,793,4604,736,1666,57,70,70,7075,9200,3750,4425,11849,12014,0
1043,1,0,194.5,173.0,222.0,326.0,3325,3420,2071,2547,1254,873,6420,187,4594,107,1826,80,70,70,7175,8825,3750,4425,12149,12664,0
1050,1,0,196.5,175.0,222.0,326.0,3370,3386,2071,2491,1299,895,6170,160,4384,85,1786,75,80,70,8125,8825,3750,4425,12149,12664,0
1057,1,0,191.5,180.0,222.0,326.0,3246,3454,1903,2603,1343,851,6580,573,4634,398,1946,175,79,70,7925,9650,3750,4425,12499,12664,0
1064,1,0,192.5,174.0,222.0,326.0,3308,3370,1987,2519,1321,851,5966,577,4097,423,1869,154,77,70,7125,8900,3750,4425,13486,13939,0
1071,1,0,177.0,175.0,214.0,311.0,3582,3538,2239,2687,1343,851,6407,661,4382,453,2025,208,77,70,5700,8700,3750,4425,14911,14789,0
1079,1,0,176.5,173.0,214.0,311.0,3683,3398,2407,2547,1276,851,6400,506,4227,348,2173,158,77,67,5325,8675,3750,4325,15486,15489,0
1086,1,0,173.5,179.0,220.0,311.0,3913,3140,2659,2379,1254,761,6886,274,4557,178,2329,96,77,67,5925,8900,3750,4325,15786,15489,0
1093,1,0,175.5,179.0,220.0,311.0,3885,2709,2631,1903,1254,806,6656,435,4367,243,2289,192,77,68,5675,9300,3750,4225,16086,15639,0
1100,1,0,185.5,184.0,228.0,311.0,4092,2770,2659,1987,1433,783,5451,228,3732,98,1719,130,77,68,5225,9650,3750,4225,16836,15639,0
1107,1,0,193.5,186.0,228.0,311.0,4159,3067,2547,2239,1612,828,4908,421,3422,283,1486,138,80,69,5625,9825,3750,4425,16886,15639,0
1114,1,0,193.5,191.0,228.0,311.0,4092,3308,2435,2435,1657,873,5377,513,3707,313,1670,200,80,69,5725,10300,3750,4425,16886,15639,0
1121,1,0,193.0,199.0,228.0,311.0,3734,3280,2099,2295,1635,985,5300,349,3692,183,1608,166,80,69,7900,10475,3750,4525,16961,15639,0
1129,1,0,199.5,199.0,228.0,311.0,3706,3381,2183,2239,1523,1142,5391,768,3607,458,1784,310,80,69,8475,10750,3750,4525,16986,15639,0
1136,1,0,200.0,199.0,234.0,311.0,3986,3616,2463,2407,1523,1209,5352,1208,3422,758,1930,450,80,69,7950,11250,3750,4525,17511,15639,0
1143,1,0,196.5,200.0,234.0,311.0,4092,3594,2603,2407,1489,1187,5608,608,3492,393,2116,215,80,69,7975,10925,3750,4525,17936,16314,0
1150,1,0,192.5,200.0,234.0,311.0,3986,3538,2631,2351,1355,1187,6078,1033,3802,678,2276,355,79,69,7825,11125,3750,4525,18086,16314,0
1157,1,0,191.0,179.0,234.0,296.0,4064,3207,2743,2211,1321,996,5509,1018,3277,678,2232,340,79,44,6550,11075,3750,4525,18686,18398,0
1164,1,0,181.0,176.0,226.0,296.0,4002,2115,2659,1399,1343,716,4962,1253,2982,833,1980,420,79,43,5700,11075,3750,4425,19711,18823,0
1171,1,0,180.5,189.0,226.0,296.0,3840,1998,2519,1259,1321,739,5118,322,2982,68,2136,254,79,43,5975,11700,3750,4425,19736,18948,0
1179,1,0,176.5,189.0,226.0,296.0,3605,1880,2351,1231,1254,649,4996,579,2987,178,2009,401,79,43,6925,11825,3750,4425,19936,18998,0
1186,1,0,197.5,192.0,226.0,296.0,3633,1858,2379,1231,1254,627,4136,390,2142,63,1994,327,78,43,7525,11775,3750,4425,19936,18998,0
1193,1,0,192.5,194.0,226.0,296.0,3734,1925,2435,1231,1299,694,4576,632,2422,213,2154,419,78,43,7825,12375,3750,4425,20336,18998,0
1200,1,0,193.5,198.0,226.0,296.0,4002,2138,2659,1399,1343,739,4706,345,2392,88,2314,257,78,43,7875,12825,3750,4425,20811,18998,0
1207,1,0,197.5,197.0,218.0,296.0,4092,2210,2771,1427,1321,783,4489,431,2027,103,2462,328,78,43,7525,12725,3750,4325,21886,19298,0
1214,1,0,185.0,197.0,218.0,296.0,4142,2266,2799,1483,1343,783,3965,684,1847,268,2118,416,78,43,7000,12850,3750,4225,22761,19398,0
1221,1,0,173.5,192.0,212.0,296.0,3650,2182,2351,1399,1299,783,3222,937,1202,433,2020,504,78,43,5425,12600,3750,4125,25142,19748,0
1229,1,0,166.0,191.0,212.0,281.0,3269,1863,2015,1147,1254,716,2459,1126,637,545,1822,581,77,43,4550,13575,3750,4125,27142,20579,0
1236,1,0,178.0,194.0,212.0,266.0,3185,1286,1931,727,1254,559,1794,1100,362,480,1432,620,77,43,4700,13575,3750,4125,27142,21129,0
1243,1,0,177.0,194.0,212.0,266.0,3280,995,1959,503,1321,492,2189,1210,597,530,1592,680,77,43,5700,13575,3750,4025,27242,21229,0
1250,1,0,166.5,173.0,212.0,266.0,3420,1186,2099,671,1321,515,2310,999,762,380,1548,619,74,36,5525,11925,3600,4025,27642,23229,0
1257,1,0,164.5,155.0,218.0,266.0,3106,1135,1875,643,1231,492,1475,746,170,125,1305,621,74,36,4425,10450,3600,4025,28704,24954,0
1264,1,0,154.5,143.0,212.0,251.0,3140,889,1931,419,1209,470,1504,757,155,80,1349,677,74,36,4025,9050,3600,4025,29904,26979,0
1271,1,0,152.5,120.0,212.0,251.0,2882,1230,1875,783,1007,447,1072,765,115,40,957,725,74,36,4025,6025,3475,4025,30347,30179,0
1279,1,0,149.5,121.0,212.0,251.0,2709,1230,1903,783,806,447,1257,856,300,75,957,781,72,36,4875,6675,2875,4025,31147,30179,0
1286,1,0,150.0,116.0,212.0,251.0,2614,1135,1875,811,739,324,1409,840,460,25,949,815,72,36,5150,6225,2875,4025,31172,30679,0
1293,1,0,161.0,115.0,212.0,251.0,2709,1051,1903,783,806,268,736,861,95,10,641,851,72,36,5850,6075,2875,4025,31222,30979,0
1300,1,0,159.0,115.0,212.0,251.0,2580,1079,1819,811,761,268,1016,998,295,115,721,883,72,36,6050,6075,2875,4025,31322,30979,0
1307,1,0,152.5,119.0,212.0,251.0,2502,1264,1819,951,683,313,1324,919,525,25,799,894,72,36,5925,6225,2875,4025,31647,30979,0
1314,1,0,154.5,121.0,212.0,251.0,2222,1488,1651,1175,571,313,736,995,15,65,721,930,72,36,6725,6325,2875,4025,31647,30979,0
1321,1,0,153.5,123.0,212.0,251.0,2266,1522,1707,1231,559,291,1023,1072,230,110,793,962,71,36,6725,6325,2875,4025,31647,30979,0
1329,1,0,143.5,122.0,212.0,251.0,2132,1527,1651,1259,481,268,1567,1084,720,115,847,969,67,36,6125,6275,2875,4025,32447,31304,0
1336,1,0,156.0,116.0,212.0,251.0,2272,1527,1847,1259,425,268,954,1266,55,265,899,1001,67,30,5700,6425,2875,4025,32872,31604,0
1343,1,0,145.5,117.0,212.0,251.0,2210,1499,1763,1231,447,268,1221,847,270,60,951,787,67,30,4875,6225,2875,4025,33697,31804,0
1350,1,0,147.0,112.0,212.0,251.0,2244,1516,1819,1203,425,313,770,1023,125,200,645,823,67,30,4900,6100,2875,4025,33922,32104,0
1357,1,0,144.0,115.0,212.0,251.0,2143,1432,1763,1119,380,313,1029,814,340,80,689,734,67,30,5650,6050,2875,4025,34072,32154,0
1364,1,0,151.5,118.0,212.0,251.0,2199,1303,1819,1035,380,268,891,807,150,45,741,762,67,30,6025,6100,2875,4025,34097,32154,0
1371,1,0,149.5,117.0,212.0,251.0,2250,911,1847,643,403,268,974,863,285,65,689,798,67,32,6225,6600,2875,4025,34197,32254,0
1379,1,0,152.5,116.0,212.0,251.0,2390,939,1987,671,403,268,601,970,10,140,591,830,67,33,6275,6600,2875,4025,34547,32304,0
1386,1,0,152.5,120.0,212.0,251.0,2406,1158,1959,867,447,291,688,901,95,60,593,841,65,33,6275,6925,2875,4025,34647,32304,0
1393,1,0,152.5,121.0,218.0,251.0,2132,1656,1763,1343,369,313,907,972,280,95,627,877,66,33,6275,6825,2875,4025,34647,32404,0
1400,1,0,152.5,123.0,218.0,251.0,2065,1712,1819,1399,246,313,1171,798,520,10,651,788,68,33,6825,6725,2875,4025,34647,32504,0
1407,1,0,165.5,121.0,218.0,251.0,2815,1695,2547,1427,268,268,877,951,190,135,687,816,68,33,6975,6950,2875,4025,34647,32654,0
1414,1,0,165.5,121.0,218.0,251.0,3151,1723,2883,1455,268,268,959,1143,240,295,719,848,68,34,6975,7050,2875,4025,34647,32654,0
1421,1,0,165.5,128.0,218.0,251.0,3258,1723,2967,1455,291,268,1355,659,600,25,755,634,68,34,7625,7050,2875,4025,34647,32654,0
1429,1,0,179.5,130.0,218.0,251.0,3280,1578,2967,1287,313,291,586,735,195,65,391,670,67,34,7625,7325,2875,4025,34647,32654,0
1436,1,0,178.5,130.0,218.0,251.0,3308,1158,2995,867,313,291,977,856,550,150,427,706,67,36,7575,7325,2875,4025,34697,32654,0
1443,1,0,176.5,130.0,210.0,251.0,3291,990,3023,699,268,291,1370,685,915,72,455,613,67,37,8425,7150,2875,4025,34997,32929,0
1450,1,0,193.5,130.0,210.0,251.0,3403,1410,3135,1119,268,291,631,849,240,200,391,649,67,37,8225,7700,2875,4025,35197,32929,0
1457,1,0,192.5,132.0,210.0,251.0,3342,1359,3051,1091,291,268,1037,667,610,115,427,552,67,37,8175,7700,2875,4025,35247,32929,0
1464,1,0,192.5,134.0,210.0,251.0,3459,1494,3191,1203,268,291,1439,562,980,99,459,463,67,37,9325,7700,2875,4025,35247,32929,0
1471,1,0,196.5,134.0,210.0,251.0,3286,1858,2995,1567,291,291,1445,774,1000,275,445,499,67,37,9025,7975,2875,4025,35547,32929,0
1479,1,0,163.5,122.0,210.0,251.0,3420,1858,3107,1567,313,291,1846,1000,1365,465,481,535,67,37,7175,6500,2875,4025,37322,34404,0
7,2,1,13.0,13.0,15.0,14.0,293,293,293,293,0,0,35,35,35,35,0,0,12,12,0,0,0,0,0,0,0
14,2,1,14.0,13.0,15.0,14.0,615,671,615,671,0,0,60,20,60,20,0,0,13,13,0,0,0,0,0,0,0
21,2,1,14.0,14.0,15.0,14.0,643,727,643,727,0,0,35,50,35,50,0,0,13,13,0,0,0,0,0,0,0
29,2,1,15.0,14.0,15.0,14.0,615,727,615,727,0,0,55,145,55,145,0,0,14,13,0,0,0,0,0,0,0
36,2,1,15.0,16.0,15.0,22.0,699,755,699,755,0,0,155,145,155,145,0,0,14,14,0,0,0,0,0,0,0
43,2,1,16.0,16.0,23.0,22.0,643,755,643,755,0,0,25,230,25,230,0,0,15,14,0,0,0,0,0,0,0
50,2,1,17.0,15.0,23.0,22.0,699,755,699,755,0,0,70,25,70,25,0,0,16,15,0,0,0,0,0,0,0
57,2,1,18.0,17.0,23.0,22.0,783,839,783,839,0,0,45,25,45,25,0,0,17,15,0,0,0,0,0,0,0
64,2,1,18.0,18.0,23.0,22.0,923,895,923,895,0,0,150,85,150,85,0,0,17,16,0,0,0,0,0,0,0
71,2,1,19.0,17.0,23.0,22.0,867,895,867,895,0,0,200,160,200,160,0,0,18,17,0,0,0,0,0,0,0
79,2,1,19.0,17.0,23.0,22.0,917,979,895,979,22,0,309,30,305,30,4,0,18,16,0,0,0,0,0,0,0
86,2,1,20.0,18.0,23.0,22.0,967,979,923,979,44,0,383,95,375,95,8,0,19,16,0,0,0,0,0,0,0
93,2,1,20.0,19.0,23.0,22.0,995,979,951,979,44,0,96,150,80,150,16,0,20,17,0,0,150,0,0,0,0
100,2,1,20.0,20.0,23.0,22.0,1040,1046,951,979,89,67,73,232,45,220,28,12,20,18,0,0,150,0,0,0,0
107,2,1,21.0,20.0,23.0,22.0,1062,1057,951,923,111,134,145,343,105,315,40,28,20,19,0,0,150,0,0,0,0
114,2,1,21.0,20.0,23.0,22.0,1062,1079,951,923,111,156,101,373,45,325,56,48,21,20,0,0,150,0,0,0,0
121,2,1,22.0,22.0,23.0,28.0,1051,1074,895,895,156,179,126,343,50,275,76,68,21,20,0,0,150,250,0,0,0
129,2,1,23.0,26.0,23.0,36.0,1102,995,923,839,179,156,211,209,115,125,96,84,22,20,0,0,150,250,0,0,0
136,2,1,25.0,28.0,31.0,36.0,1118,1029,895,895,223,134,209,45,110,45,99,0,22,20,0,0,300,250,0,0,0
143,2,1,26.0,29.0,31.0,36.0,1258,1018,923,951,335,67,209,128,120,120,89,8,23,20,0,100,300,250,0,0,0
150,2,1,26.0,30.0,31.0,36.0,1258,1018,923,951,335,67,59,201,30,185,29,16,23,22,0,100,300,250,0,0,0
157,2,1,29.0,32.0,31.0,36.0,1242,1158,951,1091,291,67,76,249,40,225,36,24,24,24,125,250,300,250,0,0,0
164,2,1,31.0,31.0,46.0,36.0,1320,1219,1007,1175,313,44,136,103,60,75,76,28,25,23,125,400,300,250,0,0,0
171,2,1,32.0,33.0,46.0,36.0,1292,1359,979,1315,313,44,237,116,125,80,112,36,26,25,125,400,300,250,0,0,0
179,2,1,34.0,33.5,46.0,36.0,1348,1382,1035,1315,313,67,347,119,195,75,152,44,28,25,250,375,300,250,0,25,0
186,2,1,34.0,34.5,46.0,36.0,1370,1242,1035,1175,335,67,92,162,50,110,42,52,28,25,125,325,550,250,125,75,0
193,2,1,36.0,35.5,46.0,36.0,1634,1382,1343,1315,291,67,184,275,110,215,74,60,30,25,125,375,550,250,125,75,0
200,2,1,37.0,39.5,46.0,44.0,1701,1466,1455,1399,246,67,187,253,85,185,102,68,31,27,125,375,550,250,125,75,0
207,2,1,38.0,39.5,46.0,44.0,1796,1527,1595,1483,201,44,141,262,115,190,26,72,32,27,125,525,550,250,125,75,0
214,2,1,39.0,40.5,46.0,44.0,1869,1544,1623,1455,246,89,158,179,100,95,58,84,33,30,300,525,550,250,125,75,0
221,2,1,40.0,41.5,46.0,52.0,1813,1611,1567,1455,246,156,176,324,90,220,86,104,34,32,300,525,550,250,125,75,0
229,2,1,41.0,44.5,46.0,52.0,1869,1667,1623,1511,246,156,249,269,135,145,114,124,35,33,300,525,550,250,125,75,0
236,2,1,43.0,45.5,46.0,58.0,1958,1751,1735,1595,223,156,237,424,95,280,142,144,36,36,300,525,800,250,125,75,0
243,2,1,44.0,50.5,46.0,66.0,2009,1774,1763,1483,246,291,330,294,160,110,170,184,37,38,300,525,800,250,125,75,0
250,2,1,45.0,50.5,54.0,66.0,1930,1874,1707,1539,223,335,509,414,315,190,194,224,38,38,300,525,950,450,125,75,0
257,2,1,49.0,58.5,62.0,66.0,1981,1936,1735,1623,246,313,402,260,230,100,172,160,38,38,550,775,1100,450,125,75,0
264,2,1,51.0,61.5,62.0,82.0,2003,2104,1735,1791,268,313,533,375,350,175,183,200,39,38,800,775,1250,450,125,75,0
271,2,1,54.0,66.5,62.0,82.0,2082,2182,1791,1847,291,335,424,380,280,140,144,240,39,38,925,875,1250,450,125,75,0
279,2,1,59.0,67.5,70.0,82.0,2132,2154,1819,1819,313,335,429,100,245,45,184,55,39,36,925,1275,1250,450,125,75,0
286,2,1,59.0,66.5,70.0,74.0,2132,2020,1819,1707,313,313,689,331,465,240,224,91,41,35,1300,1675,1250,450,125,175,0
293,2,1,63.0,70.5,70.0,74.0,2216,1986,1903,1651,313,335,384,226,295,170,89,56,41,35,1300,1875,1250,450,125,175,0
300,2,1,63.0,70.5,70.0,74.0,2160,2070,1735,1735,425,335,595,461,450,365,145,96,41,35,1425,1975,1250,700,0,175,0
307,2,1,69.0,70.5,70.0,82.0,2306,1880,1679,1567,627,313,530,667,355,535,175,132,43,38,1675,1975,1250,825,0,175,0
314,2,1,70.0,79.5,70.0,82.0,2362,1740,1735,1427,627,313,812,192,565,120,247,72,45,38,1675,1975,1250,825,0,175,0
321,2,1,70.0,79.5,70.0,82.0,2356,2014,1707,1679,649,335,483,422,160,310,323,112,45,40,1675,1975,1250,825,0,175,0
329,2,1,70.0,81.5,70.0,82.0,2468,2126,1819,1791,649,335,418,292,115,140,303,152,46,40,1675,2325,1250,825,0,175,0
336,2,1,70.0,81.5,70.0,82.0,2502,2272,1875,1959,627,313,604,353,225,215,379,138,46,41,1675,2325,1250,825,0,175,0
343,2,1,75.0,83.5,86.0,98.0,2474,2238,1847,1903,627,335,900,403,445,225,455,178,46,41,1675,2325,1250,825,0,175,0
350,2,1,76.0,88.5,86.0,106.0,2468,2272,1819,1959,649,313,900,372,365,170,535,202,46,42,1675,2325,1250,825,0,175,0
357,2,1,80.0,95.5,94.0,114.0,2546,2272,1875,1959,671,313,700,242,185,75,515,167,48,47,1825,2325,1250,825,0,175,0
364,2,1,78.0,96.5,94.0,114.0,2474,2266,1847,1931,627,335,892,377,305,170,587,207,49,50,1700,2325,1550,825,0,175,0
371,2,1,83.0,101.5,102.0,114.0,2530,2406,1903,2071,627,335,630,402,225,155,405,247,50,51,2200,2325,1550,1075,0,175,0
379,2,1,87.0,104.5,102.0,122.0,2474,2244,1847,1931,627,313,441,228,210,95,231,133,51,52,2825,2625,1650,1275,0,175,0
386,2,1,82.0,104.5,102.0,122.0,2507,2406,1903,2071,604,335,378,473,225,300,153,173,51,56,2700,2675,1650,1275,250,225,0
393,2,1,76.0,103.0,117.0,122.0,2451,2770,1847,2435,604,335,675,613,450,450,225,163,52,59,2325,2500,1750,1275,625,400,0
400,2,1,76.0,111.5,117.0,122.0,2535,2866,1931,2575,604,291,987,455,690,385,297,70,52,61,2325,2425,1750,1150,625,475,0
407,2,1,83.0,109.5,117.0,122.0,2647,2546,2043,2323,604,223,899,743,580,645,319,98,52,61,2575,2475,2050,1150,625,575,0
414,2,1,91.0,118.5,117.0,122.0,2602,2888,2043,2575,559,313,232,248,145,110,87,138,54,60,2575,2975,2050,1150,625,575,0
421,2,1,94.0,119.5,117.0,122.0,2726,3179,2099,2687,627,492,423,353,260,155,163,198,55,60,1875,2975,2050,1150,625,575,0
429,2,1,103.0,118.5,117.0,122.0,2899,3101,2295,2631,604,470,195,429,135,325,60,104,57,67,2775,2975,2050,1150,625,575,0
436,2,1,104.0,120.5,117.0,122.0,2983,3347,2379,2855,604,492,411,584,275,420,136,164,58,68,3300,2975,2350,1150,625,575,0
443,2,1,108.0,120.5,117.0,122.0,2961,3381,2379,2911,582,470,364,780,210,560,154,220,60,70,3675,2975,2350,1275,625,575,0
450,2,1,111.0,121.5,117.0,122.0,3202,3487,2575,2995,627,492,440,1045,360,765,80,280,60,70,3925,2875,2350,1275,625,675,0
457,2,1,111.0,125.5,125.0,130.0,3123,3409,2519,2939,604,470,812,1046,660,810,152,236,60,70,3925,3025,2350,1275,625,675,0
464,2,1,123.0,137.5,125.0,146.0,3347,3493,2743,2911,604,582,324,872,300,710,24,162,60,71,3925,3025,2650,1275,625,675,0
471,2,1,125.0,144.0,125.0,146.0,3291,3605,2687,2799,604,806,467,797,375,635,92,162,60,75,4825,2950,2650,1275,625,750,0
479,2,1,125.0,146.0,125.0,146.0,3319,3655,2715,2827,604,828,863,1033,695,800,168,233,62,75,4825,2950,2650,1275,625,750,0
486,2,1,119.0,144.0,125.0,154.0,3269,3678,2687,2827,582,851,1275,1338,1035,1005,240,333,62,70,4550,3700,2650,1275,1200,1000,0
493,2,1,121.0,147.0,125.0,162.0,3213,3375,2631,2547,582,828,1157,1495,1095,1070,62,425,62,69,4925,4200,2800,1275,1325,1000,0
500,2,1,124.0,157.0,125.0,168.0,3185,3129,2491,2323,694,806,1390,1381,1240,985,150,396,62,74,4925,4200,2800,1275,1325,1000,0
507,2,1,124.0,168.0,125.0,168.0,3067,3381,2239,2575,828,806,1469,1002,1215,960,254,42,63,76,5025,4200,2800,1275,1325,1000,0
514,2,1,124.0,168.0,125.0,160.0,3258,3605,2407,2799,851,806,1878,702,1520,685,358,17,63,76,5025,4500,2800,1275,1325,1200,0
521,2,1,122.0,158.0,133.0,152.0,3347,3806,2407,3023,940,783,2270,1153,1800,1040,470,113,63,72,4925,4950,2800,1275,1425,1850,0
529,2,1,140.0,152.0,149.0,184.0,3319,3930,2379,3079,940,851,1167,1453,985,1340,182,113,63,72,4925,4700,2800,1275,1425,2350,0
536,2,1,132.0,149.5,149.0,184.0,3381,3935,2463,3107,918,828,1279,1204,1135,1170,144,34,63,72,5650,3825,2800,1275,2200,3225,0
543,2,1,130.0,145.5,149.0,184.0,3459,4025,2519,3219,940,806,1687,1241,1435,1190,252,51,63,69,5550,3575,2800,1275,2300,3825,0
550,2,1,118.0,141.5,149.0,178.0,3347,3717,2407,2911,940,806,2064,1176,1700,1150,364,26,63,65,4725,2925,2800,1275,3125,5025,0
557,2,1,127.0,141.0,149.0,178.0,3409,3409,2491,2603,918,806,977,1282,955,1160,22,122,63,65,4200,3550,2800,1275,3650,5025,0
564,2,1,125.0,144.0,149.0,178.0,3319,3370,2379,2519,940,851,868,1380,730,1225,138,155,66,64,5100,3850,2800,1275,3800,5125,0
571,2,1,128.0,147.0,149.0,178.0,3325,3319,2407,2379,918,940,816,1312,720,1045,96,267,66,64,5400,4250,2800,1275,3800,5125,0
579,2,1,134.0,150.0,149.0,178.0,3263,3386,2323,2379,940,1007,577,1467,515,1230,62,237,66,64,5400,4400,2800,1275,3800,5125,0
586,2,1,132.0,149.0,149.0,178.0,3213,3554,2295,2547,918,1007,820,1778,650,1425,170,353,66,63,5675,4950,2800,1275,4050,5225,0
593,2,1,130.0,159.0,165.0,178.0,3319,3224,2379,2239,940,985,1218,1230,940,990,278,240,66,63,5500,4600,2800,1275,4225,5625,0
600,2,1,145.0,155.5,165.0,170.0,3353,3230,2435,2267,918,963,560,1522,470,1195,90,327,66,63,5800,4175,2800,1275,4225,6150,0
607,2,1,145.0,159.5,165.0,170.0,3353,3062,2435,2099,918,963,613,1492,590,1145,23,347,66,63,6850,4175,2950,1275,4225,6150,0
614,2,1,145.0,164.5,165.0,170.0,3185,2955,2267,2015,918,940,425,1598,290,1135,135,463,66,63,6850,5175,2950,1275,4225,6150,0
621,2,1,145.0,164.5,165.0,162.0,3185,3022,2267,2015,918,1007,808,1758,565,1175,243,583,66,63,6850,5475,2950,1275,4225,6250,0
629,2,1,156.0,164.5,165.0,170.0,3095,3129,2155,2099,940,1030,299,1938,190,1235,109,703,66,63,8025,5475,3100,1275,4225,6250,0
636,2,1,148.0,162.5,165.0,176.0,3078,3230,2183,2267,895,963,682,2012,465,1205,217,807,66,63,7325,5325,3100,1275,4925,6650,0
643,2,1,121.0,135.5,180.0,200.0,3426,3202,2463,2239,963,963,1089,2292,760,1365,329,927,66,62,4925,3925,3400,1275,7325,8100,0
650,2,1,107.0,116.0,180.0,208.0,3207,3062,2267,2099,940,963,596,2453,405,1510,191,943,66,59,3850,3300,3650,1275,9375,9175,0
657,2,1,114.0,116.5,180.0,198.0,3577,3034,2659,2071,918,963,264,2163,165,1150,99,1013,66,59,3675,2375,3900,1275,9725,10300,0
664,2,1,118.0,123.5,180.0,198.0,3655,3196,2715,2211,940,985,216,1849,155,1145,61,704,66,59,4150,2325,3900,1275,9725,10450,0
671,2,1,116.0,126.0,180.0,198.0,3706,3106,2743,2099,963,1007,652,1800,475,1130,177,670,66,59,3900,3200,3900,1275,9975,10525,0
679,2,1,126.0,138.0,180.0,198.0,3689,2888,2771,1903,918,985,395,886,260,425,135,461,68,59,4625,3400,3900,1275,9975,10525,0
686,2,1,132.0,140.0,180.0,198.0,3717,2530,2799,1567,918,963,297,753,200,355,97,398,68,59,4625,3700,3900,1275,9975,10525,0
693,2,1,130.0,145.5,180.0,198.0,3678,3039,2715,2099,963,940,739,834,530,320,209,514,68,59,5350,4625,3900,1275,10075,10550,0
700,2,1,126.0,141.0,180.0,198.0,3521,3224,2603,2239,918,985,648,1209,585,575,63,634,68,59,4850,5200,3900,1275,10575,10775,0
707,2,1,122.0,149.0,180.0,198.0,3409,3179,2491,2239,918,940,1064,706,885,110,179,596,68,59,4575,5250,3900,1275,10850,10925,0
714,2,1,128.0,144.0,180.0,198.0,3571,3230,2631,2267,940,963,791,886,700,170,91,716,68,59,5175,4650,3900,1275,10950,11525,0
721,2,1,136.0,140.5,180.0,198.0,3487,3386,2547,2379,940,1007,603,641,400,255,203,386,68,59,4800,4225,3900,1275,11325,12550,0
729,2,1,132.0,133.5,180.0,198.0,3498,3286,2603,2323,895,963,1026,974,715,480,311,494,68,59,5050,4025,3900,1275,11675,13200,0
736,2,1,140.0,143.5,180.0,198.0,3538,3420,2575,2435,963,985,747,764,520,150,227,614,68,58,5350,4275,3900,1275,11675,13200,0
743,2,1,143.0,147.5,180.0,198.0,3538,3314,2575,2351,963,963,814,951,475,225,339,726,68,60,6050,4275,3900,1275,11675,13200,0
750,2,1,152.0,147.0,180.0,198.0,3465,3314,2547,2351,918,963,528,1336,285,490,243,846,71,65,6750,4500,3900,1275,11675,13225,0
757,2,1,161.0,144.0,180.0,198.0,3459,3319,2519,2379,940,940,139,1097,130,310,9,787,71,69,6750,3900,3900,1400,11675,13825,0
764,2,1,161.0,147.0,180.0,198.0,3286,3498,2323,2491,963,1007,531,757,410,150,121,607,72,69,6750,3900,3900,1400,11675,13825,0
771,2,1,161.0,154.5,180.0,198.0,3386,3605,2379,2575,1007,1030,640,792,545,65,95,727,72,69,6750,4275,3900,1400,11675,13875,0
779,2,1,175.0,152.0,180.0,198.0,3818,3678,2631,2715,1187,963,313,1211,70,380,243,831,72,69,6575,5050,3900,1400,11850,14000,0
786,2,1,175.0,155.0,180.0,198.0,3902,3767,2603,2827,1299,940,469,727,220,155,249,572,72,69,7375,5250,3900,1400,11850,14050,0
793,2,1,152.0,145.0,180.0,198.0,3952,3706,2743,2743,1209,963,935,797,550,105,385,692,72,69,5775,3700,3900,1400,13750,15850,0
800,2,1,129.0,137.0,180.0,198.0,3885,3818,2631,2855,1254,963,1416,957,875,145,541,812,72,69,3800,3650,3900,1400,15525,16650,0
807,2,1,121.0,113.0,180.0,198.0,3969,3700,2715,2715,1254,985,388,1093,95,240,293,853,72,69,3950,1400,3900,1400,17275,18425,0
814,2,1,119.0,116.5,180.0,198.0,3941,3666,2687,2659,1254,1007,870,964,425,220,445,744,72,69,3950,1725,3900,1400,17375,18450,0
821,2,1,121.0,124.5,180.0,198.0,3946,3218,2715,2211,1231,1007,863,925,470,165,393,760,72,69,4425,2025,3900,1400,17375,18450,0
829,2,1,123.0,125.5,180.0,192.0,3879,3118,2603,2155,1276,963,1175,812,680,165,495,647,72,69,4425,2725,3900,1400,17375,18850,0
836,2,1,136.0,125.5,180.0,192.0,3924,3207,2603,2267,1321,940,456,1213,130,450,326,763,72,69,5575,2825,3900,1400,17375,18850,0
843,2,1,138.0,128.5,180.0,192.0,3857,3560,2603,2575,1254,985,691,1114,350,624,341,490,72,69,5825,3725,3900,1400,17375,18874,0
850,2,1,145.0,141.5,180.0,192.0,3829,3375,2575,2435,1254,940,483,531,240,104,243,427,72,68,6175,4225,3900,1400,17375,18874,0
857,2,1,142.0,140.0,188.0,192.0,3795,3554,2519,2547,1276,1007,940,871,545,324,395,547,72,68,5925,4100,3900,1400,17725,19074,0
864,2,1,130.0,118.0,188.0,192.0,3795,3554,2519,2547,1276,1007,1392,1281,845,614,547,667,72,68,4950,2550,3900,1400,18525,20849,0
871,2,1,148.0,129.0,188.0,192.0,3694,3510,2463,2547,1231,963,301,744,160,169,141,575,72,66,6475,2550,3900,1400,18525,21249,0
879,2,1,148.0,139.0,188.0,192.0,3655,3482,2379,2519,1276,963,727,209,430,114,297,95,72,65,6475,2550,3900,1400,18525,21299,0
886,2,1,146.0,132.0,188.0,192.0,3633,3532,2379,2547,1254,985,1175,452,730,127,445,325,72,65,6675,3600,3900,1400,18625,21847,0
891,2,1,146.0,124.0,188.0,192.0,3633,3442,2379,2435,1254,1007,1175,495,730,82,445,413,72,61,6675,3000,3900,1400,18625,22647,0
7,2,2,13.0,13.0,15.0,15.0,293,377,293,377,0,0,35,45,35,45,0,0,12,12,0,0,0,0,0,0,0
14,2,2,14.0,14.0,15.0,15.0,671,671,671,671,0,0,70,70,70,70,0,0,13,13,0,0,0,0,0,0,0
21,2,2,14.0,14.0,15.0,15.0,699,699,699,699,0,0,0,0,0,0,0,0,13,13,0,0,0,0,0,0,0
29,2,2,15.0,15.0,15.0,15.0,699,727,699,727,0,0,90,100,90,100,0,0,14,14,0,0,0,0,0,0,0
36,2,2,15.0,16.0,15.0,23.0,811,839,811,839,0,0,95,150,95,150,0,0,14,15,0,0,0,0,0,0,0
43,2,2,16.0,16.0,23.0,23.0,783,839,783,839,0,0,10,40,10,40,0,0,15,15,0,0,0,0,0,0,0
50,2,2,17.0,17.0,23.0,23.0,783,895,783,895,0,0,50,75,50,75,0,0,16,16,0,0,0,0,0,0,0
57,2,2,18.0,18.0,23.0,23.0,783,923,783,923,0,0,25,65,25,65,0,0,17,17,0,0,0,0,0,0,0
64,2,2,19.0,18.0,23.0,23.0,867,979,867,979,0,0,90,125,90,125,0,0,18,17,0,0,0,0,0,0,0
71,2,2,19.0,19.0,23.0,23.0,945,951,923,951,22,0,154,35,150,35,4,0,18,18,0,0,0,0,0,0,0
79,2,2,20.0,20.0,23.0,23.0,906,995,839,951,67,44,102,158,90,150,12,8,19,19,0,0,0,0,0,0,0
86,2,2,21.0,21.0,23.0,23.0,995,1034,839,923,156,111,181,75,145,55,36,20,20,20,0,0,150,150,0,0,0
93,2,2,21.0,22.0,23.0,23.0,1051,1130,783,951,268,179,103,64,35,20,68,44,20,21,0,0,150,150,0,0,0
100,2,2,22.0,22.0,23.0,23.0,1118,1208,783,1007,335,201,133,208,25,140,108,68,21,21,0,0,150,150,0,0,0
107,2,2,23.0,23.0,23.0,23.0,1174,1197,839,951,335,246,219,281,75,185,144,96,22,22,0,0,150,150,0,0,0
114,2,2,23.0,23.0,23.0,31.0,1230,1253,895,1007,335,246,310,288,130,160,180,128,23,22,0,0,150,150,0,0,0
121,2,2,24.0,25.0,31.0,31.0,1236,1270,923,979,313,291,456,158,240,90,216,68,23,23,0,0,300,450,0,0,0
129,2,2,28.0,27.0,31.0,31.0,1264,1292,951,979,313,313,156,129,50,75,106,54,23,23,0,0,450,450,0,0,0
136,2,2,28.0,27.0,31.0,31.0,1292,1270,979,979,313,291,206,180,60,90,146,90,24,23,0,0,450,450,0,0,0
143,2,2,28.0,27.0,31.0,31.0,1320,1264,1007,951,313,313,366,330,180,200,186,130,24,23,0,0,450,450,0,0,0
150,2,2,29.0,28.0,31.0,39.0,1258,1236,923,923,335,313,461,85,235,15,226,70,24,23,0,0,450,450,0,0,0
157,2,2,33.0,32.0,39.0,39.0,1309,1230,951,895,358,335,261,230,95,120,166,110,24,23,350,350,450,450,0,0,0
164,2,2,33.0,33.0,39.0,39.0,1208,1281,895,923,313,358,158,215,60,115,98,100,25,23,350,350,450,600,0,50,0
171,2,2,34.0,33.0,39.0,39.0,1214,1292,923,979,291,313,254,362,120,230,134,132,25,23,350,350,450,600,0,50,0
179,2,2,34.0,33.0,39.0,39.0,1264,1264,951,951,313,313,314,517,140,345,174,172,25,23,350,350,450,600,0,50,0
186,2,2,34.0,33.0,39.0,39.0,1264,1292,951,979,313,313,369,267,155,55,214,212,26,23,700,700,450,600,0,50,0
193,2,2,34.0,33.0,39.0,39.0,1314,1292,979,979,335,313,529,322,275,70,254,252,26,23,700,875,450,600,0,50,0
200,2,2,34.0,34.0,39.0,39.0,1264,1264,951,951,313,313,230,417,90,125,140,292,26,23,700,875,700,600,0,50,0
207,2,2,34.0,34.0,47.0,39.0,1236,1365,923,1007,313,358,81,277,55,45,26,232,26,23,700,875,800,600,0,50,0
214,2,2,34.0,35.0,47.0,47.0,1286,1230,951,895,335,335,146,418,80,150,66,268,26,24,700,875,800,600,0,50,0
221,2,2,34.0,39.0,47.0,47.0,1342,1342,1007,1007,335,335,306,224,200,20,106,204,26,25,700,875,800,600,0,50,0
229,2,2,37.0,41.0,47.0,47.0,1342,1292,1007,979,335,313,117,225,75,85,42,140,25,25,875,1375,800,600,50,50,0
236,2,2,37.0,41.0,55.0,47.0,1320,1298,1007,1007,313,291,268,231,190,55,78,176,25,25,1050,1375,800,600,50,50,0
243,2,2,37.0,41.0,55.0,47.0,1376,1326,1063,1035,313,291,428,296,310,80,118,216,25,25,1050,1375,950,850,50,50,0
250,2,2,41.0,41.0,55.0,47.0,1320,1348,1007,1035,313,313,238,152,180,50,58,102,25,25,1050,1375,950,850,50,50,0
257,2,2,42.0,43.0,55.0,62.0,1398,1370,1063,1035,335,335,348,217,250,75,98,142,25,25,1400,1375,950,850,50,50,0
264,2,2,42.0,45.0,55.0,62.0,1342,1292,1007,979,335,313,503,188,365,60,138,128,25,25,1400,1375,950,850,50,50,0
271,2,2,42.0,47.0,55.0,54.0,1370,1264,1035,951,335,313,259,193,85,25,174,168,26,27,1400,1550,950,850,50,150,0
279,2,2,42.0,49.0,55.0,54.0,1370,1426,1035,1091,335,335,399,313,185,105,214,208,26,29,1400,1550,1250,950,0,150,0
286,2,2,44.0,49.0,55.0,54.0,1376,1510,1063,1175,313,335,305,178,180,80,125,98,26,29,1400,1725,1250,950,0,300,0
293,2,2,47.0,49.0,55.0,54.0,1376,1460,1063,1147,313,313,70,244,30,110,40,134,26,29,1650,1725,1250,950,0,300,0
300,2,2,47.0,49.0,55.0,54.0,1320,1510,1007,1175,313,335,175,284,95,110,80,174,26,29,1900,1725,1250,950,0,300,0
307,2,2,48.0,47.0,55.0,54.0,1230,1454,895,1119,335,335,265,449,145,235,120,214,27,29,1900,1550,1250,950,0,475,0
314,2,2,47.0,47.0,63.0,54.0,1370,1404,1035,1091,335,313,395,265,235,115,160,150,28,27,1725,1725,1250,950,175,750,0
321,2,2,47.0,46.0,63.0,54.0,1314,1186,979,895,335,291,386,382,190,200,196,182,28,26,1725,1725,1250,1050,175,800,0
329,2,2,52.0,49.0,63.0,54.0,1264,222,951,111,313,111,297,90,165,0,132,90,29,25,1725,1875,1250,1050,175,850,0
336,2,2,52.0,45.0,63.0,54.0,1404,44,1091,0,313,44,417,94,245,0,172,94,29,25,2075,1525,1250,1200,175,1300,0
343,2,2,55.0,43.0,78.0,46.0,1320,44,1007,0,313,44,302,98,140,75,162,23,30,26,2075,1350,1250,1350,175,1575,0
350,2,2,56.0,41.0,78.0,46.0,1466,335,1175,335,291,0,243,158,145,135,98,23,31,26,2075,1200,1250,1250,175,1825,0
7,2,0,13.0,13.0,15.0,15.0,251,335,251,335,0,0,30,40,30,40,0,0,12,12,0,0,0,0,0,0,0
14,2,0,14.0,14.0,15.0,15.0,671,671,671,671,0,0,70,70,70,70,0,0,13,13,0,0,0,0,0,0,0
21,2,0,14.0,14.0,15.0,15.0,727,671,727,671,0,0,45,50,45,50,0,0,13,13,0,0,0,0,0,0,0
29,2,0,15.0,15.0,15.0,15.0,727,643,727,643,0,0,80,85,80,85,0,0,14,14,0,0,0,0,0,0,0
36,2,0,15.0,15.0,15.0,15.0,755,727,755,727,0,0,125,180,125,180,0,0,14,14,0,0,0,0,0,0,0
43,2,0,16.0,16.0,23.0,23.0,755,755,755,755,0,0,60,70,60,70,0,0,15,15,0,0,0,0,0,0,0
50,2,0,17.0,16.0,23.0,23.0,783,755,783,755,0,0,15,35,15,35,0,0,16,15,0,0,0,0,0,0,0
57,2,0,18.0,17.0,23.0,23.0,811,727,811,727,0,0,75,130,75,130,0,0,17,16,0,0,0,0,0,0,0
64,2,0,18.0,18.0,23.0,23.0,867,755,867,755,0,0,125,165,125,165,0,0,17,17,0,0,0,0,0,0,0
71,2,0,19.0,18.0,23.0,23.0,951,743,951,699,0,44,235,253,235,245,0,8,18,17,0,0,0,0,0,0,0
79,2,0,20.0,19.0,23.0,23.0,1023,771,979,615,44,156,318,298,310,270,8,28,19,18,0,0,0,0,0,0,0
86,2,0,20.0,19.0,23.0,23.0,1018,906,951,727,67,179,421,413,405,365,16,48,19,18,0,0,150,0,0,0,0
93,2,0,20.0,20.0,23.0,23.0,1018,883,951,727,67,156,399,304,375,240,24,64,20,19,0,0,150,150,0,0,0
100,2,0,21.0,20.0,23.0,23.0,978,1001,867,867,111,134,65,430,25,350,40,80,20,19,0,0,150,150,0,0,0
107,2,0,21.0,20.0,23.0,23.0,1062,978,951,867,111,111,97,147,45,55,52,92,20,19,0,0,150,150,0,0,0
114,2,0,22.0,20.0,23.0,23.0,1085,1006,951,895,134,111,178,263,110,155,68,108,21,19,0,50,150,150,0,0,0
121,2,0,21.0,21.0,23.0,23.0,1079,1001,923,867,156,134,233,129,145,55,88,74,20,19,0,50,150,150,50,0,0
129,2,0,22.0,21.0,31.0,23.0,1079,1169,923,1035,156,134,163,270,105,180,58,90,21,19,0,50,300,150,50,0,0
136,2,0,23.0,22.0,31.0,23.0,1107,1230,951,1119,156,111,243,207,165,105,78,102,22,20,0,50,300,150,50,0,0
143,2,0,24.0,22.0,31.0,31.0,1169,1253,923,1119,246,134,140,193,130,75,10,118,23,20,0,50,300,150,50,0,0
150,2,0,25.0,23.0,31.0,31.0,1292,1197,979,1063,313,134,241,284,195,150,46,134,24,21,0,50,300,150,50,0,0
157,2,0,28.0,25.0,31.0,31.0,1314,1270,979,1091,335,179,166,324,130,170,36,154,25,21,0,50,300,250,50,0,0
164,2,0,28.0,26.0,31.0,31.0,1286,1298,951,1119,335,179,121,414,45,240,76,174,25,22,0,50,300,250,50,0,0
171,2,0,30.0,28.0,46.0,31.0,1348,1303,1035,1147,313,156,227,465,115,275,112,190,26,23,0,150,300,250,50,0,0
179,2,0,32.0,28.0,46.0,46.0,1376,1359,1063,1203,313,156,297,460,145,250,152,210,28,23,0,150,550,250,50,0,0
186,2,0,33.0,29.0,46.0,46.0,1510,1247,1175,1091,335,156,132,490,90,285,42,205,29,23,175,150,550,400,50,0,0
193,2,0,34.0,32.0,46.0,46.0,1594,1191,1259,1035,335,156,132,310,50,110,82,200,30,24,175,250,550,550,50,0,0
200,2,0,37.0,32.0,46.0,46.0,1734,1527,1399,1371,335,156,113,460,45,240,68,220,31,24,175,250,550,550,50,0,0
207,2,0,38.0,38.0,46.0,46.0,1734,1606,1399,1427,335,179,268,395,160,155,108,240,32,25,175,350,700,700,50,0,0
214,2,0,39.0,38.0,46.0,46.0,1656,1723,1343,1567,313,156,69,86,25,30,44,56,33,25,175,350,700,700,50,0,0
221,2,0,40.0,40.0,46.0,54.0,1796,1919,1483,1763,313,156,154,206,70,130,84,76,34,27,175,350,700,700,50,0,0
229,2,0,41.0,46.0,46.0,54.0,1852,1975,1539,1819,313,156,229,76,105,30,124,46,35,27,350,550,700,700,50,0,0
236,2,0,44.0,48.0,54.0,54.0,1902,2031,1567,1875,335,156,174,91,110,25,64,66,36,29,350,550,700,700,50,0,0
243,2,0,45.0,50.0,54.0,62.0,1958,1947,1623,1791,335,156,299,121,195,35,104,86,38,29,500,650,850,700,50,0,0
250,2,0,48.0,54.0,62.0,62.0,2154,1998,1819,1819,335,179,170,136,80,55,90,81,38,31,675,900,850,700,50,0,0
257,2,0,50.0,56.0,62.0,62.0,2182,2026,1847,1847,335,179,325,256,270,180,55,76,40,31,675,900,1200,700,50,0,0
264,2,0,53.0,60.0,62.0,70.0,2121,2143,1651,1987,470,156,344,132,275,40,69,92,41,33,850,1000,1200,825,50,0,0
271,2,0,56.0,61.0,70.0,70.0,2322,2143,1651,1987,671,156,404,337,305,225,99,112,41,33,1025,1125,1200,825,50,0,0
279,2,0,59.0,62.0,70.0,70.0,2216,2283,1567,2127,649,156,375,567,325,435,50,132,42,35,1125,1350,1200,825,50,0,0
286,2,0,62.0,64.0,70.0,70.0,2406,2395,1735,2239,671,156,350,422,270,370,80,52,43,35,1475,1350,1200,825,50,0,0
293,2,0,65.0,67.0,70.0,78.0,2390,2552,1763,2351,627,201,402,360,300,280,102,80,44,37,1650,1450,1200,825,50,0,0
300,2,0,65.0,70.0,70.0,78.0,2468,2401,1819,2155,649,246,532,313,350,205,182,108,44,37,1750,1450,1200,825,50,0,0
307,2,0,65.0,69.0,78.0,78.0,2384,2272,1735,1959,649,313,493,348,385,250,108,98,45,37,1750,1400,1200,925,50,50,0
314,2,0,65.0,69.0,78.0,86.0,2490,2098,1819,1763,671,335,793,619,605,485,188,134,45,39,1750,1500,1200,1025,50,150,0
321,2,0,69.0,72.0,78.0,86.0,2468,2132,1819,1819,649,313,674,485,410,415,264,70,45,39,1750,1500,1200,1025,50,150,0
329,2,0,69.0,72.0,78.0,86.0,2418,2222,1791,1819,627,403,661,756,475,630,186,126,45,41,1750,1500,1350,1025,50,150,0
336,2,0,71.0,80.0,78.0,86.0,2440,2530,1791,2015,649,515,111,625,45,485,66,140,47,41,1750,1650,1350,1025,50,150,0
343,2,0,71.0,80.0,78.0,86.0,2440,2451,1791,1847,649,604,397,851,255,635,142,216,48,41,1750,1650,1350,1025,50,150,0
350,2,0,71.0,82.0,78.0,86.0,2384,2658,1735,1987,649,671,687,1016,465,720,222,296,49,43,1750,1650,1350,1025,50,150,0
357,2,0,73.0,84.0,78.0,86.0,2546,2686,1875,2015,671,671,493,1168,345,800,148,368,49,43,2000,2000,1650,1025,50,150,0
364,2,0,73.0,84.0,78.0,86.0,2602,2642,1931,2015,671,627,193,805,165,365,28,440,49,45,2000,2000,1650,1275,50,150,0
371,2,0,75.0,90.0,78.0,94.0,2502,2625,1875,2043,627,582,400,408,300,100,100,308,51,45,2000,2100,1650,1275,50,150,0
379,2,0,81.0,88.0,86.0,94.0,2580,2434,1931,1875,649,559,715,706,535,330,180,376,52,45,2000,2000,1650,1275,50,250,0
386,2,0,83.0,90.0,86.0,102.0,2524,2406,1875,1847,649,559,761,928,505,480,256,448,53,45,2000,2000,1650,1275,50,250,0
393,2,0,83.0,90.0,94.0,102.0,2597,2541,2015,1959,582,582,639,850,315,430,324,420,53,45,2000,2350,1650,1275,50,250,0
400,2,0,86.0,92.0,94.0,102.0,2535,2647,1931,2043,604,604,634,1047,355,555,279,492,55,47,2000,2350,1950,1275,50,250,0
407,2,0,92.0,92.0,109.0,102.0,2793,2541,2099,1959,694,582,379,1336,270,780,109,556,56,47,2750,2350,1950,1625,50,250,0
414,2,0,90.0,95.0,109.0,102.0,2832,2647,2183,2043,649,604,706,1303,525,775,181,528,56,47,3075,2400,1950,1925,225,300,0
421,2,0,96.0,92.0,109.0,118.0,3028,2423,2379,1931,649,492,582,1379,525,870,57,509,58,44,3075,2400,2100,1925,225,450,0
429,2,0,96.0,91.0,109.0,118.0,3224,1779,2575,1399,649,380,952,1572,815,1015,137,557,58,43,3075,2400,2100,1825,225,600,0
436,2,0,95.0,95.0,109.0,118.0,3286,1751,2659,1371,627,380,1303,1595,1090,990,213,605,58,43,2825,2650,2250,1900,475,600,0
443,2,0,103.0,95.0,109.0,110.0,3314,1634,2687,1231,627,403,853,1788,810,1135,43,653,58,43,2825,2650,2550,1825,475,775,0
450,2,0,101.0,97.0,109.0,102.0,3381,1852,2687,1427,694,425,683,1921,560,1220,123,701,59,45,2675,2650,2550,1850,725,950,0
457,2,0,101.0,97.0,109.0,86.0,3297,1410,2603,1007,694,403,878,2070,775,1325,103,745,61,45,3625,2750,2550,1950,725,1150,0
464,2,0,104.0,97.0,109.0,86.0,3342,1527,2715,1147,627,380,886,2094,715,1330,171,764,61,47,3375,2750,2550,1950,975,1150,0
471,2,0,104.0,92.0,109.0,86.0,3420,2059,2771,1679,649,380,1281,2357,1030,1545,251,812,61,47,3375,2500,2550,1950,975,1400,0
7,2,0,13.0,13.0,15.0,15.0,293,293,293,293,0,0,35,35,35,35,0,0,12,12,0,0,0,0,0,0,0
14,2,0,14.0,14.0,15.0,15.0,671,671,671,671,0,0,70,70,70,70,0,0,13,13,0,0,0,0,0,0,0
21,2,0,14.0,14.0,15.0,15.0,727,699,727,699,0,0,50,50,50,50,0,0,13,13,0,0,0,0,0,0,0
29,2,0,15.0,15.0,15.0,15.0,699,643,699,643,0,0,90,30,90,30,0,0,14,14,0,0,0,0,0,0,0
36,2,0,15.0,15.0,23.0,15.0,783,727,783,727,0,0,145,130,145,130,0,0,14,14,0,0,0,0,0,0,0
43,2,0,16.0,16.0,23.0,23.0,783,783,783,783,0,0,35,70,35,70,0,0,15,15,0,0,0,0,0,0,0
50,2,0,17.0,16.0,23.0,23.0,811,811,811,811,0,0,10,45,10,45,0,0,16,15,0,0,0,0,0,0,0
57,2,0,18.0,17.0,23.0,23.0,755,755,755,755,0,0,60,140,60,140,0,0,17,16,0,0,0,0,0,0,0
64,2,0,19.0,18.0,23.0,23.0,895,895,895,895,0,0,175,140,175,140,0,0,18,17,0,0,0,0,0,0,0
71,2,0,19.0,18.0,23.0,23.0,973,855,951,811,22,44,239,238,235,230,4,8,18,17,0,0,0,0,0,0,0
79,2,0,20.0,19.0,23.0,23.0,995,967,951,811,44,156,358,348,350,320,8,28,19,18,0,0,0,0,0,0,0
86,2,0,20.0,19.0,23.0,23.0,1023,967,979,811,44,156,336,463,320,415,16,48,19,18,0,0,150,0,0,0,0
93,2,0,20.0,20.0,23.0,23.0,962,911,895,755,67,156,39,358,15,290,24,68,20,19,0,0,150,150,0,0,0
100,2,0,21.0,20.0,23.0,23.0,1018,939,951,783,67,156,107,468,75,380,32,88,20,19,0,0,150,150,0,0,0
107,2,0,21.0,20.0,23.0,23.0,1068,962,979,783,89,179,79,178,35,70,44,108,20,19,0,50,150,150,0,0,0
114,2,0,22.0,20.0,23.0,23.0,1169,939,1035,783,134,156,90,89,30,15,60,74,21,19,0,50,150,150,0,0,0
121,2,0,23.0,21.0,23.0,23.0,1135,911,979,755,156,156,90,139,35,45,55,94,22,19,0,50,300,150,0,0,0
129,2,0,25.0,21.0,31.0,23.0,1079,1023,923,867,156,156,110,274,35,160,75,114,22,19,0,50,300,150,0,0,0
136,2,0,26.0,22.0,31.0,23.0,1152,967,951,811,201,156,99,109,50,75,49,34,23,20,0,50,300,150,0,0,0
143,2,0,26.0,22.0,31.0,31.0,1214,995,923,839,291,156,140,239,55,185,85,54,23,20,125,50,300,150,0,0,0
150,2,0,28.0,25.0,31.0,31.0,1314,1130,979,951,335,179,165,139,65,65,100,74,23,21,125,50,300,250,50,0,0
157,2,0,29.0,25.0,31.0,31.0,1292,1186,979,1007,313,179,66,239,30,145,36,94,24,21,125,50,300,250,50,0,0
164,2,0,30.0,26.0,46.0,31.0,1214,1247,923,1091,291,156,157,275,85,165,72,110,25,22,125,50,400,250,50,0,0
171,2,0,32.0,29.0,46.0,31.0,1342,1275,1007,1119,335,156,177,295,65,165,112,130,26,23,125,150,400,250,50,0,0
179,2,0,33.0,29.0,46.0,46.0,1376,1303,1063,1147,313,156,248,295,100,145,148,150,27,23,125,150,400,600,50,0,0
186,2,0,35.0,29.0,46.0,46.0,1544,1191,1231,1035,313,156,383,185,195,115,188,70,29,24,250,250,400,600,50,0,0
193,2,0,36.0,34.0,46.0,46.0,1656,1359,1343,1203,313,156,229,110,105,70,124,40,30,24,250,250,650,600,50,0,0
200,2,0,37.0,34.0,46.0,46.0,1639,1594,1371,1371,268,223,21,233,15,165,6,68,31,24,250,250,650,600,50,0,0
207,2,0,39.0,36.0,46.0,46.0,1774,1606,1483,1315,291,291,132,360,90,260,42,100,33,25,250,250,650,600,50,0,0
214,2,0,39.0,40.0,46.0,46.0,1796,1740,1483,1427,313,313,92,265,10,175,82,90,33,25,250,450,650,600,50,0,0
221,2,0,41.0,42.0,46.0,46.0,1852,1768,1539,1455,313,313,227,280,105,150,122,130,35,27,250,450,650,600,50,0,0
229,2,0,42.0,46.0,46.0,46.0,1958,1796,1623,1483,335,313,307,290,145,220,162,70,36,29,250,450,650,850,50,0,0
236,2,0,43.0,46.0,46.0,46.0,1981,1880,1623,1567,358,313,392,345,190,235,202,110,37,29,250,650,650,850,50,0,0
243,2,0,46.0,50.0,54.0,54.0,2042,1701,1707,1343,335,358,433,285,270,160,163,125,39,31,250,650,900,850,50,0,0
250,2,0,48.0,50.0,54.0,54.0,2076,1874,1763,1539,313,335,399,281,250,120,149,161,39,31,425,650,900,850,50,0,0
257,2,0,50.0,52.0,54.0,54.0,2076,1824,1763,1511,313,313,464,337,275,165,189,172,41,33,425,850,1300,850,50,0,0
264,2,0,54.0,54.0,62.0,54.0,2104,2014,1791,1679,313,335,349,221,245,130,104,91,42,33,525,950,1300,925,50,0,0
271,2,0,57.0,59.0,62.0,62.0,2160,2048,1847,1623,313,425,334,277,240,130,94,147,43,35,875,950,1300,925,50,0,0
279,2,0,58.0,61.0,62.0,62.0,2177,2121,1819,1651,358,470,398,447,260,240,138,207,44,37,875,1050,1300,1000,50,0,0
286,2,0,62.0,62.0,62.0,62.0,2373,2227,1791,1735,582,492,324,87,235,20,89,67,45,37,1150,1050,1300,1000,50,0,0
293,2,0,63.0,67.0,70.0,70.0,2446,2328,1819,1791,627,537,166,267,155,140,11,127,47,39,1150,1050,1300,1000,50,0,0
300,2,0,65.0,71.0,78.0,78.0,2429,2418,1847,1903,582,515,368,173,285,115,83,58,48,39,1150,1375,1300,1150,50,0,0
307,2,0,65.0,74.0,86.0,86.0,2356,2597,1707,2127,649,470,634,380,475,270,159,110,49,41,1250,1425,1300,1150,50,0,0
314,2,0,61.0,72.0,86.0,86.0,1393,2541,923,2071,470,470,777,660,570,490,207,170,46,43,1250,1225,1300,1275,250,200,0
321,2,0,68.0,72.0,86.0,86.0,564,2541,251,2071,313,470,202,465,105,235,97,230,45,43,1250,1175,1300,1275,300,300,0
329,2,0,68.0,68.0,86.0,86.0,665,2569,307,2099,358,470,292,450,155,260,137,190,45,43,1775,1025,1450,1275,300,500,0
336,2,0,69.0,70.0,86.0,86.0,1611,2731,1231,2239,380,492,261,655,180,430,81,225,47,45,1775,1500,1450,1275,300,600,0
343,2,0,69.0,73.0,86.0,86.0,2188,2726,1651,2211,537,515,534,146,385,90,149,56,47,45,1775,1500,1750,1275,300,600,0
350,2,0,71.0,77.0,86.0,86.0,2418,2681,1791,2211,627,470,284,263,55,205,229,58,48,47,1775,1500,1750,1275,300,600,0
357,2,0,72.0,79.0,86.0,86.0,2530,2905,1903,2435,627,470,399,398,190,280,209,118,50,49,1775,1625,1750,1275,300,600,0
364,2,0,79.0,81.0,86.0,86.0,2502,2905,1875,2435,627,470,104,498,15,345,89,153,50,49,1775,1625,1750,1275,300,600,0
371,2,0,81.0,85.0,86.0,86.0,2636,2838,1987,2323,649,515,279,421,110,200,169,221,52,51,1775,2000,1750,1275,300,600,0
379,2,0,82.0,85.0,86.0,94.0,2731,2882,2015,2211,716,671,399,590,150,310,249,280,54,51,1775,2000,1750,1275,300,600,0
386,2,0,86.0,89.0,86.0,94.0,2765,2849,2071,2155,694,694,270,696,145,365,125,331,55,53,1925,2125,1750,1275,300,600,0
393,2,0,86.0,93.0,94.0,94.0,2793,3274,2211,2603,582,671,440,507,255,300,185,207,55,55,2075,2225,1750,1425,300,600,0
400,2,0,88.0,99.0,94.0,109.0,2698,3034,2071,2407,627,627,545,259,280,105,265,154,55,55,2075,2225,1750,1425,300,600,0
407,2,0,88.0,102.0,94.0,117.0,2731,3314,2127,2687,604,627,377,384,40,275,337,109,55,55,2175,2450,1750,1500,300,600,0
414,2,0,90.0,108.0,94.0,125.0,2345,3230,1763,2603,582,627,548,499,135,335,413,164,55,57,2675,2450,1750,1550,300,625,0
421,2,0,96.0,106.0,117.0,125.0,2496,2944,1847,2295,649,649,354,799,65,555,289,244,56,57,2675,2675,1750,1700,300,725,0
429,2,0,97.0,105.0,125.0,125.0,2737,3028,2043,2379,694,649,644,1165,275,845,369,320,57,59,2675,2825,2050,1700,300,775,0
436,2,0,103.0,112.0,125.0,125.0,2894,3101,2267,2407,627,694,182,930,45,655,137,275,57,59,3025,3325,2200,1700,300,775,0
443,2,0,101.0,115.0,125.0,125.0,2922,3302,2295,2631,627,671,547,756,330,580,217,176,58,59,2850,3275,2300,1700,475,825,0
450,2,0,109.0,121.0,125.0,125.0,3034,2894,2407,2267,627,627,417,438,120,340,297,98,58,61,2850,3325,2300,1775,475,825,0
457,2,0,109.0,125.0,133.0,125.0,3084,3006,2435,2379,649,627,602,653,325,475,277,178,60,63,3150,3575,2600,1775,475,825,0
464,2,0,117.0,125.0,141.0,125.0,3168,3336,2519,2687,649,649,577,368,220,235,357,133,60,63,4050,3625,2600,1775,475,825,0
471,2,0,121.0,131.0,141.0,141.0,3129,3414,2435,2743,694,671,613,688,180,475,433,213,60,63,4050,3625,2950,1875,475,825,0
479,2,0,127.0,135.0,141.0,141.0,3269,3515,2575,2799,694,716,503,1095,290,802,213,293,61,63,4450,4150,2950,1875,475,825,0
486,2,0,128.0,140.0,141.0,141.0,3230,3655,2603,2939,627,716,681,805,400,707,281,98,63,63,4050,4700,2950,1875,475,825,0
493,2,0,130.0,146.0,141.0,157.0,3258,3633,2631,2939,627,694,776,580,415,477,361,103,64,63,4750,4925,2950,1875,475,825,0
500,2,0,139.0,150.0,141.0,165.0,3342,3627,2715,2911,627,716,426,962,335,767,91,195,65,63,4750,5175,2950,1875,475,825,0
507,2,0,141.0,155.0,141.0,165.0,3314,3834,2687,3051,627,783,107,717,40,497,67,220,67,63,4950,5175,2950,1875,475,825,0
514,2,0,141.0,159.0,141.0,181.0,3202,3689,2575,2883,627,806,372,692,225,522,147,170,69,63,4950,5900,2950,1875,475,825,0
521,2,0,140.0,165.0,141.0,181.0,3246,3594,2575,2743,671,851,778,1122,555,852,223,270,70,66,4825,6475,3250,1875,600,825,0
529,2,0,152.0,169.0,165.0,189.0,3448,3426,2799,2463,649,963,374,904,75,697,299,207,71,66,4825,6425,3250,1875,600,875,0
536,2,0,154.0,171.0,165.0,189.0,3336,3560,2687,2575,649,985,360,850,285,602,75,248,71,66,5325,6450,3250,1875,700,975,0
543,2,0,157.0,175.0,165.0,189.0,3386,3599,2715,2659,671,940,459,1282,450,922,9,360,71,66,6225,6750,3250,1875,700,975,0
550,2,0,155.0,174.0,165.0,189.0,3538,3538,2687,2575,851,963,882,997,765,617,117,380,71,66,5650,7025,3250,1875,875,1200,0
557,2,0,162.0,179.0,157.0,189.0,3510,3560,2659,2575,851,985,486,752,265,427,221,325,68,66,6600,7250,3700,1875,1200,1200,0
564,2,0,136.0,157.0,157.0,189.0,3459,3504,2631,2519,828,985,792,1168,475,727,317,441,68,66,4675,5825,3700,1875,3125,3075,0
571,2,0,106.0,125.0,165.0,197.0,3487,3582,2659,2575,828,1007,907,854,490,397,417,457,68,66,2550,3675,3700,1875,5550,5075,0
579,2,0,106.0,122.0,181.0,197.0,3403,3420,2575,2435,828,985,899,451,390,82,509,369,68,66,2850,2850,3700,2075,5550,5900,0
586,2,0,118.0,125.0,181.0,205.0,3319,3431,2491,2491,828,940,284,568,75,187,209,381,70,66,2850,2925,3700,2075,5550,6125,0
593,2,0,118.0,125.0,181.0,205.0,3386,3655,2603,2715,783,940,606,1023,305,522,301,501,70,66,2850,3350,3700,2075,5550,6125,0
600,2,0,118.0,130.0,181.0,205.0,3297,3762,2491,2799,806,963,316,533,215,287,101,246,70,66,2850,3475,3700,2075,5550,6125,0
607,2,0,125.0,137.0,181.0,205.0,3493,3644,2687,2659,806,985,391,708,190,467,201,241,70,66,3050,4175,3700,2175,5550,6125,0
614,2,0,129.0,137.0,189.0,205.0,3375,3834,2547,2827,828,1007,422,704,225,447,197,257,70,66,3400,4175,3700,2175,5550,6125,0
621,2,0,135.0,143.0,189.0,205.0,3196,3694,2323,2687,873,1007,275,341,120,322,155,19,73,66,3400,4450,3700,2175,5550,6125,0
629,2,0,141.0,151.0,189.0,205.0,3336,3756,2351,2771,985,985,327,587,160,452,167,135,73,66,4275,4700,3700,2175,5550,6125,0
636,2,0,145.0,151.0,189.0,205.0,3347,3795,2407,2855,940,940,379,1039,200,792,179,247,73,66,4775,4975,3700,2400,5550,6125,0
643,2,0,148.0,158.0,189.0,205.0,3319,3935,2379,2995,940,940,579,1149,355,907,224,242,73,66,5625,5300,3700,2500,5550,6125,0
650,2,0,152.0,158.0,189.0,220.0,3426,3818,2463,2855,963,963,604,1159,560,797,44,362,73,66,5625,5700,3700,2500,5550,6125,0
657,2,0,163.0,156.0,189.0,220.0,3274,3560,2267,2575,1007,985,275,1565,265,1087,10,478,75,66,6025,6150,3700,2750,5550,6225,0
664,2,0,163.0,160.0,204.0,220.0,3610,3420,2603,2435,1007,985,735,1316,605,947,130,369,75,66,6575,6200,3700,2750,5550,6275,0
671,2,0,157.0,164.0,204.0,220.0,3868,3090,2883,2127,985,963,1183,1309,945,882,238,427,75,66,6275,6750,3700,2750,5850,6275,0
679,2,0,171.0,164.0,204.0,220.0,3840,2787,2855,1959,985,828,398,1640,340,1117,58,523,75,66,6775,6800,3700,2750,5950,6275,0
686,2,0,157.0,157.0,204.0,220.0,4047,2177,3107,1483,940,694,900,1635,730,1057,170,578,75,57,5925,6675,3700,2750,6800,7043,0
693,2,0,160.0,167.0,204.0,212.0,3902,1482,2939,923,963,559,905,792,765,467,140,325,76,57,6225,6900,3700,2750,6800,7218,0
700,2,0,168.0,170.0,204.0,204.0,3706,1482,2743,923,963,559,405,461,395,147,10,314,76,57,6125,6900,3700,3200,6900,7318,0
707,2,0,168.0,174.0,204.0,204.0,3834,2300,2827,1651,1007,649,881,761,755,367,126,394,76,57,6775,7300,3700,3200,6900,7318,0
714,2,0,173.0,179.0,204.0,204.0,3924,2205,2939,1511,985,694,1012,312,870,42,142,270,76,57,7325,7425,3700,3200,7000,7318,0
721,2,0,181.0,179.0,204.0,196.0,4126,2418,3051,1679,1075,739,1115,609,845,247,270,362,76,57,7325,8300,3700,3200,7000,7418,0
729,2,0,183.0,176.0,204.0,196.0,4120,2709,3023,1903,1097,806,1292,945,1040,487,252,458,76,58,7925,8100,3700,3200,7100,7868,0
736,2,0,189.0,172.0,204.0,196.0,4070,2871,2995,2043,1075,828,1390,560,1010,277,380,283,76,58,8225,7400,3700,3200,7200,8668,0
743,2,0,195.0,174.0,204.0,196.0,4098,2793,3023,1987,1075,806,1477,266,965,62,512,204,76,58,8125,7400,3700,3200,7300,8668,0
750,2,0,187.0,180.0,204.0,196.0,4092,2843,2995,2015,1097,828,1874,377,1230,102,644,275,76,58,8325,7650,3700,3200,7800,8668,0
757,2,0,198.0,182.0,204.0,196.0,4120,2843,3023,2015,1097,828,1057,727,785,352,272,375,76,58,8325,7875,3700,3200,7800,8668,0
764,2,0,175.0,147.0,204.0,196.0,4064,2793,2967,1987,1097,806,1555,534,1155,142,400,392,78,58,8025,5375,3700,3200,9100,11268,0
7,0,2,13.0,13.0,15.0,15.0,251,293,251,293,0,0,30,35,30,35,0,0,12,12,0,0,0,0,0,0,1
14,0,2,14.0,14.0,15.0,15.0,643,671,643,671,0,0,65,70,65,70,0,0,13,13,0,0,0,0,0,0,1
21,0,2,14.0,14.0,15.0,15.0,643,699,643,699,0,0,40,50,40,50,0,0,13,13,0,0,0,0,0,0,1
29,0,2,15.0,15.0,15.0,15.0,671,727,671,727,0,0,80,45,80,45,0,0,14,14,0,0,0,0,0,0,1
36,0,2,15.0,15.0,15.0,23.0,727,783,727,783,0,0,130,145,130,145,0,0,14,14,0,0,0,0,0,0,1
43,0,2,16.0,16.0,23.0,23.0,783,811,783,811,0,0,65,35,65,35,0,0,15,15,0,0,0,0,0,0,1
50,0,2,16.0,17.0,23.0,23.0,783,811,783,811,0,0,35,60,35,60,0,0,15,16,0,0,0,0,0,0,1
57,0,2,17.0,18.0,23.0,23.0,755,811,755,811,0,0,55,55,55,55,0,0,16,17,0,0,0,0,0,0,1
64,0,2,18.0,19.0,23.0,23.0,839,923,839,923,0,0,95,120,95,120,0,0,17,18,0,0,0,0,0,0,1
71,0,2,18.0,19.0,23.0,23.0,771,951,727,951,44,0,78,235,70,235,8,0,17,18,0,0,0,0,0,0,1
79,0,2,19.0,20.0,23.0,23.0,827,951,671,951,156,0,133,340,105,340,28,0,18,19,0,0,0,0,0,0,1
86,0,2,19.0,20.0,23.0,23.0,928,995,615,951,313,44,243,68,175,60,68,8,18,19,0,0,0,150,0,0,1
93,0,2,20.0,20.0,23.0,23.0,978,1040,643,951,335,89,103,35,45,15,58,20,19,20,0,0,150,150,0,0,1
100,0,2,20.0,21.0,23.0,23.0,950,1085,615,951,335,134,219,36,125,0,94,36,19,20,0,0,150,150,0,0,1
107,0,2,20.0,21.0,31.0,23.0,984,1079,671,923,313,156,90,111,60,55,30,56,19,20,0,0,150,150,0,0,1
114,0,2,20.0,22.0,31.0,23.0,922,1023,699,867,223,156,199,132,145,60,54,72,19,21,0,0,150,150,0,0,1
121,0,2,21.0,23.0,31.0,23.0,945,1079,811,923,134,156,195,207,150,115,45,92,19,22,100,0,150,150,0,0,1
129,0,2,22.0,23.0,31.0,23.0,1141,1130,1007,951,134,179,291,121,230,80,61,41,20,22,100,0,150,300,0,0,1
136,0,2,22.0,26.0,31.0,31.0,1169,1158,1035,867,134,291,392,211,315,130,77,81,20,23,100,0,150,300,0,0,1
143,0,2,23.0,26.0,31.0,31.0,1197,1174,1063,839,134,335,143,41,50,20,93,21,21,23,100,0,150,300,0,0,1
150,0,2,23.0,29.0,31.0,31.0,1354,1230,1175,895,179,335,277,31,160,20,117,11,21,24,100,125,475,300,0,0,1
157,0,2,24.0,30.0,31.0,46.0,1421,1230,1175,895,246,335,349,67,250,20,99,47,22,24,100,125,475,300,0,50,1
164,0,2,28.0,30.0,31.0,46.0,1494,1258,1203,923,291,335,216,122,185,35,31,87,23,24,100,125,475,300,0,50,1
171,0,2,28.0,34.0,31.0,46.0,1494,1376,1203,1063,291,313,387,118,320,45,67,73,23,26,100,300,475,300,0,50,1
179,0,2,29.0,35.0,31.0,46.0,1538,1404,1203,1091,335,313,517,193,410,80,107,113,24,27,100,300,475,550,0,50,1
186,0,2,29.0,36.0,31.0,46.0,1376,1544,1063,1231,313,313,203,73,60,70,143,3,24,29,100,300,475,550,0,50,1
193,0,2,31.0,38.0,31.0,46.0,1404,1622,1091,1287,313,335,283,123,100,80,183,43,25,30,350,300,575,550,0,50,1
200,0,2,31.0,39.0,31.0,46.0,1516,1650,1203,1315,313,335,233,163,10,80,223,83,26,31,350,475,575,550,0,50,1
207,0,2,31.0,39.0,31.0,46.0,1510,1706,1175,1371,335,335,323,114,85,95,238,19,26,32,350,475,575,550,0,50,1
214,0,2,32.0,41.0,46.0,46.0,1510,1740,1175,1427,335,313,298,210,20,155,278,55,27,33,350,475,575,550,0,50,1
221,0,2,33.0,41.0,46.0,46.0,1538,1880,1203,1567,335,313,369,295,55,200,314,95,27,34,250,475,575,550,100,50,1
229,0,2,34.0,41.0,46.0,46.0,1572,1824,1259,1511,313,313,405,245,55,110,350,135,28,35,250,350,650,550,100,175,1
236,0,2,34.0,41.0,46.0,46.0,1572,1992,1259,1679,313,313,530,395,140,220,390,175,28,35,250,350,650,550,100,175,1
243,0,2,38.0,45.0,46.0,46.0,1656,1902,1343,1567,313,335,530,245,100,80,430,165,29,37,350,525,800,550,100,175,1
250,0,2,40.0,45.0,46.0,46.0,1510,2065,1175,1707,335,358,455,510,85,305,370,205,30,39,350,525,950,700,100,175,1
257,0,2,41.0,49.0,61.0,54.0,1790,2014,1455,1679,335,335,500,321,90,130,410,191,31,39,350,525,1050,950,100,175,1
264,0,2,44.0,51.0,61.0,54.0,1930,2020,1595,1707,335,313,381,282,35,105,346,177,33,39,450,700,1050,950,100,175,1
271,0,2,46.0,53.0,61.0,54.0,2154,1964,1819,1651,335,313,441,337,55,120,386,217,33,39,500,875,1050,1250,100,175,1
279,0,2,50.0,55.0,61.0,62.0,2216,2031,1903,1651,313,380,507,404,85,185,422,219,35,39,600,875,1050,1250,100,175,1
286,0,2,51.0,60.0,61.0,70.0,2272,2194,1959,1679,313,515,327,139,15,35,312,104,35,41,650,1650,1050,1250,100,175,1
293,0,2,56.0,60.0,61.0,70.0,2384,2171,2071,1679,313,492,437,320,85,160,352,160,38,41,700,1650,1050,1250,100,175,1
300,0,2,58.0,60.0,61.0,70.0,2518,2311,2183,1819,335,492,312,596,45,380,267,216,39,41,750,1650,1175,1250,100,175,1
307,0,2,61.0,68.0,61.0,78.0,2490,2250,2155,1735,335,515,417,171,110,95,307,76,41,41,800,2275,1175,1250,100,175,1
314,0,2,61.0,70.0,61.0,78.0,2238,2317,1903,1847,335,470,333,228,15,100,318,128,43,41,850,2450,1175,1250,100,175,1
321,0,2,64.0,70.0,69.0,78.0,2378,2261,2043,1791,335,470,638,508,280,320,358,188,43,43,925,2450,1425,1250,250,175,1
329,0,2,63.0,70.0,69.0,78.0,1908,2317,1595,1847,313,470,480,783,138,535,342,248,39,43,925,2450,1425,1250,500,175,1
336,0,2,58.0,80.0,77.0,86.0,2076,2395,1763,1903,313,492,530,258,173,150,357,108,36,43,875,3150,1425,1250,800,175,1
341,0,2,52.0,78.0,77.0,86.0,2154,2334,1819,1819,335,515,422,477,58,325,364,152,37,43,425,2975,1425,1250,1429,350,1
7,1,2,13.0,13.0,14.0,15.0,377,377,377,377,0,0,45,45,45,45,0,0,12,12,0,0,0,0,0,0,0
14,1,2,13.0,14.0,14.0,15.0,671,615,671,615,0,0,20,60,20,60,0,0,13,13,0,0,0,0,0,0,0
21,1,2,14.0,14.0,14.0,15.0,699,643,699,643,0,0,50,35,50,35,0,0,13,13,0,0,0,0,0,0,0
29,1,2,14.0,15.0,14.0,15.0,727,643,727,643,0,0,145,70,145,70,0,0,13,14,0,0,0,0,0,0,0
36,1,2,16.0,15.0,22.0,15.0,727,755,727,755,0,0,130,115,130,115,0,0,14,14,0,0,0,0,0,0,0
43,1,2,15.0,16.0,22.0,23.0,755,755,755,755,0,0,15,45,15,45,0,0,13,15,0,0,0,0,0,0,0
50,1,2,16.0,17.0,22.0,23.0,783,755,783,755,0,0,65,10,65,10,0,0,15,16,0,0,0,0,0,0,0
57,1,2,16.0,18.0,22.0,23.0,839,811,839,811,0,0,155,70,155,70,0,0,15,17,0,0,0,0,0,0,0
64,1,2,16.0,19.0,22.0,23.0,923,923,923,923,0,0,260,130,260,130,0,0,16,18,0,0,0,0,0,0,0
71,1,2,16.0,19.0,22.0,23.0,895,895,895,895,0,0,10,130,10,130,0,0,15,18,0,0,0,0,0,0,0
79,1,2,16.0,19.0,22.0,23.0,895,923,895,923,0,0,115,105,115,105,0,0,15,19,0,0,0,0,0,0,0
86,1,2,16.0,20.0,22.0,23.0,923,911,923,867,0,44,230,163,230,155,0,8,16,19,0,0,0,150,0,0,0
93,1,2,21.0,22.0,22.0,31.0,923,995,923,951,0,44,30,32,30,20,0,12,16,20,0,0,250,150,0,0,0
100,1,2,21.0,23.0,22.0,31.0,867,984,867,895,0,89,130,103,130,75,0,28,16,20,0,0,250,150,0,0,0
107,1,2,21.0,23.0,22.0,31.0,895,1062,895,951,0,111,140,130,140,90,0,40,16,20,100,100,250,150,0,0,0
114,1,2,22.0,26.0,22.0,31.0,867,1006,867,895,0,111,195,111,195,55,0,56,16,21,150,100,250,150,0,0,0
121,1,2,22.0,26.0,30.0,31.0,867,1107,867,951,0,156,300,316,300,240,0,76,16,21,150,100,250,150,0,0,0
129,1,2,21.0,29.0,30.0,31.0,867,1074,867,895,0,179,35,91,35,20,0,71,15,22,300,100,250,450,0,0,0
136,1,2,21.0,31.0,30.0,31.0,811,1130,811,951,0,179,130,96,130,30,0,66,15,22,300,200,250,450,0,0,0
143,1,2,23.0,32.0,36.0,39.0,839,1079,839,923,0,156,135,182,135,100,0,82,16,23,300,200,250,450,0,0,0
150,1,2,25.0,32.0,36.0,39.0,811,1096,811,895,0,201,85,160,85,50,0,110,16,23,300,200,250,450,0,0,0
157,1,2,27.0,33.0,36.0,39.0,866,1270,755,979,111,291,95,321,75,175,20,146,17,24,350,325,250,450,0,0,0
164,1,2,28.5,33.0,30.0,47.0,967,1236,811,923,156,313,110,471,70,285,40,186,17,24,325,450,250,450,375,0,0
171,1,2,29.0,34.0,30.0,47.0,967,1146,811,811,156,335,80,241,20,165,60,76,18,25,350,450,250,450,400,0,0
179,1,2,28.0,34.0,30.0,47.0,1046,1230,867,895,179,335,210,287,130,225,80,62,20,25,300,450,250,450,450,0,0
186,1,2,29.5,35.0,30.0,39.0,1102,1230,923,895,179,335,235,367,135,265,100,102,21,26,425,450,250,450,475,0,0
193,1,2,29.5,35.0,38.0,39.0,1062,1292,951,979,111,313,158,523,150,385,8,138,21,26,425,450,250,450,475,0,0
200,1,2,34.5,35.0,44.0,39.0,1007,1292,1007,979,0,313,33,183,25,5,8,178,23,27,425,450,250,450,475,0,0
207,1,2,36.5,35.0,44.0,39.0,1203,1348,1203,1035,0,313,33,348,25,130,8,218,23,27,425,450,250,450,475,0,0
214,1,2,38.5,39.0,44.0,39.0,1343,1342,1343,1007,0,335,103,153,95,45,8,108,24,27,625,450,250,750,475,0,0
221,1,2,38.5,40.0,44.0,47.0,1287,1348,1287,1035,0,313,153,269,145,125,8,144,25,28,625,450,250,750,475,0,0
229,1,2,39.5,40.0,44.0,47.0,1399,1370,1399,1035,0,335,278,379,270,195,8,184,26,28,625,450,250,750,475,0,0
236,1,2,43.5,39.0,52.0,47.0,1427,1348,1427,1035,0,313,253,540,245,320,8,220,27,29,625,325,250,750,475,125,0
243,1,2,44.0,39.0,52.0,47.0,1539,1404,1539,1091,0,313,333,660,325,400,8,260,28,29,700,625,250,750,550,125,0
250,1,2,45.0,43.0,52.0,47.0,1595,1398,1595,1063,0,335,103,385,95,235,8,150,31,30,700,625,250,750,550,125,0
257,1,2,45.5,46.0,52.0,47.0,1735,1404,1735,1091,0,313,168,246,160,110,8,136,33,31,675,525,250,750,575,225,0
264,1,2,43.5,46.0,52.0,47.0,1819,1264,1819,951,0,313,368,401,360,225,8,176,32,31,625,525,250,750,625,225,0
271,1,2,48.0,47.0,52.0,62.0,1847,1286,1847,951,0,335,248,206,240,140,8,66,32,32,600,525,250,750,650,225,0
279,1,2,52.0,51.0,52.0,62.0,1796,1510,1707,1175,89,335,134,306,110,200,24,106,31,32,600,825,375,750,650,225,0
286,1,2,55.0,53.0,60.0,62.0,1779,1432,1623,1119,156,313,139,482,95,340,44,142,31,34,850,1075,375,750,650,225,0
293,1,2,58.0,53.0,60.0,62.0,1830,1706,1651,1371,179,335,159,687,95,505,64,182,36,35,950,1075,375,750,700,225,0
300,1,2,57.5,54.0,60.0,62.0,1975,1712,1819,1399,156,313,305,373,225,180,80,193,39,36,825,950,500,750,825,350,0
307,1,2,60.0,55.0,60.0,62.0,2087,1740,1931,1427,156,313,195,178,95,95,100,83,41,37,800,1075,500,750,850,350,0
314,1,2,59.0,61.0,60.0,62.0,2115,1824,1959,1511,156,313,340,153,220,30,120,123,40,37,800,1475,500,750,850,350,0
321,1,2,59.5,61.0,60.0,70.0,2115,1818,1959,1483,156,335,445,413,305,250,140,163,43,37,925,1475,500,750,875,350,0
329,1,2,57.0,62.0,60.0,70.0,2059,1454,1903,1119,156,335,575,399,415,225,160,174,45,36,800,1600,500,750,1000,425,0
336,1,2,58.0,65.0,74.0,70.0,2171,1320,1903,1119,268,201,701,325,505,160,196,165,45,37,750,1600,500,750,1050,425,0
343,1,2,60.0,66.0,82.0,70.0,2367,1645,1875,1399,492,246,816,496,560,295,256,201,45,38,800,2025,500,750,1050,425,0
350,1,2,77.0,68.0,82.0,70.0,2339,1964,1847,1651,492,313,122,346,35,105,87,241,44,40,800,2025,700,750,1050,425,0
357,1,2,77.0,69.0,82.0,70.0,2373,1958,1903,1623,470,335,313,541,170,260,143,281,44,41,800,2025,700,750,1050,425,0
364,1,2,77.0,69.0,82.0,78.0,2451,2020,1959,1707,492,313,458,388,255,175,203,213,44,42,650,2025,700,750,1200,425,0
371,1,2,77.5,69.0,82.0,93.0,2339,2110,1847,1819,492,291,493,669,230,420,263,249,44,43,1375,2025,825,750,1525,425,0
379,1,2,78.5,70.0,90.0,93.0,2272,2216,1847,1903,425,313,366,630,55,495,311,135,42,43,1275,1900,825,750,1875,550,0
386,1,2,80.5,68.0,90.0,93.0,2283,2188,1903,1875,380,313,484,555,125,480,359,75,42,43,1525,1525,825,850,1875,925,0
393,1,2,88.5,69.0,90.0,93.0,2160,2210,1735,1875,425,335,82,679,50,560,32,119,42,43,1575,1750,825,850,1875,1050,0
400,1,2,89.5,69.0,90.0,93.0,2194,2250,1791,1735,403,515,191,656,115,465,76,191,42,43,2425,1750,825,1250,1875,1050,0
407,1,2,87.5,72.0,90.0,93.0,2395,2395,2015,1791,380,604,365,593,245,480,120,113,42,45,2325,2050,825,1250,1975,1100,0
414,1,2,89.0,75.0,98.0,93.0,2367,2059,1987,1455,380,604,153,475,85,390,68,85,42,44,2650,2400,825,1250,2050,1150,0
421,1,2,88.5,75.0,106.0,85.0,2507,2205,2127,1623,380,582,316,757,200,600,116,157,42,44,2425,2400,825,1150,2275,1350,0
429,1,2,81.0,71.0,114.0,85.0,2401,2446,2043,1819,358,627,480,998,395,765,85,233,42,44,2000,2000,825,1150,2850,1750,0
436,1,2,75.5,74.0,122.0,85.0,2451,2412,2071,1763,380,649,699,884,509,675,190,209,44,44,1675,2525,825,1150,3249,1925,0
443,1,2,76.0,66.0,122.0,85.0,2558,2496,2155,1847,403,649,858,1185,624,900,234,285,44,45,1550,1900,825,1150,3374,2550,0
450,1,2,80.5,60.0,122.0,85.0,2530,2182,2127,1623,403,559,796,821,514,730,282,91,44,42,1625,1550,825,1450,3424,3100,0
457,1,2,82.5,61.0,122.0,85.0,2535,1466,2155,1063,380,403,535,529,209,490,326,39,44,38,1675,1550,825,1450,3524,3300,0
464,1,2,80.0,58.0,122.0,70.0,2451,1432,2071,1007,380,425,743,266,369,175,374,91,45,40,1600,1550,825,1450,3749,4250,0
471,1,2,77.5,47.0,122.0,70.0,2457,844,2099,531,358,313,902,233,484,110,418,123,46,29,1475,1550,1075,1450,3574,4900,0
479,1,2,70.0,39.0,122.0,70.0,2530,480,2127,279,403,201,630,196,364,45,266,151,46,19,950,1550,1075,1450,4099,5400,0
486,1,2,74.5,39.0,122.0,62.0,2440,642,2015,419,425,223,388,215,174,40,214,175,50,17,1025,1550,1075,1450,4174,5800,0
493,1,2,71.0,38.0,122.0,62.0,2546,676,2099,587,447,89,570,308,304,125,266,183,49,16,1000,1750,1075,1450,4349,5850,0
500,1,2,70.0,34.0,122.0,62.0,2597,189,2127,167,470,22,821,308,499,125,322,183,54,14,900,1750,1075,1450,4449,6050,0
7,2,0,13.0,13.0,15.0,15.0,293,293,293,293,0,0,35,35,35,35,0,0,12,12,0,0,0,0,0,0,0
14,2,0,14.0,14.0,15.0,15.0,643,671,643,671,0,0,65,70,65,70,0,0,13,13,0,0,0,0,0,0,0
21,2,0,14.0,14.0,15.0,15.0,699,699,699,699,0,0,50,50,50,50,0,0,13,13,0,0,0,0,0,0,0
29,2,0,15.0,15.0,15.0,15.0,727,699,727,699,0,0,90,85,90,85,0,0,14,14,0,0,0,0,0,0,0
36,2,0,15.0,15.0,23.0,15.0,811,783,811,783,0,0,150,140,150,140,0,0,14,14,0,0,0,0,0,0,0
43,2,0,16.0,16.0,23.0,23.0,783,811,783,811,0,0,35,75,35,75,0,0,15,15,0,0,0,0,0,0,0
50,2,0,17.0,16.0,23.0,23.0,839,783,839,783,0,0,15,40,15,40,0,0,16,15,0,0,0,0,0,0,0
57,2,0,18.0,17.0,23.0,23.0,839,727,839,727,0,0,65,85,65,85,0,0,17,16,0,0,0,0,0,0,0
64,2,0,19.0,18.0,23.0,23.0,951,811,951,811,0,0,135,130,135,130,0,0,18,17,0,0,0,0,0,0,0
71,2,0,19.0,18.0,23.0,23.0,917,799,895,755,22,44,244,173,240,165,4,8,18,17,0,0,0,0,0,0,0
79,2,0,20.0,19.0,23.0,23.0,1006,883,895,727,111,156,365,293,345,265,20,28,19,18,0,0,0,0,0,0,0
86,2,0,20.0,19.0,23.0,23.0,973,911,839,755,134,156,331,398,295,350,36,48,19,18,0,0,150,0,0,0,0
93,2,0,20.0,20.0,23.0,23.0,1001,883,867,727,134,156,52,348,0,280,52,68,20,19,0,0,150,150,0,0,0
100,2,0,20.0,20.0,23.0,23.0,1074,906,895,727,179,179,182,468,110,380,72,88,20,19,0,0,150,150,0,0,0
107,2,0,21.0,21.0,23.0,23.0,1079,1018,923,839,156,179,153,93,65,35,88,58,20,19,0,50,150,150,0,0,0
114,2,0,21.0,21.0,23.0,23.0,1051,939,895,783,156,156,153,89,45,15,108,74,20,19,0,50,150,150,0,0,0
121,2,0,24.0,22.0,31.0,23.0,1051,939,895,783,156,156,53,159,0,65,53,94,21,19,0,50,300,150,0,0,0
129,2,0,25.0,22.0,31.0,23.0,1079,1051,923,895,156,156,138,39,65,25,73,14,22,19,0,50,300,150,0,0,0
136,2,0,25.0,23.0,31.0,31.0,1079,1051,923,895,156,156,218,124,125,90,93,34,22,20,0,50,300,150,0,0,0
143,2,0,26.0,24.0,31.0,31.0,1163,1191,895,1035,268,156,104,124,75,70,29,54,23,21,125,150,300,150,0,0,0
150,2,0,28.0,24.0,31.0,31.0,1180,1298,867,1119,313,179,30,99,15,75,15,24,23,21,125,150,300,150,0,0,0
157,2,0,29.0,25.0,31.0,31.0,1258,1242,923,1063,335,179,190,129,135,85,55,44,24,22,125,150,300,150,0,0,0
164,2,0,30.0,25.0,46.0,31.0,1264,1303,951,1147,313,156,136,220,45,160,91,60,25,22,125,150,300,150,0,0,0
171,2,0,31.0,26.0,46.0,31.0,1236,1275,923,1119,313,156,241,360,110,280,131,80,25,23,300,150,300,500,0,0,0
179,2,0,32.0,29.0,46.0,46.0,1270,1342,979,1119,291,223,357,272,190,160,167,112,27,24,300,150,300,500,0,0,0
186,2,0,35.0,31.0,46.0,46.0,1426,1298,1091,1007,335,291,327,63,220,15,107,48,27,24,300,150,550,600,0,0,0
193,2,0,40.0,32.0,46.0,46.0,1460,1370,1147,1035,313,335,88,133,45,45,43,88,28,25,300,150,550,600,0,0,0
200,2,0,40.0,31.0,46.0,46.0,1538,1510,1203,1175,335,335,233,133,150,30,83,103,28,25,300,150,550,600,50,100,0
207,2,0,41.0,34.0,46.0,46.0,1572,1460,1259,1147,313,313,274,239,155,100,119,139,29,26,450,250,550,600,50,100,0
214,2,0,42.0,35.0,46.0,46.0,1555,1566,1287,1231,268,335,161,304,10,125,151,179,30,26,450,250,700,675,50,100,0
221,2,0,44.0,38.0,46.0,46.0,1606,1768,1315,1455,291,313,362,340,175,150,187,190,31,28,825,350,700,925,50,100,0
229,2,0,44.0,42.0,54.0,46.0,1762,1684,1427,1371,335,313,282,105,55,75,227,30,31,29,825,350,700,925,50,100,0
236,2,0,50.0,43.0,54.0,46.0,1740,1824,1427,1511,313,313,78,205,15,135,63,70,32,30,975,350,700,925,50,100,0
243,2,0,50.0,45.0,54.0,46.0,1734,2014,1399,1679,335,335,288,365,185,255,103,110,33,31,1125,450,700,1000,50,100,0
250,2,0,51.0,46.0,54.0,46.0,1762,1981,1427,1623,335,358,448,190,305,40,143,150,34,32,1375,450,700,1000,50,100,0
257,2,0,53.0,51.0,54.0,54.0,1852,1824,1539,1511,313,313,374,87,370,30,4,57,34,33,1375,500,700,1000,50,100,0
264,2,0,54.0,52.0,54.0,54.0,1880,2020,1567,1707,313,313,400,177,360,80,40,97,34,34,1525,500,700,1000,50,100,0
271,2,0,54.0,53.0,54.0,54.0,1852,2132,1539,1819,313,313,446,87,370,50,76,37,34,35,1525,850,850,1000,50,100,0
279,2,0,57.0,54.0,70.0,54.0,1908,1992,1595,1679,313,313,506,149,440,72,66,77,35,37,1625,850,1000,1000,50,100,0
286,2,0,65.0,59.0,70.0,62.0,1908,1953,1595,1595,313,358,266,219,210,98,56,121,36,37,2175,1125,1000,1000,50,100,0
293,2,0,65.0,61.0,78.0,62.0,1908,1807,1595,1427,313,380,402,128,310,92,92,36,38,38,2175,1025,1000,1000,50,222,0
300,2,0,62.0,62.0,78.0,62.0,2014,1253,1567,1007,447,246,588,104,440,44,148,60,38,39,1850,975,1000,900,375,386,0
307,2,0,70.0,59.0,86.0,62.0,2087,1096,1595,895,492,201,344,142,140,54,204,88,39,38,1950,925,1000,900,475,536,0
314,2,0,70.0,62.0,86.0,70.0,2115,1230,1623,1007,492,223,609,145,345,29,264,116,39,40,2150,925,1000,900,475,536,0
321,2,0,64.0,51.0,86.0,70.0,2149,1202,1679,979,470,223,880,183,560,39,320,144,41,34,1775,475,1000,900,850,1336,0
329,2,0,66.0,49.0,86.0,85.0,2255,1018,1763,839,492,179,445,253,265,89,180,164,41,34,2175,775,1000,900,1150,1711,0
336,2,0,67.0,40.0,86.0,77.0,2283,687,1791,531,492,156,666,244,430,64,236,180,41,30,2175,475,1000,900,1150,2336,0
343,2,0,66.0,35.0,86.0,77.0,2261,329,1791,195,470,134,892,235,600,39,292,196,42,28,2075,150,1000,900,1250,2811,0
350,2,0,62.0,31.0,86.0,77.0,2317,525,1847,391,470,134,1167,136,815,49,352,87,42,24,1725,100,1000,900,1600,3111,0
355,2,0,62.0,26.0,86.0,77.0,2317,670,1847,559,470,111,1167,139,815,44,352,95,42,20,1725,50,1000,900,1600,3411,0
7,1,2,13.0,13.0,14.0,15.0,293,293,293,293,0,0,35,35,35,35,0,0,12,12,0,0,0,0,0,0,0
14,1,2,13.0,13.0,14.0,15.0,671,643,671,643,0,0,20,15,20,15,0,0,13,13,0,0,0,0,0,0,0
21,1,2,14.0,14.0,14.0,15.0,727,671,727,671,0,0,55,40,55,40,0,0,13,13,0,0,0,0,0,0,0
29,1,2,14.0,15.0,14.0,15.0,755,727,755,727,0,0,155,80,155,80,0,0,13,14,0,0,0,0,0,0,0
36,1,2,16.0,16.0,22.0,23.0,811,727,811,727,0,0,155,115,155,115,0,0,14,15,0,0,0,0,0,0,0
43,1,2,16.0,16.0,22.0,23.0,783,755,783,755,0,0,240,55,240,55,0,0,14,15,0,0,0,0,0,0,0
50,1,2,15.0,17.0,22.0,23.0,839,755,839,755,0,0,40,20,40,20,0,0,15,16,0,0,0,0,0,0,0
57,1,2,17.0,18.0,22.0,23.0,839,839,839,839,0,0,45,75,45,75,0,0,15,17,0,0,0,0,0,0,0
64,1,2,18.0,18.0,22.0,23.0,923,867,923,867,0,0,100,130,100,130,0,0,16,17,0,0,0,0,0,0,0
71,1,2,17.0,19.0,22.0,23.0,867,951,867,951,0,0,180,245,180,245,0,0,17,18,0,0,0,0,0,0,0
79,1,2,17.0,19.0,22.0,23.0,867,995,867,951,0,44,35,368,35,360,0,8,16,18,0,0,0,0,0,0,0
86,1,2,18.0,20.0,22.0,23.0,951,995,951,951,0,44,105,32,105,20,0,12,16,19,0,0,0,150,0,0,0
93,1,2,19.0,20.0,22.0,23.0,923,1046,923,979,0,67,155,155,155,135,0,20,18,20,0,0,0,150,0,0,0
100,1,2,20.0,21.0,22.0,23.0,990,984,923,895,67,89,227,72,215,40,12,32,18,20,0,0,0,150,0,0,0
107,1,2,20.0,21.0,22.0,23.0,1029,1118,895,1007,134,111,338,129,310,85,28,44,19,20,0,0,0,150,0,0,0
114,1,2,20.0,22.0,22.0,23.0,1051,1057,895,923,156,134,363,99,315,35,48,64,20,21,0,0,0,150,0,0,0
121,1,2,24.0,23.0,28.0,23.0,1102,1135,923,979,179,156,188,189,120,105,68,84,20,22,0,0,250,150,0,0,0
129,1,2,26.0,23.0,36.0,23.0,1051,1135,895,979,156,156,204,319,120,215,84,104,20,22,0,0,250,150,0,0,0
136,1,2,28.0,26.0,36.0,31.0,1085,1275,951,1007,134,268,40,190,40,125,0,65,20,23,0,0,250,300,0,0,0
143,1,2,28.0,26.0,36.0,31.0,1023,1320,979,1007,44,313,160,296,160,195,0,101,20,23,100,0,250,300,0,0,0
150,1,2,30.0,27.0,36.0,31.0,1007,1242,1007,951,0,291,185,63,185,55,0,8,22,24,100,0,250,300,0,0,0
157,1,2,29.0,29.0,36.0,46.0,1203,1264,1203,951,0,313,35,208,35,160,0,48,23,24,400,125,250,300,0,0,0
164,1,2,30.0,31.0,36.0,46.0,1231,1342,1231,1007,0,335,130,268,130,180,0,88,23,25,400,125,250,300,0,0,0
171,1,2,32.0,31.0,36.0,46.0,1315,1320,1315,1007,0,313,40,169,40,145,0,24,24,27,400,250,250,300,0,0,0
179,1,2,35.0,33.0,36.0,46.0,1343,1286,1343,1063,0,223,50,218,50,170,0,48,24,27,400,250,250,300,0,0,0
186,1,2,35.5,35.0,36.0,46.0,1399,1477,1399,1231,0,246,165,130,165,75,0,55,24,27,375,250,250,550,25,0,0
193,1,2,38.5,35.0,44.0,46.0,1399,1516,1399,1315,0,201,190,160,190,85,0,75,26,29,425,250,250,550,25,0,0
200,1,2,42.5,37.0,44.0,46.0,1483,1544,1483,1343,0,201,65,53,65,50,0,3,26,29,425,250,250,550,25,0,0
207,1,2,43.5,37.0,44.0,46.0,1343,1673,1343,1427,0,246,170,100,170,65,0,35,29,31,625,250,250,550,25,0,0
214,1,2,41.5,39.0,44.0,46.0,1527,1757,1483,1511,44,246,183,193,175,155,8,38,31,31,675,375,250,800,25,0,0
221,1,2,44.5,41.0,52.0,46.0,1695,1712,1539,1511,156,201,248,137,220,75,28,62,31,31,675,375,250,800,25,0,0
229,1,2,49.5,43.0,58.0,46.0,1723,1762,1567,1539,156,223,199,140,155,50,44,90,33,31,675,375,250,800,25,0,0
236,1,2,50.5,43.0,58.0,46.0,1779,1740,1623,1539,156,201,179,259,115,145,64,114,38,31,675,375,250,950,25,0,0
243,1,2,49.5,43.0,58.0,54.0,1830,1768,1651,1567,179,201,303,462,215,320,88,142,39,33,675,375,250,1100,25,0,0
250,1,2,50.5,49.0,66.0,54.0,1942,1869,1651,1623,291,246,498,230,370,110,128,120,39,33,675,1000,250,1100,25,0,0
257,1,2,62.5,49.0,74.0,62.0,2098,1891,1763,1623,335,268,163,457,95,305,68,152,39,33,675,1000,450,1250,25,0,0
264,1,2,65.5,57.0,74.0,62.0,2289,1930,1931,1707,358,223,288,181,180,105,108,76,39,35,725,1000,450,1250,25,0,0
271,1,2,70.5,59.0,74.0,70.0,2210,2009,1875,1763,335,246,199,324,55,220,144,104,39,35,925,1500,450,1250,25,0,0
279,1,2,72.5,59.0,74.0,70.0,2272,2037,1959,1791,313,246,365,551,185,415,180,136,39,37,1475,1500,600,1250,25,0,0
286,1,2,64.0,55.0,82.0,70.0,2244,2121,1931,1875,313,246,530,809,310,645,220,164,39,37,1100,1250,600,1250,550,250,0
293,1,2,63.5,55.0,82.0,70.0,2272,2003,1959,1735,313,268,545,440,285,340,260,100,38,37,1075,1250,600,1250,825,750,0
300,1,2,66.5,49.0,82.0,70.0,2216,2104,1903,1791,313,313,565,691,265,555,300,136,38,37,1075,875,600,1250,925,1125,0
307,1,2,69.5,49.0,82.0,70.0,2322,2042,1987,1707,335,335,425,836,160,660,265,176,38,37,1225,750,600,1250,1025,1250,0
314,1,2,72.0,61.0,82.0,78.0,2233,2104,1875,1791,358,313,375,117,220,105,155,12,38,39,1500,750,600,1250,1100,1250,0
321,1,2,73.0,61.0,82.0,78.0,2182,2042,1847,1707,335,335,581,367,390,315,191,52,39,39,1700,1250,600,1250,1100,1250,0
329,1,2,72.5,61.0,90.0,78.0,2160,2076,1847,1763,313,313,687,618,460,530,227,88,41,39,1725,1250,600,1250,1275,1250,0
336,1,2,76.5,71.0,90.0,86.0,2160,2160,1847,1847,313,313,522,288,355,260,167,28,42,39,1725,1250,600,1250,1275,1250,0
343,1,2,85.5,71.0,90.0,86.0,2160,2076,1847,1763,313,313,92,288,85,220,7,68,45,39,1825,2125,600,1250,1275,1250,0
350,1,2,87.5,75.0,98.0,86.0,2356,2210,2043,1875,313,335,232,83,185,75,47,8,45,41,1825,2125,600,1250,1275,1250,0
357,1,2,94.5,77.0,98.0,86.0,2362,2149,1959,1791,403,358,155,233,60,185,95,48,45,41,2025,2125,600,1250,1275,1250,0
364,1,2,97.5,77.0,98.0,94.0,2563,2216,2071,1903,492,313,231,390,105,310,126,80,45,41,2375,2125,600,1250,1275,1250,0
371,1,2,98.0,77.0,98.0,94.0,2513,2227,2043,1735,470,492,227,667,120,515,107,152,45,43,2450,2125,600,1250,1300,1250,0
379,1,2,98.0,83.0,98.0,94.0,2569,2334,2099,1707,470,627,432,523,265,370,167,153,45,43,2700,2250,600,1250,1300,1250,0
386,1,2,108.0,85.0,114.0,102.0,2513,2250,2043,1623,470,627,152,673,75,465,77,208,45,45,3000,2925,600,1250,1400,1250,0
393,1,2,113.0,85.0,122.0,102.0,2591,2356,2099,1707,492,649,197,368,60,80,137,288,45,45,3000,2925,600,1250,1400,1250,0
400,1,2,114.0,86.0,122.0,102.0,2670,2513,2155,1819,515,694,297,563,150,270,147,293,45,45,3400,2925,850,1250,1500,1250,0
407,1,2,116.0,86.0,122.0,110.0,2614,2462,2099,1791,515,671,113,859,35,490,78,369,49,45,3600,2925,850,1250,1500,1250,0
414,1,2,122.0,94.0,122.0,118.0,2731,2468,2239,1819,492,649,79,651,70,310,9,341,50,45,3700,2925,850,1250,1500,1250,0
421,1,2,121.5,96.0,122.0,118.0,2647,2468,2155,1819,492,649,174,406,105,135,69,271,50,45,3825,3525,850,1250,1525,1250,0
429,1,2,123.0,93.0,130.0,118.0,2843,2418,2239,1791,604,627,314,693,215,350,99,343,50,44,3800,3400,850,1250,1650,1425,0
436,1,2,124.5,89.0,138.0,102.0,2860,2474,2211,1847,649,627,249,998,170,575,79,423,50,46,3725,3150,850,1250,1975,1375,0
443,1,2,126.0,81.0,146.0,102.0,2860,2490,2211,1819,649,671,74,1298,15,795,59,503,50,46,3200,2650,850,1250,2500,1875,0
450,1,2,119.5,77.0,146.0,102.0,2776,2518,2239,1847,537,671,166,1598,55,1015,111,583,45,46,3475,2400,850,1400,2925,2525,0
457,1,2,114.5,74.0,146.0,102.0,2530,2446,2127,1819,403,627,214,1370,55,865,159,505,45,45,3325,1900,850,1400,3475,3075,0
464,1,2,116.0,70.0,146.0,102.0,2350,2490,2015,1819,335,671,287,795,92,260,195,535,45,45,3400,1975,850,1400,3700,3700,0
471,1,2,118.0,74.0,146.0,102.0,2266,2468,1931,1819,335,649,411,511,172,100,239,411,45,45,3550,1975,850,1400,3700,3700,0
479,1,2,124.0,74.0,146.0,102.0,2042,2502,1595,1875,447,627,346,812,47,325,299,487,46,47,3950,1975,850,1400,3700,3700,0
486,1,2,123.5,74.0,146.0,118.0,2255,2502,1763,1875,492,627,436,1017,77,450,359,567,50,47,3775,1975,850,1400,3875,3400,0
493,1,2,126.5,82.0,146.0,118.0,2558,2490,2043,1819,515,671,595,602,172,155,423,447,53,47,3775,2675,850,1400,3875,3400,0
500,1,2,127.5,82.0,146.0,118.0,2731,2552,2015,1903,716,649,413,823,102,300,311,523,54,47,3775,3050,850,1400,3875,3400,0
507,1,2,129.5,84.0,146.0,118.0,2899,2440,2071,1791,828,649,558,1004,222,405,336,599,54,47,3925,3050,850,1400,3875,3400,0
514,1,2,134.5,92.0,146.0,118.0,2966,2406,2183,1735,783,671,450,394,22,115,428,279,56,49,4025,3050,850,1400,3875,3400,0
521,1,2,135.5,92.0,146.0,118.0,2989,2194,2183,1567,806,627,760,501,232,150,528,351,56,49,4275,3650,850,1400,3875,3400,0
529,1,2,135.5,90.0,162.0,118.0,2916,2110,2043,1483,873,627,899,616,267,185,632,431,59,49,4175,3525,850,1500,3975,3525,0
536,1,2,139.5,90.0,162.0,118.0,3134,2182,2239,1511,895,671,978,876,242,365,736,511,59,49,4325,3525,850,1500,3975,3525,0
543,1,2,138.5,98.0,170.0,118.0,3179,2294,2239,1623,940,671,964,401,112,110,852,291,59,49,4325,4175,850,1500,4025,3525,0
550,1,2,134.0,92.0,170.0,118.0,3218,2110,2211,1483,1007,627,1084,648,112,285,972,363,59,49,4100,3650,850,1500,4500,4050,0
557,1,2,131.5,76.0,178.0,118.0,3174,2238,2211,1567,963,671,1106,913,97,470,1009,443,59,49,3625,2300,850,1400,4975,5500,0
7,0,2,13.0,13.0,15.0,15.0,293,293,293,293,0,0,35,35,35,35,0,0,12,12,0,0,0,0,0,0,1
14,0,2,14.0,14.0,15.0,15.0,671,671,671,671,0,0,70,70,70,70,0,0,13,13,0,0,0,0,0,0,1
21,0,2,14.0,14.0,15.0,15.0,727,727,727,727,0,0,0,0,0,0,0,0,13,13,0,0,0,0,0,0,1
29,0,2,15.0,15.0,15.0,15.0,671,671,671,671,0,0,85,85,85,85,0,0,14,14,0,0,0,0,0,0,1
36,0,2,15.0,15.0,15.0,23.0,755,811,755,811,0,0,135,145,135,145,0,0,14,14,0,0,0,0,0,0,1
43,0,2,16.0,16.0,23.0,23.0,783,811,783,811,0,0,75,35,75,35,0,0,15,15,0,0,0,0,0,0,1
50,0,2,16.0,17.0,23.0,23.0,839,867,839,867,0,0,45,15,45,15,0,0,15,16,0,0,0,0,0,0,1
57,0,2,17.0,18.0,23.0,23.0,755,839,755,839,0,0,40,70,40,70,0,0,16,17,0,0,0,0,0,0,1
64,0,2,18.0,19.0,23.0,23.0,839,979,839,979,0,0,135,190,135,190,0,0,17,18,0,0,0,0,0,0,1
71,0,2,18.0,19.0,23.0,23.0,878,1001,811,979,67,22,232,249,220,245,12,4,17,18,0,0,0,0,0,0,1
79,0,2,19.0,20.0,23.0,23.0,967,990,811,923,156,67,347,367,315,355,32,12,18,19,0,0,0,0,0,0,1
86,0,2,19.0,20.0,23.0,23.0,883,1046,727,979,156,67,452,490,400,470,52,20,18,19,0,0,0,0,0,0,1
93,0,2,20.0,20.0,23.0,23.0,911,1018,755,951,156,67,362,58,290,30,72,28,19,20,0,0,150,150,0,0,1
100,0,2,20.0,21.0,23.0,23.0,939,1057,783,923,156,134,472,129,380,85,92,44,19,20,0,0,150,150,0,0,1
107,0,2,20.0,21.0,23.0,23.0,962,1085,783,951,179,134,187,110,75,50,112,60,19,20,50,0,150,150,0,0,1
114,0,2,20.0,21.0,23.0,23.0,934,1057,755,923,179,134,297,116,165,40,132,76,19,20,50,0,150,150,0,50,1
121,0,2,21.0,22.0,23.0,31.0,911,1102,755,923,156,179,103,191,55,95,48,96,19,21,50,0,150,150,0,50,1
129,0,2,22.0,24.0,23.0,31.0,1051,1102,895,923,156,179,93,41,75,0,18,41,20,21,50,0,150,300,0,50,1
136,0,2,22.0,25.0,23.0,31.0,1023,1102,867,923,156,179,123,176,85,115,38,61,20,22,50,0,150,300,0,50,1
143,0,2,23.0,26.0,23.0,31.0,1107,1242,951,951,156,291,113,161,55,85,58,76,21,23,50,0,150,300,0,50,1
150,0,2,23.0,29.0,23.0,31.0,1135,1236,979,923,156,313,133,52,55,40,78,12,21,24,50,125,150,300,0,50,1
157,0,2,24.0,29.0,31.0,31.0,1130,1264,951,951,179,313,213,157,115,105,98,52,22,24,50,125,150,300,0,50,1
164,0,2,28.0,30.0,31.0,46.0,1135,1264,979,951,156,313,159,267,70,175,89,92,22,25,50,125,500,300,0,50,1
171,0,2,29.0,32.0,31.0,46.0,1163,1398,1007,1063,156,335,54,177,45,45,9,132,23,26,50,125,500,300,0,50,1
179,0,2,29.0,35.0,46.0,46.0,1449,1398,1203,1063,246,335,95,212,50,65,45,147,24,27,150,250,600,300,0,50,1
186,0,2,32.0,37.0,46.0,46.0,1404,1510,1091,1175,313,335,95,288,35,105,60,183,24,29,250,250,600,550,0,50,1
193,0,2,34.0,38.0,46.0,46.0,1432,1594,1119,1259,313,335,180,128,80,55,100,73,24,30,250,250,600,550,0,50,1
200,0,2,35.0,39.0,46.0,46.0,1650,1684,1315,1371,335,313,220,224,80,115,140,109,25,31,250,250,600,550,0,50,1
207,0,2,38.0,41.0,46.0,46.0,1533,1740,1175,1427,358,313,155,279,75,130,80,149,25,33,400,375,850,550,0,50,1
214,0,2,43.0,42.0,46.0,46.0,1706,1740,1371,1427,335,313,121,239,30,50,91,189,26,34,450,375,850,550,0,50,1
221,0,2,44.0,44.0,46.0,46.0,1824,1874,1511,1539,313,335,287,369,160,140,127,229,27,36,450,375,850,700,0,50,1
229,0,2,46.0,44.0,46.0,54.0,1908,1936,1595,1623,313,313,217,491,50,230,167,261,29,36,450,375,850,700,0,50,1
236,0,2,48.0,46.0,54.0,54.0,1880,1958,1567,1623,313,335,392,686,210,385,182,301,29,38,650,375,850,700,0,50,1
243,0,2,50.0,51.0,54.0,62.0,2020,1998,1707,1707,313,291,312,518,115,285,197,233,31,39,850,725,850,800,0,50,1
250,0,2,50.0,52.0,62.0,62.0,1925,2020,1567,1707,358,313,407,368,170,95,237,273,31,40,950,725,850,800,0,50,1
257,0,2,57.0,52.0,62.0,62.0,2037,2160,1679,1847,358,313,187,528,35,215,152,313,33,42,950,725,1000,800,0,50,1
264,0,2,57.0,56.0,62.0,62.0,2020,2188,1707,1875,313,313,324,298,140,195,184,103,33,42,950,725,1000,1100,0,50,1
271,0,2,59.0,58.0,62.0,70.0,2188,2216,1875,1903,313,313,234,128,210,85,24,43,35,42,950,725,1000,1100,0,50,1
279,0,2,62.0,59.0,62.0,70.0,2244,2289,1931,1931,313,358,299,143,235,60,64,83,35,43,1050,1225,1125,1100,0,50,1
286,0,2,65.0,60.0,70.0,70.0,2384,2272,2071,1959,313,313,349,220,245,105,104,115,37,44,1325,1225,1125,1100,0,50,1
293,0,2,64.0,62.0,70.0,70.0,2294,2300,1959,1987,335,313,604,436,460,285,144,151,37,46,1275,1225,1275,1100,50,50,1
300,0,2,60.0,62.0,70.0,70.0,1410,2328,1119,2015,291,313,552,557,380,370,172,187,32,46,1325,1225,1275,1100,400,50,1
307,0,2,60.0,64.0,78.0,70.0,89,2177,0,1819,89,358,560,665,380,430,180,235,32,48,1375,1225,1275,1100,400,50,1
314,0,2,60.0,64.0,78.0,70.0,67,2401,0,1931,67,470,368,905,180,610,188,295,32,48,1575,1225,1275,1500,600,50,1
321,0,2,53.0,50.0,70.0,93.0,654,2093,587,1623,67,470,381,995,185,640,196,355,28,34,1475,1225,1275,1500,1050,850,1
329,0,2,53.0,55.0,70.0,93.0,1314,1942,1203,1427,111,515,532,340,320,225,212,115,28,36,1575,1325,1275,1500,1150,1100,1
336,0,2,54.0,56.0,70.0,93.0,1348,1975,1035,1483,313,492,392,467,240,300,152,167,29,37,1575,1325,1275,1650,1200,1100,1
343,0,2,57.0,57.0,70.0,93.0,1348,2065,1035,1595,313,470,419,663,235,440,184,223,29,40,1575,1075,1275,1650,1200,1350,1
350,0,2,59.0,59.0,70.0,93.0,1292,2149,979,1679,313,470,489,283,265,75,224,208,31,41,1575,1075,1275,1650,1200,1350,1
357,0,2,59.0,66.0,70.0,93.0,1611,2244,1231,1819,380,425,606,200,330,140,276,60,31,44,1725,1075,1275,1650,1200,1350,1
364,0,2,63.0,68.0,70.0,93.0,1790,2429,1343,1959,447,470,391,405,155,285,236,120,33,46,1725,1375,1275,1650,1200,1350,1
371,0,2,65.0,73.0,70.0,93.0,1869,2563,1399,2071,470,492,417,130,125,50,292,80,35,47,1725,1475,1275,1650,1200,1350,1
379,0,2,67.0,76.0,70.0,93.0,1942,2530,1427,2015,515,515,324,290,103,150,221,140,35,50,1825,1475,1275,1650,1200,1350,1
386,0,2,67.0,78.0,70.0,93.0,2065,2462,1595,2015,470,447,466,424,195,240,271,184,37,50,1725,1575,1275,1650,1300,1350,1
393,0,2,69.0,84.0,78.0,93.0,2485,2334,2015,1931,470,403,616,456,285,220,331,236,37,53,1725,1575,1275,1650,1300,1350,1
400,0,2,73.0,86.0,78.0,93.0,2541,2737,2071,2267,470,470,491,646,125,350,366,296,39,54,1850,1775,1375,2250,1300,1350,1
407,0,2,77.0,91.0,78.0,93.0,2709,2933,2239,2463,470,470,311,207,110,105,201,102,39,56,1850,2150,1375,2350,1300,1350,1
414,0,2,77.0,93.0,78.0,93.0,2591,3022,2099,2575,492,447,196,318,35,160,161,158,41,58,1950,2150,1525,2350,1300,1350,1
421,0,2,78.0,93.0,78.0,93.0,2446,3067,1931,2575,515,492,387,279,170,65,217,214,41,58,2050,2600,1525,2350,1300,1350,1
429,0,2,78.0,93.0,78.0,93.0,2558,3095,2043,2603,515,492,237,454,60,280,177,174,42,58,2150,2600,1525,2350,1300,1350,1
436,0,2,91.0,93.0,94.0,101.0,2569,3073,2099,2603,470,470,339,615,110,385,229,230,42,58,2350,2600,1525,2350,1300,1350,1
443,0,2,93.0,101.0,94.0,109.0,2429,3050,1959,2603,470,447,354,476,165,190,189,286,42,58,2350,3250,1525,2350,1300,1350,1
450,0,2,94.0,103.0,94.0,109.0,2597,3095,2127,2603,470,492,629,756,380,410,249,346,43,58,2350,3250,1725,2350,1325,1350,1
457,0,2,94.0,107.0,94.0,149.0,2787,3123,2295,2631,492,492,339,836,205,430,134,406,43,59,2900,3250,1725,2650,1325,1350,1
464,0,2,105.0,119.0,110.0,149.0,2815,3179,2323,2687,492,492,419,427,250,65,169,362,43,60,3100,3850,1725,2650,1325,1350,1
471,0,2,106.0,119.0,110.0,149.0,2754,3202,2239,2687,515,515,540,662,315,240,225,422,43,60,3350,3850,1725,2650,1325,1350,1
479,0,2,110.0,123.0,110.0,149.0,2698,3095,2183,2603,515,492,450,488,365,260,85,228,43,60,3400,3850,1725,2650,1325,1350,1
486,0,2,117.0,129.0,118.0,149.0,2877,3073,2407,2603,470,470,377,304,290,145,87,159,43,60,4000,4275,1725,2650,1325,1475,1
493,0,2,113.0,133.0,126.0,149.0,2597,3185,2127,2715,470,470,492,369,345,275,147,94,41,60,3800,4900,1725,2750,1625,1475,1
500,0,2,108.0,123.0,126.0,149.0,1751,3207,1483,2715,268,492,661,754,490,600,171,154,37,60,3800,4750,1725,2900,1975,1975,1
507,0,2,111.0,131.0,126.0,149.0,1438,3129,1259,2659,179,470,541,230,400,20,141,210,37,60,4000,4650,1725,2900,2075,2075,1
514,0,2,104.0,131.0,134.0,149.0,1382,3006,1203,2491,179,515,356,585,245,315,111,270,36,60,3600,5150,1725,2900,2575,2075,1
521,0,2,90.0,119.0,134.0,149.0,1163,3095,1007,2603,156,492,497,951,370,625,127,326,30,60,3550,4400,1725,2900,3400,2825,1
529,0,2,95.0,119.0,134.0,157.0,1219,3017,1063,2547,156,470,289,637,192,355,97,282,30,60,3800,4050,1725,3200,3450,3475,1
536,0,2,95.0,127.0,134.0,157.0,1191,2989,1035,2519,156,470,186,582,95,240,91,342,30,60,3750,4450,1725,3400,3550,3475,1
543,0,2,75.0,121.0,134.0,157.0,1135,3011,979,2519,156,492,291,977,187,575,104,402,28,60,2675,3900,1725,3500,4725,4025,1
7,1,1,13.0,13.0,14.0,14.0,377,335,377,335,0,0,45,40,45,40,0,0,12,12,0,0,0,0,0,0,0
14,1,1,13.0,13.0,14.0,14.0,643,671,643,671,0,0,15,20,15,20,0,0,13,13,0,0,0,0,0,0,0
21,1,1,14.0,14.0,14.0,14.0,699,699,699,699,0,0,50,45,50,45,0,0,13,13,0,0,0,0,0,0,0
29,1,1,14.0,14.0,14.0,14.0,727,727,727,727,0,0,145,140,145,140,0,0,13,13,0,0,0,0,0,0,0
36,1,1,16.0,16.0,22.0,22.0,755,755,755,755,0,0,140,140,140,140,0,0,14,14,0,0,0,0,0,0,0
43,1,1,16.0,16.0,22.0,22.0,783,783,783,783,0,0,225,220,225,220,0,0,16,16,0,0,0,0,0,0,0
50,1,1,15.0,15.0,22.0,22.0,755,755,755,755,0,0,25,15,25,15,0,0,15,15,0,0,0,0,0,0,0
57,1,1,17.0,17.0,22.0,22.0,811,811,811,811,0,0,30,20,30,20,0,0,15,15,0,0,0,0,0,0,0
64,1,1,18.0,18.0,22.0,22.0,895,867,895,867,0,0,85,70,85,70,0,0,16,15,0,0,0,0,0,0,0
71,1,1,17.0,17.0,22.0,22.0,867,895,867,895,0,0,165,150,165,150,0,0,17,17,0,0,0,0,0,0,0
79,1,1,17.0,17.0,22.0,22.0,923,923,923,923,0,0,30,15,30,15,0,0,16,16,0,0,0,0,0,0,0
86,1,1,18.0,18.0,22.0,22.0,923,951,923,951,0,0,90,80,90,80,0,0,16,16,0,0,0,0,0,0,0
93,1,1,19.0,19.0,22.0,22.0,951,951,951,951,0,0,150,135,150,135,0,0,18,18,0,0,0,0,0,0,0
100,1,1,20.0,20.0,22.0,22.0,984,967,895,923,89,44,216,203,200,195,16,8,19,19,0,0,0,0,0,0,0
107,1,1,20.0,20.0,22.0,22.0,1046,1057,867,923,179,134,341,329,305,305,36,24,19,19,0,0,0,0,0,0,0
114,1,1,21.0,21.0,22.0,22.0,1130,1051,951,895,179,156,426,404,370,360,56,44,20,20,0,0,0,0,0,0,0
121,1,1,24.0,25.0,28.0,28.0,1079,1051,923,895,156,156,242,229,170,165,72,64,21,21,0,0,250,250,0,0,0
129,1,1,26.0,26.0,28.0,28.0,1135,1079,979,923,156,156,242,219,150,135,92,84,21,21,0,0,250,250,0,0,0
136,1,1,28.0,28.0,28.0,28.0,1141,1158,1007,979,134,179,78,64,70,60,8,4,21,21,0,0,250,250,0,0,0
143,1,1,30.0,30.0,36.0,36.0,1141,1197,1007,1063,134,134,109,106,85,90,24,16,21,21,50,50,250,250,0,0,0
150,1,1,30.0,30.0,36.0,36.0,1253,1169,1119,1035,134,134,265,252,225,220,40,32,23,23,50,50,250,250,0,0,0
157,1,1,30.0,32.0,36.0,36.0,1202,1281,1091,1147,111,134,62,308,10,260,52,48,24,25,200,350,250,250,0,0,0
164,1,1,31.0,32.0,36.0,36.0,1365,1258,1231,1147,134,111,173,110,105,50,68,60,24,24,350,350,250,250,0,0,0
171,1,1,32.0,31.0,36.0,36.0,1314,1398,1203,1287,111,111,75,36,45,10,30,26,25,24,350,400,250,250,0,0,0
179,1,1,33.0,33.0,36.0,36.0,1337,1370,1203,1259,134,111,96,83,50,45,46,38,25,25,350,400,250,250,0,0,0
186,1,1,35.0,35.0,36.0,36.0,1449,1482,1315,1371,134,111,167,104,105,50,62,54,27,25,350,400,250,250,0,0,0
193,1,1,39.0,39.0,44.0,44.0,1510,1533,1399,1399,111,134,149,95,75,25,74,70,28,27,350,400,250,250,0,0,0
200,1,1,41.0,40.0,44.0,44.0,1510,1583,1399,1427,111,156,130,120,40,30,90,90,30,27,350,400,250,250,0,0,0
207,1,1,44.0,43.0,44.0,44.0,1706,1611,1595,1455,111,156,142,155,40,45,102,110,33,30,350,450,250,250,0,0,0
214,1,1,44.0,44.0,44.0,44.0,1650,1606,1539,1427,111,179,218,175,100,45,118,130,32,29,500,450,450,450,0,0,0
221,1,1,46.0,46.0,52.0,52.0,1869,1751,1735,1595,134,156,339,281,205,135,134,146,33,32,500,700,450,450,0,0,0
229,1,1,50.0,52.0,58.0,52.0,1869,1667,1735,1511,134,156,220,171,95,5,125,166,35,34,500,700,450,450,0,0,0
236,1,1,54.0,51.0,58.0,58.0,1930,1779,1819,1623,111,156,242,261,105,75,137,186,37,36,500,700,450,450,0,0,0
243,1,1,55.0,52.0,66.0,58.0,1981,1807,1847,1651,134,156,128,241,75,135,53,106,40,40,700,700,575,575,0,0,0
250,1,1,55.0,54.0,66.0,58.0,2037,1975,1903,1819,134,156,139,181,70,55,69,126,42,39,800,700,575,575,0,0,0
257,1,1,59.0,57.0,66.0,66.0,2166,2020,1987,1819,179,201,159,180,70,30,89,150,41,40,800,700,575,575,0,0,0
264,1,1,61.0,59.5,74.0,66.0,2311,2216,2155,1903,156,313,225,195,120,5,105,190,44,45,800,675,575,575,0,25,0
271,1,1,62.0,63.0,74.0,66.0,2367,2356,2211,2043,156,313,220,286,195,60,25,226,48,46,800,650,575,575,0,50,0
279,1,1,62.5,65.0,74.0,74.0,2434,2462,2211,2127,223,335,177,221,120,55,57,166,49,48,775,700,575,575,25,50,0
286,1,1,64.0,67.0,82.0,82.0,2636,2630,2323,2295,313,335,302,341,205,135,97,206,49,53,750,700,575,775,50,50,0
293,1,1,71.0,70.0,90.0,82.0,2720,2636,2407,2323,313,313,117,312,55,70,62,242,50,52,750,700,775,775,50,50,0
300,1,1,76.0,69.5,98.0,90.0,2905,2720,2547,2407,358,313,147,417,120,135,27,282,52,54,650,675,775,775,75,75,0
307,1,1,80.0,74.0,106.0,90.0,2871,2938,2491,2603,380,335,286,532,240,210,46,322,54,59,650,650,775,775,75,100,0
314,1,1,85.0,75.0,114.0,90.0,2849,2944,2379,2631,470,313,382,623,280,365,102,258,56,61,1050,650,775,775,75,100,0
321,1,1,91.0,79.5,114.0,98.0,3067,3017,2463,2435,604,582,432,382,250,90,182,292,57,63,1250,625,775,775,75,125,0
329,1,1,93.0,86.5,114.0,98.0,3084,3454,2435,2491,649,963,552,443,315,60,237,383,60,65,1350,625,1025,775,75,125,0
336,1,1,92.5,90.5,114.0,98.0,3090,3515,2463,2575,627,940,524,611,365,195,159,416,67,65,1325,625,1025,1025,100,125,0
343,1,1,94.0,97.5,114.0,98.0,3336,3403,2687,2463,649,940,524,836,285,375,239,461,67,66,1400,1075,1025,1025,125,125,0
350,1,1,92.5,96.5,114.0,98.0,3358,3700,2687,2715,671,985,469,681,350,150,119,531,65,65,1475,1325,1025,1025,150,125,0
357,1,1,92.5,97.5,122.0,98.0,3498,3610,2715,2603,783,1007,604,566,535,65,69,501,68,65,1475,1725,1025,1025,150,125,0
364,1,1,100.5,103.5,122.0,122.0,3706,3644,2743,2659,963,985,439,438,350,25,89,413,68,65,1475,1925,1025,1025,150,125,0
371,1,1,112.5,103.5,122.0,122.0,3722,3700,2715,2715,1007,985,274,680,190,255,84,425,68,66,1475,1925,1025,1025,150,125,0
379,1,1,120.5,113.5,122.0,138.0,3722,3644,2715,2659,1007,985,215,610,115,190,100,420,68,66,1875,1925,1025,1150,150,125,0
386,1,1,119.0,112.5,138.0,138.0,3812,3627,2827,2687,985,940,582,657,370,275,212,382,70,66,2200,2175,1025,1150,225,175,0
393,1,1,133.0,118.5,146.0,138.0,3812,3594,2827,2631,985,963,328,592,175,165,153,427,70,66,2300,2175,1025,1150,225,175,0
400,1,1,133.0,122.5,154.0,138.0,3874,3672,2911,2687,963,985,579,442,310,45,269,397,70,66,2700,2675,1025,1150,225,175,0
407,1,1,137.0,125.5,154.0,154.0,3767,3694,2827,2687,940,1007,840,673,455,160,385,513,70,65,2700,2775,1025,1150,225,175,0
414,1,1,137.0,132.0,162.0,162.0,3812,3610,2827,2603,985,1007,1090,709,635,180,455,529,70,66,3400,3000,1025,1150,225,250,0
421,1,1,153.0,144.0,176.0,168.0,3862,3672,2855,2687,1007,985,115,396,65,5,50,391,73,69,3400,3000,1475,1150,225,250,0
429,1,1,159.0,143.0,184.0,168.0,3924,3711,2939,2771,985,940,167,758,80,255,87,503,76,68,3500,3000,1475,1150,275,250,0
436,1,1,163.0,151.0,184.0,168.0,3930,3571,2967,2631,963,940,139,670,90,147,49,523,76,68,3500,3900,1475,1150,275,250,0
443,1,1,162.0,149.0,176.0,168.0,4148,3454,3163,2491,985,963,534,695,365,52,169,643,76,58,4550,4300,1475,1400,375,475,0
450,1,1,176.0,153.0,184.0,176.0,4210,3224,3247,2239,963,985,335,770,225,157,110,613,76,58,4750,4300,1475,1400,375,475,0
457,1,1,182.0,155.0,200.0,168.0,4182,3252,3107,2267,1075,985,375,777,275,77,100,700,75,66,5100,5050,1475,1525,375,575,0
464,1,1,184.0,156.0,200.0,160.0,4355,3274,3191,2267,1164,1007,685,883,595,92,90,791,75,67,5300,5050,1475,1525,375,675,0
471,1,1,194.0,159.0,200.0,176.0,4299,3560,3135,2575,1164,985,382,739,260,132,122,607,80,66,6200,5050,1475,1525,375,675,0
479,1,1,199.0,161.0,200.0,168.0,3347,3515,2407,2575,940,940,332,951,210,232,122,719,77,66,6200,5250,1475,1525,525,775,0
486,1,1,198.0,164.0,200.0,176.0,3302,3571,2519,2631,783,940,639,1036,425,197,214,839,78,66,6600,5050,1475,1650,525,975,0
493,1,1,198.0,170.0,200.0,184.0,3907,3476,3079,2491,828,985,577,1151,505,267,72,884,77,71,6800,5050,1475,1775,525,975,0
500,1,1,197.0,175.0,208.0,176.0,4131,3554,3079,2547,1052,1007,1082,977,870,177,212,800,77,71,7000,5050,1475,1775,575,1125,0
507,1,1,196.0,168.0,208.0,192.0,4271,3510,2995,2547,1276,963,1389,789,1075,27,314,762,76,69,6800,4700,1475,1775,825,2225,0
514,1,1,197.0,148.0,208.0,192.0,4254,3566,2911,2715,1343,851,1575,1211,1180,357,395,854,75,68,6600,3800,1475,1775,1075,3300,0
521,1,1,195.0,142.0,208.0,192.0,4109,3605,2855,2799,1254,806,666,846,485,92,181,754,75,68,5000,2900,1475,1775,2675,4400,0
7,2,1,13.0,13.0,15.0,14.0,293,293,293,293,0,0,35,35,35,35,0,0,12,12,0,0,0,0,0,0,1
14,2,1,14.0,13.0,15.0,14.0,615,643,615,643,0,0,60,15,60,15,0,0,13,13,0,0,0,0,0,0,1
21,2,1,14.0,14.0,15.0,14.0,615,671,615,671,0,0,30,40,30,40,0,0,13,13,0,0,0,0,0,0,1
29,2,1,14.0,14.0,15.0,14.0,643,755,643,755,0,0,120,140,120,140,0,0,14,13,0,0,0,0,0,0,1
36,2,1,15.0,16.0,15.0,22.0,727,727,727,727,0,0,160,130,160,130,0,0,14,14,0,0,0,0,0,0,1
43,2,1,16.0,16.0,23.0,22.0,755,727,755,727,0,0,40,215,40,215,0,0,15,14,0,0,0,0,0,0,1
50,2,1,17.0,17.0,23.0,22.0,755,755,755,755,0,0,85,265,85,265,0,0,16,16,0,0,0,0,0,0,1
57,2,1,18.0,17.0,23.0,22.0,811,839,811,839,0,0,60,15,60,15,0,0,17,16,0,0,0,0,0,0,1
64,2,1,18.0,18.0,23.0,22.0,923,895,923,895,0,0,110,75,110,75,0,0,17,16,0,0,0,0,0,0,1
71,2,1,19.0,17.0,23.0,22.0,979,923,979,923,0,0,225,160,225,160,0,0,18,16,0,0,0,0,0,0,1
79,2,1,19.0,17.0,23.0,22.0,973,951,951,951,22,0,284,20,280,20,4,0,18,16,0,0,0,0,0,0,1
86,2,1,20.0,18.0,23.0,22.0,1046,895,979,895,67,0,402,80,390,80,12,0,19,16,0,0,0,0,0,0,1
93,2,1,20.0,19.0,23.0,22.0,1018,867,951,867,67,0,125,125,105,125,20,0,20,18,0,0,150,0,0,0,1
100,2,1,21.0,20.0,23.0,22.0,1040,934,951,867,89,67,42,192,10,180,32,12,20,18,0,0,150,0,0,0,1
107,2,1,21.0,20.0,23.0,22.0,1029,1085,895,951,134,134,88,328,40,300,48,28,20,19,0,0,150,0,0,0,1
114,2,1,22.0,20.0,23.0,22.0,1001,1051,867,895,134,156,159,353,95,305,64,48,21,20,0,0,150,0,0,0,1
121,2,1,22.0,20.0,23.0,22.0,1079,1107,923,951,156,156,149,478,65,410,84,68,21,20,0,0,150,250,0,0,1
129,2,1,23.0,26.0,23.0,36.0,1051,1051,895,895,156,156,274,213,170,125,104,88,22,20,0,0,150,250,0,0,1
136,2,1,25.0,27.0,31.0,36.0,1113,1057,867,923,246,134,140,85,75,85,65,0,22,20,0,0,300,250,0,0,1
143,2,1,26.0,28.0,31.0,36.0,1158,1001,867,979,291,22,286,155,185,155,101,0,23,20,0,100,300,250,0,0,1
150,2,1,27.0,30.0,31.0,36.0,1258,979,923,979,335,0,86,180,45,180,41,0,24,22,0,100,300,250,0,0,1
157,2,1,29.0,30.0,31.0,36.0,1286,1091,951,1091,335,0,57,305,30,305,27,0,24,23,125,100,300,250,0,0,1
164,2,1,31.0,30.0,46.0,36.0,1314,1119,979,1119,335,0,108,95,45,95,63,0,25,23,125,400,300,250,0,0,1
171,2,1,33.0,33.0,46.0,36.0,1314,1147,979,1147,335,0,218,45,115,45,103,0,27,23,125,400,300,250,0,0,1
179,2,1,34.0,34.0,46.0,36.0,1404,1315,1091,1315,313,0,84,55,45,55,39,0,28,24,125,400,300,250,0,0,1
186,2,1,35.0,35.0,46.0,36.0,1432,1371,1119,1371,313,0,214,160,135,160,79,0,29,25,300,400,550,250,0,0,1
193,2,1,37.0,36.0,46.0,36.0,1622,1399,1287,1399,335,0,259,285,140,285,119,0,31,27,300,400,550,250,0,0,1
200,2,1,37.0,42.0,46.0,44.0,1650,1499,1315,1455,335,44,299,168,140,160,159,8,31,28,300,400,550,250,0,0,1
207,2,1,41.0,44.0,46.0,44.0,1690,1662,1399,1595,291,67,36,266,20,250,16,16,33,29,300,550,550,250,0,0,1
214,2,1,42.0,42.0,46.0,44.0,1824,1628,1511,1539,313,89,211,273,155,245,56,28,34,32,300,550,550,250,0,0,1
221,2,1,42.0,44.0,46.0,44.0,1874,1779,1539,1623,335,156,286,393,190,345,96,48,35,34,300,550,800,250,0,0,1
229,2,1,44.0,44.0,46.0,44.0,1930,1835,1595,1679,335,156,201,513,65,445,136,68,36,34,300,550,800,250,0,0,1
236,2,1,46.0,49.0,46.0,50.0,1942,1835,1651,1679,291,156,218,478,50,390,168,88,36,36,425,550,800,250,0,0,1
243,2,1,46.0,50.0,46.0,58.0,2076,1897,1763,1651,313,246,373,319,165,295,208,24,36,39,425,550,950,250,0,0,1
250,2,1,48.0,50.5,54.0,58.0,2020,1986,1707,1651,313,335,483,124,260,60,223,64,38,38,675,525,950,250,0,25,1
257,2,1,52.0,50.5,54.0,58.0,2093,2042,1735,1707,358,335,382,384,140,280,242,104,38,39,925,525,950,450,0,25,1
264,2,1,54.0,55.5,62.0,66.0,2143,2210,1651,1875,492,335,587,405,285,265,302,140,40,41,925,525,1100,450,0,25,1
271,2,1,54.0,63.5,62.0,66.0,2115,2350,1623,2015,492,335,788,165,430,60,358,105,40,44,925,625,1100,825,0,25,1
279,2,1,62.0,65.5,62.0,66.0,2171,2328,1679,2015,492,313,239,346,200,230,39,116,42,44,1675,725,1400,825,0,25,1
286,2,1,61.0,63.0,62.0,66.0,2227,2440,1735,2127,492,313,519,651,420,495,99,156,41,44,1675,1000,1400,825,50,150,1
293,2,1,57.0,57.0,62.0,74.0,2205,1891,1735,1623,470,268,775,629,620,445,155,184,43,38,1425,900,1400,825,300,650,1
300,2,1,51.0,66.0,62.0,74.0,2289,1578,1819,1399,470,179,1070,284,855,130,215,154,43,38,675,900,1400,950,1050,775,1
307,2,1,51.0,71.0,62.0,74.0,2339,1891,1847,1735,492,156,840,215,815,45,25,170,43,37,425,1100,1400,950,1300,825,1
314,2,1,52.0,70.0,62.0,74.0,2306,1919,1791,1763,515,156,575,455,490,265,85,190,43,41,425,1600,1400,950,1300,875,1
321,2,1,58.0,73.0,62.0,74.0,2306,2143,1791,1987,515,156,835,555,790,345,45,210,44,43,425,1600,1400,950,1300,875,1
329,2,1,60.0,73.0,62.0,74.0,2334,2138,1707,1959,627,179,181,314,160,180,21,134,44,43,875,1600,1400,950,1350,875,1
336,2,1,61.0,72.0,62.0,74.0,2468,2339,1819,2071,649,268,377,505,280,335,97,170,45,46,975,1550,1400,950,1350,925,1
343,2,1,62.0,74.0,62.0,74.0,2390,2552,1763,2239,627,313,213,466,40,285,173,181,46,46,900,1500,1400,950,1425,975,1
350,2,1,62.0,83.0,62.0,98.0,2474,2642,1847,2351,627,291,463,278,210,240,253,38,47,46,1275,1500,1400,950,1425,975,1
357,2,1,62.0,87.0,62.0,114.0,2580,2552,1931,2239,649,313,1073,229,740,205,333,24,48,46,1175,1550,1400,950,1525,1025,1
364,2,1,68.0,91.5,70.0,122.0,2580,2608,1931,2295,649,313,1074,199,790,160,284,39,48,47,1175,1875,1400,950,1525,1050,1
371,2,1,72.0,94.5,78.0,130.0,2630,2580,1959,2267,671,313,575,279,340,200,235,79,50,46,1675,2075,1400,950,1525,1050,1
379,2,1,72.0,99.5,78.0,130.0,2608,2602,1959,2267,649,335,826,289,515,245,311,44,50,52,1675,2225,1400,950,1525,1100,1
386,2,1,76.0,102.5,78.0,138.0,2670,2630,2043,2295,627,335,783,314,525,305,258,9,52,53,1675,2175,1400,950,1525,1250,1
393,2,1,76.0,105.0,78.0,138.0,2726,2798,2099,2463,627,335,693,415,455,370,238,45,52,53,2300,2250,1400,950,1525,1275,1
400,2,1,82.0,112.0,86.0,138.0,2664,2944,2015,2519,649,425,893,356,575,355,318,1,54,53,2300,2400,1400,950,1525,1325,1
407,2,1,82.0,113.0,86.0,146.0,2686,2905,2015,2435,671,470,568,352,170,295,398,57,56,53,1800,2850,1550,950,1525,1325,1
414,2,1,82.0,120.0,94.0,146.0,2642,2933,2015,2463,627,470,671,192,305,150,366,42,56,51,2250,2950,1550,950,1525,1325,1
421,2,1,88.0,124.0,94.0,146.0,2782,2899,2155,2407,627,492,587,287,345,260,242,27,56,51,2350,3300,1550,950,1525,1325,1
429,2,1,87.0,128.0,94.0,146.0,2670,2983,2043,2491,627,492,529,337,315,250,214,87,55,51,2650,3650,1550,950,1525,1425,1
436,2,1,84.0,124.0,94.0,146.0,2726,2922,2099,2407,627,515,859,638,565,495,294,143,54,51,2550,3650,1650,1075,1725,1675,1
443,2,1,78.0,124.5,94.0,146.0,2720,2955,2071,2463,649,492,1199,664,825,465,374,199,54,51,2150,3525,1650,1075,2500,1950,1
7,0,0,13.0,13.0,15.0,15.0,293,293,293,293,0,0,35,35,35,35,0,0,12,12,0,0,0,0,0,0,1
14,0,0,14.0,14.0,15.0,15.0,643,671,643,671,0,0,65,70,65,70,0,0,13,13,0,0,0,0,0,0,1
21,0,0,14.0,14.0,15.0,15.0,699,699,699,699,0,0,50,0,50,0,0,0,13,13,0,0,0,0,0,0,1
29,0,0,15.0,15.0,15.0,15.0,699,699,699,699,0,0,85,15,85,15,0,0,14,14,0,0,0,0,0,0,1
36,0,0,15.0,15.0,15.0,15.0,727,727,727,727,0,0,125,55,125,55,0,0,14,14,0,0,0,0,0,0,1
43,0,0,16.0,16.0,23.0,23.0,755,755,755,755,0,0,65,145,65,145,0,0,15,15,0,0,0,0,0,0,1
50,0,0,16.0,16.0,23.0,23.0,783,783,783,783,0,0,35,30,35,30,0,0,15,15,0,0,0,0,0,0,1
57,0,0,17.0,17.0,23.0,23.0,755,799,755,755,0,44,5,83,5,75,0,8,16,16,0,0,0,0,0,0,1
64,0,0,18.0,18.0,23.0,23.0,783,883,783,727,0,156,95,138,95,110,0,28,17,17,0,0,0,0,0,0,1
71,0,0,18.0,18.0,23.0,23.0,743,911,699,755,44,156,133,239,125,195,8,44,17,17,0,0,0,0,0,0,1
79,0,0,19.0,19.0,23.0,23.0,822,939,643,783,179,156,242,349,210,285,32,64,18,18,0,0,0,0,0,0,1
86,0,0,19.0,19.0,23.0,23.0,928,995,615,839,313,156,352,474,280,390,72,84,18,18,0,0,0,0,0,0,1
93,0,0,20.0,20.0,23.0,23.0,950,995,615,839,335,156,108,344,50,290,58,54,19,19,0,0,150,150,0,0,1
100,0,0,20.0,20.0,23.0,23.0,1012,1046,699,867,313,179,219,459,125,385,94,74,19,19,0,0,150,150,0,0,1
107,0,0,20.0,20.0,23.0,23.0,962,1018,671,839,291,179,95,179,65,85,30,94,19,19,0,0,150,150,0,0,1
114,0,0,21.0,20.0,31.0,23.0,928,967,727,811,201,156,154,35,100,25,54,10,19,19,0,0,150,150,0,0,1
121,0,0,22.0,21.0,31.0,23.0,1001,1023,755,867,246,156,171,110,135,80,36,30,19,19,100,0,150,150,0,0,1
129,0,0,23.0,22.0,31.0,23.0,1090,1135,867,979,223,156,260,25,200,25,60,0,20,20,100,100,150,150,0,0,1
136,0,0,23.0,22.0,31.0,23.0,1309,1107,1063,951,246,156,392,60,300,40,92,20,20,20,100,100,150,150,0,0,1
143,0,0,24.0,23.0,31.0,23.0,1309,1079,1063,923,246,156,540,150,420,110,120,40,21,21,100,100,150,150,0,0,1
150,0,0,26.0,23.0,31.0,23.0,1393,1096,1147,895,246,201,208,234,60,170,148,64,22,21,100,100,400,150,0,0,1
157,0,0,27.0,24.0,31.0,31.0,1342,1180,1119,867,223,313,211,384,85,280,126,104,22,22,200,100,400,400,0,0,1
164,0,0,28.0,24.0,31.0,31.0,1443,1320,1175,1007,268,313,233,315,75,275,158,40,23,22,200,100,400,500,0,0,1
171,0,0,28.0,29.0,31.0,31.0,1438,1376,1147,1063,291,313,328,145,155,90,173,55,23,23,300,100,400,500,0,0,1
179,0,0,29.0,29.0,31.0,46.0,1432,1376,1119,1063,313,313,183,165,70,70,113,95,24,23,300,100,400,500,0,0,1
186,0,0,29.0,29.0,39.0,46.0,1202,1370,867,1035,335,335,324,210,175,75,149,135,24,24,300,100,400,500,0,0,1
193,0,0,35.0,35.0,39.0,46.0,1342,1348,1007,1035,335,313,104,151,15,5,89,146,25,24,300,300,575,575,0,0,1
200,0,0,35.0,35.0,39.0,46.0,1292,1432,979,1119,313,313,135,241,10,105,125,136,25,24,300,300,575,825,0,0,1
207,0,0,36.0,37.0,39.0,46.0,1572,1404,1259,1091,313,313,340,212,175,140,165,72,26,24,300,300,575,825,0,0,1
214,0,0,38.0,41.0,39.0,46.0,1488,1572,1175,1259,313,313,335,212,155,100,180,112,27,24,400,625,825,825,0,0,1
221,0,0,39.0,43.0,54.0,46.0,1678,1628,1343,1315,335,313,330,192,110,65,220,127,27,24,650,625,825,825,0,0,1
229,0,0,41.0,45.0,54.0,46.0,1740,1706,1315,1371,425,335,216,227,140,60,76,167,27,24,750,625,900,825,0,0,1
236,0,0,43.0,46.0,54.0,46.0,1863,1701,1371,1343,492,358,182,247,50,65,132,182,28,26,750,1025,900,825,0,0,1
243,0,0,46.0,47.0,54.0,54.0,1830,1516,1315,1203,515,313,107,339,40,125,67,214,29,26,750,1150,900,825,0,0,1
250,0,0,48.0,52.0,54.0,54.0,1645,1572,1175,1259,470,313,184,209,65,55,119,154,29,27,750,1150,900,900,0,0,1
257,0,0,49.0,54.0,54.0,54.0,1729,1600,1259,1287,470,313,214,209,35,15,179,194,30,28,800,1150,900,900,0,0,1
264,0,0,50.0,57.0,54.0,62.0,1975,1712,1483,1287,492,425,354,89,115,35,239,54,31,29,700,1150,900,900,100,0,1
271,0,0,39.0,55.0,54.0,62.0,1516,1785,1091,1315,425,470,467,320,180,210,287,110,27,30,750,1150,900,900,650,100,1
279,0,0,42.0,57.0,62.0,62.0,1303,1970,923,1455,380,515,237,375,85,205,152,170,27,31,1025,1050,1050,900,750,200,1
286,0,0,45.0,60.0,62.0,70.0,1303,1942,923,1427,380,515,255,225,55,120,200,105,27,31,1025,1300,1050,900,750,200,1
293,0,0,46.0,62.0,62.0,70.0,1331,2009,951,1539,380,470,169,357,25,200,144,157,29,33,1025,1300,1050,900,750,200,1
300,0,0,48.0,66.0,62.0,70.0,1443,2227,1063,1735,380,492,257,132,65,115,192,17,29,35,1075,1400,1050,900,750,200,1
307,0,0,51.0,66.0,62.0,70.0,1516,2429,1091,1959,425,470,288,503,40,430,248,73,31,35,1125,1700,1050,900,750,200,1
314,0,0,52.0,68.0,62.0,78.0,1723,2317,1231,1847,492,470,449,256,145,124,304,132,31,37,1400,1975,1050,900,750,200,1
321,0,0,57.0,71.0,62.0,78.0,1919,2283,1427,1791,492,492,314,149,75,93,239,56,33,37,1500,1975,1050,900,750,200,1
329,0,0,61.0,73.0,62.0,78.0,2367,2446,1875,1931,492,515,240,205,20,101,220,104,33,39,1550,1975,1050,900,750,200,1
336,0,0,62.0,75.0,62.0,78.0,2395,2507,1903,2015,492,492,410,286,130,126,280,160,35,39,1550,1975,1050,900,750,200,1
343,0,0,62.0,77.0,62.0,78.0,2457,2731,1987,2239,470,492,541,497,205,281,336,216,36,41,1450,1975,1050,900,850,200,1
350,0,0,69.0,78.0,70.0,78.0,2479,2983,1987,2491,492,492,331,262,60,111,271,151,36,43,1600,2650,1050,900,850,200,1
357,0,0,70.0,82.0,70.0,86.0,2541,2866,2071,2351,470,515,467,596,190,381,277,215,37,43,2000,2650,1050,900,850,200,1
364,0,0,72.0,86.0,78.0,86.0,2591,2636,2099,2099,492,537,697,164,360,131,337,33,39,45,2100,2650,1050,900,850,200,1
371,0,0,74.0,86.0,78.0,86.0,2681,2653,2211,2071,470,582,508,412,115,311,393,101,39,45,2150,2650,1050,900,850,200,1
379,0,0,75.0,86.0,78.0,86.0,2507,2625,2015,2043,492,582,443,480,90,311,353,169,39,45,2425,2650,1050,900,850,200,1
386,0,0,77.0,91.0,78.0,109.0,2401,2334,1931,1819,470,515,354,231,70,131,284,100,41,45,2525,2925,1050,900,850,200,1
393,0,0,77.0,95.0,78.0,109.0,2395,2300,1903,1763,492,537,634,294,290,201,344,93,41,47,2525,3375,1050,900,850,200,1
400,0,0,75.0,97.0,86.0,109.0,2429,2462,1959,1903,470,559,815,282,415,196,400,86,42,47,2100,3375,1050,1200,1325,200,1
407,0,0,81.0,96.0,86.0,109.0,2451,1981,1959,1511,492,470,455,309,195,271,260,38,42,46,2150,3375,1050,1325,1325,350,1
414,0,0,81.0,97.0,86.0,109.0,2451,1275,1959,895,492,380,580,422,260,336,320,86,43,46,1950,3375,1050,1325,1525,350,1
421,0,0,83.0,99.0,86.0,109.0,2507,1936,2015,1511,492,425,716,395,340,261,376,134,44,48,2100,3875,1050,1450,1525,350,1
429,0,0,86.0,105.0,86.0,109.0,2563,2530,2071,2015,492,515,826,139,390,91,436,48,45,50,2375,4150,1050,1450,1525,350,1
436,0,0,86.0,105.0,86.0,109.0,2530,2804,2015,2155,515,649,681,375,310,251,371,124,46,50,2375,4150,1050,1450,1525,350,1
443,0,0,91.0,108.0,101.0,117.0,2647,2832,2043,2183,604,649,802,160,355,56,447,104,47,52,2825,4150,1050,1650,1525,350,1
450,0,0,96.0,108.0,109.0,125.0,2586,2614,1959,1987,627,627,388,266,65,186,323,80,47,52,2925,4150,1050,1650,1525,350,1
457,0,0,99.0,113.0,117.0,125.0,2692,2580,2043,1931,649,649,568,300,165,159,403,141,48,55,2925,4150,1200,1750,1525,350,1
464,0,0,102.0,114.0,117.0,125.0,2608,2658,1959,1987,649,671,693,451,210,236,483,215,49,55,2975,4500,1200,1750,1525,450,1
471,0,0,103.0,117.0,117.0,141.0,2742,2910,2071,2239,671,671,1004,167,445,101,559,66,49,58,3025,4500,1200,1750,1525,450,1
479,0,0,108.0,121.0,117.0,141.0,2630,3056,1959,2407,671,649,959,364,445,226,514,138,50,58,3500,4650,1450,1750,1525,550,1
486,0,0,109.0,121.0,117.0,141.0,2636,2972,1987,2323,649,649,1116,254,530,136,586,118,50,61,3600,4650,1450,1750,1825,550,1
493,0,0,115.0,128.0,117.0,141.0,2636,2894,1987,2267,649,627,541,140,275,46,266,94,50,61,3650,4800,1450,1750,1825,550,1
500,0,0,117.0,128.0,117.0,141.0,2580,2894,1931,2267,649,627,492,195,150,21,342,174,52,61,3800,5075,1450,1750,1825,550,1
507,0,0,117.0,130.0,117.0,141.0,2804,2888,2155,2239,649,649,737,450,315,196,422,254,52,62,3900,5075,1450,2075,1825,550,1
514,0,0,117.0,135.0,117.0,141.0,3090,3230,2463,2379,627,851,953,613,455,251,498,362,52,63,4225,5275,1450,2075,1825,550,1
521,0,0,125.0,135.0,133.0,141.0,3078,3448,2407,2463,671,985,623,650,170,301,453,349,52,64,4425,5225,1450,2075,2075,800,1
529,0,0,126.0,137.0,133.0,141.0,3078,3510,2407,2547,671,963,914,967,385,506,529,461,53,63,4425,5225,1450,2075,2075,850,1
536,0,0,106.0,132.0,133.0,141.0,3028,3437,2379,2519,649,918,1220,1120,615,551,605,569,55,60,3025,5025,1450,2075,3675,1600,1
543,0,0,103.0,130.0,133.0,141.0,3062,2882,2435,2211,627,671,1491,1002,810,486,681,516,56,59,2725,4975,1450,1975,4025,1800,1
550,0,0,99.0,114.0,133.0,149.0,3129,3028,2547,2379,582,649,1604,1367,855,771,749,596,53,59,2350,4225,1450,1975,4550,2900,1
557,0,0,104.0,113.0,133.0,141.0,2894,3078,2379,2407,515,671,1383,1432,770,756,613,676,55,59,2450,4175,1450,1975,4825,3300,1
564,0,0,104.0,113.0,133.0,133.0,2754,3084,2127,2435,627,649,1399,1038,835,511,564,527,56,59,2200,4175,1450,1975,5125,3400,1
571,0,0,100.0,124.0,133.0,125.0,2720,2854,2071,2183,649,671,775,789,235,386,540,403,57,59,1900,4425,1750,1975,5575,3500,1
579,0,0,101.0,123.0,133.0,125.0,2664,2485,2015,1791,649,694,466,733,50,246,416,487,57,59,2000,4425,1750,1975,5575,3500,1
586,0,0,106.0,124.0,133.0,125.0,3056,2664,2407,1903,649,761,541,615,120,186,421,429,60,61,2500,4700,1750,2125,5575,3500,1
593,0,0,112.0,131.0,133.0,133.0,3258,2714,2631,1931,627,783,532,745,110,266,422,479,61,62,2825,4900,1750,2125,5575,3500,1
600,0,0,116.0,133.0,133.0,133.0,3370,3123,2631,2295,739,828,518,662,125,242,393,420,62,62,2925,5300,1975,2275,5575,3500,1
607,0,0,120.0,133.0,133.0,133.0,3734,3224,2771,2351,963,873,659,588,200,125,459,463,64,62,2975,5500,1975,2525,5575,3500,1
614,0,0,122.0,138.0,133.0,133.0,3958,3370,2995,2519,963,851,781,266,310,72,471,194,64,62,3025,5500,2175,2625,5575,3600,1
621,0,0,126.0,138.0,141.0,133.0,3812,3358,2827,2463,985,895,346,400,105,214,241,186,67,62,3475,5775,2425,2725,5575,3600,1
629,0,0,126.0,140.0,141.0,141.0,4008,3353,3023,2435,985,918,622,438,365,281,257,157,67,65,3525,5775,2425,3175,5575,3600,1
636,0,0,136.0,141.0,141.0,141.0,3935,3599,2995,2659,940,940,464,594,220,329,244,265,67,65,4100,6000,2425,3175,5575,3600,1
643,0,0,136.0,141.0,141.0,141.0,3594,3762,2631,2799,963,963,879,1027,515,645,364,382,70,67,4100,6225,2425,3275,5575,3600,1
650,0,0,109.0,138.0,141.0,141.0,3582,3616,2575,2631,1007,985,1184,1148,700,657,484,491,70,67,2350,5475,2525,3275,7525,4400,1
657,0,0,113.0,141.0,156.0,156.0,3700,3448,2715,2463,985,985,455,1172,155,695,300,477,70,67,1725,5475,2525,3275,8150,4400,1
664,0,0,114.0,150.0,156.0,156.0,3560,3420,2575,2435,985,985,612,503,200,272,412,231,70,67,1725,5725,2775,3275,8150,4400,1
671,0,0,124.0,153.0,156.0,156.0,3442,3336,2435,2351,1007,985,402,590,20,256,382,334,72,67,2450,5975,2775,3275,8150,4400,1
679,0,0,126.0,156.0,156.0,156.0,3426,3062,2463,2099,963,963,724,778,230,343,494,435,72,70,2500,6250,2775,3275,8150,4400,1
686,0,0,127.0,156.0,156.0,156.0,3795,3095,2855,2155,940,940,1130,498,520,86,610,412,72,70,3150,6500,2850,3275,8150,4400,1
693,0,0,138.0,162.0,164.0,164.0,3902,3118,2939,2155,963,963,495,524,40,162,455,362,72,70,3400,7225,2850,3275,8150,4400,1
700,0,0,144.0,164.0,164.0,164.0,4030,3280,3023,2295,1007,985,685,410,110,57,575,353,72,72,3725,7375,2850,3275,8150,4400,1
707,0,0,147.0,165.0,164.0,172.0,4198,3230,3191,2267,1007,963,826,650,260,221,566,429,72,72,3875,7425,2850,3775,8150,4400,1
714,0,0,148.0,170.0,172.0,188.0,4260,3414,3275,2407,985,1007,868,626,190,106,678,520,72,74,4025,7425,2850,3775,8150,4400,1
721,0,0,159.0,176.0,180.0,188.0,4232,3364,3247,2379,985,985,639,722,45,86,594,636,72,75,4900,7700,2850,4100,8150,4400,1
729,0,0,163.0,176.0,180.0,188.0,4434,3487,3471,2547,963,940,795,1039,210,291,585,748,72,76,4950,7700,2850,4250,8200,4400,1
736,0,0,168.0,178.0,188.0,188.0,4434,3717,3471,2687,963,1030,731,615,155,281,576,334,72,76,5575,7975,2850,4250,8200,4525,1
743,0,0,170.0,184.0,188.0,188.0,4288,4103,3303,2827,985,1276,916,781,220,291,696,490,72,76,5575,8075,2850,4250,8200,4525,1
750,0,0,171.0,184.0,188.0,196.0,4120,4254,3135,2911,985,1343,1242,1297,430,651,812,646,72,76,5925,8075,2850,4250,8200,4525,1
757,0,0,176.0,188.0,204.0,196.0,3840,4131,2855,2855,985,1276,1294,1225,495,681,799,544,72,76,6550,8150,2850,4250,8200,4750,1
764,0,0,185.0,192.0,204.0,196.0,3974,4042,2967,2743,1007,1299,1124,726,405,176,719,550,72,76,6600,8150,3050,4250,8200,4750,1
771,0,0,185.0,194.0,204.0,196.0,3846,4014,2883,2715,963,1299,556,1122,225,416,331,706,72,76,6875,8150,3150,4250,8200,4750,1
779,0,0,188.0,193.0,204.0,196.0,3739,3739,2799,2463,940,1276,862,1453,415,596,447,857,72,75,7175,8750,3150,4250,8200,4800,1
786,0,0,187.0,195.0,204.0,196.0,3762,3762,2799,2463,963,1299,1312,1575,745,769,567,806,72,77,7175,8750,3150,4350,8250,4800,1
793,0,0,168.0,196.0,219.0,196.0,3890,3840,2883,2519,1007,1321,1352,1466,790,709,562,757,72,77,6625,9175,3150,4350,9625,5483,1
800,0,0,132.0,173.0,219.0,196.0,3756,3818,2771,2519,985,1299,1223,1503,670,719,553,784,72,77,3625,7225,3150,4225,12625,7742,1
807,0,0,136.0,175.0,219.0,196.0,3672,3930,2687,2631,985,1299,1105,1666,640,741,465,925,72,77,3500,7225,3150,4225,12900,7742,1
814,0,0,128.0,168.0,219.0,196.0,3644,3762,2659,2463,985,1299,1566,1553,985,610,581,943,72,77,2800,6600,3150,4225,13650,8667,1
821,0,0,130.0,171.0,219.0,196.0,3510,3734,2547,2435,963,1299,882,1495,185,550,697,945,72,77,3100,6600,3150,4225,13925,8867,1
829,0,0,137.0,174.0,219.0,196.0,3403,3465,2463,2211,940,1254,828,727,140,139,688,588,72,77,3200,7375,3150,4225,13925,8867,1
836,0,0,142.0,176.0,219.0,196.0,3454,3392,2491,2071,963,1321,878,769,195,133,683,636,72,77,4125,7875,3150,4225,13925,8867,1
843,0,0,144.0,177.0,219.0,211.0,3532,3588,2547,2267,985,1321,1209,1130,410,352,799,778,72,77,4225,8250,3150,4225,13925,8867,1
850,0,0,151.0,177.0,219.0,211.0,3392,3739,2407,2463,985,1276,1000,1515,335,593,665,922,72,76,4375,8900,3150,4125,13925,9242,1
857,0,0,156.0,190.0,219.0,211.0,3532,3840,2547,2519,985,1321,1181,686,400,158,781,528,72,76,4700,8900,3150,4125,13925,9242,1
864,0,0,162.0,190.0,219.0,211.0,3286,3812,2323,2491,963,1321,1088,647,320,163,768,484,72,76,4800,9000,3150,4125,13925,9242,1
871,0,0,168.0,193.0,219.0,211.0,3123,3795,2183,2519,940,1276,1214,824,330,313,884,511,72,76,5375,9200,3600,4125,13925,9242,1
879,0,0,170.0,191.0,219.0,211.0,3146,3739,2183,2463,963,1276,964,1265,235,598,729,667,72,76,5575,8950,3600,4125,14125,9542,1
886,0,0,172.0,191.0,219.0,211.0,3470,3868,2463,2547,1007,1321,1229,1740,380,913,849,827,72,76,5575,9175,3600,4125,14175,9542,1
893,0,0,168.0,194.0,219.0,211.0,3784,3868,2799,2547,985,1321,1570,1192,605,463,965,729,72,76,5725,8700,3600,4125,14575,10242,1
900,0,0,177.0,192.0,219.0,211.0,3840,3857,2855,2603,985,1254,1337,1481,485,608,852,873,72,74,6100,9250,3600,4025,14575,10767,1
907,0,0,170.0,187.0,234.0,211.0,3812,3700,2827,2491,985,1209,1593,2094,725,948,868,1146,72,74,5650,9100,3600,4200,15125,11542,1
914,0,0,153.0,172.0,234.0,196.0,3930,3622,2967,2435,963,1187,1904,2324,920,1038,984,1286,72,71,4675,8200,3900,4200,16525,13347,1
921,0,0,158.0,165.0,234.0,196.0,3717,2916,2855,1931,862,985,1646,837,685,143,961,694,72,61,4425,7775,3900,4200,16925,14397,1
929,0,0,152.0,161.0,234.0,196.0,3661,2765,2911,1903,750,862,1935,810,880,18,1055,792,72,61,4300,7350,3900,4200,17475,15006,1
936,0,0,162.0,168.0,234.0,196.0,3482,2614,2799,1819,683,795,1025,1072,415,188,610,884,72,63,4800,7925,3900,4200,17475,15006,1
943,0,0,164.0,171.0,234.0,196.0,3302,2563,2631,1847,671,716,1195,1372,605,408,590,964,72,63,5150,8075,3900,4200,17475,15081,1
950,0,0,145.0,157.0,234.0,196.0,3302,2647,2631,1931,671,716,1276,1595,610,543,666,1052,72,64,3875,7100,3900,4200,18850,16741,1
957,0,0,146.0,160.0,234.0,196.0,3386,2563,2715,1847,671,716,1212,1333,595,318,617,1015,72,64,3850,7050,3900,4200,19400,16891,1
964,0,0,148.0,162.0,234.0,196.0,3896,2569,3247,1875,649,694,1588,1388,895,293,693,1095,72,64,3850,7700,3900,4200,19400,16991,1
971,0,0,151.0,169.0,234.0,196.0,3958,2462,3331,1791,627,671,1884,1074,1115,303,769,771,72,64,4925,7850,3900,4200,19400,16991,1
979,0,0,168.0,170.0,234.0,196.0,3986,2485,3359,1791,627,694,1104,1383,680,528,424,855,72,65,5075,8150,3900,4200,19400,16991,1
986,0,0,163.0,167.0,234.0,196.0,3980,2580,3331,1931,649,649,1474,1489,970,558,504,931,72,59,5050,8575,3900,4200,19750,17341,1
993,0,0,169.0,176.0,234.0,196.0,4036,2916,3387,2267,649,649,1375,979,920,393,455,586,72,59,5225,8575,3900,4200,20025,17341,1
1000,0,0,171.0,180.0,234.0,196.0,3885,3050,3191,2379,694,671,1725,894,1190,328,535,566,72,59,5325,8575,3900,4200,20025,17341,1
1007,0,0,162.0,175.0,234.0,196.0,4008,2910,3359,2239,649,671,2107,1219,1500,573,607,646,72,59,5175,8325,3900,4200,20700,17791,1
1014,0,0,151.0,171.0,234.0,196.0,3930,2882,3303,2211,627,671,2178,1519,1495,793,683,726,72,59,4225,8875,3900,4200,21900,18041,1
1021,0,0,152.0,173.0,234.0,196.0,3986,3000,3359,2351,627,649,2198,1275,1435,873,763,402,72,59,5200,8650,3900,4200,21900,18266,1
1029,0,0,160.0,179.0,234.0,196.0,3784,3162,3135,2491,649,671,1713,1360,995,878,718,482,72,59,5200,8925,3900,4200,21900,18266,1
1036,0,0,169.0,173.0,234.0,196.0,3840,3050,3191,2379,649,671,1733,1420,935,858,798,562,72,59,5600,9000,3900,4200,21900,18841,1
1043,0,0,159.0,169.0,234.0,196.0,3778,3168,3107,2519,671,649,1829,1376,955,863,874,513,72,59,4500,8275,3900,4200,23150,19902,1
1050,0,0,170.0,172.0,234.0,196.0,3806,3134,3135,2463,671,671,1145,1290,520,743,625,547,72,59,5100,8425,3900,4450,23150,19902,1
1057,0,0,179.0,174.0,234.0,196.0,3476,3078,2827,2407,649,671,971,741,395,168,576,573,72,59,5375,8425,3900,4450,23150,19902,1
1064,0,0,181.0,179.0,234.0,196.0,3426,2888,2799,2239,627,649,1277,866,625,313,652,553,72,61,5725,9325,3900,4450,23150,19902,1
1071,0,0,177.0,183.0,234.0,196.0,3426,2849,2799,2155,627,694,1482,581,750,348,732,233,72,61,5025,9750,3900,4600,23900,19902,1
1079,0,0,179.0,190.0,234.0,196.0,3392,2748,2799,2099,593,649,1277,357,675,298,602,59,72,63,6100,9900,3900,4600,23900,19902,1
1086,0,0,188.0,190.0,234.0,196.0,3034,2787,2519,2071,515,716,702,694,365,543,337,151,72,63,6100,9900,3900,4825,23900,19902,1
1093,0,0,186.0,190.0,234.0,196.0,2950,2882,2435,2099,515,783,1038,1035,645,788,393,247,72,64,6475,9900,3900,4825,24100,19902,1
1100,0,0,187.0,196.0,249.0,196.0,2793,2950,2323,2155,470,795,1300,1099,855,758,445,341,72,64,6575,9900,3900,4825,24100,19902,1
1107,0,0,166.0,190.0,264.0,196.0,3146,2726,2631,2043,515,683,1653,1305,1140,888,513,417,72,64,5475,10050,3900,4825,25200,20302,1
1114,0,0,179.0,195.0,264.0,196.0,3319,2675,2715,2071,604,604,1134,1039,670,808,464,231,72,64,6000,10550,4400,4825,25350,20402,1
1121,0,0,184.0,196.0,264.0,196.0,3347,2726,2743,2099,604,627,996,870,585,563,411,307,72,64,6050,10850,4400,4825,25350,20402,1
1129,0,0,189.0,197.0,264.0,211.0,3403,2731,2799,2127,604,604,873,1197,690,818,183,379,71,64,6650,10950,4400,4825,25400,20402,1
1136,0,0,193.0,197.0,279.0,211.0,3476,2658,2827,2099,649,559,625,729,570,278,55,451,71,64,6850,11050,4400,4825,25400,20402,1
1143,0,0,194.0,197.0,279.0,211.0,3448,2569,2799,1987,649,582,991,771,860,373,131,398,71,64,7175,11050,4400,4825,25400,20402,1
1150,0,0,199.0,200.0,279.0,211.0,3487,2675,2883,2071,604,604,1159,854,960,488,199,366,71,64,7225,11650,4400,4825,25400,20402,1
1157,0,0,199.0,199.0,279.0,211.0,3409,2826,2827,2267,582,559,1571,1208,1300,778,271,430,71,64,8100,11600,4550,4825,25400,20402,1
1164,0,0,187.0,184.0,279.0,211.0,3554,2826,2995,2267,559,559,1988,992,1645,748,343,244,71,64,7550,10325,4550,5050,26100,21794,1
1171,0,0,176.0,189.0,271.0,211.0,3431,3017,2827,2435,604,582,1674,840,1380,528,294,312,71,64,6200,10000,4550,4725,27700,22444,1
1179,0,0,172.0,181.0,263.0,196.0,3504,2362,2855,1847,649,515,1625,462,1455,301,170,161,71,49,5750,10275,4550,4725,28250,24294,1
1186,0,0,173.0,184.0,255.0,196.0,3420,1152,2771,727,649,425,867,320,625,142,242,178,71,46,5800,10575,4300,4725,28650,24444,1
1193,0,0,165.0,187.0,247.0,196.0,3146,939,2519,559,627,380,1429,224,1115,30,314,194,71,46,5900,10725,4225,4725,29025,24444,1
1200,0,0,157.0,187.0,247.0,181.0,2989,850,2407,559,582,291,1457,567,950,345,507,222,70,46,5700,11000,3550,4725,30025,25217,1
1207,0,0,157.0,186.0,232.0,196.0,2877,805,2295,559,582,246,1784,860,1205,510,579,350,70,46,6100,11650,3475,4725,30650,25217,1
1214,0,0,157.0,184.0,232.0,196.0,2899,1006,2295,783,604,223,2150,1003,1495,625,655,378,70,46,6100,11625,2975,4725,31150,25517,1
1221,0,0,155.0,183.0,209.0,196.0,2877,1309,2295,1063,582,246,2498,1160,1775,750,723,410,68,45,6100,11625,2275,4500,32600,25792,1
1229,0,0,154.0,189.0,201.0,196.0,2642,1230,2239,1007,403,223,2679,603,1820,415,859,188,66,45,6100,11675,1950,4425,33125,25867,1
1236,0,0,154.0,189.0,201.0,196.0,2468,1230,2155,1063,313,167,2529,742,1780,540,749,202,66,45,6100,11675,1950,4425,33275,25867,1
1243,0,0,153.0,189.0,193.0,196.0,2401,1068,2155,979,246,89,2827,869,2050,655,777,214,63,45,6100,11675,2875,4425,33650,25867,1
1250,0,0,160.0,189.0,193.0,196.0,2373,1012,2127,923,246,89,2759,986,1950,760,809,226,63,45,6150,11675,3525,4425,33725,25867,1
1257,0,0,164.0,191.0,193.0,196.0,2395,1001,2127,867,268,134,2656,807,1915,765,741,42,63,45,6250,11675,3075,4425,34250,25867,1
1264,0,0,167.0,191.0,161.0,196.0,2378,934,2155,867,223,67,2700,911,1935,865,765,46,66,45,6350,12225,3075,4425,34650,25867,1
1271,0,0,167.0,191.0,161.0,196.0,2115,934,1847,867,268,67,2506,1033,1705,975,801,58,67,45,6600,12225,3075,4425,34650,25867,1
1279,0,0,167.0,191.0,161.0,196.0,2412,850,2099,783,313,67,2556,1126,1715,1060,841,66,67,45,6750,12225,3075,4425,34650,25867,1
1286,0,0,162.0,191.0,161.0,196.0,2726,766,2435,699,291,67,2838,1224,1965,1150,873,74,66,45,6550,12225,2875,4200,35100,26092,1
1293,0,0,177.0,190.0,201.0,196.0,3000,788,2687,699,313,89,2838,1316,1925,1230,913,86,66,45,6550,12175,2775,4200,35200,26142,1
1300,0,0,177.0,190.0,178.0,196.0,2798,883,2463,727,335,156,3074,1435,2125,1325,949,110,66,45,6550,12475,3025,4200,36000,26142,1
1307,0,0,177.0,190.0,170.0,196.0,3084,967,2771,699,313,268,3440,1551,2455,1405,985,146,67,45,7000,12475,2925,4200,36200,26142,1
1314,0,0,177.0,190.0,162.0,196.0,3034,1018,2743,727,291,291,3691,1682,2670,1500,1021,182,67,45,7250,12475,2925,4200,36300,26142,1
1321,0,0,177.0,190.0,162.0,196.0,3314,995,3023,727,291,268,3788,1794,2735,1580,1053,214,67,45,7250,12475,2925,4200,36300,26142,1
1329,0,0,177.0,190.0,162.0,196.0,3174,1046,2883,755,291,291,3333,1925,2265,1675,1068,250,67,45,7250,12475,2925,4200,36300,26142,1
1336,0,0,169.0,190.0,162.0,196.0,3084,1018,2771,727,313,291,3694,2041,2590,1755,1104,286,67,45,6500,12475,2925,4200,37050,26142,1
1343,0,0,169.0,190.0,162.0,196.0,3028,1012,2715,699,313,313,4079,2162,2935,1840,1144,322,67,45,6500,12475,2925,4200,37050,26142,1
1350,0,0,170.0,190.0,170.0,196.0,3118,872,2827,559,291,313,4386,2254,3210,1900,1176,354,67,45,6400,12475,3000,4200,37150,26142,1
1357,0,0,178.0,186.0,218.0,196.0,3134,855,2799,587,335,268,4756,2366,3540,1980,1216,386,67,45,6350,12150,3000,4200,37200,26532,1
1364,0,0,117.0,158.0,218.0,196.0,3034,878,2743,587,291,291,4978,2017,3730,1595,1248,422,68,45,2750,9100,3000,4200,40800,29582,1
7,,,13.0,13.0,15.0,15.0,335,293,335,293,0,0,40,35,40,35,0,0,12,12,0,0,0,0,0,0,0
14,,,14.0,14.0,15.0,15.0,671,671,671,671,0,0,70,70,70,70,0,0,13,13,0,0,0,0,0,0,0
21,,,14.0,14.0,15.0,15.0,727,671,727,671,0,0,50,45,50,45,0,0,13,13,0,0,0,0,0,0,0
29,,,15.0,15.0,15.0,15.0,755,699,755,699,0,0,95,30,95,30,0,0,14,14,0,0,0,0,0,0,0
36,,,16.0,15.0,23.0,23.0,811,755,811,755,0,0,150,135,150,135,0,0,15,14,0,0,0,0,0,0,0
43,,,16.0,16.0,23.0,23.0,811,755,811,755,0,0,35,15,35,15,0,0,15,15,0,0,0,0,0,0,0
50,,,17.0,17.0,23.0,23.0,867,783,867,783,0,0,20,40,20,40,0,0,16,16,0,0,0,0,0,0,0
57,,,18.0,18.0,23.0,23.0,811,755,811,755,0,0,50,45,50,45,0,0,17,17,0,0,0,0,0,0,0
64,,,18.0,18.0,23.0,23.0,923,811,923,811,0,0,115,60,115,60,0,0,17,17,0,0,0,0,0,0,0
71,,,19.0,19.0,23.0,23.0,945,867,923,867,22,0,174,175,170,175,4,0,18,18,0,0,0,0,0,0,0
79,,,20.0,20.0,23.0,23.0,1012,839,923,839,89,0,106,75,90,75,16,0,19,19,0,0,0,0,0,0,0
86,,,21.0,20.0,23.0,23.0,1040,962,839,895,201,67,89,57,45,45,44,12,20,19,0,0,150,150,0,0,0
93,,,22.0,21.0,23.0,23.0,1051,967,783,811,268,156,156,112,80,80,76,32,21,20,0,0,150,150,0,0,0
100,,,22.0,21.0,23.0,23.0,1074,1012,783,811,291,201,146,146,30,90,116,56,21,21,0,0,150,150,0,0,0
107,,,23.0,22.0,23.0,23.0,1118,1079,783,811,335,268,271,123,115,35,156,88,22,21,0,0,150,150,0,0,0
114,,,23.0,23.0,23.0,31.0,1118,1186,783,895,335,291,411,260,215,140,196,120,22,22,0,0,150,150,0,0,0
121,,,27.0,23.0,31.0,31.0,1152,1102,839,811,313,291,98,386,20,230,78,156,23,22,0,0,450,300,0,0,0
129,,,27.0,28.0,31.0,31.0,1236,1202,923,867,313,335,258,161,140,115,118,46,23,23,0,0,450,450,0,0,0
136,,,27.0,28.0,31.0,31.0,1208,1096,895,783,313,313,153,82,95,50,58,32,23,23,0,0,450,450,0,0,0
143,,,27.0,29.0,31.0,31.0,1236,1124,923,811,313,313,308,222,210,150,98,72,23,24,0,0,450,450,0,0,0
150,,,27.0,29.0,31.0,31.0,1258,1118,923,783,335,335,108,367,70,255,38,112,23,25,0,0,450,450,0,0,0
157,,,31.0,29.0,31.0,39.0,1258,1258,923,923,335,335,159,527,85,375,74,152,23,25,350,325,450,450,0,0,0
164,,,31.0,29.0,31.0,39.0,1258,1236,923,923,335,313,304,263,190,75,114,188,23,25,350,325,450,450,0,0,0
171,,,31.0,29.0,31.0,39.0,1236,1314,923,979,313,335,155,333,155,105,0,228,23,25,350,325,700,450,0,0,0
179,,,31.0,29.0,39.0,39.0,1264,1292,951,979,313,313,305,229,265,65,40,164,23,25,350,325,700,450,0,0,0
186,,,31.0,31.0,39.0,39.0,1314,1270,979,979,335,291,460,230,380,130,80,100,23,25,700,325,700,450,0,0,0
193,,,35.0,32.0,39.0,39.0,1264,1208,951,895,313,313,256,205,240,115,16,90,23,24,700,325,700,450,0,50,0
200,,,35.0,32.0,39.0,39.0,1342,1286,1007,951,335,335,411,265,355,135,56,130,23,24,700,325,700,550,0,50,0
207,,,35.0,32.0,39.0,39.0,1214,1253,923,895,291,358,148,410,60,240,88,170,23,24,700,475,700,550,0,50,0
214,,,35.0,33.0,39.0,39.0,1191,1236,923,923,268,313,199,207,75,155,124,52,23,24,700,475,700,800,0,50,0
221,,,35.0,34.0,39.0,47.0,1258,1236,923,923,335,313,349,317,185,225,164,92,23,25,1050,650,700,800,0,50,0
229,,,35.0,34.0,47.0,47.0,1264,1236,951,923,313,313,486,367,290,235,196,132,23,25,1050,650,700,800,0,50,0
236,,,39.0,39.0,47.0,47.0,1264,1258,951,923,313,335,141,117,5,45,136,72,23,26,1400,1000,700,800,0,50,0
243,,,39.0,39.0,47.0,62.0,1236,1258,923,923,313,335,296,173,120,65,176,108,23,26,1400,1000,700,800,0,50,0
250,,,39.0,41.0,47.0,62.0,1286,1342,951,1007,335,335,441,243,225,95,216,148,23,27,1400,1000,700,800,0,50,0
257,,,44.0,43.0,47.0,62.0,1253,1376,895,1063,358,313,196,234,40,100,156,134,23,27,1400,1175,700,900,0,50,0
264,,,44.0,45.0,47.0,70.0,1236,1516,923,1203,313,313,338,249,150,125,188,124,23,29,1400,1350,700,900,0,50,0
271,,,45.0,45.0,47.0,70.0,1236,1488,923,1175,313,313,388,175,160,115,228,60,24,29,1750,1350,700,900,0,50,0
279,,,43.0,43.0,62.0,70.0,1208,1578,895,1287,313,291,543,191,275,145,268,46,24,29,1575,1000,700,900,175,400,0
286,,,42.0,41.0,62.0,70.0,1320,1544,1007,1231,313,313,703,101,395,65,308,36,25,29,1400,825,850,1200,350,750,0
293,,,49.0,41.0,62.0,70.0,1314,1600,979,1287,335,313,233,306,35,230,198,76,25,29,1400,1000,850,1200,350,750,0
300,,,51.0,44.0,62.0,70.0,1426,1628,1091,1315,335,313,354,356,120,240,234,116,27,29,1925,1100,850,1200,350,750,0
307,,,49.0,38.0,62.0,70.0,1516,1729,1203,1371,313,358,540,301,270,270,270,31,28,29,1750,400,850,1200,525,1450,0
314,,,49.0,32.0,62.0,70.0,1544,1650,1231,1315,313,335,715,317,405,250,310,67,29,30,1750,0,850,1300,525,1950,0
321,,,57.0,31.0,62.0,62.0,1656,1600,1343,1287,313,313,305,508,105,405,200,103,29,29,1750,250,850,1550,525,2100,0
329,,,57.0,30.0,62.0,62.0,1622,1460,1287,1147,335,313,235,423,95,405,140,18,31,26,2275,250,850,1350,525,2450,0
336,,,56.0,28.0,62.0,62.0,1572,1292,1259,979,313,313,326,578,150,520,176,58,30,24,2275,500,850,1350,575,2550,0
343,,,50.0,26.0,62.0,46.0,1617,1247,1371,867,246,380,515,626,315,520,200,106,24,22,2275,500,850,1350,875,2850,0
350,,,43.0,14.0,70.0,46.0,1303,687,1147,419,156,268,650,670,430,540,220,130,19,10,2100,500,850,1350,1300,3450,0
357,,,37.0,7.0,70.0,46.0,1057,179,923,0,134,179,671,690,435,540,236,150,13,3,2100,500,850,1350,1600,3800,0
364,,,33.0,8.0,70.0,54.0,743,134,699,0,44,134,641,402,405,365,236,37,9,1,2100,500,850,1350,1800,3900,0
371,,,31.0,8.0,70.0,46.0,503,22,503,0,0,22,691,402,455,365,236,37,9,2,1925,750,850,1350,1975,4000,0
379,,,38.0,8.0,78.0,46.0,531,27,531,27,0,0,131,307,120,270,11,37,9,1,1925,750,1100,1350,1975,4050,0
386,,,38.0,9.0,70.0,46.0,503,83,503,83,0,0,201,317,190,280,11,37,9,2,2450,750,1100,1350,2075,4050,0
393,,,38.0,8.0,62.0,46.0,531,71,531,27,0,44,256,325,245,280,11,45,9,2,2550,750,1200,1350,2175,4100,0
7,,,13.0,13.0,15.0,15.0,335,293,335,293,0,0,40,35,40,35,0,0,12,12,0,0,0,0,0,0,0
14,,,14.0,14.0,15.0,15.0,643,671,643,671,0,0,65,70,65,70,0,0,13,13,0,0,0,0,0,0,0
21,,,14.0,14.0,15.0,15.0,699,699,699,699,0,0,45,50,45,50,0,0,13,13,0,0,0,0,0,0,0
29,,,15.0,15.0,15.0,15.0,699,755,699,755,0,0,80,45,80,45,0,0,14,14,0,0,0,0,0,0,0
36,,,16.0,15.0,23.0,23.0,811,811,811,811,0,0,140,145,140,145,0,0,15,14,0,0,0,0,0,0,0
43,,,16.0,16.0,23.0,23.0,839,811,839,811,0,0,30,30,30,30,0,0,15,15,0,0,0,0,0,0,0
50,,,17.0,17.0,23.0,23.0,923,839,923,839,0,0,10,10,10,10,0,0,16,16,0,0,0,0,0,0,0
57,,,18.0,18.0,23.0,23.0,895,895,895,895,0,0,50,35,50,35,0,0,17,17,0,0,0,0,0,0,0
64,,,18.0,19.0,23.0,23.0,979,923,979,923,0,0,105,95,105,95,0,0,17,18,0,0,0,0,0,0,0
71,,,19.0,19.0,23.0,23.0,1029,923,1007,923,22,0,24,5,20,5,4,0,18,18,0,0,0,0,0,0,0
79,,,20.0,20.0,23.0,23.0,1068,995,979,951,89,44,96,78,80,70,16,8,19,19,0,0,0,0,0,0,0
86,,,21.0,21.0,23.0,23.0,1085,1006,839,895,246,111,77,35,25,15,52,20,20,20,0,0,150,150,0,0,0
93,,,22.0,22.0,23.0,23.0,1068,1057,755,923,313,134,143,71,55,35,88,36,21,21,0,0,150,150,0,0,0
100,,,22.0,22.0,23.0,23.0,1124,1124,811,923,313,201,188,115,60,55,128,60,21,21,0,0,150,150,0,0,0
107,,,23.0,23.0,23.0,23.0,1090,1118,755,895,335,223,273,192,105,100,168,92,22,22,0,0,150,150,0,0,0
114,,,23.0,23.0,23.0,23.0,1174,1208,839,895,335,313,418,352,210,220,208,132,22,23,0,0,300,150,0,0,0
121,,,23.0,28.0,31.0,31.0,1202,1180,867,867,335,313,564,47,320,25,244,22,23,23,0,0,300,450,0,0,0
129,,,27.0,28.0,31.0,31.0,1230,1286,895,951,335,335,269,172,135,160,134,12,23,23,0,0,450,450,0,0,0
136,,,27.0,29.0,31.0,31.0,1186,1236,895,923,291,313,156,218,90,170,66,48,23,24,0,0,450,450,0,0,0
143,,,27.0,29.0,31.0,31.0,1163,1286,895,951,268,335,212,373,110,285,102,88,23,25,0,0,450,450,0,0,0
150,,,27.0,29.0,31.0,31.0,1242,1292,951,979,291,313,363,529,225,405,138,124,23,25,0,0,450,450,0,0,0
157,,,31.0,33.0,31.0,39.0,1236,1348,923,1035,313,313,228,354,150,340,78,14,23,25,350,325,450,450,0,0,0
164,,,31.0,32.0,31.0,39.0,1286,1342,951,1007,335,335,388,114,270,60,118,54,23,24,350,325,450,450,0,50,0
171,,,31.0,33.0,31.0,39.0,1320,1370,1007,1035,313,335,135,119,135,25,0,94,23,24,350,325,700,450,0,50,0
179,,,31.0,36.0,31.0,39.0,1320,1292,1007,979,313,313,190,65,150,35,40,30,23,25,350,475,700,450,0,50,0
186,,,31.0,36.0,39.0,39.0,1292,1314,979,979,313,335,335,125,255,55,80,70,23,25,700,650,700,450,0,50,0
193,,,35.0,37.0,39.0,39.0,1258,1314,923,979,335,335,130,225,110,115,20,110,23,26,700,650,700,450,0,50,0
200,,,35.0,38.0,47.0,39.0,1208,1292,895,979,313,313,126,81,70,35,56,46,23,27,700,650,700,550,0,50,0
207,,,35.0,39.0,47.0,47.0,1314,1236,979,923,335,313,281,181,185,95,96,86,23,28,700,800,700,550,0,50,0
214,,,35.0,39.0,47.0,47.0,1258,1342,923,1007,335,335,426,351,290,225,136,126,23,28,700,800,700,550,0,50,0
221,,,35.0,39.0,47.0,47.0,1264,1376,951,1063,313,313,582,272,410,110,172,162,23,29,1050,800,700,550,0,50,0
229,,,35.0,39.0,47.0,47.0,1236,1348,923,1035,313,313,327,423,115,225,212,198,23,29,1050,800,700,550,0,50,0
236,,,37.0,44.0,47.0,62.0,1230,1264,895,951,335,313,307,178,105,40,202,138,23,29,1050,975,700,550,0,50,0
243,,,39.0,45.0,47.0,62.0,1202,1208,867,895,335,313,277,278,85,100,192,178,23,30,1050,1150,700,550,0,50,0
250,,,39.0,48.0,47.0,62.0,1208,1426,895,1091,313,335,428,138,200,20,228,118,23,30,1400,1150,850,800,0,50,0
257,,,39.0,50.0,47.0,62.0,1258,1566,923,1231,335,335,578,233,310,75,268,158,23,30,1400,1150,850,900,0,50,0
264,,,45.0,52.0,47.0,62.0,1264,1622,951,1287,313,335,209,254,55,110,154,144,23,30,1750,1325,850,1050,0,50,0
271,,,46.0,54.0,47.0,62.0,1236,1600,923,1287,313,313,304,340,110,160,194,180,23,32,1925,1325,850,1050,0,50,0
279,,,44.0,53.0,47.0,62.0,1286,1600,951,1287,335,313,459,315,225,145,234,170,23,34,1750,1525,850,1050,175,400,0
286,,,40.0,49.0,47.0,62.0,1286,1488,951,1175,335,313,619,315,345,155,274,160,24,34,1400,1000,850,1050,525,925,0
293,,,47.0,53.0,47.0,62.0,1292,1460,979,1147,313,313,185,115,25,15,160,100,24,35,1925,1175,850,1050,525,925,0
300,,,47.0,53.0,47.0,62.0,1370,1790,1035,1455,335,335,355,165,155,75,200,90,24,35,1925,1000,850,1050,525,1100,0
307,,,41.0,47.0,62.0,62.0,1342,1701,1007,1343,335,358,515,185,275,105,240,80,25,35,1400,625,850,1050,1050,1825,0
314,,,41.0,46.0,62.0,62.0,1432,1370,1119,1035,313,335,676,151,400,85,276,66,25,34,1400,450,850,1050,1050,2050,0
321,,,49.0,46.0,62.0,54.0,1320,1236,1007,923,313,313,206,192,40,90,166,102,25,34,1925,625,850,1050,1050,2150,0
329,,,49.0,46.0,62.0,54.0,1454,1404,1119,1091,335,313,391,372,185,230,206,142,25,34,1925,1000,850,850,1050,2350,0
336,,,47.0,50.0,62.0,54.0,1398,1544,1063,1231,335,313,556,182,310,100,246,82,27,34,1750,1000,850,850,1225,2350,0
7,0,1,13.0,13.0,15.0,14.0,293,293,293,293,0,0,35,35,35,35,0,0,12,12,0,0,0,0,0,0,0
14,0,1,14.0,13.0,15.0,14.0,671,671,671,671,0,0,70,20,70,20,0,0,13,13,0,0,0,0,0,0,0
21,0,1,14.0,14.0,15.0,14.0,727,727,727,727,0,0,0,45,0,45,0,0,13,13,0,0,0,0,0,0,0
29,0,1,15.0,14.0,15.0,14.0,671,755,671,755,0,0,80,140,80,140,0,0,14,13,0,0,0,0,0,0,0
36,0,1,15.0,17.0,15.0,22.0,755,783,755,783,0,0,130,85,130,85,0,0,14,14,0,0,0,0,0,0,0
43,0,1,16.0,17.0,23.0,22.0,783,783,783,783,0,0,70,175,70,175,0,0,15,14,0,0,0,0,0,0,0
50,0,1,16.0,18.0,23.0,22.0,811,867,811,867,0,0,40,235,40,235,0,0,15,17,0,0,0,0,0,0,0
57,0,1,17.0,17.0,23.0,22.0,783,811,783,811,0,0,130,35,130,35,0,0,16,16,0,0,0,0,0,0,0
64,0,1,18.0,17.0,23.0,22.0,783,923,783,923,0,0,170,70,170,70,0,0,17,16,0,0,0,0,0,0,0
71,0,1,18.0,17.0,23.0,22.0,799,867,755,867,44,0,268,170,260,170,8,0,17,16,0,0,0,0,0,0,0
79,0,1,19.0,17.0,23.0,22.0,883,923,727,923,156,0,318,35,290,35,28,0,18,16,0,0,0,0,0,0,0
86,0,1,19.0,18.0,23.0,22.0,911,923,755,923,156,0,433,100,385,100,48,0,18,16,0,0,0,0,0,0,0
93,0,1,19.0,19.0,23.0,22.0,939,922,783,811,156,111,298,150,280,130,18,20,19,18,0,0,150,0,0,0,0
100,0,1,19.0,19.0,23.0,22.0,995,1046,839,867,156,179,413,270,375,230,38,40,19,18,0,0,150,0,0,0,0
107,0,1,19.0,19.0,23.0,22.0,990,1074,811,895,179,179,128,295,70,235,58,60,19,19,0,0,150,0,0,0,0
114,0,1,19.0,20.0,23.0,22.0,990,1079,811,923,179,156,143,371,65,295,78,76,19,19,0,0,150,0,0,0,0
121,0,1,20.0,20.0,23.0,30.0,967,1079,811,923,156,156,209,491,115,395,94,96,19,19,0,0,150,250,0,0,0
129,0,1,23.0,23.0,23.0,36.0,1135,956,979,867,156,89,194,209,80,205,114,4,20,20,0,0,250,250,0,0,0
136,0,1,23.0,27.0,31.0,36.0,1135,1074,979,1007,156,67,334,97,200,85,134,12,20,20,0,0,250,250,0,0,0
143,0,1,24.0,27.0,31.0,36.0,1107,1158,951,1091,156,67,324,230,170,210,154,20,21,21,0,50,250,250,0,0,0
150,0,1,26.0,27.0,31.0,36.0,1135,1158,979,1091,156,67,219,368,145,340,74,28,21,22,100,50,250,250,0,0,0
157,0,1,27.0,28.0,31.0,36.0,1158,1242,979,1175,179,67,164,116,70,80,94,36,22,21,100,50,250,250,0,0,0
164,0,1,27.0,30.0,31.0,36.0,1214,1247,1035,1203,179,44,184,105,70,65,114,40,22,21,200,200,250,250,0,0,0
171,0,1,30.0,32.0,31.0,36.0,1135,1298,979,1231,156,67,225,98,95,50,130,48,23,23,200,350,250,250,0,0,0
179,0,1,30.0,32.0,46.0,36.0,1331,1270,1175,1203,156,67,255,246,105,190,150,56,24,23,200,350,250,250,0,0,0
186,0,1,33.0,35.5,46.0,36.0,1180,1354,979,1287,201,67,233,209,55,145,178,64,24,23,300,325,250,250,0,25,0
193,0,1,33.0,35.0,46.0,36.0,1354,1382,1063,1315,291,67,418,172,200,100,218,72,24,27,300,300,250,250,0,50,0
200,0,1,34.0,36.0,46.0,36.0,1538,1415,1203,1371,335,44,393,276,185,200,208,76,25,27,300,450,650,250,0,50,0
207,0,1,38.0,38.0,46.0,44.0,1454,1555,1119,1511,335,44,333,324,85,240,248,84,26,28,400,600,650,250,0,50,0
214,0,1,38.0,45.0,46.0,52.0,1600,1550,1287,1483,313,67,534,147,250,55,284,92,26,28,400,600,650,250,0,50,0
221,0,1,43.0,44.0,46.0,52.0,1824,1606,1511,1539,313,67,234,185,35,135,199,50,28,32,500,600,800,250,0,50,0
229,0,1,43.0,48.0,46.0,58.0,1790,1488,1455,1399,335,89,444,117,205,55,239,62,29,34,500,600,800,250,0,50,0
236,0,1,46.0,52.0,46.0,58.0,1964,1695,1651,1539,313,156,275,122,100,40,175,82,30,34,500,600,800,250,0,50,0
243,0,1,49.0,57.0,62.0,58.0,2132,1914,1819,1735,313,179,385,102,170,0,215,102,32,36,500,750,800,250,0,50,0
250,0,1,50.0,57.0,62.0,58.0,2042,2059,1707,1903,335,156,225,333,95,215,130,118,32,40,550,750,800,250,0,50,0
257,0,1,55.0,58.0,62.0,58.0,2042,2059,1707,1903,335,156,275,348,105,210,170,138,33,45,875,750,800,250,0,50,0
264,0,1,57.0,58.0,62.0,58.0,2188,2171,1875,2015,313,156,231,438,25,280,206,158,33,45,925,900,800,450,0,50,0
271,0,1,59.0,58.0,70.0,66.0,2462,2311,2127,2155,335,156,261,463,115,285,146,178,35,42,975,900,800,450,0,50,0
279,0,1,61.0,64.0,70.0,74.0,2294,2222,1959,2043,335,179,281,408,95,210,186,198,37,42,975,900,800,450,0,50,0
286,0,1,64.0,62.0,70.0,74.0,2048,2306,1735,2127,313,179,357,408,135,290,222,118,37,50,1350,900,800,450,0,50,0
293,0,1,67.0,67.0,78.0,74.0,2266,2384,1931,2183,335,201,232,452,95,310,137,142,39,50,1350,900,800,575,0,50,0
300,0,1,69.0,72.0,78.0,74.0,2378,2457,2043,2099,335,358,332,505,155,315,177,190,39,53,1500,900,800,700,0,50,0
307,0,1,72.0,73.0,78.0,74.0,2502,2401,2099,1931,403,470,159,560,30,310,129,250,39,54,1500,900,1050,700,0,50,0
314,0,1,72.0,73.0,78.0,74.0,2541,2602,2071,1931,470,671,344,303,205,215,139,88,41,59,1500,900,1175,700,0,50,0
321,0,1,76.0,73.0,86.0,74.0,2614,2832,2099,2183,515,649,299,629,200,465,99,164,41,59,1650,900,1325,700,0,50,0
329,0,1,79.0,74.0,86.0,90.0,2681,2910,2211,2127,470,783,326,734,300,470,26,264,41,59,1925,1000,1325,700,0,50,0
336,0,1,79.0,80.0,86.0,90.0,2569,3241,2099,2323,470,918,541,835,455,455,86,380,41,59,1925,1000,1325,700,0,50,0
343,0,1,82.0,80.0,86.0,106.0,2815,3364,2323,2379,492,985,596,921,500,425,96,496,41,59,2125,1000,1325,950,0,50,0
350,0,1,82.0,80.0,86.0,106.0,2591,3386,2099,2379,492,1007,576,567,420,305,156,262,41,58,2125,1350,1325,950,0,50,0
357,0,1,85.0,89.0,86.0,106.0,2429,3302,1959,2295,470,1007,702,453,490,75,212,378,41,57,2275,1350,1325,950,0,50,0
364,0,1,89.0,89.0,102.0,106.0,2474,3258,1959,2295,515,963,337,825,265,335,72,490,41,57,2550,1350,1325,950,0,50,0
371,0,1,89.0,89.0,102.0,106.0,2502,3207,1987,2267,515,940,517,1216,385,610,132,606,41,57,2550,1800,1325,950,0,50,0
379,0,1,94.0,103.0,102.0,106.0,2401,3230,1931,2267,470,963,339,796,155,70,184,726,41,57,2700,1900,1425,950,0,50,0
386,0,1,97.0,103.0,118.0,106.0,2541,3280,2071,2295,470,985,119,1092,100,250,19,842,41,57,2700,1900,1425,950,0,50,0
393,0,1,104.0,103.0,118.0,106.0,2395,3252,1903,2267,492,985,94,1482,15,520,79,962,41,57,3250,2600,1725,950,0,50,0
400,0,1,106.0,108.0,118.0,122.0,2401,3252,1931,2267,470,985,275,1614,140,540,135,1074,41,57,3350,2600,1725,950,0,50,0
407,0,1,106.0,109.0,126.0,114.0,2457,3246,1987,2239,470,1007,465,1944,270,750,195,1194,41,57,3350,2600,1725,950,0,150,0
414,0,1,112.0,114.0,134.0,114.0,2530,3179,2015,2239,515,940,615,887,360,85,255,802,41,57,3975,2600,1725,950,0,150,0
421,0,1,116.0,114.0,134.0,114.0,2558,3202,2043,2239,515,963,290,1212,100,315,190,897,41,57,4175,2900,1725,1400,0,150,0
429,0,1,119.0,124.0,134.0,136.0,2485,3286,2015,2323,470,963,462,662,220,45,242,617,41,57,4325,4150,1725,1400,0,150,0
436,0,1,121.0,117.0,150.0,136.0,2507,3252,2015,2267,492,985,767,1053,465,320,302,733,41,57,4475,3850,1725,1400,50,500,0
443,0,1,122.0,101.5,150.0,136.0,2367,3297,1875,2267,492,1030,357,1433,120,580,237,853,41,57,4475,3075,1725,1400,50,1275,0
450,0,1,131.0,116.5,150.0,136.0,2205,3190,1735,2183,470,1007,618,1055,325,90,293,965,41,57,5050,3075,1725,1400,50,1275,0
457,0,1,131.0,116.5,158.0,136.0,2194,3230,1679,2267,515,963,743,1452,390,375,353,1077,41,57,5050,3875,1725,1400,50,1275,0
464,0,1,134.0,125.0,158.0,136.0,2278,3207,1763,2267,515,940,808,633,395,40,413,593,41,57,5200,4500,1725,1400,100,1550,0
471,0,1,137.0,114.0,158.0,136.0,2289,3174,1819,2211,470,963,760,1023,420,310,340,713,41,57,5350,3950,1725,1400,100,2100,0
479,0,1,141.0,121.0,158.0,136.0,2345,3224,1875,2239,470,985,600,613,200,5,400,608,41,57,5675,3950,1725,1400,100,2100,0
486,0,1,147.0,123.0,158.0,136.0,2367,3224,1875,2239,492,985,460,784,100,160,360,624,41,57,5975,3950,1725,1400,100,2100,0
493,0,1,147.0,120.5,158.0,136.0,2227,3280,1735,2295,492,985,710,1176,290,440,420,736,41,57,5975,5825,1725,1400,100,2225,0
500,0,1,148.0,110.0,158.0,136.0,2261,3274,1791,2267,470,1007,526,1556,50,700,476,856,41,57,6025,5200,1725,1400,200,2850,0
507,0,1,151.0,109.0,166.0,136.0,2334,3174,1819,2211,515,963,736,1923,200,955,536,968,41,57,6125,5350,1725,1400,250,2900,0
514,0,1,152.0,129.0,166.0,136.0,2278,3118,1763,2155,515,963,851,1294,255,210,596,1084,42,57,6450,5350,1725,1400,250,2900,0
521,0,1,158.0,129.0,166.0,136.0,2233,3090,1763,2127,470,963,858,924,210,95,648,829,42,57,6750,5350,1725,1400,250,2900,0
529,0,1,158.0,129.0,166.0,136.0,2233,3140,1763,2155,470,985,1118,1090,410,245,708,845,42,57,6750,5350,1725,1400,250,2900,0
536,0,1,162.0,121.0,166.0,136.0,2171,3112,1679,2127,492,985,1373,1450,605,485,768,965,42,57,6950,5400,1725,1400,250,3850,0
543,0,1,165.0,119.5,166.0,136.0,2261,2983,1791,2043,470,940,1654,1790,830,725,824,1065,42,57,7100,5225,1725,1400,250,4025,0
550,0,1,166.0,116.5,166.0,136.0,2205,2826,1735,1931,470,895,1914,2128,1030,955,884,1173,42,57,7150,5075,1725,1400,250,4175,0
557,0,1,166.0,113.0,166.0,136.0,2222,2815,1707,1987,515,828,1529,2409,585,1140,944,1269,42,57,7350,4750,1725,1400,350,4500,0
564,0,1,166.0,115.0,166.0,136.0,2093,2776,1623,1903,470,873,1291,1887,520,510,771,1377,42,57,7150,3450,1725,1400,550,5800,0
571,0,1,157.0,98.5,158.0,130.0,1314,2804,979,1931,335,873,742,2040,60,555,682,1485,32,57,6950,1725,1725,1400,1400,7425,0
579,0,1,156.0,88.0,134.0,130.0,1118,2742,783,1847,335,895,812,2249,90,660,722,1589,31,57,7100,1600,1725,1400,1750,7850,0
586,0,1,156.0,80.5,134.0,124.0,1090,2513,755,1707,335,806,891,1452,129,325,762,1127,31,53,7300,1575,1725,1400,1750,8625,0
593,0,1,155.0,57.5,134.0,118.0,1180,1477,867,1007,313,470,1031,1101,233,55,798,1046,31,28,7250,1525,1725,1400,1800,10375,0
600,0,1,145.0,46.0,134.0,118.0,1454,1012,1119,699,335,313,1205,1221,367,135,838,1086,31,24,7225,1700,1725,1400,2300,11675,0
607,0,1,127.0,30.0,134.0,118.0,1538,928,1203,615,335,313,704,1341,51,215,653,1126,31,21,5725,550,1725,1400,3800,13375,0
7,2,0,13.0,13.0,15.0,15.0,293,293,293,293,0,0,35,35,35,35,0,0,12,12,0,0,0,0,0,0,0
14,2,0,14.0,14.0,15.0,15.0,671,643,671,643,0,0,70,65,70,65,0,0,13,13,0,0,0,0,0,0,0
21,2,0,14.0,14.0,15.0,15.0,699,727,699,727,0,0,45,45,45,45,0,0,13,13,0,0,0,0,0,0,0
29,2,0,15.0,15.0,15.0,15.0,699,643,699,643,0,0,80,75,80,75,0,0,14,14,0,0,0,0,0,0,0
36,2,0,15.0,15.0,15.0,15.0,755,755,755,755,0,0,125,175,125,175,0,0,14,14,0,0,0,0,0,0,0
43,2,0,16.0,16.0,23.0,23.0,727,755,727,755,0,0,5,65,5,65,0,0,15,15,0,0,0,0,0,0,0
50,2,0,17.0,16.0,23.0,23.0,783,811,783,811,0,0,20,35,20,35,0,0,16,15,0,0,0,0,0,0,0
57,2,0,18.0,17.0,23.0,23.0,783,699,783,699,0,0,70,125,70,125,0,0,17,16,0,0,0,0,0,0,0
64,2,0,19.0,18.0,23.0,23.0,923,755,923,755,0,0,125,160,125,160,0,0,18,17,0,0,0,0,0,0,0
71,2,0,19.0,18.0,23.0,23.0,951,755,951,755,0,0,185,250,185,250,0,0,18,17,0,0,0,0,0,0,0
79,2,0,20.0,19.0,23.0,23.0,967,866,923,755,44,111,298,305,290,285,8,20,19,18,0,0,0,0,0,0,0
86,2,0,20.0,19.0,23.0,23.0,990,990,923,811,67,179,421,425,405,385,16,40,19,18,0,0,0,0,0,0,0
93,2,0,20.0,20.0,23.0,23.0,990,939,923,783,67,156,384,271,360,265,24,6,20,19,0,0,150,150,0,0,0
100,2,0,21.0,20.0,23.0,23.0,1034,939,923,783,111,156,65,391,25,365,40,26,20,19,0,0,150,150,0,0,0
107,2,0,21.0,20.0,23.0,23.0,978,911,867,755,111,156,72,101,20,55,52,46,20,19,0,0,150,150,0,0,0
114,2,0,22.0,20.0,23.0,23.0,1085,939,951,783,134,156,93,116,25,50,68,66,21,19,0,0,150,150,0,0,0
121,2,0,22.0,21.0,23.0,23.0,1023,883,867,727,156,156,213,116,125,30,88,86,21,19,0,0,150,150,0,0,0
129,2,0,24.0,22.0,31.0,23.0,1079,1158,923,979,156,179,118,266,35,160,83,106,22,19,0,100,300,150,0,0,0
136,2,0,25.0,23.0,31.0,31.0,1018,1214,839,1035,179,179,93,96,40,70,53,26,22,20,0,100,300,150,0,0,0
143,2,0,25.0,23.0,31.0,31.0,1113,1247,867,1091,246,156,105,57,45,15,60,42,23,20,0,150,300,150,0,0,0
150,2,0,28.0,24.0,31.0,31.0,1163,1219,895,1063,268,156,187,47,95,35,92,12,23,21,125,150,300,150,0,0,0
157,2,0,27.0,24.0,31.0,31.0,1152,1135,839,979,313,156,77,182,45,150,32,32,23,21,125,150,400,150,50,0,0
164,2,0,28.0,25.0,31.0,31.0,962,1130,671,951,291,179,133,286,65,230,68,56,23,22,250,150,400,150,50,0,0
171,2,0,28.0,24.0,46.0,31.0,1180,1253,867,1007,313,246,293,439,185,355,108,84,23,21,250,150,400,250,50,50,0
179,2,0,30.0,23.0,46.0,46.0,1152,1202,839,979,313,223,328,433,180,325,148,108,24,21,250,150,400,500,50,100,0
186,2,0,32.0,26.0,46.0,46.0,1309,1264,951,1063,358,201,268,192,130,160,138,32,24,21,250,150,400,600,50,100,0
193,2,0,33.0,28.0,46.0,46.0,1264,1219,951,951,313,268,415,243,245,175,170,68,26,21,250,150,400,600,50,100,0
200,2,0,35.0,29.0,46.0,46.0,1460,1426,1147,1091,313,335,195,358,135,250,60,108,27,22,250,150,650,600,50,100,0
207,2,0,36.0,30.0,46.0,46.0,1432,1488,1119,1175,313,313,315,423,215,275,100,148,28,23,250,250,650,600,50,200,0
214,2,0,37.0,32.0,46.0,46.0,1550,1454,1259,1119,291,335,196,423,160,260,36,163,29,23,425,250,650,600,50,200,0
221,2,0,38.0,34.0,46.0,46.0,1449,1729,1203,1371,246,358,173,428,105,325,68,103,30,24,425,250,650,850,50,200,0
229,2,0,39.0,36.0,46.0,46.0,1656,1706,1343,1371,313,335,333,519,225,380,108,139,31,25,425,350,650,925,50,200,0
236,2,0,40.0,38.0,46.0,46.0,1734,1768,1399,1455,335,313,333,235,185,60,148,175,32,25,425,350,650,925,50,200,0
243,2,0,41.0,36.0,46.0,46.0,1874,1768,1539,1455,335,313,509,455,325,240,184,215,34,25,425,350,650,925,50,300,0
250,2,0,40.0,36.0,46.0,46.0,1818,1516,1483,1203,335,313,394,540,220,285,174,255,34,25,175,550,650,925,300,400,0
257,2,0,42.0,38.0,46.0,46.0,1880,1734,1567,1399,313,335,260,690,50,395,210,295,36,25,350,550,650,925,300,400,0
264,2,0,43.0,43.0,46.0,46.0,1807,1818,1539,1483,268,335,387,440,220,255,167,185,37,27,350,550,900,925,300,400,0
271,2,0,45.0,43.0,54.0,46.0,2026,1930,1735,1595,291,335,433,656,230,435,203,221,38,27,350,550,1050,925,300,400,0
279,2,0,50.0,45.0,62.0,46.0,2042,1908,1707,1595,335,313,273,162,130,105,143,57,39,29,350,650,1200,1000,300,400,0
286,2,0,51.0,46.0,70.0,46.0,2042,1740,1707,1427,335,313,408,292,300,195,108,97,40,31,800,650,1200,1000,300,400,0
293,2,0,55.0,46.0,70.0,46.0,2110,1768,1707,1455,403,313,391,157,285,145,106,12,41,31,975,925,1200,1000,300,400,0
300,2,0,56.0,46.0,70.0,46.0,2182,1768,1623,1455,559,313,107,182,75,130,32,52,42,32,975,925,1200,1000,300,400,0
307,2,0,58.0,46.0,70.0,46.0,2250,1930,1623,1595,627,335,218,297,185,205,33,92,43,32,1075,925,1200,1000,300,400,0
314,2,0,59.0,55.0,70.0,61.0,2272,1925,1623,1567,649,358,493,357,380,225,113,132,44,32,1075,925,1200,1000,300,400,0
321,2,0,58.0,55.0,70.0,77.0,2384,1930,1735,1595,649,335,334,598,145,430,189,168,45,32,1075,925,1200,1000,300,400,0
329,2,0,60.0,57.0,70.0,85.0,2378,2048,1707,1735,671,313,359,634,90,430,269,204,45,34,1175,1025,1200,1300,300,400,0
336,2,0,62.0,59.0,70.0,85.0,2468,1936,1819,1623,649,313,560,609,215,365,345,244,45,34,1175,1025,1350,1300,300,400,0
343,2,0,63.0,62.0,78.0,85.0,2440,1936,1791,1623,649,313,801,344,380,85,421,259,46,36,1175,1025,1350,1300,300,400,0
350,2,0,64.0,62.0,78.0,93.0,2468,2160,1819,1847,649,313,356,629,155,330,201,299,47,36,1175,1025,1650,1300,300,400,0
357,2,0,70.0,62.0,78.0,93.0,2390,2350,1763,2015,627,335,242,814,115,525,127,289,48,39,1425,1700,1650,1375,300,400,0
364,2,0,72.0,66.0,78.0,93.0,2412,2552,1763,2127,649,425,257,746,150,530,107,216,49,39,1425,1700,1650,1375,300,400,0
371,2,0,72.0,69.0,78.0,93.0,2474,2580,1847,2155,627,425,504,654,325,390,179,264,49,39,1425,1700,1650,1375,300,400,0
379,2,0,73.0,74.0,86.0,93.0,2446,2199,1819,1707,627,492,345,434,90,235,255,199,51,42,1425,1800,1650,1375,300,400,0
386,2,0,73.0,76.0,86.0,93.0,2429,2390,1847,1763,582,627,658,559,335,330,323,229,52,42,1425,1925,1650,1375,300,400,0
393,2,0,74.0,81.0,101.0,93.0,2591,2608,1987,1959,604,649,615,439,220,155,395,284,52,45,1925,1925,1650,1675,300,400,0
400,2,0,84.0,83.0,101.0,93.0,2597,2748,2015,2099,582,649,168,275,105,165,63,110,52,45,2075,2150,1650,1925,300,400,0
407,2,0,87.0,85.0,101.0,93.0,2726,2770,2099,2099,627,671,200,485,65,320,135,165,53,48,2225,2150,1650,1925,300,400,0
414,2,0,87.0,87.0,101.0,101.0,2787,2826,2183,2155,604,671,537,701,330,485,207,216,53,48,2225,2275,1650,1925,300,400,0
421,2,0,87.0,89.0,101.0,101.0,2759,2832,2155,2183,604,649,849,937,570,645,279,292,56,48,2225,2375,2100,2025,300,400,0
429,2,0,95.0,101.0,101.0,101.0,2849,3056,2267,2407,582,649,396,378,195,360,201,18,56,48,2325,2500,2350,2025,300,400,0
436,2,0,101.0,101.0,101.0,101.0,2938,3000,2379,2351,559,649,214,393,145,320,69,73,58,48,2525,2625,2500,2125,300,400,0
443,2,0,101.0,101.0,101.0,101.0,3062,2754,2435,2127,627,627,570,404,425,255,145,149,58,48,3325,2725,2500,2125,300,400,0
450,2,0,101.0,107.0,109.0,109.0,3078,2412,2407,1763,671,649,640,394,415,165,225,229,60,48,3325,3175,2500,2125,300,400,0
457,2,0,101.0,109.0,109.0,109.0,3062,2457,2435,1763,627,694,852,349,555,90,297,259,60,50,3325,3575,2500,2125,300,400,0
464,2,0,103.0,113.0,117.0,117.0,3112,2462,2463,1791,649,671,472,410,195,175,277,235,60,50,3325,3675,2650,2125,300,400,0
471,2,0,106.0,114.0,133.0,141.0,3112,2278,2463,1651,649,627,697,522,340,215,357,307,60,50,3325,3600,2650,2125,300,600,0
479,2,0,118.0,122.0,133.0,149.0,3146,2552,2519,1903,627,649,473,232,40,45,433,187,63,53,3725,3825,2650,2325,300,600,0
486,2,0,118.0,126.0,133.0,149.0,3168,2636,2407,1987,761,649,394,307,65,90,329,217,63,53,4075,3950,2650,2325,300,600,0
493,2,0,117.0,131.0,133.0,149.0,3112,2832,2127,2183,985,649,610,368,165,100,445,268,63,53,4075,3950,2650,2325,300,600,0
500,2,0,117.0,131.0,133.0,149.0,3196,2944,2211,2295,985,649,1006,718,445,370,561,348,63,53,4075,4150,2650,2325,300,600,0
507,2,0,127.0,138.0,141.0,149.0,3179,2994,2239,2323,940,671,128,554,80,130,48,424,64,56,4825,4800,2950,2325,300,600,0
514,2,0,128.0,142.0,149.0,149.0,3336,2972,2351,2323,985,649,433,450,265,100,168,350,63,56,4425,4925,3250,2575,350,600,0
521,2,0,128.0,142.0,149.0,149.0,3375,3202,2435,2575,940,627,850,236,570,85,280,151,63,59,5325,4925,3600,2575,350,600,0
529,2,0,128.0,140.0,157.0,149.0,3314,3493,2351,2799,963,694,1225,299,825,235,400,64,63,59,5325,5000,3600,2575,350,725,0
536,2,0,128.0,136.0,157.0,149.0,3386,3470,2379,2799,1007,671,1400,700,1005,560,395,140,63,55,5475,5000,3600,2575,175,925,0
543,2,0,124.0,128.0,157.0,149.0,3308,2345,2323,1987,985,358,1797,912,1290,740,507,172,63,47,5125,5225,3600,2575,450,1325,0
550,2,0,110.0,112.0,157.0,149.0,3454,1426,2491,1315,963,111,2208,1098,1585,910,623,188,63,46,4100,4575,3600,2575,1475,2250,0
557,2,0,124.0,123.0,157.0,149.0,3420,1029,2435,895,985,134,1914,544,1175,415,739,129,63,45,4100,4575,3600,2825,1475,2300,0
564,2,0,122.0,123.0,157.0,149.0,3448,1286,2463,1175,985,111,984,726,425,585,559,141,63,45,4550,4575,3600,2825,1725,2300,0
571,2,0,128.0,123.0,157.0,149.0,3319,1398,2379,1287,940,111,896,917,325,760,571,157,63,48,4550,4725,3600,2825,1725,2300,0
579,2,0,132.0,133.0,165.0,149.0,3392,2037,2407,1903,985,134,911,623,520,525,391,98,65,48,4550,5100,3600,2825,1725,2300,0
586,2,0,141.0,138.0,165.0,149.0,3336,2630,2351,2519,985,111,552,580,195,545,357,35,65,48,4850,5100,3600,2825,1725,2300,0
593,2,0,141.0,138.0,165.0,149.0,3224,2580,2239,2267,985,313,933,773,460,690,473,83,65,51,5300,5300,3600,2825,1725,2375,0
600,2,0,147.0,135.0,173.0,149.0,3342,2765,2379,2295,963,470,1039,1099,450,960,589,139,68,50,5300,5575,3750,2725,1725,2625,0
607,2,0,149.0,122.0,173.0,149.0,3336,3118,2351,2603,985,515,1130,1338,425,1135,705,203,68,42,5775,4975,3750,2625,1925,3825,0
614,2,0,139.0,121.0,173.0,141.0,3392,2513,2407,2155,985,358,1195,1083,470,915,725,168,68,32,4875,5200,3750,2625,3125,4425,0
621,2,0,141.0,119.0,173.0,141.0,3392,2104,2407,1903,985,201,922,1332,335,1140,587,192,68,32,4975,5200,3750,2625,3375,4525,0
629,2,0,147.0,119.0,173.0,141.0,3476,2166,2491,1987,985,179,533,1417,430,1205,103,212,68,31,4875,5200,3750,2625,3475,4650,0
636,2,0,147.0,118.0,188.0,133.0,3504,2278,2519,2099,985,179,489,1691,370,1455,119,236,68,28,4875,5675,3750,2625,3475,4950,0
643,2,0,141.0,79.0,188.0,133.0,3655,1998,2715,1819,940,179,916,1926,685,1670,231,256,68,25,5650,3500,3750,2625,3975,7275,0
650,2,0,143.0,41.0,188.0,118.0,3610,1639,2715,1483,895,156,953,2096,610,1820,343,276,68,20,5600,1500,3750,2625,4425,10275,0
7,2,0,13.0,13.0,15.0,15.0,293,293,293,293,0,0,35,35,35,35,0,0,12,12,0,0,0,0,0,0,0
14,2,0,14.0,14.0,15.0,15.0,671,671,671,671,0,0,70,70,70,70,0,0,13,13,0,0,0,0,0,0,0
21,2,0,14.0,14.0,15.0,15.0,727,699,727,699,0,0,0,50,0,50,0,0,13,13,0,0,0,0,0,0,0
29,2,0,15.0,15.0,15.0,15.0,727,671,727,671,0,0,90,85,90,85,0,0,14,14,0,0,0,0,0,0,0
36,2,0,15.0,15.0,15.0,15.0,811,755,811,755,0,0,150,135,150,135,0,0,14,14,0,0,0,0,0,0,0
43,2,0,16.0,16.0,23.0,23.0,839,783,839,783,0,0,40,70,40,70,0,0,15,15,0,0,0,0,0,0,0
50,2,0,17.0,16.0,23.0,23.0,839,867,839,867,0,0,10,45,10,45,0,0,16,15,0,0,0,0,0,0,0
57,2,0,18.0,17.0,23.0,23.0,839,727,839,727,0,0,75,35,75,35,0,0,17,16,0,0,0,0,0,0,0
64,2,0,19.0,18.0,23.0,23.0,895,867,895,867,0,0,175,140,175,140,0,0,18,17,0,0,0,0,0,0,0
71,2,0,19.0,18.0,23.0,23.0,973,883,951,839,22,44,294,233,290,225,4,8,18,17,0,0,0,0,0,0,0
79,2,0,20.0,19.0,23.0,23.0,967,939,923,783,44,156,358,343,350,315,8,28,19,18,0,0,0,0,0,0,0
86,2,0,20.0,19.0,23.0,23.0,1018,911,951,755,67,156,331,453,315,405,16,48,19,18,0,0,150,0,0,0,0
93,2,0,20.0,20.0,23.0,23.0,990,906,923,727,67,179,49,303,25,285,24,18,20,19,0,0,150,150,0,0,0
100,2,0,21.0,20.0,23.0,23.0,1040,939,951,783,89,156,126,414,90,380,36,34,20,19,0,0,150,150,0,0,0
107,2,0,22.0,20.0,23.0,23.0,1057,911,923,755,134,156,97,119,45,65,52,54,21,19,0,0,150,150,0,0,0
114,2,0,22.0,20.0,23.0,23.0,1085,883,951,727,134,156,158,234,90,160,68,74,21,19,0,0,150,150,0,0,0
121,2,0,25.0,21.0,31.0,23.0,1079,911,923,755,156,156,109,149,50,55,59,94,22,19,0,0,300,150,0,0,0
129,2,0,25.0,22.0,31.0,23.0,1107,1023,951,867,156,156,89,124,60,10,29,114,22,19,0,100,300,150,0,0,0
136,2,0,26.0,22.0,31.0,23.0,1186,962,1007,783,179,179,183,154,130,70,53,84,23,20,0,100,300,150,0,0,0
143,2,0,28.0,22.0,31.0,23.0,1253,1074,1007,895,246,179,155,139,120,35,35,104,23,20,125,100,300,150,50,0,0
150,2,0,28.0,23.0,31.0,31.0,1270,967,979,811,291,156,255,210,180,90,75,120,23,21,125,100,300,150,50,0,0
157,2,0,29.0,23.0,31.0,31.0,1337,1191,979,1035,358,156,230,225,165,85,65,140,24,21,125,100,300,150,50,0,0
164,2,0,31.0,24.0,46.0,31.0,1314,1219,979,1063,335,156,336,365,235,205,101,160,24,22,300,100,300,300,50,0,0
171,2,0,33.0,24.0,46.0,31.0,1264,1247,951,1091,313,156,127,435,90,280,37,155,25,23,300,100,300,400,50,0,0
179,2,0,33.0,25.0,46.0,31.0,1298,1331,1007,1175,291,156,238,435,165,260,73,175,25,21,300,100,300,400,50,100,0
186,2,0,35.0,27.0,46.0,31.0,1320,1270,1007,1091,313,179,353,245,240,175,113,70,27,21,300,100,300,475,50,100,0
193,2,0,37.0,29.0,46.0,31.0,1432,1242,1119,1063,313,179,123,225,70,160,53,65,29,22,475,200,300,625,50,100,0
200,2,0,38.0,29.0,46.0,46.0,1505,1191,1147,1035,358,156,263,216,170,135,93,81,30,22,475,200,300,625,50,100,0
207,2,0,40.0,28.0,46.0,46.0,1510,1219,1175,1063,335,156,379,281,250,180,129,101,32,22,475,275,550,625,50,200,0
214,2,0,40.0,33.0,46.0,46.0,1628,1191,1315,1035,313,156,85,171,70,100,15,71,32,22,475,325,550,700,50,200,0
221,2,0,42.0,33.0,46.0,46.0,1684,1247,1371,1091,313,156,90,316,35,225,55,91,34,22,475,325,550,700,50,200,0
229,2,0,43.0,33.0,46.0,46.0,1936,1298,1623,1119,313,179,180,330,85,219,95,111,35,22,475,275,550,700,50,350,0
236,2,0,45.0,37.0,46.0,46.0,1852,1298,1539,1119,313,179,100,140,40,59,60,81,36,23,475,525,800,700,50,350,0
243,2,0,46.0,38.0,46.0,46.0,2070,1499,1735,1343,335,156,190,341,90,244,100,97,38,23,475,575,800,700,50,350,0
250,2,0,45.0,38.0,46.0,46.0,2014,1443,1679,1287,335,156,266,141,130,124,136,17,38,23,350,525,800,700,175,551,0
257,2,0,48.0,40.0,62.0,46.0,2098,1303,1763,1147,335,156,266,196,140,159,126,37,39,23,450,775,950,700,175,551,0
264,2,0,51.0,44.0,62.0,46.0,2132,1359,1819,1203,313,156,347,106,260,49,87,57,41,25,625,875,950,700,175,551,0
271,2,0,54.0,44.0,62.0,54.0,2188,1471,1875,1315,313,156,227,126,150,49,77,77,42,25,800,875,1100,700,175,551,0
279,2,0,59.0,46.0,62.0,54.0,2188,1522,1875,1343,313,179,142,271,125,174,17,97,43,27,800,875,1200,700,175,551,0
286,2,0,60.0,50.0,62.0,54.0,2306,1544,1903,1343,403,201,319,120,250,49,69,71,44,27,1250,975,1200,700,175,551,0
293,2,0,63.0,54.0,70.0,54.0,2306,1830,1679,1539,627,291,164,166,65,59,99,107,45,29,1250,975,1200,700,175,551,0
300,2,0,65.0,54.0,70.0,54.0,2434,1936,1763,1623,671,313,360,146,260,99,100,47,46,29,1425,975,1200,1075,175,551,0
307,2,0,70.0,54.0,70.0,54.0,2518,2020,1847,1707,671,313,146,187,70,154,76,33,48,31,1625,1225,1200,1075,175,551,0
314,2,0,70.0,58.0,70.0,62.0,2608,2160,1959,1847,649,313,257,272,105,199,152,73,48,31,1625,1325,1200,1075,175,551,0
321,2,0,70.0,62.0,70.0,62.0,2502,2076,1875,1763,627,313,548,152,320,89,228,63,49,31,1725,1325,1300,1075,175,551,0
329,2,0,71.0,62.0,78.0,62.0,2636,1986,1987,1651,649,335,863,187,555,84,308,103,49,33,1725,1425,1450,1075,175,551,0
336,2,0,71.0,62.0,86.0,62.0,2580,1981,1931,1623,649,358,269,116,135,69,134,47,49,33,1725,1375,1450,1325,175,601,0
343,2,0,73.0,65.0,86.0,70.0,2580,2143,1931,1651,649,492,294,176,130,69,164,107,50,33,1725,1625,1450,1425,175,601,0
350,2,0,75.0,69.0,86.0,78.0,2552,2255,1903,1763,649,492,430,261,240,194,190,67,50,35,2075,1625,1450,1425,175,601,0
357,2,0,75.0,73.0,86.0,78.0,2742,2233,2071,1763,671,470,305,107,35,84,270,23,50,35,2075,1725,1450,1425,175,601,0
364,2,0,77.0,75.0,94.0,86.0,2558,2177,1931,1707,627,470,448,107,110,74,338,33,50,37,2075,1600,1450,1425,175,726,0
371,2,0,74.0,67.0,94.0,86.0,2563,2390,1959,1875,604,515,765,382,355,289,410,93,51,37,1725,1125,1450,1425,525,1201,0
379,2,0,85.0,66.0,94.0,94.0,2586,2334,1959,1819,627,515,226,157,140,104,86,53,52,37,1725,1000,1750,1425,525,1426,0
386,2,0,89.0,70.0,94.0,94.0,2614,2423,1987,1931,627,492,356,454,190,349,166,105,54,37,2125,1650,1750,1425,525,1426,0
393,2,0,89.0,70.0,94.0,94.0,2642,2619,2015,2127,627,492,376,159,130,94,246,65,54,39,2125,1700,1750,1425,525,1426,0
400,2,0,89.0,74.0,94.0,94.0,2658,2513,1987,2043,671,470,196,245,20,124,176,121,56,39,2125,1700,1750,1425,525,1426,0
407,2,0,93.0,74.0,94.0,94.0,2748,2709,2099,2239,649,470,278,515,130,334,148,181,56,39,2125,1950,2050,1425,525,1426,0
414,2,0,96.0,78.0,117.0,94.0,2580,2591,1931,2099,649,492,434,445,210,254,224,191,56,41,2375,1950,2200,1525,525,1426,0
421,2,0,100.0,84.0,125.0,94.0,2440,2558,1791,2043,649,515,379,150,75,124,304,26,56,41,2875,2050,2300,1525,525,1426,0
429,2,0,100.0,84.0,133.0,94.0,2838,2507,2211,2015,627,492,735,366,355,284,380,82,59,39,3075,2050,2400,1525,525,1526,0
436,2,0,106.0,86.0,133.0,102.0,3118,2507,2491,1903,627,604,615,562,355,404,260,158,59,41,3075,2300,2400,1525,525,1526,0
443,2,0,116.0,90.0,133.0,102.0,3190,2552,2519,1903,671,649,185,422,45,234,140,188,59,41,3075,2300,2400,1525,525,1526,0
450,2,0,115.0,88.0,133.0,102.0,2961,2558,2267,1931,694,627,420,733,200,469,220,264,58,43,3875,2600,2400,1600,575,1726,0
457,2,0,117.0,85.0,133.0,102.0,2328,2776,1679,2127,649,649,582,1058,290,714,292,344,58,43,3875,2425,2550,1600,575,1901,0
464,2,0,123.0,90.0,133.0,110.0,2552,2849,1903,2155,649,694,493,1023,125,649,368,374,56,45,3975,2625,2550,1600,675,1951,0
471,2,0,126.0,87.0,141.0,125.0,2838,2910,2211,2239,627,671,629,384,185,259,444,125,56,45,4375,1925,2550,1600,675,2651,0
479,2,0,133.0,88.0,141.0,125.0,3006,2810,2379,2183,627,627,504,496,180,299,324,197,59,45,4875,2025,2550,1600,675,2651,0
486,2,0,133.0,89.0,141.0,125.0,3028,2972,2379,2323,649,649,849,781,445,504,404,277,59,45,4875,2275,2550,1600,675,2651,0
493,2,0,135.0,97.0,141.0,125.0,3050,2726,2379,2099,671,627,474,462,90,259,384,203,60,47,4875,2275,2550,1600,675,2651,0
500,2,0,135.0,97.0,141.0,125.0,2938,2782,2267,2155,671,627,820,812,360,529,460,283,60,47,4875,2950,2550,1600,675,2651,0
507,2,0,135.0,101.0,141.0,125.0,3022,2686,2351,2015,671,671,516,532,180,344,336,188,62,49,4875,3050,2550,1600,675,2651,0
514,2,0,140.0,110.0,165.0,125.0,2860,2686,2211,2015,649,671,427,323,65,259,362,64,62,49,5050,3300,2550,1600,675,2651,0
521,2,0,142.0,112.0,165.0,125.0,3090,2552,2239,1903,851,649,728,524,250,384,478,140,64,51,5050,3300,2550,1600,675,2651,0
529,2,0,147.0,114.0,165.0,125.0,3230,2636,2267,1987,963,649,769,570,275,379,494,191,65,51,5400,3300,2550,1900,675,2651,0
536,2,0,154.0,119.0,165.0,125.0,3302,2552,2295,1903,1007,649,859,495,245,324,614,171,68,51,6000,3825,2550,1900,675,2651,0
543,2,0,156.0,122.0,165.0,133.0,3241,3062,2211,2435,1030,627,1054,521,470,399,584,122,68,53,6200,4325,2900,1900,675,2651,0
550,2,0,156.0,125.0,165.0,133.0,3398,3224,2435,2575,963,649,947,716,255,514,692,202,69,54,6400,4275,3050,1975,675,2701,0
557,2,0,156.0,125.0,165.0,141.0,3538,2826,2575,2155,963,671,1363,1056,555,774,808,282,69,54,6400,4525,3200,1975,675,2701,0
7,,,13.0,13.0,15.0,15.0,377,293,377,293,0,0,45,35,45,35,0,0,12,12,0,0,0,0,0,0,1
14,,,14.0,14.0,15.0,15.0,671,671,671,671,0,0,70,70,70,70,0,0,13,13,0,0,0,0,0,0,1
21,,,14.0,14.0,15.0,15.0,727,727,727,727,0,0,155,50,155,50,0,0,13,13,0,0,0,0,0,0,1
29,,,15.0,15.0,15.0,15.0,783,727,783,727,0,0,95,85,95,85,0,0,14,14,0,0,0,0,0,0,1
36,,,15.0,15.0,15.0,23.0,755,811,755,811,0,0,145,45,145,45,0,0,14,14,0,0,0,0,0,0,1
43,,,15.0,16.0,15.0,23.0,783,755,783,755,0,0,230,70,230,70,0,0,15,15,0,0,0,0,0,0,1
50,,,16.0,17.0,23.0,23.0,783,811,783,811,0,0,105,45,105,45,0,0,15,16,0,0,0,0,0,0,1
57,,,16.0,17.0,23.0,23.0,727,839,727,839,0,0,100,45,100,45,0,0,15,16,0,0,0,0,0,0,1
64,,,17.0,18.0,23.0,23.0,783,867,783,867,0,0,140,95,140,95,0,0,16,17,0,0,0,0,0,0,1
71,,,18.0,18.0,23.0,23.0,783,911,783,867,0,44,240,208,240,200,0,8,17,17,0,0,0,0,0,0,1
79,,,18.0,19.0,23.0,31.0,850,934,783,755,67,179,342,127,330,95,12,32,17,18,0,0,0,0,0,0,1
86,,,19.0,19.0,23.0,31.0,827,911,671,755,156,156,447,83,415,35,32,48,18,18,0,0,0,150,0,0,1
93,,,19.0,21.0,23.0,31.0,883,967,727,811,156,156,562,103,510,35,52,68,18,19,0,0,0,150,0,0,1
100,,,19.0,22.0,23.0,31.0,939,995,783,839,156,156,32,168,10,80,22,88,19,19,0,0,150,150,0,0,1
107,,,19.0,23.0,23.0,31.0,1046,1001,867,867,179,134,152,169,110,65,42,104,19,20,0,0,150,150,0,0,1
114,,,19.0,23.0,23.0,31.0,995,1023,839,867,156,156,158,244,100,120,58,124,19,20,0,0,150,150,0,0,1
121,,,19.0,26.0,23.0,31.0,995,1079,839,923,156,156,268,209,190,115,78,94,19,21,0,100,150,450,0,0,1
129,,,20.0,28.0,23.0,31.0,911,1124,755,923,156,201,323,72,225,50,98,22,19,21,0,100,150,450,0,0,1
136,,,22.0,29.0,31.0,31.0,855,1214,699,923,156,291,273,164,155,110,118,54,19,22,0,100,250,450,0,0,1
143,,,22.0,29.0,31.0,31.0,827,1264,671,951,156,313,63,149,25,105,38,44,20,22,0,275,250,450,0,0,1
150,,,23.0,31.0,31.0,31.0,766,1264,587,951,179,313,103,295,45,215,58,80,20,23,0,450,250,450,0,0,1
157,,,23.0,31.0,31.0,31.0,822,1264,643,951,179,313,158,445,80,325,78,120,19,23,100,450,250,450,50,0,1
164,,,24.0,31.0,31.0,31.0,799,1236,643,923,156,313,194,590,100,430,94,160,20,23,100,625,250,450,50,0,1
171,,,21.0,31.0,31.0,31.0,911,1230,755,895,156,335,249,740,135,540,114,200,18,23,50,625,250,450,250,0,1
178,,,18.0,29.0,46.0,31.0,934,1208,755,895,179,313,354,881,220,645,134,236,16,23,50,450,350,450,400,175,1
7,2,2,13.0,13.0,15.0,15.0,293,293,293,293,0,0,35,35,35,35,0,0,12,12,0,0,0,0,0,0,1
14,2,2,14.0,14.0,15.0,15.0,671,671,671,671,0,0,70,70,70,70,0,0,13,13,0,0,0,0,0,0,1
21,2,2,14.0,14.0,15.0,15.0,699,727,699,727,0,0,50,0,50,0,0,0,13,13,0,0,0,0,0,0,1
29,2,2,15.0,15.0,15.0,15.0,671,671,671,671,0,0,80,85,80,85,0,0,14,14,0,0,0,0,0,0,1
36,2,2,15.0,15.0,15.0,23.0,783,811,783,811,0,0,190,140,190,140,0,0,14,14,0,0,0,0,0,0,1
43,2,2,16.0,16.0,23.0,23.0,811,811,811,811,0,0,75,30,75,30,0,0,15,15,0,0,0,0,0,0,1
50,2,2,17.0,17.0,23.0,23.0,811,811,811,811,0,0,120,10,120,10,0,0,16,16,0,0,0,0,0,0,1
57,2,2,18.0,18.0,23.0,23.0,811,783,811,783,0,0,100,105,100,105,0,0,17,17,0,0,0,0,0,0,1
64,2,2,18.0,19.0,23.0,23.0,923,895,923,895,0,0,165,90,165,90,0,0,17,18,0,0,0,0,0,0,1
71,2,2,19.0,19.0,23.0,23.0,923,895,923,895,0,0,270,0,270,0,0,0,18,18,0,0,0,0,0,0,1
79,2,2,19.0,20.0,23.0,23.0,923,995,923,951,0,44,385,123,385,115,0,8,19,19,0,0,0,0,0,0,1
86,2,2,20.0,21.0,23.0,23.0,883,1079,839,923,44,156,363,213,355,185,8,28,19,20,0,0,0,0,0,0,1
93,2,2,23.0,22.0,23.0,23.0,911,1113,755,979,156,134,187,130,155,90,32,40,20,21,0,0,150,150,0,0,1
100,2,2,23.0,22.0,23.0,23.0,939,1130,783,951,156,179,198,114,150,50,48,64,20,21,0,0,150,150,0,0,1
107,2,2,23.0,23.0,23.0,23.0,995,1225,839,979,156,246,323,157,255,65,68,92,21,22,0,0,150,150,0,0,1
114,2,2,24.0,24.0,31.0,31.0,1012,1247,811,979,201,268,401,258,305,130,96,128,21,23,100,0,150,150,0,0,1
121,2,2,24.0,24.0,31.0,31.0,1096,1242,783,951,313,291,536,394,400,230,136,164,21,23,100,0,150,300,0,0,1
129,2,2,25.0,28.0,31.0,31.0,1146,1337,811,979,335,358,217,109,45,55,172,54,22,24,100,0,300,450,0,100,1
136,2,2,25.0,28.0,31.0,31.0,1146,1202,811,867,335,335,247,140,35,50,212,90,22,24,100,0,300,450,0,100,1
143,2,2,27.0,28.0,31.0,31.0,1208,1292,895,979,313,313,223,46,25,20,198,26,23,24,100,0,300,450,0,100,1
150,2,2,28.0,29.0,31.0,31.0,1208,1214,895,923,313,291,213,137,25,75,188,62,23,24,100,0,300,450,0,100,1
157,2,2,28.0,29.0,39.0,39.0,1208,1286,895,951,313,335,258,287,30,185,228,102,23,24,100,350,300,450,0,100,1
164,2,2,28.0,33.0,39.0,39.0,1258,1258,923,923,335,335,408,97,140,55,268,42,24,25,275,350,300,450,0,100,1
171,2,2,28.0,33.0,39.0,39.0,1208,1264,895,951,313,313,249,238,95,160,154,78,24,25,275,350,300,450,0,100,1
179,2,2,29.0,32.0,31.0,39.0,1320,1286,1007,951,313,335,360,398,170,280,190,118,24,24,275,350,300,700,100,150,1
186,2,2,30.0,32.0,31.0,39.0,1264,1292,951,979,313,313,355,249,125,245,230,4,25,24,275,350,400,700,100,150,1
193,2,2,29.0,32.0,31.0,39.0,1264,1264,951,951,313,313,496,399,230,355,266,44,24,24,275,700,400,700,150,150,1
200,2,2,32.0,32.0,46.0,39.0,1314,1264,979,951,335,313,436,149,180,65,256,84,25,24,275,700,400,700,150,150,1
207,2,2,33.0,32.0,54.0,39.0,1348,1286,1035,951,313,335,532,159,240,35,292,124,25,24,275,700,400,700,150,150,1
214,2,2,38.0,33.0,54.0,39.0,1398,1348,1063,1035,335,313,302,270,120,110,182,160,27,24,275,700,700,700,150,150,1
221,2,2,38.0,34.0,54.0,39.0,1454,1314,1119,979,335,335,477,366,255,170,222,196,28,25,275,700,700,700,150,150,1
229,2,2,38.0,34.0,54.0,39.0,1516,1314,1203,979,313,335,558,426,300,190,258,236,28,25,450,700,700,700,150,150,1
236,2,2,40.0,38.0,54.0,39.0,1516,1208,1203,895,313,313,643,222,345,50,298,172,28,26,450,700,700,700,150,150,1
243,2,2,44.0,38.0,54.0,39.0,1566,1264,1231,951,335,313,288,272,100,60,188,212,29,26,800,1050,700,700,150,150,1
250,2,2,46.0,38.0,54.0,39.0,1566,1264,1231,951,335,313,363,432,135,180,228,252,30,26,800,1050,700,700,150,150,1
257,2,2,46.0,38.0,54.0,39.0,1606,1286,1315,951,291,335,305,587,45,295,260,292,30,26,800,1050,800,950,150,150,1
264,2,2,48.0,44.0,62.0,47.0,1667,1258,1399,923,268,335,407,212,115,30,292,182,32,26,800,1400,800,950,150,150,1
271,2,2,49.0,44.0,62.0,62.0,1712,1286,1399,951,313,335,572,268,240,50,332,218,33,26,800,1575,900,950,150,150,1
279,2,2,49.0,45.0,70.0,62.0,1796,1230,1483,895,313,335,423,368,155,110,268,258,35,26,1050,1575,900,950,250,150,1
286,2,2,52.0,44.0,70.0,62.0,1908,1208,1595,895,313,313,388,559,180,265,208,294,36,26,1200,1575,900,950,250,150,1
293,2,2,53.0,49.0,70.0,70.0,1936,1320,1623,1007,313,313,255,329,15,95,240,234,37,26,1200,1925,900,950,250,150,1
300,2,2,54.0,50.0,70.0,70.0,1975,1432,1707,1119,268,313,442,264,170,40,272,224,38,26,1200,1925,900,950,250,325,1
307,2,2,60.0,51.0,70.0,62.0,2048,1454,1735,1119,313,335,242,344,80,80,162,264,40,27,1200,1925,1050,950,250,425,1
314,2,2,54.0,54.0,70.0,62.0,2132,1533,1819,1175,313,358,327,334,175,80,152,254,40,29,500,1925,1300,950,950,425,1
321,2,2,56.0,56.0,70.0,62.0,2188,1538,1875,1203,313,335,222,245,80,5,142,240,42,29,850,2100,1300,950,950,425,1
329,2,2,56.0,57.0,70.0,62.0,2289,1572,1931,1259,358,313,382,386,200,110,182,276,42,30,850,2275,1200,950,1050,425,1
336,2,2,52.0,58.0,70.0,62.0,2289,1628,1931,1315,358,313,557,481,335,165,222,316,42,30,500,2275,1250,950,1500,425,1
343,2,2,48.0,60.0,78.0,70.0,1852,1600,1539,1287,313,313,374,446,220,140,154,306,42,32,525,2275,1400,950,2175,600,1
350,2,2,46.0,57.0,78.0,70.0,1292,1678,979,1343,313,335,259,381,115,85,144,296,40,33,350,1925,1500,950,2450,1125,1
356,2,2,37.0,58.0,78.0,70.0,1236,1818,923,1483,313,335,376,463,200,135,176,328,35,34,175,1925,1600,950,3050,1125,1
7,0,2,13.0,13.0,15.0,15.0,293,293,293,293,0,0,35,35,35,35,0,0,12,12,0,0,0,0,0,0,1
14,0,2,14.0,14.0,15.0,15.0,671,671,671,671,0,0,70,70,70,70,0,0,13,13,0,0,0,0,0,0,1
21,0,2,14.0,14.0,15.0,15.0,699,699,699,699,0,0,50,0,50,0,0,0,13,13,0,0,0,0,0,0,1
29,0,2,15.0,15.0,15.0,15.0,671,699,671,699,0,0,85,40,85,40,0,0,14,14,0,0,0,0,0,0,1
36,0,2,15.0,15.0,15.0,23.0,727,783,727,783,0,0,125,150,125,150,0,0,14,14,0,0,0,0,0,0,1
43,0,2,16.0,16.0,23.0,23.0,755,839,755,839,0,0,70,50,70,50,0,0,15,15,0,0,0,0,0,0,1
50,0,2,16.0,17.0,23.0,23.0,811,811,811,811,0,0,45,10,45,10,0,0,15,16,0,0,0,0,0,0,1
57,0,2,17.0,18.0,23.0,23.0,811,839,811,839,0,0,140,70,140,70,0,0,16,17,0,0,0,0,0,0,1
64,0,2,18.0,19.0,23.0,23.0,839,895,839,895,0,0,185,135,185,135,0,0,17,18,0,0,0,0,0,0,1
71,0,2,18.0,19.0,23.0,23.0,833,951,811,951,22,0,284,245,280,245,4,0,17,18,0,0,0,0,0,0,1
79,0,2,19.0,20.0,23.0,23.0,861,923,727,923,134,0,344,355,320,355,24,0,18,19,0,0,0,0,0,0,1
86,0,2,19.0,20.0,23.0,23.0,883,1023,727,979,156,44,450,328,410,320,40,8,18,19,0,0,0,150,0,0,1
93,0,2,20.0,20.0,23.0,23.0,967,1012,811,923,156,89,380,45,320,25,60,20,19,20,0,0,150,150,0,0,1
100,0,2,20.0,20.0,23.0,23.0,995,1079,839,923,156,156,485,70,405,30,80,40,19,20,0,0,150,150,0,0,1
107,0,2,21.0,21.0,23.0,23.0,1074,1079,895,923,179,156,110,150,60,90,50,60,19,20,50,0,150,150,0,0,1
114,0,2,22.0,22.0,23.0,23.0,1023,1102,867,923,156,179,76,145,10,65,66,80,19,21,50,0,150,150,0,0,1
121,0,2,22.0,24.0,23.0,31.0,995,1107,839,951,156,156,191,56,105,35,86,21,19,21,50,0,150,300,0,0,1
129,0,2,23.0,25.0,23.0,31.0,1163,1079,1007,923,156,156,36,76,30,35,6,41,20,22,50,0,150,300,0,0,1
136,0,2,23.0,25.0,31.0,31.0,1135,1146,979,923,156,223,176,223,150,150,26,73,20,22,50,0,150,300,0,0,1
143,0,2,24.0,26.0,31.0,31.0,1135,1202,979,867,156,335,171,108,125,95,46,13,21,23,150,125,150,300,0,0,1
150,0,2,24.0,29.0,31.0,31.0,1275,1174,1119,839,156,335,116,33,100,30,16,3,21,24,150,125,150,300,0,0,1
157,0,2,25.0,29.0,31.0,31.0,1298,1202,1119,867,179,335,256,174,220,135,36,39,22,24,150,125,150,300,0,0,1
164,0,2,25.0,30.0,31.0,46.0,1298,1202,1119,867,179,335,401,269,345,190,56,79,23,25,150,125,150,300,0,0,1
171,0,2,25.0,31.0,31.0,46.0,1275,1180,1119,867,156,313,492,270,420,155,72,115,23,25,50,125,500,300,100,0,1
179,0,2,28.0,33.0,46.0,46.0,1354,1292,1063,979,291,313,96,140,80,135,16,5,24,27,50,125,500,550,100,0,1
186,0,2,30.0,34.0,46.0,46.0,1236,1454,923,1119,313,335,127,220,75,175,52,45,24,28,50,300,600,550,100,0,1
193,0,2,31.0,36.0,46.0,46.0,1348,1482,1035,1147,313,335,262,195,170,110,92,85,25,30,50,300,600,550,100,0,1
200,0,2,33.0,37.0,46.0,46.0,1454,1516,1119,1203,335,313,257,41,150,20,107,21,25,31,250,300,600,550,100,0,1
207,0,2,35.0,38.0,46.0,46.0,1482,1650,1147,1315,335,335,242,81,95,20,147,61,26,32,250,300,600,550,100,0,1
214,0,2,35.0,39.0,46.0,46.0,1706,1706,1371,1371,335,335,383,236,225,135,158,101,27,33,250,300,925,550,100,0,1
221,0,2,39.0,40.0,46.0,46.0,1846,1796,1511,1483,335,313,248,362,50,225,198,137,28,34,350,300,925,550,100,0,1
229,0,2,42.0,43.0,54.0,46.0,1908,1908,1595,1595,313,313,129,252,95,125,34,127,29,35,350,300,925,550,100,0,1
236,0,2,43.0,43.0,54.0,46.0,1824,1908,1511,1595,313,313,218,368,144,205,74,163,30,36,350,475,925,550,100,0,1
243,0,2,47.0,44.0,54.0,46.0,1880,2009,1567,1651,313,358,245,463,131,260,114,203,32,37,450,475,1000,700,100,0,1
250,0,2,50.0,48.0,54.0,54.0,1930,1992,1595,1679,335,313,87,260,58,75,29,185,32,38,450,475,1000,950,100,0,1
257,0,2,52.0,52.0,54.0,54.0,2009,2048,1651,1735,358,313,237,230,164,55,73,175,34,38,450,825,1000,1100,100,0,1
264,0,2,54.0,54.0,54.0,54.0,2289,2104,1819,1791,470,313,313,320,184,155,129,165,35,38,550,825,1150,1100,100,0,1
271,0,2,57.0,55.0,62.0,62.0,2362,2104,1847,1791,515,313,328,290,189,160,139,130,36,40,850,1250,1150,1250,100,0,1
279,0,2,58.0,55.0,62.0,62.0,2311,2104,1819,1791,492,313,294,545,199,375,95,170,37,40,950,1250,1150,1250,100,0,1
286,0,2,60.0,63.0,62.0,70.0,2289,2065,1819,1707,470,358,85,95,59,85,26,10,38,40,1225,1250,1150,1250,100,0,1
293,0,2,66.0,63.0,70.0,70.0,2429,2026,1959,1623,470,403,270,248,184,190,86,58,40,40,1275,2050,1150,1250,100,0,1
300,0,2,66.0,65.0,70.0,70.0,2479,2143,1987,1651,492,492,490,324,344,210,146,114,40,40,1225,2050,1150,1250,226,0,1
307,0,2,66.0,63.0,70.0,70.0,2457,2093,1987,1623,470,470,329,590,127,420,202,170,42,40,1225,1875,1150,1250,276,175,1
314,0,2,68.0,69.0,78.0,78.0,2255,2233,1763,1763,492,470,207,165,45,135,162,30,42,42,1225,1700,1050,1250,430,350,1
321,0,2,70.0,71.0,78.0,78.0,2479,2261,1987,1791,492,470,398,340,280,250,118,90,42,42,1500,2400,1050,1250,405,350,1
329,0,2,69.0,63.0,78.0,78.0,2345,2283,1875,1791,470,492,280,600,233,450,47,150,41,44,1225,1700,1050,1250,834,1050,1
336,0,2,70.0,67.0,78.0,78.0,2345,2474,1875,1959,470,515,415,555,308,445,107,110,41,44,1225,1700,1050,1250,884,1050,1
343,0,2,72.0,71.0,78.0,78.0,2479,2322,1987,1763,492,559,480,369,313,295,167,74,42,44,1225,2400,1050,1250,884,1050,1
350,0,2,73.0,71.0,78.0,78.0,2317,2474,1847,1847,470,627,331,260,208,110,123,150,42,44,1725,2400,1050,1250,984,1050,1
357,0,2,70.0,71.0,78.0,78.0,1779,2362,1399,1735,380,627,371,540,208,310,163,230,40,44,1850,2400,1050,1250,1284,1050,1
364,0,2,73.0,71.0,86.0,86.0,1662,2468,1259,1819,403,649,289,195,203,185,86,10,40,44,1900,2400,1050,1250,1284,1050,1
371,0,2,74.0,73.0,86.0,86.0,2020,2367,1483,1763,537,604,448,372,298,290,150,82,42,44,1850,2400,1050,1250,1334,1050,1
379,0,2,79.0,75.0,101.0,86.0,2110,2412,1595,1763,515,649,268,552,133,390,135,162,42,46,2100,2400,1050,1250,1334,1050,1
386,0,2,80.0,75.0,101.0,94.0,2440,2457,1903,1763,537,694,176,312,73,70,103,242,44,46,2150,2400,1050,1250,1334,1050,1
393,0,2,83.0,80.0,101.0,94.0,2518,2518,1959,1847,559,671,359,253,188,135,171,118,44,48,2475,2700,1050,1250,1334,1050,1
400,0,2,83.0,80.0,101.0,94.0,2597,2474,2015,1847,582,627,326,545,208,355,118,190,44,48,2300,2700,1200,1600,1609,1050,1
407,0,2,86.0,86.0,101.0,94.0,2860,2580,2211,1931,649,649,501,155,328,85,173,70,46,49,2575,2900,1200,1600,1609,1050,1
414,0,2,89.0,86.0,101.0,94.0,3084,2446,2435,1819,649,627,422,236,198,90,224,146,47,49,2575,2900,1200,1700,1609,1050,1
421,0,2,88.0,88.0,101.0,109.0,3000,2502,2351,1875,649,627,727,342,423,270,304,72,48,51,2525,2725,1200,1700,1709,1225,1
429,0,2,86.0,90.0,101.0,109.0,3162,2546,2491,1875,671,671,918,347,563,195,355,152,49,51,2500,2950,1275,1850,2059,1500,1
436,0,2,85.0,87.0,101.0,109.0,3168,2474,2519,1847,649,627,1144,479,713,255,431,224,49,51,2425,2750,1275,2150,2209,1800,1
443,0,2,91.0,87.0,101.0,109.0,3062,2222,2435,1707,627,515,260,489,178,205,82,284,49,51,2375,2750,1525,2250,2309,1850,1
450,0,2,97.0,93.0,101.0,109.0,3056,2474,2407,1847,649,627,100,149,63,85,37,64,50,53,2600,3150,1525,2250,2309,1850,1
457,0,2,99.0,97.0,101.0,109.0,3280,2692,2631,2043,649,649,300,315,233,250,67,65,53,56,2600,3150,1525,2250,2309,1850,1
464,0,2,100.0,102.0,101.0,109.0,3112,2726,2463,2099,649,627,306,301,163,160,143,141,53,57,2650,3350,1525,2250,2309,1850,1
471,0,2,101.0,106.0,101.0,117.0,3000,3006,2351,2379,649,627,282,267,113,50,169,217,56,60,3500,3350,1525,2250,2309,1850,1
479,0,2,101.0,106.0,101.0,117.0,3106,3196,2435,2547,671,649,367,652,243,355,124,297,56,60,3500,3550,1525,2250,2309,1850,1
486,0,2,112.0,118.0,125.0,125.0,3062,3174,2435,2547,627,627,304,238,108,165,196,73,56,62,3550,3850,1525,2400,2309,1850,1
493,0,2,111.0,118.0,125.0,133.0,3146,3090,2519,2463,627,627,699,401,423,360,276,41,56,62,3500,3950,1525,2400,2359,1850,1
500,0,2,97.0,103.0,125.0,133.0,3196,2401,2547,1931,649,470,1084,663,728,570,356,93,59,61,2250,3550,1825,2400,3609,2750,1
507,0,2,91.0,110.0,141.0,133.0,3218,2115,2547,1735,671,380,574,361,388,220,186,141,59,61,1575,3350,1825,2400,4584,2950,1
514,0,2,92.0,112.0,141.0,133.0,3291,2121,2575,1763,716,358,1087,245,688,160,399,85,60,59,1575,3800,1825,2400,4584,3050,1
521,0,2,99.0,112.0,141.0,133.0,3308,2132,2547,1707,761,425,520,503,458,370,62,133,63,62,1525,3800,1825,2400,5009,3050,1
529,0,2,104.0,112.0,141.0,133.0,3381,2104,2575,1679,806,425,476,751,368,570,108,181,62,62,1775,3800,1900,2400,5059,3050,1
536,0,2,93.0,124.0,141.0,133.0,2938,2597,2155,2239,783,358,593,402,418,185,175,217,57,62,1450,3800,1900,2400,5684,3150,1
7,0,0,13.0,13.0,15.0,15.0,251,293,251,293,0,0,30,35,30,35,0,0,12,12,0,0,0,0,0,0,1
14,0,0,14.0,14.0,15.0,15.0,671,671,671,671,0,0,70,70,70,70,0,0,13,13,0,0,0,0,0,0,1
21,0,0,14.0,14.0,15.0,15.0,699,727,699,727,0,0,50,55,50,55,0,0,13,13,0,0,0,0,0,0,1
29,0,0,15.0,15.0,15.0,15.0,727,699,727,699,0,0,90,40,90,40,0,0,14,14,0,0,0,0,0,0,1
36,0,0,15.0,15.0,15.0,15.0,783,727,783,727,0,0,135,130,135,130,0,0,14,14,0,0,0,0,0,0,1
43,0,0,16.0,16.0,23.0,23.0,811,811,811,811,0,0,80,85,80,85,0,0,15,15,0,0,0,0,0,0,1
50,0,0,16.0,16.0,23.0,23.0,783,783,783,783,0,0,40,45,40,45,0,0,15,15,0,0,0,0,0,0,1
57,0,0,17.0,17.0,23.0,23.0,783,811,783,811,0,0,60,10,60,10,0,0,16,16,0,0,0,0,0,0,1
64,0,0,18.0,18.0,23.0,23.0,755,783,755,783,0,0,100,55,100,55,0,0,17,17,0,0,0,0,0,0,1
71,0,0,18.0,18.0,23.0,23.0,805,805,783,783,22,22,189,149,185,145,4,4,17,17,0,0,0,0,0,0,1
79,0,0,19.0,19.0,23.0,23.0,799,883,643,727,156,156,233,248,205,220,28,28,18,18,0,0,0,0,0,0,1
86,0,0,19.0,20.0,23.0,23.0,883,906,615,615,268,291,344,268,280,250,64,18,18,18,0,0,0,150,0,0,1
93,0,0,20.0,20.0,23.0,23.0,950,1006,615,671,335,335,109,143,55,85,54,58,19,19,0,0,150,150,0,0,1
100,0,0,20.0,20.0,23.0,23.0,978,1040,643,727,335,313,229,259,135,165,94,94,19,19,0,0,150,150,0,0,1
107,0,0,20.0,20.0,23.0,23.0,962,967,671,699,291,268,91,126,65,100,26,26,19,19,0,0,150,150,0,0,1
114,0,0,20.0,21.0,31.0,31.0,928,984,727,783,201,201,196,200,150,150,46,50,19,19,0,0,150,150,0,0,1
121,0,0,22.0,21.0,31.0,31.0,934,1102,755,923,179,179,161,190,145,170,16,20,19,19,100,100,150,150,0,0,1
129,0,0,23.0,22.0,31.0,31.0,1135,1298,979,1119,156,179,261,335,225,295,36,40,20,20,100,100,150,150,0,0,1
136,0,0,23.0,22.0,31.0,31.0,1186,1303,1007,1147,179,156,405,490,345,430,60,60,20,20,100,100,150,150,0,0,1
143,0,0,24.0,23.0,31.0,31.0,1236,1326,1035,1147,201,179,114,185,30,105,84,80,21,21,100,100,150,150,0,0,1
150,0,0,26.0,26.0,31.0,31.0,1331,1326,1175,1147,156,179,195,194,95,90,100,104,21,22,100,100,400,400,0,0,1
157,0,0,27.0,28.0,31.0,31.0,1421,1393,1175,1147,246,246,201,51,115,15,86,36,22,22,200,100,400,500,0,0,1
164,0,0,27.0,29.0,31.0,31.0,1516,1421,1203,1063,313,358,71,161,45,85,26,76,22,23,200,100,400,500,0,0,1
171,0,0,28.0,31.0,31.0,31.0,1488,1286,1175,951,313,335,136,222,70,110,66,112,23,23,300,200,400,500,0,0,1
179,0,0,31.0,32.0,31.0,39.0,1460,1230,1147,895,313,335,151,82,70,30,81,52,24,24,300,200,400,500,0,0,1
186,0,0,31.0,32.0,31.0,39.0,1314,1320,979,1007,335,313,281,258,160,170,121,88,24,24,300,200,400,500,0,0,1
193,0,0,34.0,37.0,39.0,39.0,1421,1488,1063,1175,358,313,311,83,150,55,161,28,25,25,300,500,500,500,0,0,1
200,0,0,36.0,37.0,39.0,39.0,1376,1516,1063,1203,313,313,198,188,130,120,68,68,25,25,400,500,750,500,0,0,1
207,0,0,37.0,38.0,39.0,39.0,1516,1510,1203,1175,313,335,238,313,130,205,108,108,26,26,400,500,750,500,0,0,1
214,0,0,39.0,39.0,54.0,54.0,1544,1589,1231,1231,313,358,273,143,125,45,148,98,26,27,500,600,825,750,0,0,1
221,0,0,43.0,41.0,54.0,54.0,1628,1650,1315,1315,313,335,163,234,75,100,88,134,27,27,500,800,825,750,0,0,1
229,0,0,45.0,42.0,54.0,54.0,1740,1762,1427,1427,313,335,208,389,80,215,128,174,27,28,600,800,825,825,0,0,1
236,0,0,47.0,46.0,54.0,54.0,1757,1874,1399,1427,358,447,218,299,75,165,143,134,28,28,800,800,825,900,0,0,1
243,0,0,45.0,47.0,54.0,54.0,1762,1869,1427,1399,335,470,314,364,135,170,179,194,28,29,700,800,825,900,100,100,1
250,0,0,45.0,49.0,54.0,54.0,1488,2082,1175,1567,313,515,110,314,20,260,90,54,27,30,950,800,900,900,350,100,1
257,0,0,45.0,49.0,54.0,54.0,1432,1947,1119,1455,313,492,235,440,105,330,130,110,27,31,950,800,900,900,350,200,1
264,0,0,48.0,51.0,62.0,54.0,1516,1634,1203,1231,313,403,240,495,70,345,170,150,26,31,1050,800,900,900,400,200,1
271,0,0,49.0,54.0,62.0,54.0,1432,1286,1119,951,313,335,410,280,200,215,210,65,27,33,1050,1050,900,900,400,200,1
279,0,0,51.0,54.0,62.0,54.0,1667,1432,1287,1119,380,313,263,251,205,150,58,101,28,33,1000,1050,900,900,450,200,1
286,0,0,54.0,54.0,62.0,54.0,1998,1331,1483,951,515,380,358,428,240,275,118,153,29,33,1375,1150,900,900,450,200,1
293,0,0,58.0,54.0,62.0,54.0,2003,1701,1511,1231,492,470,164,268,115,55,49,213,30,33,1375,1450,900,900,450,200,1
300,0,0,60.0,58.0,62.0,70.0,2065,1807,1595,1315,470,492,195,184,90,115,105,69,31,33,1425,1725,900,900,450,200,1
307,0,0,61.0,61.0,62.0,70.0,1813,1863,1343,1371,470,492,395,49,230,45,165,4,32,33,1475,1725,900,900,450,200,1
314,0,0,63.0,63.0,70.0,70.0,2031,2031,1539,1539,492,492,565,200,340,140,225,60,34,35,1475,1725,900,900,450,200,1
321,0,0,66.0,66.0,70.0,70.0,2171,2373,1679,1903,492,470,495,276,410,160,85,116,34,37,2100,1675,900,900,450,250,1
329,0,0,61.0,65.0,70.0,70.0,2434,2429,1875,1959,559,470,734,546,585,370,149,176,36,37,1525,1625,900,900,1025,300,1
336,0,0,66.0,67.0,70.0,78.0,2513,2535,1931,2043,582,492,177,656,85,420,92,236,36,39,1575,1725,900,900,1025,300,1
343,0,0,69.0,70.0,70.0,78.0,2283,2339,1679,1847,604,492,284,534,120,369,164,165,38,39,1575,2300,900,900,1025,300,1
350,0,0,69.0,72.0,70.0,78.0,2328,2283,1679,1791,649,492,469,388,225,168,244,220,38,41,1625,2300,900,900,1025,300,1
357,0,0,70.0,76.0,70.0,78.0,2530,2334,1903,1819,627,515,375,209,55,79,320,130,40,43,1675,2300,900,900,1025,300,1
364,0,0,65.0,76.0,78.0,78.0,2552,2412,1903,1875,649,537,385,388,110,194,275,194,40,43,1750,2100,900,900,1525,500,1
371,0,0,56.0,76.0,86.0,93.0,2490,2328,1819,1791,671,537,650,607,295,349,355,258,42,43,1075,2000,900,900,2200,600,1
379,0,0,56.0,78.0,86.0,101.0,2406,2054,1735,1539,671,515,821,181,390,34,431,147,42,45,975,2275,900,900,2300,600,1
