time,race1,race2,supplyUsed1,supplyUsed2,supplyMade1,supplyMade2,totalIncome1,totalIncome2,mineralsIncome1,mineralsIncome2,vespeneIncome1,vespeneIncome2,totalResources1,totalResources2,minerals1,minerals2,vespene1,vespene2,activeWorkers1,activeWorkers2,army1,army2,technology1,technology2,lostResources1,lostResources2,winner
7,2,2,13.0,13.0,15.0,15.0,335,251,335,251,0,0,40,30,40,30,0,0,12,12,0,0,0,0,0,0,1
14,2,2,14.0,14.0,15.0,15.0,671,643,671,643,0,0,70,65,70,65,0,0,13,13,0,0,0,0,0,0,1
21,2,2,14.0,14.0,15.0,15.0,671,699,671,699,0,0,45,0,45,0,0,0,13,13,0,0,0,0,0,0,1
29,2,2,15.0,15.0,15.0,15.0,727,727,727,727,0,0,40,35,40,35,0,0,14,14,0,0,0,0,0,0,1
36,2,2,15.0,15.0,15.0,23.0,839,783,839,783,0,0,145,135,145,135,0,0,14,14,0,0,0,0,0,0,1
43,2,2,16.0,16.0,23.0,23.0,839,783,839,783,0,0,190,30,190,30,0,0,15,15,0,0,0,0,0,0,1
50,2,2,17.0,17.0,23.0,23.0,895,811,895,811,0,0,300,5,300,5,0,0,16,16,0,0,0,0,0,0,1
57,2,2,17.0,18.0,23.0,23.0,867,811,867,811,0,0,395,50,395,50,0,0,16,17,0,0,0,0,0,0,1
64,2,2,17.0,19.0,23.0,23.0,923,923,923,923,0,0,110,95,110,95,0,0,17,18,0,0,0,0,0,0,1
71,2,2,18.0,19.0,23.0,23.0,895,923,895,923,0,0,15,5,15,5,0,0,17,18,0,0,0,0,0,0,1
79,2,2,19.0,20.0,23.0,23.0,979,945,979,923,0,22,5,119,5,115,0,4,18,19,0,0,0,0,0,0,1
86,2,2,19.0,21.0,23.0,23.0,923,1062,923,951,0,111,70,50,70,30,0,20,18,20,0,0,0,150,0,0,1
93,2,2,20.0,22.0,23.0,23.0,923,1051,923,895,0,156,40,125,40,85,0,40,19,21,0,0,0,150,0,0,1
100,2,2,21.0,22.0,23.0,23.0,895,1152,895,839,0,313,5,115,5,35,0,80,20,21,0,0,0,150,0,0,1
107,2,2,21.0,23.0,23.0,23.0,939,1146,895,811,44,335,73,246,65,130,8,116,20,22,0,0,0,150,0,0,1
114,2,2,22.0,23.0,23.0,31.0,1034,1208,923,895,111,313,199,392,175,240,24,152,21,23,0,0,150,150,0,0,1
121,2,2,23.0,27.0,23.0,31.0,1096,1236,895,923,201,313,137,187,85,95,52,92,22,23,0,0,150,450,0,0,1
129,2,2,23.0,27.0,23.0,31.0,1141,1286,895,951,246,335,220,82,140,50,80,32,22,23,0,0,150,450,0,0,1
136,2,2,25.0,27.0,38.0,31.0,1135,1230,867,895,268,335,307,127,195,55,112,72,23,23,0,0,150,450,0,0,1
143,2,2,26.0,27.0,38.0,31.0,1219,1180,951,867,268,313,303,268,155,160,148,108,24,23,0,0,150,450,0,0,1
150,2,2,28.0,27.0,38.0,31.0,1264,1230,951,895,313,335,413,58,225,10,188,48,26,23,0,0,300,450,0,0,1
157,2,2,32.0,31.0,38.0,39.0,1426,1258,1091,923,335,335,283,213,155,125,128,88,27,23,0,250,450,450,0,0,1
164,2,2,32.0,31.0,38.0,39.0,1460,1236,1147,923,313,313,195,214,135,90,60,124,28,23,0,250,450,450,0,0,1
171,2,2,32.0,31.0,38.0,39.0,1348,1208,1035,895,313,313,176,359,130,195,46,164,28,23,0,250,450,450,0,0,1
179,2,2,35.0,33.0,38.0,39.0,1320,1230,1007,895,313,335,157,259,125,55,32,204,27,23,350,250,450,700,50,0,1
186,2,2,37.0,35.0,38.0,39.0,1348,1258,1035,923,313,335,117,239,45,45,72,194,27,23,350,600,450,700,50,0,1
193,2,2,37.0,35.0,38.0,39.0,1236,1208,923,895,313,313,267,385,155,155,112,230,27,23,350,600,450,700,50,0,1
200,2,2,37.0,35.0,38.0,39.0,1286,1286,951,951,335,335,322,540,220,270,102,270,29,23,350,600,450,700,50,0,1
207,2,2,37.0,39.0,46.0,39.0,1426,1286,1091,951,335,335,402,220,260,10,142,210,29,23,700,850,450,850,50,0,1
214,2,2,41.0,39.0,46.0,39.0,1594,1270,1259,979,335,291,203,362,125,120,78,242,29,23,700,1025,700,850,50,0,1
221,2,2,42.0,39.0,46.0,39.0,1600,1292,1287,979,313,313,244,522,130,240,114,282,29,23,700,1025,700,850,50,0,1
229,2,2,42.0,39.0,46.0,47.0,1544,1236,1231,923,313,313,379,657,225,335,154,322,29,23,700,1025,700,850,100,0,1
236,2,2,41.0,43.0,46.0,47.0,1538,1320,1315,1007,223,313,523,447,345,185,178,262,27,23,1075,1400,800,850,200,0,1
243,2,2,47.0,43.0,54.0,47.0,1477,1258,1231,923,246,335,139,488,75,190,64,298,28,23,1075,1400,800,850,200,0,1
250,2,2,49.0,47.0,54.0,47.0,1561,1314,1203,979,358,335,149,268,95,55,54,213,29,23,1075,1675,800,850,200,0,1
257,2,2,51.0,47.0,54.0,55.0,1538,1208,1203,895,335,313,130,399,40,150,90,249,29,23,1075,1675,800,850,200,0,1
264,2,2,50.0,47.0,54.0,55.0,1600,1236,1287,923,313,313,336,559,210,270,126,289,28,23,1075,1675,800,850,250,0,1
271,2,2,52.0,53.0,62.0,63.0,1572,1208,1259,895,313,313,411,204,245,0,166,204,30,23,1625,2050,800,850,250,0,1
279,2,2,54.0,55.0,62.0,63.0,1628,1230,1315,895,313,335,271,204,65,60,206,144,30,23,1800,2325,800,850,250,0,1
286,2,2,54.0,55.0,62.0,63.0,1656,1202,1343,867,313,335,471,354,225,170,246,184,32,23,1800,2325,800,850,250,0,1
293,2,2,50.0,55.0,62.0,63.0,1734,1174,1399,839,335,335,591,250,305,80,286,170,32,23,1250,2075,800,850,800,250,1
300,2,2,53.0,55.0,62.0,63.0,1757,1180,1399,867,358,313,366,296,140,90,226,206,32,23,1500,2700,800,850,800,250,1
307,2,2,51.0,51.0,62.0,63.0,1790,1208,1455,895,335,313,382,446,120,200,262,246,33,23,1150,2450,900,850,1250,500,1
314,2,2,45.0,47.0,62.0,63.0,1628,1202,1315,867,313,335,568,591,270,305,298,286,31,23,975,2150,900,850,1625,800,1
321,2,2,42.0,53.0,62.0,71.0,1404,1258,1091,923,313,335,358,222,120,50,238,172,28,23,975,2150,900,850,1775,800,1
7,1,0,13.0,13.0,14.0,15.0,251,293,251,293,0,0,30,35,30,35,0,0,12,12,0,0,0,0,0,0,0
14,1,0,13.0,14.0,14.0,15.0,671,643,671,643,0,0,20,65,20,65,0,0,13,13,0,0,0,0,0,0,0
21,1,0,14.0,14.0,14.0,15.0,699,699,699,699,0,0,55,50,55,50,0,0,13,13,0,0,0,0,0,0,0
29,1,0,14.0,15.0,14.0,15.0,755,671,755,671,0,0,150,80,150,80,0,0,13,14,0,0,0,0,0,0,0
36,1,0,16.0,15.0,22.0,15.0,755,643,755,643,0,0,145,155,145,155,0,0,14,14,0,0,0,0,0,0,0
43,1,0,16.0,15.0,22.0,23.0,755,587,755,587,0,0,240,225,240,225,0,0,14,15,0,0,0,0,0,0,0
50,1,0,15.0,15.0,22.0,23.0,783,671,783,671,0,0,40,10,40,10,0,0,15,15,0,0,0,0,0,0,0
57,1,0,17.0,15.0,22.0,23.0,811,699,811,699,0,0,40,85,40,85,0,0,15,15,0,0,0,0,0,0,0
64,1,0,18.0,16.0,22.0,23.0,811,727,811,727,0,0,85,55,85,55,0,0,16,15,0,0,0,0,0,0,0
71,1,0,18.0,16.0,22.0,23.0,643,615,643,615,0,0,150,70,150,70,0,0,18,15,0,0,0,0,0,0,0
79,1,0,18.0,17.0,22.0,23.0,643,699,643,699,0,0,225,165,225,165,0,0,18,16,0,0,0,0,0,0,0
86,1,0,18.0,17.0,22.0,23.0,643,671,643,671,0,0,45,195,45,195,0,0,17,16,0,0,0,0,0,50,0
93,1,0,19.0,16.0,22.0,23.0,699,732,699,643,0,89,50,512,50,496,0,16,17,15,0,0,0,0,0,100,0
100,1,0,19.0,17.0,22.0,23.0,615,738,615,559,0,179,70,147,70,111,0,36,18,16,0,0,0,0,0,100,0
107,1,0,20.0,17.0,22.0,23.0,643,794,643,615,0,179,85,97,85,41,0,56,19,16,0,0,0,0,0,100,0
114,1,0,20.0,18.0,22.0,23.0,643,771,643,615,0,156,170,138,170,66,0,72,20,17,0,0,0,0,0,100,0
121,1,0,22.0,19.0,28.0,23.0,861,799,839,643,22,156,184,176,180,84,4,92,20,18,0,0,0,0,0,100,0
129,1,0,21.0,19.0,28.0,23.0,1001,827,867,671,134,156,134,281,110,169,24,112,19,18,0,0,250,0,0,100,0
136,1,0,23.0,20.0,28.0,23.0,1023,855,867,699,156,156,64,331,20,199,44,132,20,19,0,0,250,0,0,100,0
143,1,0,23.0,20.0,28.0,23.0,1051,939,895,783,156,156,89,446,25,294,64,152,20,19,0,0,250,0,0,100,0
150,1,0,23.0,20.0,28.0,23.0,1130,990,951,811,179,179,229,566,145,394,84,172,20,20,0,0,250,150,0,100,0
157,1,0,25.0,21.0,28.0,23.0,1130,962,951,783,179,179,214,231,110,139,104,92,20,20,50,0,250,150,0,100,0
164,1,0,25.0,21.0,36.0,23.0,1107,967,951,811,156,156,250,352,130,244,120,108,20,20,50,0,250,150,0,100,0
171,1,0,33.0,21.0,36.0,38.0,1107,967,951,811,156,156,35,117,20,39,15,78,20,20,200,50,450,150,0,100,0
179,1,0,35.0,22.0,36.0,38.0,1135,1023,979,867,156,156,75,207,65,109,10,98,20,20,200,50,450,150,0,100,0
186,1,0,37.0,22.0,44.0,38.0,1191,1163,1035,1007,156,156,120,297,115,179,5,118,20,20,200,50,450,150,0,100,0
193,1,0,39.0,23.0,44.0,38.0,1186,1303,1007,1147,179,156,105,402,80,264,25,138,20,21,700,50,450,150,0,100,0
200,1,0,39.0,24.0,44.0,46.0,1186,1354,1007,1175,179,179,135,182,90,149,45,33,20,21,800,50,450,400,0,150,0
207,1,0,42.0,24.0,44.0,46.0,1135,1494,979,1315,156,179,116,352,55,299,61,53,20,22,900,50,450,400,0,150,0
214,1,0,43.0,26.0,52.0,46.0,1191,1555,1035,1399,156,156,156,438,150,369,6,69,22,23,900,50,450,400,0,150,0
221,1,0,46.0,26.0,52.0,46.0,1163,1583,1007,1427,156,156,141,623,115,534,26,89,23,24,900,50,450,575,0,150,0
227,1,0,46.0,30.0,52.0,46.0,1163,1606,1007,1427,156,179,141,579,115,474,26,105,23,25,900,50,450,575,0,150,0
7,0,2,13.0,13.0,15.0,15.0,293,335,293,335,0,0,35,40,35,40,0,0,12,12,0,0,0,0,0,0,0
14,0,2,14.0,14.0,15.0,15.0,643,671,643,671,0,0,65,70,65,70,0,0,13,13,0,0,0,0,0,0,0
21,0,2,14.0,14.0,15.0,15.0,671,671,671,671,0,0,50,45,50,45,0,0,13,13,0,0,0,0,0,0,0
29,0,2,15.0,15.0,15.0,15.0,699,727,699,727,0,0,95,90,95,90,0,0,14,14,0,0,0,0,0,0,0
36,0,2,15.0,15.0,15.0,23.0,755,783,755,783,0,0,130,35,130,35,0,0,14,14,0,0,0,0,0,0,0
43,0,2,16.0,16.0,23.0,23.0,811,811,811,811,0,0,5,75,5,75,0,0,15,15,0,0,0,0,0,0,0
50,0,2,16.0,17.0,23.0,23.0,811,811,811,811,0,0,45,45,45,45,0,0,15,16,0,0,0,0,0,0,0
57,0,2,17.0,18.0,23.0,23.0,811,895,811,895,0,0,135,110,135,110,0,0,16,17,0,0,0,0,0,0,0
64,0,2,18.0,18.0,23.0,23.0,811,923,811,923,0,0,180,35,180,35,0,0,17,17,0,0,0,0,0,0,0
71,0,2,18.0,19.0,23.0,23.0,900,945,811,923,89,22,291,54,275,50,16,4,17,18,0,0,0,0,0,0,0
79,0,2,19.0,20.0,23.0,23.0,934,1062,755,951,179,111,346,185,310,165,36,20,18,19,0,0,0,0,0,0,0
86,0,2,19.0,20.0,23.0,31.0,939,1085,783,951,156,134,457,106,405,70,52,36,18,19,0,0,0,150,0,0,0
93,0,2,20.0,23.0,23.0,31.0,911,1085,755,951,156,134,317,137,295,85,22,52,19,20,0,0,150,150,0,0,0
100,0,2,20.0,23.0,23.0,31.0,967,1174,811,951,156,223,437,224,395,140,42,84,19,20,0,0,150,150,0,0,0
107,0,2,20.0,24.0,23.0,31.0,939,1225,783,979,156,246,152,367,90,255,62,112,19,21,0,0,150,150,0,0,0
114,0,2,21.0,23.0,23.0,31.0,883,1247,727,979,156,268,112,559,30,415,82,144,19,22,0,0,150,150,0,0,0
121,0,2,21.0,24.0,23.0,31.0,1046,1197,867,951,179,246,547,226,445,75,102,151,19,22,100,0,150,300,0,0,0
129,0,2,23.0,25.0,23.0,31.0,1191,1214,1035,923,156,291,333,317,315,130,18,187,20,22,100,0,150,300,0,0,0
136,0,2,23.0,25.0,31.0,31.0,1191,1214,1035,923,156,291,468,154,430,85,38,69,20,22,100,0,150,300,0,0,0
143,0,2,24.0,28.0,31.0,31.0,1275,1208,1119,895,156,313,88,34,30,0,58,34,21,23,150,125,150,300,0,0,0
150,0,2,24.0,28.0,31.0,31.0,1163,1208,1007,895,156,313,103,174,50,100,53,74,21,23,150,125,150,300,0,0,0
157,0,2,25.0,29.0,31.0,31.0,1247,1292,1091,979,156,313,143,189,70,75,73,114,22,24,150,125,150,300,0,0,0
164,0,2,26.0,29.0,31.0,31.0,1298,1208,1119,895,179,313,233,280,140,130,93,150,23,24,150,125,150,300,0,0,0
171,0,2,26.0,32.0,31.0,39.0,1174,1258,951,923,223,335,381,305,260,140,121,165,23,25,150,250,400,300,0,0,0
179,0,2,26.0,36.0,39.0,39.0,1264,1258,951,923,313,335,537,115,380,60,157,55,24,26,150,250,475,600,0,0,0
186,0,2,30.0,36.0,39.0,39.0,1174,1292,839,979,335,313,282,276,235,185,47,91,24,26,150,250,475,600,0,0,0
193,0,2,30.0,38.0,39.0,54.0,1376,1292,1063,979,313,313,453,331,370,200,83,131,24,27,150,250,475,600,0,0,0
200,0,2,31.0,38.0,39.0,54.0,1376,1370,1063,1035,313,335,168,96,45,75,123,21,25,27,150,250,475,600,0,0,0
207,0,2,31.0,43.0,39.0,54.0,1404,1510,1091,1175,313,335,358,191,195,130,163,61,25,29,150,675,475,600,0,0,0
214,0,2,34.0,43.0,54.0,54.0,1370,1544,1035,1231,335,313,123,362,20,265,103,97,26,29,400,675,475,600,0,50,0
221,0,2,36.0,44.0,54.0,54.0,1622,1678,1287,1343,335,335,238,377,95,240,143,137,26,30,400,675,575,600,0,50,0
229,0,2,36.0,46.0,54.0,54.0,1622,1600,1287,1287,335,313,369,308,190,235,179,73,26,32,400,675,575,600,0,50,0
236,0,2,36.0,48.0,54.0,54.0,1678,1718,1343,1427,335,291,264,420,145,315,119,105,27,32,300,975,575,600,100,50,0
243,0,2,39.0,50.0,54.0,62.0,1544,1718,1231,1427,313,291,230,381,75,340,155,41,28,34,350,975,575,600,100,50,0
250,0,2,41.0,52.0,54.0,62.0,1628,1830,1315,1539,313,291,270,307,100,230,170,77,28,35,600,1225,575,600,100,50,0
257,0,2,44.0,54.0,54.0,62.0,1538,1908,1203,1595,335,313,340,447,130,330,210,117,29,36,700,1225,575,600,100,50,0
264,0,2,44.0,50.0,54.0,62.0,1706,1992,1371,1679,335,313,540,323,290,270,250,53,29,36,700,975,575,600,100,300,0
271,0,2,42.0,51.0,69.0,62.0,1600,2042,1287,1707,313,335,251,473,65,380,186,93,30,38,350,925,825,600,550,600,0
279,0,2,41.0,53.0,69.0,62.0,1762,2076,1427,1763,335,313,491,719,265,590,226,129,30,40,200,925,925,600,800,600,0
286,0,2,44.0,53.0,69.0,62.0,1992,2104,1679,1791,313,313,362,129,175,60,187,69,32,40,200,925,925,600,800,600,0
293,0,2,47.0,57.0,69.0,62.0,2104,2070,1791,1735,313,335,312,219,85,110,227,109,33,42,300,1175,925,600,800,600,0
300,0,2,49.0,57.0,69.0,62.0,2244,2070,1931,1735,313,335,342,124,75,75,267,49,34,42,300,1175,925,900,800,600,0
307,0,2,49.0,59.0,69.0,70.0,2154,2132,1819,1819,335,313,587,285,280,200,307,85,34,44,550,1175,925,900,800,600,0
314,0,2,52.0,62.0,69.0,78.0,2154,2294,1819,1959,335,335,702,186,355,165,347,21,36,45,875,1425,925,900,800,600,0
321,0,2,52.0,63.0,69.0,78.0,2210,2317,1875,1847,335,470,468,371,110,290,358,81,36,46,875,1425,925,900,800,600,0
329,0,2,55.0,62.0,69.0,78.0,2266,2490,1931,1819,335,671,503,317,105,260,398,57,39,48,875,1125,925,900,800,900,0
336,0,2,56.0,60.0,69.0,78.0,2356,2474,2043,1847,313,627,694,459,260,330,434,129,38,49,875,1000,1150,1150,800,1025,0
343,0,2,59.0,64.0,69.0,86.0,2440,2479,2127,1875,313,604,439,305,165,200,274,105,41,50,975,1250,1300,1150,800,1025,0
350,0,2,60.0,71.0,69.0,86.0,2468,2535,2043,1931,425,604,374,191,140,85,234,106,39,51,975,1250,1550,1150,800,1025,0
357,0,2,63.0,73.0,77.0,86.0,2686,2479,2015,1875,671,604,159,97,45,15,114,82,42,52,975,1875,1550,1150,800,1025,0
364,0,2,62.0,76.0,77.0,101.0,2720,2552,2071,1903,649,649,470,243,284,85,186,158,41,53,1125,1875,1550,1150,800,1025,0
371,0,2,66.0,74.0,77.0,101.0,2854,2642,2183,2015,671,627,296,371,39,145,257,226,44,53,1125,1875,1550,1150,800,1025,0
379,0,2,71.0,78.0,77.0,101.0,2938,2653,2267,2071,671,582,295,183,63,35,232,148,44,54,1125,1875,1650,1150,800,1025,0
386,0,2,77.0,85.0,77.0,101.0,3062,2922,2435,2295,627,627,267,260,113,65,154,195,44,54,1325,2375,1650,1450,800,1025,0
393,0,2,77.0,85.0,77.0,101.0,2726,2922,2099,2295,627,627,297,605,88,330,209,275,47,54,1325,2500,1650,1450,800,1025,0
400,0,2,77.0,91.0,77.0,101.0,2748,3039,2099,2435,649,604,327,286,63,85,264,201,47,57,1325,2500,1650,1600,800,1025,0
407,0,2,77.0,94.0,77.0,101.0,2664,3000,2015,2351,649,649,377,486,83,205,294,281,47,57,1525,3000,1650,1600,800,1025,0
414,0,2,89.0,100.0,93.0,109.0,2961,3134,2267,2463,694,671,758,491,388,205,370,286,47,59,1925,3375,1650,1750,800,1025,0
421,0,2,93.0,106.0,101.0,117.0,2910,3190,2239,2519,671,671,374,492,178,205,196,287,47,60,1925,4000,1950,1900,800,1025,0
429,0,2,93.0,110.0,101.0,117.0,2838,3196,2211,2547,627,649,271,633,103,320,168,313,49,60,1925,4250,1950,1900,800,1025,0
436,0,2,101.0,110.0,101.0,117.0,2922,3224,2295,2575,627,649,276,824,153,435,123,389,49,60,2375,4250,1950,1900,900,1025,0
443,0,2,98.0,112.0,101.0,117.0,2642,3258,2015,2631,627,627,322,830,173,440,149,390,48,60,2275,4125,1950,1900,1000,1525,0
450,0,2,92.0,100.0,101.0,133.0,1510,3314,1063,2687,447,627,521,1245,328,775,193,470,46,60,1975,3250,1925,1900,1513,2400,0
457,0,2,94.0,108.0,101.0,133.0,1118,3414,783,2743,335,671,386,1020,228,595,158,425,44,60,2600,3750,1925,1900,1752,2525,0
464,0,2,94.0,112.0,101.0,133.0,1594,3386,1259,2715,335,671,352,1040,208,610,144,430,44,60,2400,4000,1925,1900,1952,2650,0
471,0,2,81.0,83.0,101.0,133.0,1902,3364,1567,2715,335,649,347,1287,163,785,184,502,38,60,1825,1875,2025,1900,2877,4775,0
479,0,2,87.0,89.0,101.0,133.0,2020,3386,1707,2715,313,671,253,917,58,460,195,457,38,60,2200,1625,2275,1900,2877,5025,0
486,0,2,95.0,100.0,101.0,133.0,2423,3224,1931,2575,492,649,125,518,8,160,117,358,40,63,2500,2625,2275,1900,2877,5025,0
493,0,2,97.0,100.0,101.0,133.0,2686,3258,2015,2631,671,627,231,659,138,325,93,334,40,63,2600,2625,2275,1900,2877,5025,0
500,0,2,101.0,100.0,101.0,133.0,2720,3056,2071,2407,649,649,182,629,63,315,119,314,40,66,2825,2625,2275,1900,2877,5025,0
507,0,2,101.0,108.0,101.0,133.0,2563,3218,1959,2547,604,671,439,364,248,270,191,94,39,66,3125,2875,2275,1900,2927,5025,0
514,0,2,101.0,108.0,101.0,133.0,2569,3302,1987,2631,582,671,456,560,243,490,213,70,39,66,3125,3325,2275,2050,2927,5025,0
521,0,2,109.0,108.0,109.0,133.0,2709,3330,2127,2659,582,671,378,851,193,705,185,146,39,66,3825,3325,2275,2050,2927,5025,0
529,0,2,108.0,114.0,109.0,133.0,2479,3140,1875,2491,604,649,675,332,418,285,257,47,39,66,3675,2525,2275,2050,3077,5825,0
536,0,2,109.0,112.0,109.0,133.0,2283,3230,1679,2603,604,627,546,723,263,600,283,123,39,66,3825,3400,2275,2300,3127,6075,0
543,0,2,120.0,114.0,125.0,133.0,2339,3129,1735,2435,604,694,419,420,118,305,301,115,39,66,4025,3275,2275,2500,3127,6200,0
550,0,2,120.0,110.0,125.0,133.0,2418,3286,1791,2435,627,851,480,809,128,590,352,219,39,66,4025,2900,2275,2600,3127,6575,0
557,0,2,125.0,122.0,125.0,133.0,2255,3269,1651,2351,604,918,318,447,98,270,220,177,39,66,4500,3650,2275,2600,3127,6575,0
564,0,2,132.0,126.0,133.0,133.0,2121,3308,1539,2435,582,873,311,283,73,210,238,73,39,66,4925,3950,2275,2600,3127,6575,0
571,0,2,115.0,114.0,133.0,133.0,928,3218,503,2323,425,895,319,561,33,380,286,181,25,66,4675,3575,2275,2900,4077,7325,0
579,0,2,100.0,110.0,133.0,133.0,358,2742,0,1959,358,783,363,129,33,60,330,69,10,58,4850,3325,2275,2900,4827,7975,0
586,0,2,97.0,100.0,133.0,141.0,166,2138,55,1511,111,627,377,205,43,110,334,95,7,46,5350,3850,2275,2800,4977,8675,0
593,0,2,92.0,95.0,133.0,149.0,463,2104,419,1455,44,649,400,450,58,275,342,175,7,45,5275,3350,2275,2550,5302,9625,0
600,0,2,88.0,95.0,125.0,149.0,542,1958,475,1287,67,671,468,180,118,25,350,155,7,43,5075,2750,2275,2550,5602,10325,0
607,0,2,70.0,68.0,125.0,141.0,458,1230,391,671,67,559,376,300,18,85,358,215,4,36,4100,2175,2275,2300,6727,12475,0
614,0,2,54.0,48.0,125.0,141.0,44,1079,0,587,44,492,380,436,18,165,362,271,1,30,3450,1125,2275,2300,7577,13825,0
621,0,2,53.0,41.0,125.0,141.0,44,1034,0,587,44,447,384,749,18,330,366,419,0,23,3450,1125,2275,2000,7627,14475,0
629,0,2,53.0,49.0,125.0,133.0,0,1040,0,615,0,425,384,265,18,140,366,125,0,23,3600,1750,2275,2000,7627,14575,0
636,0,2,53.0,48.0,125.0,125.0,0,816,0,503,0,313,384,347,18,190,366,157,0,22,3600,1750,2275,1850,7627,14875,0
643,0,2,52.0,47.0,125.0,125.0,0,122,0,55,0,67,384,355,18,190,366,165,0,21,3550,1750,2275,1850,7677,14925,0
650,0,2,52.0,47.0,125.0,125.0,0,138,0,27,0,111,384,376,18,195,366,181,0,21,3550,1750,2175,1850,7777,14925,0
657,0,2,52.0,51.0,125.0,110.0,0,587,0,587,0,0,384,131,18,50,366,81,0,21,3550,1750,2175,1850,7777,15325,0
664,0,2,52.0,51.0,125.0,94.0,0,951,0,951,0,0,384,251,18,170,366,81,0,21,3550,2100,2175,1850,7777,15525,0
671,0,2,50.0,51.0,125.0,94.0,0,951,0,951,0,0,384,166,18,85,366,81,0,21,3350,2100,2175,1700,7977,15675,0
679,0,2,50.0,51.0,125.0,94.0,0,1007,0,1007,0,0,384,191,18,110,366,81,0,21,3350,2100,2175,1700,7977,15675,0
686,0,2,50.0,53.0,125.0,94.0,0,1063,0,1063,0,0,384,141,18,110,366,31,0,21,3350,2100,2175,1700,7977,15675,0
693,0,2,50.0,55.0,109.0,79.0,0,1012,0,923,0,89,384,142,18,120,366,22,0,21,3350,2275,2175,1700,8077,16075,0
700,0,2,50.0,55.0,109.0,87.0,0,1023,0,867,0,156,384,253,18,215,366,38,0,21,3350,2400,2175,1900,8077,16075,0
707,0,2,46.0,55.0,101.0,87.0,0,1079,0,923,0,156,379,388,13,330,366,58,0,21,3150,2400,2175,1750,8377,16225,0
714,0,2,44.0,50.0,101.0,87.0,0,536,0,447,0,89,368,416,2,350,366,66,0,18,3050,2275,2175,1750,8477,16575,0
721,0,2,44.0,49.0,93.0,87.0,0,363,0,363,0,0,366,426,0,360,366,66,0,18,3050,2150,2175,1750,8577,16700,0
729,0,2,44.0,48.0,93.0,87.0,419,839,419,839,0,0,441,256,75,240,366,16,0,15,3050,2325,2175,1750,8577,16900,0
736,0,2,44.0,47.0,93.0,87.0,839,727,839,727,0,0,516,331,150,315,366,16,0,14,3050,2325,2175,1750,8577,17000,0
743,0,2,40.0,25.0,93.0,87.0,559,643,559,643,0,0,591,351,225,335,366,16,0,8,2850,1175,1925,1750,9027,18450,0
750,0,2,37.0,28.0,93.0,87.0,559,279,559,279,0,0,666,171,300,155,366,16,0,9,2700,1025,1925,1650,9177,18700,0
757,0,2,37.0,24.0,93.0,87.0,559,111,559,111,0,0,537,141,171,125,366,16,0,7,2550,1125,1925,1650,9327,18950,0
764,0,2,40.0,15.0,93.0,87.0,559,279,559,279,0,0,310,181,94,165,216,16,0,6,2550,500,1925,1650,9327,19625,0
7,1,0,13.0,13.0,14.0,15.0,335,335,335,335,0,0,40,40,40,40,0,0,12,12,0,0,0,0,0,0,0
14,1,0,13.0,14.0,14.0,15.0,671,671,671,671,0,0,20,70,20,70,0,0,13,13,0,0,0,0,0,0,0
21,1,0,14.0,14.0,14.0,15.0,671,671,671,671,0,0,45,45,45,45,0,0,13,13,0,0,0,0,0,0,0
29,1,0,14.0,15.0,14.0,15.0,727,699,727,699,0,0,150,35,150,35,0,0,13,14,0,0,0,0,0,0,0
36,1,0,16.0,15.0,22.0,15.0,727,727,727,727,0,0,140,125,140,125,0,0,14,14,0,0,0,0,0,0,0
43,1,0,16.0,16.0,22.0,23.0,783,811,783,811,0,0,230,70,230,70,0,0,16,15,0,0,0,0,0,0,0
50,1,0,15.0,16.0,22.0,23.0,755,783,755,783,0,0,30,40,30,40,0,0,15,15,0,0,0,0,0,0,0
57,1,0,17.0,17.0,22.0,23.0,811,811,811,811,0,0,35,85,35,85,0,0,15,16,0,0,0,0,0,0,0
64,1,0,18.0,18.0,22.0,23.0,895,811,895,811,0,0,85,120,85,120,0,0,16,17,0,0,0,0,0,0,0
71,1,0,17.0,18.0,22.0,23.0,895,878,895,811,0,67,165,187,165,175,0,12,17,17,0,0,0,0,0,0,0
79,1,0,17.0,19.0,22.0,23.0,923,939,923,783,0,156,30,302,30,270,0,32,16,18,0,0,0,0,0,0,0
86,1,0,18.0,19.0,22.0,23.0,979,995,979,839,0,156,90,412,90,360,0,52,16,18,0,0,0,0,0,0,0
93,1,0,19.0,20.0,22.0,23.0,979,1018,979,839,0,179,150,337,150,315,0,22,18,19,0,0,0,150,0,0,0
100,1,0,20.0,20.0,22.0,23.0,990,990,923,811,67,179,212,47,200,5,12,42,19,19,0,0,0,150,0,0,0
107,1,0,20.0,20.0,22.0,23.0,1085,967,951,811,134,156,343,58,315,0,28,58,19,19,0,0,0,150,0,0,0
114,1,0,21.0,21.0,22.0,23.0,1079,911,923,755,156,156,428,113,380,35,48,78,20,19,0,0,0,150,0,0,0
121,1,0,27.0,22.0,28.0,23.0,1079,939,923,783,156,156,148,183,80,85,68,98,21,19,0,100,250,150,0,0,0
129,1,0,27.0,23.0,28.0,31.0,1051,1191,895,1035,156,156,283,288,195,170,88,118,21,20,0,100,250,150,0,0,0
136,1,0,28.0,23.0,28.0,31.0,1029,1275,895,1119,134,156,60,128,60,90,0,38,21,20,0,100,250,150,0,0,0
143,1,0,28.0,24.0,28.0,31.0,1001,1186,979,1007,22,179,185,163,185,155,0,8,21,21,100,150,250,150,0,0,0
150,1,0,28.0,25.0,36.0,31.0,1063,1326,1063,1147,0,179,325,258,325,230,0,28,22,22,100,150,250,150,0,0,0
157,1,0,26.0,25.0,36.0,31.0,1203,1247,1203,1091,0,156,95,404,95,360,0,44,20,22,400,150,250,150,0,0,0
164,1,0,30.0,26.0,36.0,31.0,1147,1275,1147,1119,0,156,147,104,147,40,0,64,21,23,400,150,250,150,0,0,0
171,1,0,33.0,26.0,36.0,46.0,1147,1303,1147,1147,0,156,82,254,82,170,0,84,21,23,400,150,250,150,0,0,0
179,1,0,35.0,27.0,36.0,46.0,1203,1247,1203,1091,0,156,27,219,27,115,0,104,25,24,400,150,250,500,0,0,0
186,1,0,36.0,27.0,36.0,46.0,1315,1275,1315,1119,0,156,137,64,137,40,0,24,25,24,400,150,250,500,0,0,0
193,1,0,36.0,28.0,44.0,46.0,1483,1466,1483,1287,0,179,222,184,222,140,0,44,28,25,400,150,250,500,0,0,0
200,1,0,41.0,33.0,44.0,46.0,1539,1494,1539,1315,0,179,142,104,142,40,0,64,28,26,400,150,250,500,0,0,0
207,1,0,44.0,34.0,52.0,46.0,1623,1723,1623,1567,0,156,137,90,137,35,0,55,28,26,550,150,250,500,0,0,0
214,1,0,48.0,36.0,52.0,46.0,1695,1869,1651,1623,44,246,95,286,87,195,8,91,33,28,550,150,250,500,0,0,0
221,1,0,49.0,40.0,52.0,46.0,1863,2042,1707,1707,156,335,260,321,232,190,28,131,34,28,550,350,250,825,0,0,0
229,1,0,54.5,45.0,58.0,46.0,1914,1863,1735,1595,179,268,80,101,32,92,48,9,35,30,475,350,250,825,75,0,0
236,1,0,54.0,45.0,58.0,61.0,1919,1981,1763,1735,156,246,111,74,47,37,64,37,35,30,550,350,250,825,100,0,0
243,1,0,58.0,51.0,58.0,61.0,2003,2233,1847,1987,156,246,101,117,17,52,84,65,40,32,700,550,250,825,100,0,0
250,1,0,58.0,52.0,58.0,61.0,2003,2154,1847,1931,156,223,186,91,82,2,104,89,40,32,850,550,250,825,100,0,0
257,1,0,64.0,54.0,74.0,61.0,2087,2042,1931,1819,156,223,151,114,27,97,124,17,40,34,950,550,250,825,100,0,0
264,1,0,66.0,60.0,74.0,61.0,2087,2154,1931,1931,156,223,311,82,167,37,144,45,41,35,1100,750,250,825,100,0,0
271,1,0,68.0,62.0,82.0,69.0,2250,2244,2071,2043,179,201,391,61,227,42,164,19,44,37,1100,1100,250,825,100,0,0
279,1,0,69.0,63.0,82.0,69.0,2362,2272,2183,2071,179,201,356,174,222,127,134,47,47,39,1250,1100,250,825,100,0,0
286,1,0,72.0,66.0,90.0,69.0,2479,2653,2323,2407,156,246,202,187,152,112,50,75,46,40,1250,1300,250,825,100,0,0
293,1,0,74.0,66.0,90.0,69.0,2591,2653,2435,2407,156,246,292,265,222,162,70,103,45,41,1450,1300,250,825,100,0,0
300,1,0,78.0,68.0,90.0,77.0,2507,2658,2351,2435,156,223,337,209,247,82,90,127,50,42,1600,1350,375,825,100,0,0
307,1,0,79.0,70.0,90.0,77.0,2591,2574,2435,2351,156,223,357,327,247,172,110,155,50,44,1600,1350,375,825,100,0,0
314,1,0,81.0,72.0,90.0,77.0,2619,2462,2463,2239,156,223,577,385,447,277,130,108,50,45,1600,1350,500,825,100,0,0
321,1,0,87.0,74.0,98.0,77.0,2647,2401,2491,2043,156,358,438,377,292,217,146,160,53,46,1650,1400,500,825,150,0,0
329,1,0,89.0,75.0,98.0,85.0,2703,2692,2547,2155,156,537,663,61,497,37,166,24,53,48,1650,1400,700,1375,150,0,0
336,1,0,90.0,78.0,98.0,85.0,2619,2574,2351,2015,268,559,329,285,127,197,202,88,58,50,1850,1450,700,1375,150,0,0
343,1,0,89.0,79.0,106.0,93.0,2854,2748,2407,2211,447,537,284,480,172,332,112,148,55,50,1850,1450,950,1450,150,0,0
350,1,0,92.0,88.0,106.0,93.0,3095,3101,2603,2519,492,582,414,191,242,92,172,99,60,53,1900,1450,950,1450,150,0,0
357,1,0,96.0,91.0,106.0,93.0,3235,3370,2743,2743,492,627,594,495,362,319,232,176,63,54,1900,1500,950,1450,150,0,0
364,1,0,98.5,93.0,106.0,93.0,3291,3314,2799,2687,492,627,725,161,437,112,288,49,64,56,1875,1700,1200,1450,175,0,0
371,1,0,100.0,103.0,114.0,109.0,3280,3470,2743,2799,537,671,564,259,412,136,152,123,66,57,1850,1750,1200,1450,200,0,0
379,1,0,101.0,104.0,114.0,109.0,3409,3515,2715,2799,694,716,717,227,477,180,240,47,69,59,1850,2025,1200,1750,200,0,0
386,1,0,105.0,109.0,122.0,109.0,3493,3448,2687,2799,806,649,523,95,337,35,186,60,72,60,1850,2225,1200,1750,200,0,0
393,1,0,105.5,112.0,130.0,117.0,3470,3482,2687,2855,783,627,894,231,612,195,282,36,76,62,1825,2475,1200,1750,225,0,0
400,1,0,110.5,114.0,138.0,125.0,3605,3734,2799,3107,806,627,694,446,512,330,182,116,78,63,1825,2675,1450,1750,225,0,0
407,1,0,116.5,118.0,152.0,125.0,3767,3594,2939,2967,828,627,599,431,417,235,182,196,79,65,1825,2925,1450,1750,225,0,0
414,1,0,123.5,121.0,152.0,125.0,3907,3672,3079,2911,828,761,510,396,332,225,178,171,80,65,2225,2925,1450,1850,225,0,0
421,1,0,125.5,125.0,152.0,125.0,4215,3678,3387,2827,828,851,726,517,552,250,174,267,80,65,2475,3075,1450,2200,225,0,0
429,1,0,132.5,125.0,152.0,125.0,4271,3734,3443,2883,828,851,402,268,232,180,170,88,80,65,2575,3175,1450,2200,225,0,0
436,1,0,128.0,116.0,152.0,133.0,4389,3610,3583,2827,806,783,918,686,652,510,266,176,79,65,2600,2525,1450,2450,575,800,0
443,1,0,131.5,115.0,152.0,141.0,4389,3582,3583,2799,806,783,614,476,452,350,162,126,78,65,2625,2450,1450,2450,825,1200,0
450,1,0,134.5,124.0,152.0,149.0,4361,3470,3555,2687,806,783,884,161,622,60,262,101,78,65,2975,2650,1450,2450,825,1200,0
457,1,0,142.5,125.0,152.0,149.0,4361,3549,3555,2743,806,806,885,186,527,160,358,26,81,65,3575,2900,1450,2450,825,1200,0
464,1,0,142.5,131.0,160.0,149.0,4406,3263,3555,2435,851,828,1395,177,937,55,458,122,81,68,3675,3100,1450,2450,825,1200,0
471,1,0,147.5,133.0,160.0,165.0,4450,3224,3555,2351,895,873,939,97,677,50,262,47,80,68,3725,3500,1450,2450,825,1200,0
479,1,0,151.5,136.0,160.0,180.0,4467,3515,3527,2575,940,940,972,384,702,225,270,159,80,70,4125,3825,1575,2550,825,1200,0
486,1,0,156.5,146.0,160.0,188.0,4490,3538,3527,2575,963,963,1237,196,847,100,390,96,85,70,4725,4025,1575,2550,850,1200,0
493,1,0,156.0,151.0,160.0,188.0,4512,3650,3527,2687,985,963,1287,296,777,180,510,116,85,70,4800,4225,1575,2550,875,1200,0
500,1,0,156.0,152.0,168.0,188.0,4568,3588,3471,2603,1097,985,1432,291,932,80,500,211,85,73,5250,4225,1575,2550,875,1200,0
507,1,0,168.0,142.0,174.0,188.0,4691,3678,3527,2715,1164,963,883,387,622,85,261,302,85,73,4950,3725,1825,2550,875,2000,0
514,1,0,171.5,147.0,214.0,188.0,4770,3750,3583,2743,1187,1007,704,478,532,110,172,368,85,73,4875,4075,1825,2550,950,2000,0
521,1,0,168.0,148.0,222.0,188.0,4585,3857,3443,2827,1142,1030,1227,538,927,200,300,338,85,73,4700,4225,1825,2550,1200,2050,0
529,1,0,178.5,157.0,222.0,188.0,4366,3846,3247,2883,1119,963,648,356,437,160,211,196,90,75,5775,4575,1825,2550,1350,2050,0
536,1,0,176.5,154.0,222.0,188.0,4456,3907,3359,2967,1097,940,939,322,592,110,347,212,90,75,5225,4125,1825,2550,1600,2600,0
543,1,0,175.5,154.0,222.0,188.0,4422,3958,3303,2995,1119,963,764,512,452,255,312,257,89,75,5875,4275,1825,2550,1600,2600,0
550,1,0,185.5,154.0,222.0,188.0,4590,4092,3471,3107,1119,985,765,922,317,545,448,377,89,77,6075,4425,1825,2850,1650,2600,0
557,1,0,183.0,162.0,222.0,188.0,4658,4322,3471,3359,1187,963,1325,924,737,560,588,364,89,78,6300,5125,1825,3000,1875,2600,0
564,1,0,183.0,161.0,222.0,188.0,4770,4366,3583,3359,1187,1007,1346,854,622,495,724,359,88,78,6150,4625,1950,3075,2425,2800,0
571,1,0,181.0,162.0,222.0,196.0,4870,4428,3751,3443,1119,985,1830,456,982,85,848,371,88,79,6050,4525,1950,3075,2525,2900,0
579,1,0,188.0,164.0,222.0,196.0,4904,4075,3807,3135,1097,940,1786,803,902,320,884,483,87,79,6050,4825,1950,3075,2525,2900,0
586,1,0,184.0,163.0,222.0,196.0,4870,3812,3751,2827,1119,985,1721,503,1047,175,674,328,86,82,6350,5025,2300,3075,2625,3150,0
593,1,0,196.5,158.0,230.0,196.0,4730,3812,3611,2827,1119,985,536,543,497,220,39,323,89,83,6425,4825,2300,3300,2650,3400,0
600,1,0,196.5,170.0,230.0,196.0,4786,4456,3667,3471,1119,985,1117,208,942,90,175,118,89,83,6825,5150,2300,3300,2675,3400,0
607,1,0,180.0,167.0,230.0,196.0,4624,4921,3415,3779,1209,1142,1642,692,1327,430,315,262,89,79,6500,5150,2300,3525,3600,3600,0
614,1,0,197.0,164.0,230.0,196.0,4730,4635,3499,3471,1231,1164,1212,850,757,460,455,390,89,73,6200,5425,2300,3725,3900,3900,0
621,1,0,197.0,174.0,230.0,196.0,4725,4333,3471,3303,1254,1030,866,477,717,350,149,127,89,76,6800,5675,2300,3925,3900,3900,0
629,1,0,200.0,184.0,230.0,196.0,4943,4417,3667,3387,1276,1030,902,327,797,201,105,126,89,77,7800,6350,2300,4175,3900,3900,0
636,1,0,192.0,179.0,236.0,196.0,4826,4473,3527,3443,1299,1030,1487,578,1222,453,265,125,88,81,8350,6000,2300,4175,4300,4250,0
643,1,0,200.0,182.0,236.0,211.0,4960,4389,3639,3359,1321,1030,1482,186,1157,58,325,128,91,81,8450,6250,2300,4175,4300,4250,0
650,1,0,198.0,187.0,236.0,211.0,4954,4568,3611,3359,1343,1209,1309,327,1132,168,177,159,89,81,8450,6900,2300,4275,4300,4250,0
657,1,0,200.0,187.0,236.0,211.0,4954,4428,3611,3107,1343,1321,1730,753,1397,463,333,290,88,85,8850,7450,2300,4275,4300,4250,0
664,1,0,200.0,188.0,236.0,219.0,4882,4652,3583,3331,1299,1321,2318,619,1837,423,481,196,90,85,8850,7725,2300,4275,4300,4250,0
671,1,0,198.0,189.0,236.0,219.0,4943,4826,3667,3527,1276,1299,2304,877,2067,658,237,219,91,85,8150,7450,2775,4450,5000,4525,0
679,1,0,199.5,176.0,236.0,219.0,5072,4876,3751,3555,1321,1321,1578,1052,1177,823,401,229,91,85,6775,6950,2900,4450,6225,5479,0
686,1,0,182.0,165.0,228.0,219.0,5010,4971,3555,3695,1455,1276,1663,1299,1082,1043,581,256,91,84,4250,5925,2900,4450,8750,6679,0
693,1,0,189.5,171.0,228.0,219.0,5128,4915,3695,3639,1433,1276,1091,1540,742,1178,349,362,91,84,4225,5925,2900,4450,8775,6679,0
700,1,0,188.5,178.0,228.0,219.0,4876,4960,3331,3639,1545,1321,921,855,567,483,354,372,90,84,6175,6425,2900,4450,8775,6679,0
707,1,0,187.5,179.0,228.0,219.0,4775,4949,3275,3583,1500,1366,1329,1105,882,698,447,407,89,84,7275,6525,2900,4450,8825,6679,0
714,1,0,199.5,183.0,228.0,219.0,4932,4982,3499,3639,1433,1343,622,922,357,663,265,259,89,86,7625,7050,2900,4450,8825,6679,0
721,1,0,193.0,180.0,228.0,234.0,4994,4764,3583,3443,1411,1321,778,884,337,723,441,161,89,85,6550,7125,3025,4450,10075,7104,0
729,1,0,192.5,184.0,228.0,234.0,5122,4182,3667,2883,1455,1299,1388,905,767,713,621,192,89,85,7125,7125,3025,4450,10100,7104,0
736,1,0,199.5,189.0,228.0,234.0,4982,4053,3527,2799,1455,1254,588,656,312,587,276,69,89,86,7125,7450,3025,4550,10100,7104,0
743,1,0,199.5,199.0,228.0,234.0,4781,3851,3303,2575,1478,1276,1150,441,702,387,448,54,89,86,7575,7875,3025,4550,10100,7104,0
750,1,0,199.5,199.0,228.0,234.0,4848,3890,3303,2547,1545,1343,1571,671,1022,332,549,339,89,86,8825,8150,3025,4550,10218,7104,0
757,1,0,200.0,200.0,228.0,234.0,4870,4053,3415,2687,1455,1366,1405,796,1042,422,363,374,89,86,8800,8050,3025,4550,10243,7204,0
764,1,0,184.0,188.0,228.0,234.0,4994,4271,3583,2883,1411,1388,1997,1299,1462,769,535,530,89,79,8000,8475,3175,4550,11043,8429,0
771,1,0,153.0,165.0,228.0,264.0,4938,4008,3527,2687,1411,1321,2612,375,1897,289,715,86,90,74,4750,6000,3175,4550,14068,11254,0
779,1,0,192.0,171.0,234.0,249.0,5178,3963,3723,2687,1455,1276,677,557,232,319,445,238,90,74,4400,6275,3175,4550,14418,11954,0
786,1,0,194.0,174.0,234.0,249.0,5066,3851,3611,2575,1455,1276,518,404,222,260,296,144,90,76,4400,6325,3175,4550,14418,12029,0
793,1,0,199.5,176.0,234.0,249.0,5162,3874,3639,2575,1523,1299,739,228,267,199,472,29,90,76,5625,6450,3175,4550,14543,12304,0
800,1,0,198.5,178.0,234.0,249.0,5134,3538,3611,2239,1523,1299,1231,326,587,149,644,177,90,76,6675,7400,3025,4550,14943,12629,0
807,1,0,200.0,179.0,234.0,249.0,5156,3470,3723,2239,1433,1231,1590,443,857,272,733,171,90,76,7000,7725,3025,4550,14968,12572,0
814,1,0,200.0,188.0,234.0,249.0,5050,3398,3639,2211,1411,1187,1696,259,1037,77,659,182,90,78,7900,8100,3025,4550,15118,12572,0
821,1,0,189.5,188.0,234.0,249.0,5150,3745,3695,2491,1455,1254,2326,441,1487,232,839,209,90,81,7125,8200,3025,4550,15893,12847,0
829,1,0,191.0,165.0,234.0,249.0,5150,4081,3695,2827,1455,1254,1881,658,862,422,1019,236,90,77,6500,6800,3025,4550,17118,14497,0
836,1,0,183.0,167.0,234.0,249.0,5094,3935,3639,2659,1455,1276,2078,654,887,370,1191,284,90,75,5550,6525,3025,4550,18068,15146,0
843,1,0,185.5,173.0,234.0,249.0,5184,3314,3639,2015,1545,1299,2398,351,1102,132,1296,219,90,75,6525,6800,3025,4550,18143,15146,0
850,1,0,192.5,176.0,234.0,249.0,5195,3756,3695,2435,1500,1321,2131,232,917,132,1214,100,90,77,6925,6850,3025,4550,18143,15146,0
857,1,0,196.5,176.0,234.0,249.0,5022,4484,3611,3163,1411,1321,2375,804,1047,552,1328,252,89,79,7075,7225,3175,4550,18143,15146,0
864,1,0,198.0,178.0,234.0,249.0,4994,4506,3583,3163,1411,1343,2690,840,1257,582,1433,258,89,79,7850,7350,3025,4775,18368,15521,0
871,1,0,199.5,184.0,234.0,249.0,4954,4473,3499,3219,1455,1254,3090,949,1477,672,1613,277,89,79,8075,7625,3025,4775,18493,15521,0
879,1,0,196.0,163.0,234.0,249.0,5033,4574,3555,3387,1478,1187,3140,1237,1347,937,1793,300,89,73,7450,6500,3025,4550,19418,17471,0
886,1,0,184.5,153.0,234.0,234.0,4854,4002,3331,2771,1523,1231,3312,1388,1347,932,1965,456,89,70,6075,5975,3025,4550,20243,19508,0
7,2,0,13.0,13.0,15.0,15.0,251,293,251,293,0,0,30,35,30,35,0,0,12,12,0,0,0,0,0,0,1
14,2,0,14.0,14.0,15.0,15.0,615,671,615,671,0,0,60,70,60,70,0,0,13,13,0,0,0,0,0,0,1
21,2,0,14.0,14.0,15.0,15.0,699,699,699,699,0,0,35,50,35,50,0,0,13,13,0,0,0,0,0,0,1
29,2,0,15.0,15.0,15.0,15.0,671,727,671,727,0,0,70,10,70,10,0,0,14,14,0,0,0,0,0,0,1
36,2,0,15.0,15.0,23.0,15.0,783,699,783,699,0,0,115,50,115,50,0,0,14,14,0,0,0,0,0,0,1
43,2,0,16.0,16.0,23.0,23.0,783,783,783,783,0,0,55,140,55,140,0,0,15,15,0,0,0,0,0,0,1
50,2,0,17.0,16.0,23.0,23.0,783,755,783,755,0,0,25,25,25,25,0,0,16,15,0,0,0,0,0,0,1
57,2,0,18.0,17.0,23.0,23.0,867,693,867,671,0,22,30,99,30,95,0,4,17,16,0,0,0,0,0,0,1
64,2,0,19.0,18.0,23.0,23.0,951,838,951,727,0,111,90,149,90,129,0,20,18,17,0,0,0,0,0,0,1
71,2,0,19.0,18.0,23.0,23.0,979,771,979,615,0,156,210,235,210,195,0,40,18,17,0,0,0,0,0,0,1
79,2,0,20.0,19.0,23.0,23.0,995,883,951,727,44,156,313,305,305,245,8,60,19,18,0,0,0,0,0,0,1
86,2,0,20.0,19.0,23.0,23.0,1029,939,895,783,134,156,443,405,415,325,28,80,19,18,0,0,0,0,0,0,1
93,2,0,20.0,19.0,23.0,23.0,1029,855,895,699,134,156,409,512,365,412,44,100,20,19,0,0,150,0,0,0,1
100,2,0,21.0,20.0,23.0,23.0,1062,1046,951,867,111,179,91,391,35,321,56,70,20,19,0,0,150,150,0,0,1
107,2,0,21.0,20.0,23.0,23.0,984,1046,895,867,89,179,98,116,30,26,68,90,20,19,0,0,150,150,0,0,1
114,2,0,22.0,20.0,23.0,23.0,1085,1051,951,895,134,156,118,227,30,121,88,106,21,19,0,0,150,150,0,0,1
121,2,0,22.0,21.0,23.0,23.0,1051,995,895,839,156,156,193,47,85,21,108,26,21,19,0,0,150,150,0,0,1
129,2,0,25.0,21.0,31.0,23.0,1102,939,923,783,179,156,43,162,15,116,28,46,22,19,0,100,300,150,0,0,1
136,2,0,26.0,22.0,31.0,23.0,1102,1247,923,1091,179,156,133,92,85,76,48,16,23,20,0,100,300,150,0,0,1
143,2,0,26.0,22.0,31.0,23.0,1202,1186,979,1007,223,179,276,72,200,36,76,36,23,20,0,100,300,150,0,0,1
150,2,0,27.0,23.0,31.0,23.0,1236,1242,923,1063,313,179,126,217,110,161,16,56,24,21,175,100,300,150,0,0,1
157,2,0,29.0,23.0,31.0,23.0,1242,1242,951,1063,291,179,102,312,100,236,2,76,24,21,175,100,300,150,0,0,1
164,2,0,30.0,24.0,31.0,31.0,1236,1326,923,1035,313,291,202,202,160,186,42,16,25,22,175,100,300,400,0,0,1
171,2,0,31.0,28.0,46.0,31.0,1292,1348,979,1035,313,313,207,117,125,86,82,31,25,22,175,100,300,500,0,0,1
179,2,0,32.0,29.0,46.0,31.0,1365,1348,1007,1035,358,313,222,272,100,201,122,71,26,23,175,100,300,500,0,0,1
186,2,0,34.0,32.0,46.0,46.0,1449,1292,1091,979,358,313,42,147,30,36,12,111,28,24,175,200,550,500,0,0,1
193,2,0,36.0,34.0,46.0,46.0,1516,1225,1203,867,313,358,119,197,75,71,44,126,30,24,350,300,550,500,0,0,1
200,2,0,37.0,37.0,46.0,46.0,1572,1533,1259,1175,313,358,259,152,175,86,84,66,32,25,350,300,550,750,0,0,1
207,2,0,38.0,39.0,46.0,46.0,1656,1460,1343,1147,313,313,169,214,145,116,24,98,32,25,350,400,550,750,0,0,1
214,2,0,40.0,40.0,46.0,46.0,1662,1600,1371,1287,291,313,120,184,60,71,60,113,34,26,350,500,550,750,0,0,1
221,2,0,40.0,41.0,46.0,46.0,1818,1796,1483,1483,335,313,140,194,40,41,100,153,34,26,350,600,550,750,0,0,1
229,2,0,42.0,44.0,46.0,46.0,1785,1712,1427,1399,358,313,215,289,75,96,140,193,36,27,350,600,700,750,0,0,1
236,2,0,45.0,46.0,46.0,46.0,1824,1936,1511,1623,313,313,252,154,130,46,122,108,37,29,350,800,700,825,0,0,1
243,2,0,46.0,49.0,54.0,54.0,1964,2009,1651,1651,313,358,297,194,135,71,162,123,38,29,525,850,700,925,0,0,1
250,2,0,49.0,53.0,54.0,54.0,1992,2098,1679,1763,313,335,247,235,95,76,152,159,39,31,700,900,1050,925,0,0,1
257,2,0,51.0,53.0,54.0,54.0,2076,2020,1763,1707,313,313,397,481,280,286,117,195,40,31,700,900,1200,1000,0,0,1
264,2,0,55.0,51.0,62.0,62.0,2182,2076,1847,1763,335,313,307,691,250,456,57,235,41,33,875,750,1200,1000,0,150,1
271,2,0,55.0,52.0,62.0,62.0,1673,2244,1315,1931,358,313,417,506,320,431,97,75,41,33,1050,1025,1200,1000,50,250,1
279,2,0,58.0,55.0,62.0,62.0,1734,2188,1399,1875,335,313,348,316,215,201,133,115,41,34,1150,1025,1200,1000,50,250,1
286,2,0,58.0,59.0,62.0,62.0,2328,2429,1903,2071,425,358,619,211,430,181,189,30,42,36,1150,925,1200,1000,50,350,1
293,2,0,58.0,62.0,62.0,62.0,2261,2401,1791,2043,470,358,180,116,85,46,95,70,43,37,1150,1025,1200,1000,50,350,1
300,2,0,60.0,63.0,62.0,70.0,2261,2384,1791,2071,470,313,255,228,100,126,155,102,43,38,1150,1025,1200,1000,50,350,1
307,2,0,60.0,64.0,62.0,70.0,2294,2244,1847,1931,447,313,261,388,150,246,111,142,43,39,1150,1025,1200,1000,50,350,1
314,2,0,61.0,65.0,70.0,70.0,2373,2272,1903,1959,470,313,491,558,320,376,171,182,45,40,1400,1700,1200,1125,50,350,1
321,2,0,61.0,70.0,70.0,70.0,2446,2362,1931,1959,515,403,336,364,105,251,231,113,46,42,1400,1700,1200,1125,50,350,1
329,2,0,62.0,72.0,70.0,78.0,2350,2703,1903,2211,447,492,554,359,275,311,279,48,46,43,1400,1650,1200,1425,50,400,1
336,2,0,63.0,71.0,70.0,78.0,2401,2804,1931,2267,470,537,730,24,395,16,335,8,46,44,1400,1600,1200,1425,50,500,1
343,2,0,67.0,73.0,70.0,78.0,2468,2614,1931,2099,537,515,737,75,480,11,257,64,47,45,1400,1650,1500,1425,50,500,1
350,2,0,69.0,76.0,70.0,86.0,2446,2625,1819,2155,627,470,354,92,75,26,279,66,49,46,1575,1925,1500,1500,50,500,1
357,2,0,70.0,78.0,70.0,86.0,2530,2765,1903,2295,627,470,555,137,200,111,355,26,49,47,1575,1975,1650,1500,50,500,1
364,2,0,71.0,80.0,85.0,86.0,2552,2849,1903,2379,649,470,865,372,430,286,435,86,50,48,1875,2075,1650,1500,50,500,1
371,2,0,78.0,84.0,101.0,94.0,2748,2916,2099,2379,649,537,541,214,280,56,261,158,50,50,1875,2125,1950,1500,50,500,1
379,2,0,81.0,85.0,101.0,94.0,2692,2826,2043,2155,649,671,506,340,265,106,241,234,51,50,2225,2175,1950,1500,50,500,1
386,2,0,83.0,91.0,101.0,94.0,2798,2849,2127,2155,671,694,377,250,60,61,317,189,51,52,2325,2175,1950,1500,50,500,1
393,2,0,90.0,94.0,101.0,94.0,2860,2922,2211,2295,649,627,293,58,100,26,193,32,54,53,2325,2325,1950,1500,50,500,1
400,2,0,90.0,100.0,101.0,102.0,2866,2950,2239,2323,627,627,260,213,195,101,65,112,56,54,2625,2375,1950,1500,50,500,1
407,2,0,90.0,102.0,117.0,102.0,2894,2642,2267,2015,627,627,511,258,370,91,141,167,57,54,2925,2425,2250,1500,50,500,1
414,2,0,93.0,105.0,117.0,117.0,3106,2804,2435,2155,671,649,586,458,515,211,71,247,57,56,2925,2425,2250,1500,50,500,1
421,2,0,105.0,108.0,117.0,125.0,3162,2888,2491,2239,671,649,187,308,40,181,147,127,57,56,2925,3025,2250,1800,50,500,1
429,2,0,106.0,115.0,125.0,125.0,3090,3213,2463,2519,627,694,499,344,280,191,219,153,57,58,3525,3350,2250,1800,50,500,1
436,2,0,108.0,109.0,125.0,125.0,3106,3437,2435,2743,671,694,764,159,465,76,299,83,58,58,3525,2950,2750,1800,50,950,1
443,2,0,108.0,111.0,133.0,125.0,3034,3566,2407,2939,627,627,1126,272,755,171,371,101,58,60,3525,2950,2750,1875,50,1000,1
450,2,0,122.0,118.0,133.0,125.0,3202,3426,2575,2799,627,627,816,312,365,156,451,156,60,60,4525,3200,2750,1875,50,1000,1
457,2,0,126.0,123.0,133.0,125.0,3129,3594,2435,2967,694,627,644,87,255,76,389,11,60,62,4525,3525,2750,1975,50,1000,1
464,2,0,132.0,124.0,133.0,125.0,3190,3728,2407,3079,783,649,731,122,250,31,481,91,61,63,4525,3775,2750,1975,50,1000,1
471,2,0,132.0,130.0,133.0,141.0,3157,3879,2351,3163,806,716,601,215,20,161,581,54,61,63,4825,4200,2750,1975,50,1000,1
479,2,0,132.0,130.0,149.0,141.0,3291,4070,2463,3219,828,851,1002,551,325,401,677,150,61,63,4825,4300,2750,2075,50,1000,1
486,2,0,140.0,136.0,149.0,157.0,3347,4025,2519,3219,828,806,1002,274,225,211,777,63,61,62,4825,4600,2750,2075,50,1050,1
493,2,0,147.0,139.0,157.0,157.0,3358,3627,2575,2911,783,716,879,403,160,331,719,72,61,60,5725,4725,2750,2075,50,1150,1
500,2,0,147.0,121.0,157.0,149.0,3403,2910,2575,2351,828,559,1089,651,270,511,819,140,61,42,5725,5050,2750,2100,250,2400,1
507,2,0,140.0,95.0,157.0,141.0,3314,1874,2463,1539,851,335,1374,559,455,516,919,43,60,22,5250,4800,2750,2100,775,4109,1
514,2,0,136.0,86.0,149.0,141.0,2350,1079,1679,923,671,156,1497,375,360,341,1137,34,56,17,5275,4450,2250,2000,2050,4984,1
521,2,0,136.0,72.0,134.0,133.0,2042,77,1483,55,559,22,1746,650,545,591,1201,59,56,8,5275,4675,2250,2000,2450,5609,1
529,2,0,126.0,72.0,126.0,125.0,1947,0,1455,0,492,0,1985,650,720,591,1265,59,56,8,4775,4675,1900,2000,3400,5709,1
536,2,0,115.0,71.0,118.0,117.0,1774,0,1371,0,403,0,1692,650,375,591,1317,59,37,8,4675,4900,1750,1825,4700,5984,1
543,2,0,93.0,65.0,133.0,117.0,1326,0,1035,0,291,0,1740,650,395,591,1345,59,29,8,4400,4400,1750,1825,5975,6484,1
550,2,0,61.0,57.0,133.0,117.0,900,0,699,0,201,0,1840,650,475,591,1365,59,21,8,2750,3725,1750,1750,8025,7234,1
557,2,0,62.0,54.0,117.0,117.0,906,0,727,0,179,0,1250,650,65,591,1185,59,18,8,2500,3450,1600,1750,8750,7759,1
564,2,0,62.0,54.0,94.0,109.0,850,0,671,0,179,0,1340,650,135,591,1205,59,18,8,3200,3450,1600,1750,9250,7859,1
571,2,0,62.0,54.0,78.0,109.0,906,0,727,0,179,0,1459,650,230,591,1229,59,18,8,3200,3450,1450,1750,9675,7859,1
579,2,0,62.0,54.0,78.0,109.0,850,0,671,0,179,0,1559,650,310,591,1249,59,18,8,3200,3450,1450,1625,9675,7984,1
586,2,0,48.0,39.0,78.0,109.0,906,0,727,0,179,0,1668,650,395,591,1273,59,18,2,2500,2800,1450,1625,10375,8934,1
593,2,0,44.0,35.0,78.0,109.0,844,0,643,0,201,0,1567,650,270,591,1297,59,18,2,1975,2550,1450,1625,10900,9184,1
600,2,0,40.0,36.0,70.0,109.0,872,0,671,0,201,0,1672,450,355,391,1317,59,17,2,1875,2275,1450,1625,11350,9459,1
607,2,0,40.0,34.0,55.0,109.0,850,0,671,0,179,0,1777,300,440,241,1337,59,17,2,1875,2000,1450,1625,11750,9734,1
614,2,0,44.0,32.0,55.0,109.0,827,0,671,0,156,0,1677,250,320,191,1357,59,17,3,1875,1775,1450,1625,11750,9959,1
621,2,0,44.0,35.0,55.0,109.0,855,27,699,27,156,0,1792,155,415,96,1377,59,17,2,2075,1925,1450,1625,11750,10059,1
629,2,0,36.0,30.0,55.0,109.0,827,83,671,83,156,0,1892,115,495,56,1397,59,17,3,1675,1600,1450,1625,12150,10384,1
636,2,0,32.0,29.0,55.0,109.0,855,83,699,83,156,0,2007,75,590,16,1417,59,17,4,1325,1650,1450,1625,12500,10484,1
643,2,0,36.0,27.0,55.0,109.0,878,139,699,139,179,0,1812,95,375,36,1437,59,17,4,1525,1450,1450,1625,12500,10684,1
650,2,0,36.0,27.0,55.0,109.0,850,279,671,279,179,0,1917,135,460,76,1457,59,17,4,1525,1500,1450,1625,12500,10684,1
657,2,0,36.0,28.0,55.0,109.0,855,643,699,643,156,0,1623,165,150,106,1473,59,17,4,1525,1550,1450,1625,12500,10684,1
664,2,0,36.0,32.0,55.0,109.0,855,1315,699,1315,156,0,1718,60,225,26,1493,34,17,4,1525,1550,1450,1625,12500,10684,1
671,2,0,36.0,30.0,55.0,109.0,855,1398,699,1287,156,111,1823,255,310,201,1513,54,17,5,1525,1350,1450,1625,12500,10884,1
679,2,0,36.0,27.0,63.0,109.0,855,1639,699,1483,156,156,1928,211,395,166,1533,45,17,7,1525,1100,1450,1625,12500,11134,1
686,2,0,42.0,34.0,63.0,109.0,906,1667,727,1511,179,156,1508,166,105,101,1403,65,17,7,2050,1225,1450,1625,12500,11134,1
693,2,0,42.0,36.0,63.0,109.0,850,1846,671,1623,179,223,1608,258,185,161,1423,97,17,8,2050,1275,1450,1625,12500,11209,1
700,2,0,39.0,36.0,63.0,109.0,855,1992,699,1679,156,313,1659,318,220,206,1439,112,17,10,1850,1225,1450,1625,12700,11359,1
707,2,0,38.0,40.0,63.0,109.0,799,2188,643,1875,156,313,1754,408,295,256,1459,152,18,12,1750,1400,1450,1625,12800,11359,1
714,2,0,39.0,40.0,63.0,109.0,855,2065,699,1707,156,358,1414,333,135,191,1279,142,18,12,1750,1275,1450,1625,12800,11484,1
721,2,0,38.0,42.0,63.0,109.0,911,1314,755,979,156,335,1429,224,130,46,1299,178,19,15,1575,1050,1450,1625,12975,11809,1
729,2,0,39.0,46.0,78.0,109.0,939,788,783,475,156,313,1384,150,65,11,1319,139,19,17,1575,1175,1450,1625,12975,11809,1
736,2,0,40.0,47.0,78.0,109.0,1018,984,839,671,179,313,1519,225,180,46,1339,179,20,18,1575,1350,1450,1625,12975,11809,1
743,2,0,42.0,50.0,78.0,109.0,1074,1180,895,867,179,313,1494,235,135,16,1359,219,22,19,1575,1500,1450,1625,12975,11809,1
750,2,0,44.0,52.0,78.0,109.0,1163,1208,1007,895,156,313,1590,260,215,26,1375,234,24,21,1575,1500,1800,1625,12975,11809,1
757,2,0,53.0,54.0,78.0,109.0,1219,1286,1063,951,156,335,835,315,40,41,795,274,25,21,2375,1700,1800,1625,12975,11809,1
764,2,0,53.0,56.0,78.0,109.0,1331,1309,1175,951,156,358,615,335,0,21,615,314,26,21,2375,1800,1800,1625,12975,11809,1
771,2,0,55.0,59.0,78.0,109.0,1443,1622,1287,1287,156,335,680,426,45,101,635,325,27,22,2375,1925,1900,1625,12975,11809,1
779,2,0,55.0,60.0,78.0,109.0,1230,1908,1119,1595,111,313,817,602,170,241,647,361,27,24,2375,2025,1900,1625,13075,11809,1
786,2,0,44.0,60.0,78.0,109.0,738,1936,671,1623,67,313,715,727,110,326,605,401,26,25,1500,1925,1900,1625,14100,11909,1
793,2,0,33.0,60.0,78.0,109.0,794,2020,727,1707,67,313,828,572,215,331,613,241,15,25,1675,1825,1900,1625,14650,12134,1
800,2,0,30.0,57.0,78.0,109.0,458,1964,391,1651,67,313,751,512,130,256,621,256,10,26,1675,1325,1800,1625,15000,12634,1
807,2,0,31.0,56.0,78.0,109.0,318,1897,251,1539,67,358,629,572,50,276,579,296,9,27,1850,1150,1800,1625,15050,12859,1
814,2,0,31.0,59.0,78.0,109.0,525,2070,503,1623,22,447,684,368,105,166,579,202,11,27,1850,1050,1800,1625,15050,13059,1
821,2,0,33.0,65.0,78.0,109.0,559,2143,559,1651,0,492,584,310,55,81,529,229,11,30,2025,1175,1800,1625,15050,13059,1
829,2,0,34.0,69.0,78.0,109.0,671,2227,671,1735,0,492,614,175,85,86,529,89,11,30,2025,1675,1800,1625,15050,13059,1
836,2,0,35.0,73.0,78.0,109.0,615,2345,615,1875,0,470,639,271,110,126,529,145,12,33,2025,1725,1800,1700,15050,13059,1
843,2,0,36.0,74.0,78.0,109.0,671,2485,671,2015,0,470,664,451,135,246,529,205,12,33,2025,2075,1800,1700,15050,13109,1
850,2,0,31.0,73.0,78.0,109.0,671,2423,671,1931,0,492,704,576,175,336,529,240,13,36,1500,1975,1800,1700,15575,13309,1
7,0,2,13.0,13.0,15.0,15.0,293,293,293,293,0,0,35,35,35,35,0,0,12,12,0,0,0,0,0,0,1
14,0,2,14.0,14.0,15.0,15.0,615,671,615,671,0,0,60,70,60,70,0,0,13,13,0,0,0,0,0,0,1
21,0,2,14.0,14.0,15.0,15.0,643,699,643,699,0,0,35,55,35,55,0,0,13,13,0,0,0,0,0,0,1
29,0,2,15.0,15.0,15.0,15.0,643,755,643,755,0,0,65,100,65,100,0,0,14,14,0,0,0,0,0,0,1
36,0,2,15.0,16.0,15.0,23.0,727,811,727,811,0,0,165,145,165,145,0,0,14,15,0,0,0,0,0,0,1
43,0,2,16.0,16.0,23.0,23.0,755,811,755,811,0,0,45,40,45,40,0,0,15,15,0,0,0,0,0,0,1
50,0,2,16.0,17.0,23.0,23.0,839,867,839,867,0,0,15,20,15,20,0,0,15,16,0,0,0,0,0,0,1
57,0,2,17.0,18.0,23.0,23.0,783,839,783,839,0,0,35,80,35,80,0,0,16,17,0,0,0,0,0,0,1
64,0,2,18.0,19.0,23.0,23.0,839,951,839,951,0,0,80,190,80,190,0,0,17,18,0,0,0,0,0,0,1
71,0,2,18.0,19.0,23.0,23.0,855,973,811,951,44,22,123,254,115,250,8,4,17,18,0,0,0,0,0,0,1
79,0,2,19.0,20.0,23.0,23.0,883,1001,727,867,156,134,218,374,190,350,28,24,18,19,0,0,0,0,0,0,1
86,0,2,19.0,20.0,23.0,23.0,995,1079,727,923,268,156,349,355,285,315,64,40,18,19,0,0,0,150,0,0,1
93,0,2,20.0,20.0,23.0,23.0,984,1057,671,923,313,134,100,76,50,20,50,56,19,20,0,0,150,150,0,0,1
100,0,2,20.0,20.0,23.0,23.0,1012,1107,699,951,313,156,220,101,130,25,90,76,19,20,0,0,150,150,0,0,1
107,0,2,20.0,21.0,23.0,23.0,928,1135,615,979,313,156,81,107,55,15,26,92,19,20,0,0,150,150,0,0,1
114,0,2,21.0,22.0,23.0,23.0,928,1051,727,895,201,156,141,182,95,70,46,112,19,21,0,0,150,150,0,0,1
121,0,2,22.0,24.0,31.0,31.0,962,1135,783,979,179,156,51,192,35,85,16,107,19,21,100,0,150,300,0,0,1
129,0,2,23.0,25.0,31.0,31.0,1270,1107,1091,951,179,156,170,272,130,145,40,127,20,22,100,0,150,300,0,0,1
136,0,2,23.0,24.0,31.0,31.0,1303,990,1147,811,156,179,271,341,215,190,56,151,20,21,100,0,150,300,0,50,1
143,0,2,24.0,25.0,31.0,31.0,1303,822,1147,643,156,179,356,141,280,120,76,21,21,22,100,125,150,300,0,50,1
150,0,2,25.0,27.0,31.0,31.0,1410,922,1231,699,179,223,450,74,375,50,75,24,22,22,100,125,400,300,0,50,1
157,0,2,25.0,28.0,31.0,31.0,1460,1208,1259,895,201,313,209,69,110,55,99,14,22,23,200,125,500,300,0,50,1
164,0,2,26.0,29.0,31.0,46.0,1426,1264,1203,951,223,313,312,234,185,180,127,54,23,24,200,125,500,300,0,50,1
171,0,2,29.0,32.0,31.0,46.0,1438,1236,1147,923,291,313,128,54,65,10,63,44,23,24,200,250,575,300,0,50,1
179,0,2,30.0,33.0,31.0,46.0,1292,1314,979,979,313,335,238,169,135,85,103,84,24,25,200,250,575,300,0,50,1
186,0,2,31.0,34.0,31.0,46.0,1208,1370,895,1035,313,335,93,234,50,110,43,124,25,26,200,250,575,300,0,50,1
193,0,2,31.0,38.0,31.0,46.0,1292,1370,979,1035,313,335,243,45,160,35,83,10,25,27,200,250,575,600,0,50,1
200,0,2,34.0,39.0,39.0,46.0,1482,1370,1147,1035,335,335,163,160,140,110,23,50,26,27,450,425,575,700,0,50,1
207,0,2,35.0,41.0,39.0,46.0,1533,1404,1175,1091,358,313,288,131,225,45,63,86,26,29,450,425,575,700,0,50,1
214,0,2,35.0,41.0,39.0,46.0,1510,1376,1175,1063,335,313,159,301,60,175,99,126,26,29,450,425,575,700,50,50,1
221,0,2,35.0,43.0,39.0,46.0,1516,1482,1203,1147,313,335,210,131,100,65,110,66,26,31,450,425,825,700,50,50,1
229,0,2,36.0,45.0,39.0,54.0,1544,1426,1231,1091,313,335,285,292,185,190,100,102,27,31,450,825,825,700,50,50,1
236,0,2,39.0,47.0,39.0,54.0,1376,1398,1063,1063,313,335,190,107,175,65,15,42,27,33,700,825,825,700,50,50,1
243,0,2,39.0,49.0,62.0,54.0,1454,1348,1119,1035,335,313,165,163,110,85,55,78,28,33,600,1075,800,700,250,50,1
250,0,2,38.0,51.0,62.0,54.0,1510,1628,1175,1315,335,313,185,278,90,160,95,118,28,35,500,1075,800,700,350,50,1
257,0,2,41.0,51.0,62.0,54.0,1594,1740,1259,1427,335,313,106,228,50,170,56,58,29,37,500,1075,800,700,350,50,1
264,0,2,43.0,57.0,62.0,62.0,1706,1902,1371,1567,335,335,191,98,95,50,96,48,29,37,500,1325,1050,700,350,50,1
271,0,2,43.0,58.0,62.0,62.0,1762,2037,1427,1679,335,358,246,238,110,150,136,88,30,38,775,1500,1050,700,350,50,1
279,0,2,40.0,59.0,62.0,62.0,1813,2042,1455,1707,358,335,350,469,170,345,180,124,29,39,525,1500,1050,700,650,50,1
286,0,2,45.0,61.0,62.0,70.0,1813,2104,1455,1791,358,313,228,370,75,310,153,60,29,41,850,1625,1050,700,650,175,1
293,0,2,44.0,61.0,62.0,70.0,1774,2188,1371,1875,403,313,316,535,140,435,176,100,29,41,600,1625,1150,700,900,175,1
300,0,2,44.0,63.0,62.0,70.0,1662,2160,1259,1847,403,313,404,390,180,250,224,140,31,43,475,1625,1150,700,1125,175,1
307,0,2,47.0,63.0,62.0,70.0,1421,2020,1063,1707,358,313,195,220,35,140,160,80,31,43,475,1875,1150,700,1125,175,1
314,0,2,49.0,63.0,62.0,70.0,1572,2014,1259,1679,313,335,204,65,8,45,196,20,33,45,800,1700,1300,700,1125,350,1
321,0,2,51.0,65.0,62.0,70.0,1880,2233,1567,1875,313,358,229,225,93,165,136,60,33,45,950,1700,1300,700,1125,350,1
329,0,2,53.0,63.0,62.0,70.0,2048,2250,1735,1847,313,403,109,493,33,385,76,108,35,45,725,1450,1300,700,1350,600,1
336,0,2,52.0,67.0,62.0,70.0,2076,2395,1763,1791,313,604,349,429,233,345,116,84,34,47,725,1700,1300,700,1400,600,1
343,0,2,53.0,67.0,62.0,70.0,2070,2558,1735,1931,335,627,494,439,338,275,156,164,35,49,875,1700,1300,1100,1450,600,1
350,0,2,57.0,69.0,62.0,70.0,2322,2451,1987,1847,335,604,455,220,263,180,192,40,35,49,925,1700,1300,1100,1450,600,1
357,0,2,61.0,69.0,62.0,70.0,2401,2630,2043,1959,358,671,424,445,238,375,186,70,37,49,925,1950,1400,1100,1450,600,1
364,0,2,61.0,70.0,62.0,70.0,2462,2446,2015,1819,447,627,95,372,53,230,42,142,37,51,1125,1950,1400,1100,1450,600,1
371,0,2,70.0,71.0,70.0,85.0,2513,2395,2043,1791,470,604,135,364,33,150,102,214,39,51,1125,1950,1525,1100,1450,600,1
379,0,2,70.0,74.0,70.0,93.0,2373,2642,1903,2015,470,627,375,504,213,310,162,194,39,52,1225,2100,1525,1100,1450,600,1
386,0,2,73.0,77.0,78.0,93.0,2255,2860,1763,2211,492,649,240,399,118,125,122,274,39,54,1275,2100,1525,1100,1500,600,1
393,0,2,75.0,77.0,78.0,93.0,2306,2944,1791,2295,515,649,430,745,248,395,182,350,39,54,1425,2100,1525,1400,1550,600,1
400,0,2,78.0,83.0,78.0,93.0,2166,3050,1651,2379,515,671,236,356,48,230,188,126,40,57,1525,2550,1525,1700,1550,600,1
407,0,2,78.0,86.0,78.0,93.0,2199,2994,1707,2323,492,671,517,287,273,85,244,202,41,57,2025,2550,1525,1700,1550,600,1
414,0,2,78.0,86.0,78.0,93.0,2149,3118,1679,2491,470,627,468,669,268,395,200,274,41,58,2025,2550,1525,1850,1550,600,1
421,0,2,90.0,92.0,94.0,101.0,2233,3118,1763,2491,470,627,438,414,303,210,135,204,41,60,2175,2725,1525,1850,1550,600,1
429,0,2,93.0,92.0,94.0,101.0,2233,3140,1763,2491,470,649,328,489,208,205,120,284,41,60,2175,3075,1525,1850,1550,600,1
436,0,2,94.0,92.0,94.0,101.0,2283,3084,1791,2435,492,649,573,855,393,495,180,360,43,60,2275,3075,1425,2600,1577,600,1
443,0,2,94.0,97.0,94.0,109.0,2552,3168,2015,2519,537,649,388,816,148,430,240,386,43,60,2525,3250,1425,2600,1577,600,1
450,0,2,99.0,103.0,110.0,125.0,2474,3078,1959,2407,515,671,449,472,178,210,271,262,44,58,3050,3950,1425,2600,1577,700,1
457,0,2,91.0,97.0,110.0,125.0,2513,2513,2043,2043,470,470,736,761,413,455,323,306,45,59,2550,3525,1425,2700,1977,1225,1
464,0,2,94.0,99.0,118.0,133.0,2513,2916,2043,2603,470,313,286,796,103,550,183,246,45,59,2300,3625,1425,2700,2327,1475,1
471,0,2,86.0,104.0,118.0,125.0,2541,3084,2071,2771,470,313,496,661,253,475,243,186,45,59,1725,3375,1425,2450,3027,2075,1
479,0,2,75.0,101.0,118.0,125.0,2647,2994,2155,2659,492,335,461,1016,208,790,253,226,45,58,1050,3475,1425,2450,3602,2375,1
486,0,2,78.0,101.0,118.0,125.0,2614,3011,2099,2519,515,492,606,779,293,585,313,194,47,61,1425,3475,1425,2450,3652,2375,1
493,0,2,77.0,113.0,118.0,125.0,2446,3106,1931,2435,515,671,682,126,313,110,369,16,47,61,1300,3475,1425,2450,3902,2375,1
500,0,2,79.0,116.0,118.0,125.0,2367,3168,1875,2519,492,649,573,237,348,145,225,92,47,61,1475,4300,1425,2450,4027,2375,1
507,0,2,87.0,106.0,118.0,125.0,2401,3090,1931,2463,470,627,319,618,138,450,181,168,47,51,1600,4300,1425,2450,4027,2875,1
514,0,2,83.0,104.0,125.0,125.0,1914,2810,1511,2183,403,627,487,953,258,705,229,248,41,54,1675,4125,1425,2450,4477,3050,1
521,0,2,65.0,103.0,125.0,133.0,1421,2832,1063,2183,358,649,475,263,198,185,277,78,25,54,1525,3025,1425,2450,5527,4325,1
529,0,2,47.0,95.0,125.0,133.0,1236,2770,923,2099,313,671,352,398,93,240,259,158,26,54,800,2875,1425,2450,6977,5000,1
7,1,2,13.0,13.0,14.0,15.0,377,335,377,335,0,0,45,40,45,40,0,0,12,12,0,0,0,0,0,0,1
14,1,2,13.0,14.0,14.0,15.0,671,643,671,643,0,0,20,15,20,15,0,0,13,13,0,0,0,0,0,0,1
21,1,2,14.0,14.0,14.0,15.0,699,643,699,643,0,0,50,40,50,40,0,0,13,13,0,0,0,0,0,0,1
29,1,2,14.0,15.0,14.0,15.0,755,643,755,643,0,0,150,65,150,65,0,0,13,14,0,0,0,0,0,0,1
36,1,2,16.0,15.0,22.0,15.0,783,727,783,727,0,0,145,120,145,120,0,0,14,14,0,0,0,0,0,0,1
43,1,2,17.0,16.0,22.0,23.0,839,783,839,783,0,0,185,5,185,5,0,0,16,15,0,0,0,0,0,0,1
50,1,2,17.0,17.0,22.0,23.0,811,811,811,811,0,0,280,15,280,15,0,0,17,16,0,0,0,0,0,0,1
57,1,2,17.0,18.0,22.0,23.0,895,811,895,811,0,0,35,65,35,65,0,0,16,17,0,0,0,0,0,0,1
64,1,2,18.0,19.0,22.0,23.0,951,867,951,867,0,0,95,70,95,70,0,0,16,18,0,0,0,0,0,0,1
71,1,2,17.0,19.0,22.0,23.0,867,923,867,923,0,0,170,175,170,175,0,0,17,18,0,0,0,0,0,0,1
79,1,2,17.0,20.0,22.0,23.0,895,995,895,951,0,44,30,248,30,240,0,8,16,19,0,0,0,0,0,0,1
86,1,2,18.0,20.0,22.0,23.0,839,1018,839,951,0,67,90,421,90,405,0,16,16,19,0,0,0,0,0,0,1
93,1,2,19.0,20.0,22.0,23.0,895,1018,895,951,0,67,145,134,145,110,0,24,18,20,0,0,0,150,0,0,1
100,1,2,20.0,21.0,22.0,23.0,934,1034,867,923,67,111,217,55,205,15,12,40,18,20,0,0,0,150,0,0,1
107,1,2,20.0,21.0,22.0,23.0,978,1090,867,979,111,111,329,117,305,65,24,52,19,20,0,0,0,150,0,0,1
114,1,2,20.0,22.0,22.0,23.0,1001,1113,867,979,134,134,359,188,315,120,44,68,20,21,0,0,0,150,0,0,1
121,1,2,22.0,22.0,22.0,23.0,1079,1102,923,923,156,179,344,168,280,80,64,88,20,21,0,0,250,150,0,0,1
129,1,2,26.0,23.0,36.0,23.0,1079,1102,923,923,156,179,214,258,130,150,84,108,20,22,0,0,250,150,0,0,1
136,1,2,28.0,25.0,36.0,31.0,1012,1118,923,895,89,223,232,156,140,95,92,61,20,22,0,0,250,300,0,0,1
143,1,2,28.0,26.0,36.0,31.0,1018,1135,951,867,67,268,145,257,145,160,0,97,20,23,100,0,250,300,0,0,1
150,1,2,30.0,27.0,36.0,31.0,1135,1208,1091,895,44,313,184,162,180,125,4,37,22,24,100,0,250,300,0,0,1
157,1,2,30.0,29.0,36.0,31.0,1119,1208,1119,895,0,313,319,77,315,50,4,27,23,24,250,125,250,300,0,0,1
164,1,2,30.0,31.0,36.0,46.0,1119,1208,1119,895,0,313,94,119,90,60,4,59,23,25,400,125,250,300,0,0,1
171,1,2,32.0,32.0,36.0,46.0,1315,1253,1315,1007,0,246,69,127,65,40,4,87,23,26,400,125,250,300,0,0,1
179,1,2,33.0,34.0,36.0,46.0,1259,1342,1259,1119,0,223,159,176,155,65,4,111,23,28,450,300,250,300,0,0,1
186,1,2,36.0,37.0,44.0,46.0,1287,1639,1287,1371,0,268,114,208,110,90,4,118,24,29,500,300,250,550,0,0,1
193,1,2,39.0,38.0,44.0,46.0,1315,1678,1315,1455,0,223,111,337,107,195,4,142,26,30,500,300,250,550,0,0,1
200,1,2,42.0,40.0,44.0,46.0,1371,1768,1371,1567,0,201,31,96,27,30,4,66,27,32,500,300,250,550,0,0,1
207,1,2,44.0,40.0,44.0,46.0,1477,1762,1455,1539,22,223,60,168,52,70,8,98,29,32,500,300,250,550,0,0,1
214,1,2,45.0,42.0,52.0,46.0,1488,1818,1399,1595,89,223,96,67,72,45,24,22,32,34,500,425,250,550,0,0,1
221,1,2,48.0,42.0,52.0,46.0,1729,1869,1595,1623,134,246,107,249,67,195,40,54,32,34,650,425,250,700,0,0,1
229,1,2,50.0,44.0,60.0,54.0,1779,1975,1623,1707,156,268,217,321,157,235,60,86,33,36,650,425,250,700,0,0,1
236,1,2,51.0,45.0,66.0,54.0,1886,2031,1707,1763,179,268,192,403,112,285,80,118,34,37,650,425,250,700,0,0,1
243,1,2,52.0,50.0,66.0,54.0,1886,2110,1707,1819,179,291,242,354,142,250,100,104,35,38,800,425,250,850,0,0,1
250,1,2,55.0,53.0,66.0,54.0,1863,2115,1707,1847,156,268,278,336,162,225,116,111,37,39,800,675,250,850,0,0,1
257,1,2,60.0,54.0,66.0,62.0,2003,2110,1847,1819,156,291,273,577,137,430,136,147,38,40,950,800,250,850,0,0,1
264,1,2,63.5,60.0,74.0,62.0,2003,2294,1847,1847,156,447,208,262,52,105,156,157,39,42,925,800,250,1100,25,0,1
271,1,2,63.5,60.0,74.0,70.0,2087,2233,1931,1763,156,470,373,232,197,165,176,67,39,42,1175,1050,250,1100,25,0,1
279,1,2,69.5,64.0,82.0,70.0,1998,2210,1819,1763,179,447,298,203,177,105,121,98,39,42,1175,1175,450,1100,25,0,1
286,1,2,73.5,64.0,90.0,78.0,2138,2283,1959,1791,179,492,358,493,267,335,91,158,39,42,1525,1175,450,1100,25,0,1
293,1,2,75.5,69.0,90.0,78.0,2059,2311,1903,1819,156,492,129,469,47,305,82,164,36,44,1525,1175,450,1100,25,0,1
300,1,2,79.5,73.0,90.0,78.0,1975,2255,1819,1763,156,492,69,359,17,235,52,124,37,44,1925,1675,450,1100,25,0,1
307,1,2,83.5,73.0,90.0,78.0,2031,2345,1875,1763,156,582,114,541,42,345,72,196,39,46,2025,1800,450,1100,25,0,1
314,1,2,86.5,73.0,90.0,86.0,2059,2412,1903,1763,156,649,124,846,57,570,67,276,40,46,2225,1800,825,1100,25,0,1
321,1,2,90.0,82.0,98.0,86.0,2143,2524,1987,1875,156,649,179,462,142,335,37,127,44,46,2300,2275,825,1400,50,0,1
329,1,2,90.0,82.0,98.0,94.0,2250,2552,2071,1903,179,649,344,568,287,465,57,103,44,46,2300,2275,825,1400,50,0,1
336,1,2,92.0,84.0,106.0,94.0,2334,2574,2155,1903,179,671,324,783,297,600,27,183,44,46,2300,2275,825,1400,150,0,1
343,1,2,92.5,82.0,114.0,94.0,2339,2580,2183,1931,156,649,410,314,367,280,43,34,44,46,2275,1775,825,1400,375,500,1
350,1,2,101.5,87.0,114.0,94.0,2423,2474,2267,1847,156,627,125,600,112,490,13,110,44,48,2275,2450,825,1400,375,500,1
357,1,2,102.5,86.0,122.0,94.0,2339,2574,2183,1903,156,671,135,920,102,730,33,190,47,48,2475,2450,825,1400,375,550,1
364,1,2,94.5,85.0,122.0,94.0,1835,2580,1679,1931,156,649,235,1171,182,905,53,266,39,49,2475,2325,825,1400,775,675,1
371,1,2,100.5,83.0,122.0,94.0,1639,2586,1483,1959,156,627,145,1077,122,735,23,342,39,49,2725,2500,825,1400,775,800,1
379,1,2,99.5,88.0,138.0,94.0,1964,2636,1763,1987,201,649,279,1417,232,1070,47,347,39,49,2675,2875,825,1400,825,850,1
386,1,2,104.0,90.0,138.0,94.0,2082,2686,1791,2015,291,671,295,872,212,445,83,427,41,49,2950,2875,825,1400,850,850,1
393,1,2,106.0,90.0,138.0,94.0,2076,2602,1763,1931,313,671,190,873,167,520,23,353,45,49,3300,2875,825,1400,850,850,1
400,1,2,106.0,94.0,146.0,94.0,2154,2586,1819,1959,335,627,355,875,292,500,63,375,46,51,3200,3125,825,1400,950,850,1
407,1,2,111.0,94.0,146.0,94.0,2434,2636,2099,1987,335,649,355,1035,277,580,78,455,49,51,3150,3125,825,1400,1000,850,1
414,1,2,110.5,96.0,146.0,110.0,2546,2502,2211,1875,335,627,565,676,447,220,118,456,50,51,3125,3025,825,1400,1025,950,1
421,1,2,117.0,98.0,146.0,110.0,2798,2502,2463,1875,335,627,496,927,342,395,154,532,50,53,3250,3025,825,1550,1050,950,1
429,1,2,102.5,96.0,154.0,110.0,2686,2630,2351,1959,335,671,711,1233,517,625,194,608,50,53,2675,2900,825,1550,1775,1075,1
436,1,2,106.0,90.0,154.0,110.0,2944,2664,2631,2015,313,649,882,1280,652,700,230,580,55,55,2650,2500,825,1550,1800,1575,1
443,1,2,100.0,84.0,154.0,110.0,2502,2664,2211,2015,291,649,893,1556,627,900,266,656,51,55,2400,2125,825,1650,2250,1950,1
450,1,2,99.5,80.0,162.0,110.0,2171,2692,2015,2043,156,649,914,1811,632,1075,282,736,55,57,2325,1750,1075,1650,2425,2325,1
457,1,2,96.5,87.0,170.0,110.0,2686,2670,2575,2043,111,627,816,1047,572,535,244,512,57,59,2225,1500,1075,1800,2725,2575,1
464,1,2,100.5,87.0,178.0,125.0,2686,2670,2575,2043,111,627,482,1223,222,635,260,588,56,59,2225,2025,1075,2100,2725,2575,1
471,1,2,104.5,94.0,186.0,125.0,2877,2843,2631,2239,246,604,288,771,92,215,196,556,57,61,2225,2375,1075,2100,2725,2575,1
479,1,2,108.5,95.0,186.0,125.0,2961,3056,2603,2407,358,649,433,1141,197,505,236,636,61,62,2225,2675,1075,2100,2725,2575,1
486,1,2,110.5,103.0,186.0,125.0,3056,3336,2743,2687,313,649,520,702,302,190,218,512,66,64,2225,3375,1200,2100,2725,2575,1
493,1,2,112.5,104.0,194.0,133.0,3000,3342,2687,2715,313,627,445,1053,287,465,158,588,64,65,2375,3375,1200,2100,2725,2575,1
500,1,2,121.5,108.0,194.0,133.0,3252,3599,2939,2771,313,828,320,1125,247,525,73,600,63,65,2725,3725,1200,2100,2725,2575,1
507,1,2,130.5,108.0,194.0,133.0,3084,3588,2771,2603,313,985,235,1561,197,845,38,716,66,66,2775,3725,1400,2250,2725,2575,1
514,1,2,131.5,116.0,194.0,133.0,3112,3560,2687,2575,425,985,551,1266,457,630,94,636,66,66,3025,4425,1400,2400,2725,2575,1
521,1,2,125.0,116.0,194.0,133.0,3112,3398,2463,2435,649,963,830,1269,652,525,178,744,66,66,2950,4425,1400,2550,3150,2575,1
529,1,2,126.5,116.0,194.0,133.0,3174,3426,2323,2463,851,963,906,1680,632,820,274,860,62,66,3325,4425,1400,2550,3375,2575,1
536,1,2,133.5,125.0,194.0,133.0,3263,3420,2435,2435,828,985,950,1245,572,465,378,780,65,66,3475,5125,1400,2550,3375,2575,1
543,1,2,134.5,132.0,200.0,133.0,3258,3230,2407,2267,851,963,1168,862,682,170,486,692,67,66,3475,5825,1400,2550,3375,2575,1
550,1,2,140.5,133.0,192.0,133.0,3202,3118,2351,2155,851,963,1142,723,602,115,540,608,67,66,3775,5825,1400,2550,3475,2575,1
557,1,2,146.5,135.0,192.0,141.0,3420,3112,2547,2127,873,985,821,1103,402,375,419,728,70,67,3725,5825,1400,2550,3575,2575,1
564,1,2,149.5,141.0,192.0,149.0,3476,3168,2603,2183,873,985,776,994,332,250,444,744,70,67,3475,6150,1525,2550,3875,2750,1
571,1,2,138.0,146.0,200.0,149.0,3610,3409,2715,2379,895,1030,1009,820,482,110,527,710,70,69,3200,6200,1525,2550,4750,2875,1
579,1,2,144.0,148.0,200.0,149.0,3538,3286,2687,2323,851,963,844,923,267,155,577,768,70,70,3300,6425,1525,2550,5000,3000,1
586,1,2,145.0,149.0,194.0,149.0,3510,3235,2659,2295,851,940,953,884,272,150,681,734,70,70,3800,6600,1525,2550,5350,3000,1
593,1,2,151.0,153.0,194.0,164.0,3532,3347,2659,2407,873,940,776,1179,137,325,639,854,70,73,4150,6600,1525,2900,5350,3000,1
600,1,2,128.0,145.0,194.0,164.0,3526,3482,2631,2519,895,963,1035,1600,292,630,743,970,69,73,3050,5900,1525,2900,6550,3700,1
607,1,2,125.5,152.0,194.0,164.0,3448,3834,2575,2827,873,1007,1054,890,357,200,697,690,69,77,3075,6200,1525,2900,6825,4275,1
614,1,2,127.5,155.0,194.0,164.0,3470,3930,2575,2967,895,963,1374,968,577,220,797,748,69,77,3175,6375,1525,2900,6825,4275,1
621,1,2,124.5,153.0,178.0,164.0,3448,4120,2575,3135,873,985,1343,1468,492,600,851,868,69,78,2425,6200,1525,2900,7700,4450,1
629,1,2,111.5,159.0,178.0,164.0,3459,4238,2631,3275,828,963,1408,900,482,220,926,680,69,78,1575,6725,1525,2900,8700,4975,1
636,1,2,98.0,153.0,178.0,164.0,3263,4187,2435,3247,828,940,1607,1246,627,450,980,796,65,78,1100,5900,1525,2900,10025,5800,1
7,2,1,13.0,13.0,15.0,14.0,335,377,335,377,0,0,40,45,40,45,0,0,12,12,0,0,0,0,0,0,0
14,2,1,14.0,13.0,15.0,14.0,671,671,671,671,0,0,70,20,70,20,0,0,13,13,0,0,0,0,0,0,0
21,2,1,14.0,14.0,15.0,14.0,671,727,671,727,0,0,45,50,45,50,0,0,13,13,0,0,0,0,0,0,0
29,2,1,15.0,14.0,15.0,14.0,643,727,643,727,0,0,75,140,75,140,0,0,14,13,0,0,0,0,0,0,0
36,2,1,15.0,16.0,15.0,22.0,755,783,755,783,0,0,125,140,125,140,0,0,14,14,0,0,0,0,0,0,0
43,2,1,16.0,16.0,23.0,22.0,755,839,755,839,0,0,65,240,65,240,0,0,15,14,0,0,0,0,0,0,0
50,2,1,17.0,15.0,23.0,22.0,811,783,811,783,0,0,45,25,45,25,0,0,16,15,0,0,0,0,0,0,0
57,2,1,18.0,17.0,23.0,22.0,811,839,811,839,0,0,90,35,90,35,0,0,17,15,0,0,0,0,0,0,0
64,2,1,19.0,18.0,23.0,22.0,951,867,951,867,0,0,165,90,165,90,0,0,18,16,0,0,0,0,0,0,0
71,2,1,19.0,17.0,23.0,22.0,923,923,923,923,0,0,215,180,215,180,0,0,18,17,0,0,0,0,0,0,0
79,2,1,20.0,17.0,23.0,22.0,1085,979,1063,979,22,0,359,35,355,35,4,0,19,16,0,0,0,0,0,0,0
86,2,1,21.0,18.0,23.0,22.0,1012,951,923,951,89,0,21,100,5,100,16,0,20,16,0,0,150,0,0,0,0
93,2,1,21.0,19.0,23.0,22.0,1118,951,1007,951,111,0,163,165,135,165,28,0,21,18,0,0,150,0,0,0,0
100,2,1,22.0,20.0,23.0,22.0,1057,1018,923,951,134,67,83,232,35,220,48,12,21,18,0,0,150,0,0,0,0
107,2,1,22.0,20.0,23.0,22.0,1163,1057,1007,923,156,134,128,358,60,330,68,28,21,19,0,0,150,0,0,0,0
114,2,1,23.0,21.0,23.0,22.0,1163,1135,1007,979,156,156,218,448,130,400,88,48,22,20,0,0,150,0,0,0,0
121,2,1,23.0,25.0,23.0,28.0,1214,1130,1035,951,179,179,233,273,125,205,108,68,23,20,0,0,150,250,0,0,0
129,2,1,24.0,26.0,31.0,28.0,1186,1219,1007,1063,179,156,373,264,245,180,128,84,23,21,0,0,150,250,0,0,0
136,2,1,27.0,28.0,31.0,28.0,1275,1169,1119,1035,156,134,199,100,155,100,44,0,24,22,0,0,300,250,0,0,0
143,2,1,28.0,29.0,31.0,36.0,1270,1141,1091,1119,179,22,298,185,230,185,68,0,25,22,0,0,300,250,0,0,0
150,2,1,29.0,30.0,31.0,36.0,1365,1315,1119,1315,246,0,260,290,160,290,100,0,26,24,0,0,300,250,0,0,0
157,2,1,29.0,31.0,46.0,36.0,1359,1315,1091,1315,268,0,376,50,240,50,136,0,26,24,0,300,300,250,0,0,0
164,2,1,31.0,33.0,46.0,36.0,1320,1371,1007,1371,313,0,272,60,100,60,172,0,27,24,175,350,300,250,0,0,0
171,2,1,34.0,34.0,46.0,36.0,1432,1371,1119,1371,313,0,157,75,45,75,112,0,28,26,175,350,300,250,0,0,0
179,2,1,36.0,36.0,46.0,36.0,1572,1427,1259,1427,313,0,377,150,150,150,227,0,30,26,175,350,300,250,0,0,0
186,2,1,38.0,38.0,46.0,44.0,1628,1511,1315,1511,313,0,263,85,100,85,163,0,32,27,175,350,300,250,0,0,0
193,2,1,40.0,42.0,46.0,44.0,1561,1539,1315,1539,246,0,181,70,15,70,166,0,32,29,175,350,450,250,0,0,0
200,2,1,42.0,44.0,46.0,44.0,1684,1651,1483,1651,201,0,345,115,155,115,190,0,34,29,175,500,450,250,0,0,0
207,2,1,42.0,46.0,46.0,52.0,1813,1779,1567,1735,246,44,517,233,295,225,222,8,34,33,300,500,450,250,0,0,0
214,2,1,44.0,47.0,54.0,52.0,1846,1891,1623,1735,223,156,596,278,350,250,246,28,36,32,300,500,600,250,0,0,0
221,2,1,45.0,47.0,54.0,52.0,1902,1919,1679,1763,223,156,579,499,405,455,174,44,37,34,300,650,850,250,0,0,0
229,2,1,45.0,51.5,62.0,58.0,2009,1835,1763,1679,246,156,827,464,625,400,202,64,38,36,425,625,850,250,0,25,0
236,2,1,51.0,53.5,62.0,58.0,2042,1947,1819,1791,223,156,295,384,140,300,155,84,39,35,550,775,850,375,0,25,0
243,2,1,53.0,52.5,62.0,58.0,2042,1975,1819,1819,223,156,338,479,155,375,183,104,39,37,800,875,850,375,0,25,0
250,2,1,53.0,54.5,62.0,58.0,2121,2003,1875,1847,246,156,251,554,140,430,111,124,40,37,800,875,850,375,0,25,0
257,2,1,59.0,60.5,70.0,66.0,2126,2110,1903,1931,223,179,119,519,55,375,64,144,41,37,800,975,850,375,0,25,0
264,2,1,61.0,59.5,70.0,66.0,2278,2166,1987,1987,291,179,170,544,70,480,100,64,41,36,1175,1125,850,625,0,25,0
271,2,1,61.0,65.5,78.0,66.0,2216,2115,1903,1959,313,156,305,385,165,305,140,80,41,36,1175,1125,850,750,0,25,0
279,2,1,63.0,65.5,78.0,66.0,2244,2003,1931,1847,313,156,580,515,400,415,180,100,43,36,1175,1425,850,750,0,25,0
286,2,1,65.0,67.5,78.0,74.0,2289,1807,1931,1651,358,156,550,435,430,365,120,70,43,35,1325,1675,850,750,0,25,0
293,2,1,67.0,70.5,78.0,74.0,2278,1841,1875,1595,403,246,663,211,495,105,168,106,45,35,1325,1725,850,750,0,25,0
300,2,1,73.0,73.5,78.0,82.0,2289,2009,1707,1651,582,358,525,241,385,95,140,146,47,37,1325,1725,1100,750,0,25,0
307,2,1,80.0,76.5,93.0,82.0,2446,2014,1819,1679,627,335,255,332,110,150,145,182,47,40,1575,1725,1100,750,0,25,0
314,2,1,83.0,76.0,93.0,82.0,2474,2188,1847,1875,627,313,355,248,130,130,225,118,50,46,1700,1700,1100,750,0,50,0
321,2,1,83.0,79.0,101.0,82.0,2530,2356,1903,2043,627,313,625,293,320,135,305,158,50,47,1700,1700,1100,750,0,50,0
329,2,1,90.0,82.0,101.0,82.0,2765,2608,2071,2295,694,313,565,463,230,265,335,198,53,47,2325,1700,1100,950,0,50,0
336,2,1,97.0,87.0,109.0,98.0,2933,2636,2239,2323,694,313,481,490,170,252,311,238,56,47,2325,1850,1200,950,0,50,0
343,2,1,97.0,76.0,109.0,98.0,2972,2546,2323,2211,649,335,668,805,285,527,383,278,56,47,2325,1450,1200,950,0,575,0
350,2,1,102.0,79.0,109.0,98.0,3062,2630,2435,2295,627,335,494,806,335,492,159,314,59,47,2200,1550,1200,950,125,725,0
357,2,1,102.0,85.0,109.0,98.0,3202,2714,2575,2379,627,335,429,596,240,242,189,354,59,52,2500,1500,1200,950,125,775,0
364,2,1,102.0,82.5,109.0,98.0,3280,2664,2631,2351,649,313,634,697,415,307,219,390,62,52,2125,1175,1200,950,500,1100,0
371,2,1,104.0,85.5,109.0,104.0,3263,2888,2659,2575,604,313,621,547,330,292,291,255,64,52,2675,1575,1200,1200,500,1100,0
379,2,1,108.0,87.5,109.0,104.0,3375,2972,2771,2659,604,313,423,692,260,447,163,245,64,52,2975,1775,1200,1200,500,1100,0
386,2,1,108.0,87.5,109.0,104.0,3325,3050,2743,2715,582,335,746,1042,515,757,231,285,64,52,2975,2175,1200,1200,500,1175,0
393,2,1,108.0,89.5,109.0,104.0,3364,2938,2827,2603,537,335,550,1127,355,802,195,325,64,51,3225,2375,1350,1200,500,1175,0
400,2,1,108.0,98.5,109.0,104.0,3392,2910,2855,2575,537,335,554,1003,295,642,259,361,64,51,3225,2475,1500,1400,500,1175,0
407,2,1,108.0,98.5,109.0,112.0,3437,2832,2855,2519,582,313,966,654,635,557,331,97,64,63,3225,2475,1500,1400,500,1175,0
414,2,1,116.0,103.0,133.0,112.0,3358,2854,2687,2519,671,335,670,703,455,587,215,116,64,63,3225,2400,1500,1400,500,1250,0
421,2,1,117.0,110.5,141.0,120.0,3414,2854,2631,2407,783,447,961,653,725,577,236,76,64,67,3925,2375,1750,1400,500,1275,0
429,2,1,119.0,114.5,141.0,112.0,3459,3101,2631,2631,828,470,1056,393,770,257,286,136,64,67,3925,2375,1900,1400,500,1375,0
436,2,1,119.0,114.5,141.0,112.0,3403,3431,2575,2939,828,492,1187,418,805,372,382,46,64,67,4200,2775,2050,1400,500,1375,0
443,2,1,131.0,121.0,141.0,128.0,3330,3700,2547,3163,783,537,534,577,360,489,174,88,64,67,5250,2950,2050,1400,500,1436,0
450,2,1,119.0,113.5,149.0,152.0,3297,3762,2491,3247,806,515,929,683,655,539,274,144,64,67,4475,2225,2350,1400,1275,2136,0
457,2,1,125.0,125.5,157.0,152.0,3459,3689,2631,3219,828,470,829,275,605,229,224,46,64,67,5000,2225,2500,1400,1275,2136,0
464,2,1,125.0,125.0,157.0,152.0,3398,3829,2547,3359,851,470,1234,495,910,389,324,106,64,67,5000,2600,2500,1400,1275,2411,0
471,2,1,133.0,133.0,157.0,152.0,3666,3857,2771,3387,895,470,622,315,490,249,132,66,64,67,5750,3100,2500,1400,1575,2461,0
479,2,1,125.0,130.5,157.0,152.0,3392,3879,2519,3387,873,492,922,615,690,564,232,51,64,67,5175,3125,2500,1400,2150,2686,0
486,2,1,129.0,125.0,157.0,152.0,3403,3823,2463,3331,940,492,452,680,350,644,102,36,64,67,4725,2800,2500,1400,2600,3061,0
493,2,1,133.0,128.0,157.0,152.0,3431,3818,2491,3303,940,515,268,726,150,709,118,17,64,67,5350,3400,2500,1400,2850,3211,0
500,2,1,127.0,123.0,165.0,152.0,3386,3795,2379,3303,1007,492,668,882,430,809,238,73,64,67,5350,2750,2500,1400,3350,3486,0
507,2,1,127.0,134.0,173.0,168.0,3549,3801,2519,3331,1030,470,1088,463,730,409,358,54,64,67,5350,2850,2500,1400,3350,3686,0
514,2,1,129.0,127.5,173.0,168.0,3454,3689,2491,3219,963,470,602,828,390,714,212,114,64,67,5675,2775,2500,1275,3900,4079,0
521,2,1,132.0,132.0,173.0,168.0,3532,3661,2547,3191,985,470,497,493,315,419,182,74,64,67,5975,2950,2500,1275,4025,4429,0
529,2,1,132.0,126.5,173.0,160.0,3504,3515,2519,3023,985,492,737,418,485,284,252,134,64,67,5975,2525,2500,1275,4200,5054,0
536,2,1,138.0,130.0,173.0,160.0,3403,3420,2463,2883,940,537,514,418,275,324,239,94,64,67,5625,2750,2500,1275,4550,5179,0
543,2,1,142.0,124.5,173.0,152.0,3476,3426,2491,2911,985,515,404,539,195,464,209,75,64,67,6075,2675,2500,1275,4725,6004,0
550,2,1,136.0,121.5,173.0,152.0,3526,3084,2519,2659,1007,425,820,283,495,239,325,44,64,66,6075,2125,2500,1275,5250,6704,0
557,2,1,130.0,108.0,173.0,152.0,3454,2720,2491,2407,963,313,522,333,285,299,237,34,64,59,5550,1750,2500,1275,6475,7879,0
564,2,1,128.0,93.5,173.0,152.0,3510,2636,2547,2323,963,313,583,548,330,474,253,74,64,54,5475,1325,2500,1275,6900,8854,0
571,2,1,134.0,91.0,173.0,152.0,3420,2720,2435,2407,985,313,468,433,245,319,223,114,64,50,5475,1400,2500,1275,6900,9379,0
579,2,1,134.0,87.5,173.0,146.0,3420,2322,2435,1987,985,335,869,498,530,419,339,79,64,48,6000,1475,2500,1275,6900,10054,0
586,2,1,134.0,95.5,173.0,146.0,3067,2154,2127,1819,940,335,1231,194,780,154,451,40,64,48,6000,1725,2500,1275,6900,10054,0
593,2,1,146.0,97.0,173.0,146.0,3246,2294,2239,1959,1007,335,586,334,315,254,271,80,64,48,7050,2150,2500,1275,6900,10129,0
600,2,1,148.0,100.0,173.0,146.0,3274,2496,2267,2183,1007,313,506,500,315,384,191,116,64,48,7225,2150,2500,1150,6900,10254,0
607,2,1,149.0,105.5,173.0,146.0,3342,2636,2379,2323,963,313,814,510,590,354,224,156,64,48,7225,2575,2500,1025,6900,10404,0
614,2,1,149.0,109.5,173.0,146.0,3336,2664,2351,2351,985,313,1209,540,865,419,344,121,64,48,7225,2525,2500,1025,6900,10504,0
621,2,1,161.0,113.0,173.0,144.0,3398,2714,2435,2379,963,335,626,465,370,404,256,61,64,48,7975,3000,2500,1025,7150,10829,0
629,2,1,161.0,111.0,173.0,138.0,3431,2714,2491,2379,940,335,1022,780,650,679,372,101,64,48,8075,3100,2500,1025,7150,11279,0
636,2,1,162.0,121.0,173.0,138.0,3459,2686,2519,2351,940,335,1262,296,820,284,442,12,63,48,8250,3200,2500,1025,7200,11279,0
643,2,1,172.0,125.5,173.0,138.0,3498,2580,2491,2267,1007,313,1042,297,605,249,437,48,63,48,8250,3525,2500,1025,7200,11354,0
650,2,1,162.0,111.5,173.0,138.0,3414,2580,2407,2267,1007,313,1228,472,675,409,553,63,63,47,8200,2725,2500,1025,7875,12154,0
657,2,1,144.0,97.0,173.0,138.0,3235,2608,2295,2295,940,313,1616,732,955,629,661,103,63,47,6925,2600,2500,1025,9150,13029,0
664,2,1,140.0,87.5,181.0,138.0,3336,1947,2351,1679,985,268,1321,84,740,49,581,35,63,47,6625,1175,2500,1025,10150,14504,0
671,2,1,142.0,59.0,189.0,138.0,3364,782,2379,559,985,223,1086,82,510,19,576,63,63,27,6600,750,2500,1025,10800,16129,0
7,0,2,13.0,13.0,15.0,15.0,335,335,335,335,0,0,40,40,40,40,0,0,12,12,0,0,0,0,0,0,0
14,0,2,14.0,14.0,15.0,15.0,671,671,671,671,0,0,70,70,70,70,0,0,13,13,0,0,0,0,0,0,0
21,0,2,14.0,14.0,15.0,15.0,699,699,699,699,0,0,5,0,5,0,0,0,13,13,0,0,0,0,0,0,0
29,0,2,15.0,15.0,15.0,15.0,755,727,755,727,0,0,100,100,100,100,0,0,14,14,0,0,0,0,0,0,0
36,0,2,15.0,16.0,15.0,23.0,755,839,755,839,0,0,135,150,135,150,0,0,14,15,0,0,0,0,0,0,0
43,0,2,16.0,16.0,23.0,23.0,839,783,839,783,0,0,10,30,10,30,0,0,15,15,0,0,0,0,0,0,0
50,0,2,16.0,17.0,23.0,23.0,811,811,811,811,0,0,50,10,50,10,0,0,15,16,0,0,0,0,0,0,0
57,0,2,17.0,18.0,23.0,23.0,839,867,839,867,0,0,20,120,20,120,0,0,16,17,0,0,0,0,0,0,0
64,0,2,18.0,19.0,23.0,23.0,783,923,783,923,0,0,110,175,110,175,0,0,17,18,0,0,0,0,0,0,0
71,0,2,18.0,19.0,23.0,23.0,844,945,755,923,89,22,156,294,140,290,16,4,17,18,0,0,0,0,0,0,0
79,0,2,19.0,20.0,23.0,23.0,883,990,727,923,156,67,257,367,225,355,32,12,18,19,0,0,0,0,0,0,0
86,0,2,19.0,20.0,23.0,23.0,911,1018,643,951,268,67,372,335,300,315,72,20,18,19,0,0,0,150,0,0,0
93,0,2,20.0,20.0,23.0,23.0,1062,928,727,839,335,89,252,47,190,15,62,32,19,20,0,0,150,150,0,0,0
100,0,2,20.0,21.0,23.0,23.0,1034,1023,699,867,335,156,267,127,165,75,102,52,19,20,0,0,150,150,0,0,0
107,0,2,20.0,22.0,23.0,23.0,990,1051,699,895,291,156,139,107,105,35,34,72,19,21,0,0,150,150,0,0,0
114,0,2,21.0,22.0,23.0,23.0,939,1107,671,951,268,156,196,157,130,65,66,92,19,21,0,0,150,150,0,0,0
121,0,2,21.0,25.0,23.0,31.0,928,1051,727,895,201,156,205,112,165,25,40,87,19,22,100,0,150,300,0,0,0
129,0,2,22.0,25.0,23.0,31.0,1230,1102,1007,923,223,179,328,97,260,40,68,57,20,22,100,0,150,300,0,0,0
136,0,2,22.0,26.0,31.0,31.0,1365,1124,1119,923,246,201,431,101,335,45,96,56,20,23,100,0,150,300,0,0,0
143,0,2,23.0,28.0,31.0,31.0,1365,1270,1119,979,246,291,179,357,55,215,124,142,21,23,100,125,150,300,0,0,0
150,0,2,23.0,29.0,31.0,31.0,1370,1242,1147,951,223,291,78,153,30,125,48,28,22,24,100,125,400,300,0,0,0
157,0,2,26.0,30.0,31.0,31.0,1348,1270,1147,979,201,291,82,258,35,190,47,68,22,25,100,125,500,300,0,0,0
164,0,2,27.0,30.0,31.0,31.0,1348,1314,1147,979,201,335,130,358,55,250,75,108,23,25,100,125,500,300,0,0,0
171,0,2,29.0,32.0,31.0,46.0,1342,1320,1119,1007,223,313,128,309,25,215,103,94,23,26,100,250,500,300,0,0,0
179,0,2,30.0,34.0,31.0,46.0,1309,1376,1063,1063,246,313,166,270,60,140,106,130,24,28,200,250,500,300,0,0,0
186,0,2,30.0,36.0,31.0,46.0,1236,1460,923,1147,313,313,206,405,60,235,146,170,24,30,200,250,750,300,0,0,0
193,0,2,33.0,39.0,39.0,46.0,1236,1650,923,1315,313,335,297,305,115,195,182,110,25,31,300,250,750,600,0,0,0
200,0,2,36.0,40.0,39.0,46.0,1376,1650,1063,1315,313,335,227,55,105,5,122,50,25,32,300,250,825,600,0,0,0
207,0,2,38.0,41.0,39.0,46.0,1538,1706,1203,1371,335,335,292,161,130,75,162,86,26,33,400,250,825,700,0,0,0
214,0,2,41.0,44.0,54.0,46.0,1594,1818,1259,1483,335,335,197,126,70,100,127,26,26,34,400,500,825,700,0,0,0
221,0,2,41.0,46.0,54.0,46.0,1600,1908,1287,1595,313,313,183,152,20,90,163,62,26,36,400,500,825,700,0,0,0
229,0,2,44.0,46.0,54.0,46.0,1706,2020,1371,1707,335,313,273,347,70,245,203,102,27,36,500,500,825,700,0,0,0
236,0,2,48.0,46.0,54.0,46.0,1790,2098,1455,1763,335,335,178,282,35,140,143,142,28,38,750,750,825,950,0,0,0
243,0,2,48.0,47.0,54.0,54.0,1712,2126,1399,1791,313,335,269,332,90,250,179,82,28,38,750,750,825,1100,0,0,0
250,0,2,49.0,50.0,54.0,54.0,1628,2020,1315,1707,313,313,389,168,170,150,219,18,29,39,975,750,825,1100,100,0,0
257,0,2,53.0,51.0,54.0,54.0,1986,2126,1651,1791,335,335,224,278,40,220,184,58,29,40,975,750,825,1100,100,0,0
264,0,2,54.0,51.0,54.0,54.0,2154,2154,1819,1819,335,335,359,128,135,30,224,98,31,41,975,750,825,1100,100,0,0
271,0,2,59.0,51.0,62.0,62.0,2020,2216,1707,1903,313,313,255,134,95,100,160,34,31,41,1275,750,825,1100,100,0,0
279,0,2,61.0,55.0,62.0,70.0,1958,2216,1623,1903,335,313,360,294,160,220,200,74,32,41,1325,1000,825,1100,100,0,0
286,0,2,61.0,58.0,62.0,70.0,1964,2210,1651,1875,313,335,361,329,125,265,236,64,32,42,1550,1275,825,1250,100,0,0
293,0,2,65.0,56.0,70.0,70.0,2048,2210,1735,1875,313,335,626,499,350,395,276,104,34,42,1650,1150,825,1400,100,125,0
300,0,2,66.0,60.0,70.0,70.0,2076,2188,1763,1875,313,313,531,555,240,415,291,140,35,42,1650,1600,825,1400,100,125,0
307,0,2,68.0,64.0,70.0,78.0,2210,2182,1875,1847,335,335,491,365,160,285,331,80,36,42,1950,1700,825,1400,100,225,0
314,0,2,70.0,67.0,70.0,78.0,2014,2188,1679,1875,335,313,626,486,255,370,371,116,38,42,2000,1700,900,1400,100,225,0
321,0,2,68.0,65.0,70.0,78.0,1930,2132,1595,1819,335,313,667,896,260,640,407,256,38,42,1750,1800,900,1100,350,625,0
329,0,2,69.0,61.0,70.0,78.0,1846,2244,1511,1931,335,313,577,981,230,685,347,296,39,43,1750,1350,900,1100,450,1175,0
336,0,2,65.0,54.0,70.0,93.0,1964,2238,1651,1903,313,335,488,1196,105,860,383,336,40,43,1400,1050,900,1100,800,1575,0
343,0,2,63.0,57.0,86.0,93.0,1992,2300,1679,1987,313,313,733,1217,310,845,423,372,41,43,1150,1125,900,1100,1100,1700,0
350,0,2,65.0,54.0,86.0,93.0,2042,1762,1707,1427,335,335,613,1082,150,670,463,412,43,41,1200,1125,1200,1000,1100,2150,0
357,0,2,62.0,45.0,86.0,93.0,1958,1370,1623,1035,335,335,738,1092,235,640,503,452,43,38,925,425,1200,1000,1375,3050,0
364,0,2,64.0,48.0,86.0,93.0,1992,1292,1679,979,313,313,979,993,440,505,539,488,44,39,1025,525,1325,1000,1375,3150,0
371,0,2,66.0,42.0,86.0,101.0,1986,1348,1651,1035,335,313,714,1003,135,475,579,528,44,39,1025,175,1425,1000,1375,3750,0
7,0,1,13.0,13.0,15.0,14.0,377,377,377,377,0,0,45,45,45,45,0,0,12,12,0,0,0,0,0,0,0
14,0,1,14.0,13.0,15.0,14.0,643,671,643,671,0,0,65,20,65,20,0,0,13,13,0,0,0,0,0,0,0
21,0,1,14.0,14.0,15.0,14.0,615,727,615,727,0,0,30,55,30,55,0,0,13,13,0,0,0,0,0,0,0
29,0,1,15.0,14.0,15.0,14.0,615,811,615,811,0,0,65,155,65,155,0,0,14,13,0,0,0,0,0,0,0
36,0,1,15.0,16.0,15.0,22.0,643,839,643,839,0,0,140,155,140,155,0,0,14,14,0,0,0,0,0,0,0
43,0,1,15.0,16.0,23.0,22.0,699,839,699,839,0,0,65,245,65,245,0,0,15,16,0,0,0,0,0,0,0
50,0,1,15.0,15.0,23.0,22.0,727,839,727,839,0,0,155,45,155,45,0,0,15,15,0,0,0,0,0,0,0
57,0,1,16.0,17.0,23.0,22.0,783,839,783,839,0,0,55,45,55,45,0,0,15,15,0,0,0,0,0,0,0
64,0,1,16.0,18.0,23.0,22.0,811,895,811,895,0,0,90,105,90,105,0,0,15,16,0,0,0,0,0,0,0
71,0,1,17.0,17.0,23.0,22.0,755,895,755,895,0,0,50,185,50,185,0,0,16,17,0,0,0,0,0,0,0
79,0,1,18.0,17.0,23.0,22.0,811,923,811,923,0,0,155,50,155,50,0,0,17,16,0,0,0,0,0,0,0
86,0,1,18.0,18.0,23.0,22.0,783,979,783,979,0,0,245,115,245,115,0,0,17,16,0,0,0,0,0,0,0
93,0,1,19.0,19.0,23.0,22.0,861,973,839,951,22,22,144,179,140,175,4,4,18,18,0,0,150,0,0,0,0
100,0,1,20.0,20.0,23.0,22.0,838,1068,727,979,111,89,95,261,75,245,20,16,18,19,0,0,300,0,0,0,0
107,0,1,21.0,20.0,23.0,22.0,883,1085,727,951,156,134,150,382,110,350,40,32,18,19,50,0,300,0,0,0,0
114,0,1,21.0,21.0,23.0,22.0,883,1107,727,951,156,156,160,458,100,410,60,48,18,20,50,0,300,0,0,0,0
121,0,1,23.0,27.0,31.0,28.0,855,575,699,531,156,44,110,98,30,50,80,48,18,21,100,0,300,250,0,0,0
129,0,1,24.0,27.0,31.0,28.0,967,335,811,335,156,0,210,133,110,85,100,48,19,21,150,0,300,250,0,0,0
136,0,1,26.0,28.0,31.0,28.0,1158,307,979,307,179,0,250,123,130,75,120,48,19,21,200,0,300,250,0,0,0
143,0,1,27.0,27.0,31.0,28.0,1046,419,867,419,179,0,85,173,45,125,40,48,20,20,250,100,300,250,0,50,0
150,0,1,25.0,24.0,31.0,28.0,1051,419,895,419,156,0,166,218,110,170,56,48,20,18,150,100,300,250,100,200,0
157,0,1,25.0,25.0,31.0,28.0,1079,447,923,447,156,0,211,68,135,20,76,48,20,15,150,400,300,250,200,350,0
164,0,1,24.0,25.0,31.0,28.0,1135,419,979,419,156,0,386,73,290,25,96,48,20,18,100,350,300,250,250,400,0
171,0,1,25.0,25.0,31.0,28.0,1303,755,1147,755,156,0,151,178,35,130,116,48,21,19,100,350,300,250,250,400,0
179,0,1,26.0,26.0,31.0,28.0,1331,1119,1175,1119,156,0,211,148,75,100,136,48,21,20,150,350,300,250,250,400,0
186,0,1,27.0,28.0,31.0,28.0,1270,1175,1091,1175,179,0,336,198,180,150,156,48,22,20,150,350,550,250,250,400,0
193,0,1,28.0,28.0,31.0,28.0,1023,1119,867,1119,156,0,97,128,75,80,22,48,23,22,150,350,550,250,250,500,0
200,0,1,28.0,30.0,31.0,28.0,1191,1219,1035,1175,156,44,102,164,60,108,42,56,23,23,200,350,550,250,250,362,0
207,0,1,28.0,30.0,31.0,36.0,1303,1258,1147,1147,156,111,172,315,110,243,62,72,23,23,200,350,550,250,300,362,0
214,0,1,28.0,36.0,31.0,44.0,1331,1337,1175,1203,156,134,272,126,190,38,82,88,23,25,200,350,550,250,300,362,0
221,0,1,29.0,38.0,39.0,44.0,1359,1398,1203,1287,156,111,427,3,325,3,102,0,24,27,200,350,550,250,300,362,0
229,0,1,36.0,40.0,39.0,44.0,1370,1522,1147,1455,223,67,115,76,85,68,30,8,25,30,200,350,900,250,300,362,0
236,0,1,36.0,40.0,39.0,44.0,1348,1606,1035,1539,313,67,232,214,166,198,66,16,25,31,200,300,900,250,300,412,0
243,0,1,37.0,40.0,39.0,44.0,1376,1667,1063,1623,313,44,288,423,186,403,102,20,26,34,200,300,900,250,300,412,0
250,0,1,39.0,41.0,39.0,44.0,1426,1818,1091,1707,335,111,258,239,116,203,142,36,26,33,400,450,900,250,300,412,0
257,0,1,39.0,43.0,39.0,44.0,1426,1891,1091,1735,335,156,318,134,161,78,157,56,27,34,400,450,900,250,300,412,0
264,0,1,42.0,44.0,47.0,44.0,1404,1863,1091,1707,313,156,364,149,196,73,168,76,27,33,600,450,900,250,300,412,0
271,0,1,44.0,44.0,62.0,44.0,1460,1835,1147,1679,313,156,234,264,26,168,208,96,27,33,700,600,900,250,300,412,0
279,0,1,46.0,44.0,62.0,44.0,1650,1802,1315,1623,335,179,184,174,36,58,148,116,28,33,700,700,900,250,300,412,0
286,0,1,48.0,44.0,62.0,60.0,1566,1947,1231,1679,335,268,139,420,51,268,88,152,28,33,800,700,900,250,300,412,0
293,0,1,49.0,46.0,62.0,76.0,1656,1874,1343,1539,313,335,50,421,26,233,24,188,29,33,900,700,900,250,300,412,0
300,0,1,51.0,56.0,62.0,76.0,1622,1930,1287,1595,335,335,155,156,91,53,64,103,29,33,950,700,900,450,300,512,0
307,0,1,52.0,53.0,70.0,76.0,1824,1768,1511,1455,313,313,356,272,256,133,100,139,30,30,950,800,900,450,300,612,0
314,0,1,50.0,57.0,70.0,84.0,2020,1404,1707,1091,313,313,556,194,416,90,140,104,32,28,800,800,900,450,500,762,0
321,0,1,52.0,60.0,70.0,90.0,2154,1510,1819,1175,335,335,656,184,376,65,280,119,33,27,800,1300,900,450,500,812,0
329,0,1,54.0,60.0,70.0,90.0,2098,1538,1763,1203,335,335,331,369,36,210,295,159,34,27,800,1300,900,450,500,812,0
336,0,1,55.0,65.0,70.0,90.0,2020,1572,1707,1259,313,313,432,205,101,160,331,45,35,27,800,1700,900,450,500,812,0
343,0,1,59.0,69.0,70.0,90.0,1986,1594,1651,1259,335,335,422,145,176,135,246,10,36,27,850,2000,975,450,500,812,0
350,0,1,61.0,71.0,70.0,90.0,2126,1538,1791,1203,335,335,587,220,301,170,286,50,38,27,850,2250,1075,450,500,812,0
357,0,1,63.0,74.0,70.0,90.0,2132,1544,1819,1231,313,313,348,106,26,95,322,11,39,27,850,2400,1075,450,500,812,0
364,0,1,64.0,73.5,70.0,90.0,1908,1544,1595,1231,313,313,570,296,208,245,362,51,40,27,1100,2475,1075,450,600,837,0
371,0,1,64.0,76.5,70.0,98.0,1538,1622,1203,1287,335,335,380,136,103,120,277,16,40,27,1150,2475,1075,450,750,1037,0
379,0,1,66.0,69.0,70.0,98.0,1650,1594,1315,1259,335,335,404,316,87,260,317,56,38,27,1425,2150,1375,450,900,1462,0
386,0,1,55.0,62.5,70.0,98.0,1656,1566,1343,1231,313,335,432,157,79,65,353,92,33,27,1000,1675,1375,450,1583,2187,0
393,0,1,55.0,54.5,70.0,98.0,1124,1622,923,1287,201,335,431,242,62,110,369,132,31,27,1000,1075,1375,450,1783,2787,0
400,0,1,50.0,51.5,70.0,98.0,743,1572,699,1259,44,313,486,223,113,55,373,168,32,35,700,725,1375,450,2083,3137,0
407,0,1,56.0,52.0,62.0,98.0,1214,1824,1147,1511,67,313,239,358,58,150,181,208,33,38,1125,650,1375,450,2183,3212,0
414,0,1,56.0,58.0,62.0,98.0,1970,2042,1903,1707,67,335,402,303,263,55,139,248,35,40,1125,650,1375,450,2183,3212,0
421,0,1,60.0,60.0,62.0,98.0,2356,2210,2155,1875,201,335,149,468,103,180,46,288,35,45,1125,650,1375,450,2183,3212,0
429,0,1,61.0,61.0,62.0,98.0,2350,2272,2015,1959,335,313,229,424,143,100,86,324,36,47,1225,650,1375,450,2183,3212,0
436,0,1,64.0,61.5,77.0,90.0,2328,2490,2015,2155,313,335,400,689,278,325,122,364,38,49,1225,625,1375,450,2183,3337,0
443,0,1,64.0,69.5,93.0,90.0,2216,2630,1903,2295,313,335,210,559,48,155,162,404,38,51,1225,625,1375,450,2183,3337,0
450,0,1,67.0,72.5,93.0,90.0,2339,2692,1959,2379,380,313,273,485,163,145,110,340,39,58,1575,625,1275,450,2278,3337,0
457,0,1,68.0,71.5,93.0,90.0,2653,2664,2183,2351,470,313,149,350,33,20,116,330,41,57,1850,625,1375,700,2278,3337,0
464,0,1,69.0,70.5,93.0,90.0,2647,2854,2155,2519,492,335,385,160,213,40,172,120,41,55,1850,775,1500,700,2278,3387,0
471,0,1,70.0,73.5,93.0,90.0,2681,3022,2211,2687,470,335,321,280,293,120,28,160,42,55,1950,775,1625,700,2278,3387,0
479,0,1,76.0,79.5,93.0,90.0,2423,2972,1931,2659,492,313,166,311,78,115,88,196,43,56,1950,925,1625,700,2278,3387,0
486,0,1,77.0,80.5,93.0,90.0,2451,3190,1959,2855,492,335,396,336,248,100,148,236,44,55,1950,1075,1625,700,2278,3387,0
493,0,1,82.0,84.0,93.0,98.0,2401,3084,1931,2771,470,313,122,487,43,215,79,272,46,55,2200,1050,1625,700,2278,3412,0
500,0,1,85.0,86.0,93.0,114.0,2558,2754,2043,2463,515,291,147,498,108,190,39,308,46,56,2150,1350,1625,900,2328,3512,0
507,0,1,87.0,93.5,101.0,114.0,2395,2110,1903,1931,492,179,338,368,243,40,95,328,48,56,2150,1375,1625,1150,2328,3537,0
514,0,1,90.0,94.0,101.0,122.0,2457,2742,1987,2407,470,335,374,361,223,135,151,226,49,56,2250,1550,1925,1150,2328,3562,0
521,0,1,93.0,96.0,101.0,122.0,2177,3106,1707,2659,470,447,189,623,78,345,111,278,50,64,2525,1700,1925,1150,2328,3562,0
529,0,1,95.0,97.5,101.0,122.0,2451,3213,1959,2743,492,470,374,910,203,580,171,330,50,66,2675,1675,1925,1150,2328,3587,0
536,0,1,99.0,99.5,109.0,128.0,2563,3297,2071,2827,492,470,345,1106,243,720,102,386,53,66,2875,1625,1925,1150,2328,3687,0
543,0,1,106.0,107.0,117.0,128.0,2681,3358,2211,2911,470,447,206,988,148,550,58,438,54,65,2975,1700,2225,1150,2328,3762,0
550,0,1,110.0,108.0,117.0,128.0,2899,2961,2407,2603,492,358,176,1202,58,720,118,482,54,65,2975,1750,2225,1150,2328,3862,0
557,0,1,113.0,113.0,117.0,128.0,3599,3504,3107,3079,492,425,481,1402,303,860,178,542,56,66,3125,2100,2425,1150,2328,3862,0
564,0,1,116.0,114.0,117.0,128.0,3605,3577,3135,3107,470,470,517,1282,283,680,234,602,56,66,3600,2150,2425,1150,2328,3962,0
571,0,1,117.0,114.5,117.0,128.0,3706,3683,3191,3191,515,492,512,1117,318,630,194,487,56,66,3750,2075,2425,1150,2378,4037,0
579,0,1,123.0,123.0,125.0,128.0,3538,3504,3023,2967,515,537,502,792,448,370,54,422,56,65,4050,2450,2425,1150,2378,4062,0
586,0,1,125.0,123.0,125.0,136.0,3370,3510,2855,2995,515,515,531,368,413,265,118,103,56,67,4050,2950,2425,1150,2378,4087,0
593,0,1,135.0,124.5,141.0,144.0,3218,3409,2659,2939,559,470,354,500,293,420,61,80,56,66,4250,3575,2425,1150,2378,4187,0
600,0,1,131.0,128.0,141.0,152.0,3442,3381,2883,2911,559,470,602,545,473,405,129,140,58,66,3950,3300,2425,1150,2728,4312,0
607,0,1,119.0,131.0,141.0,152.0,3190,3577,2631,3107,559,470,516,498,323,354,193,144,42,66,4450,3175,2425,1150,3647,4499,0
614,0,1,107.0,119.5,149.0,152.0,1706,3717,1259,3247,447,470,659,733,418,529,241,204,30,66,4450,2600,2425,1150,4397,5424,0
621,0,1,96.0,102.5,141.0,152.0,1124,3706,811,3191,313,515,495,913,218,649,277,264,30,66,3600,1800,2675,1150,5497,6474,0
629,0,1,97.0,109.0,141.0,144.0,1258,3728,1035,3191,223,537,518,518,213,269,305,249,30,66,4225,1475,2675,1150,5547,6899,0
636,0,1,104.0,104.5,141.0,144.0,1370,3661,1147,3191,223,470,431,946,98,649,333,297,33,66,4275,1450,2675,1150,5547,7124,0
643,0,1,104.0,97.5,141.0,144.0,1370,3605,1147,3135,223,470,431,1241,98,884,333,357,33,66,4275,1400,2675,1150,5547,7749,0
7,1,1,13.0,13.0,14.0,14.0,377,377,377,377,0,0,45,45,45,45,0,0,12,12,0,0,0,0,0,0,1
14,1,1,13.0,13.0,14.0,14.0,699,671,699,671,0,0,25,20,25,20,0,0,13,13,0,0,0,0,0,0,1
21,1,1,14.0,14.0,14.0,14.0,727,727,727,727,0,0,55,55,55,55,0,0,13,13,0,0,0,0,0,0,1
29,1,1,14.0,14.0,14.0,14.0,755,811,755,811,0,0,155,155,155,155,0,0,13,13,0,0,0,0,0,0,1
36,1,1,16.0,16.0,22.0,22.0,755,783,755,783,0,0,145,145,145,145,0,0,14,14,0,0,0,0,0,0,1
43,1,1,16.0,16.0,22.0,22.0,811,783,811,783,0,0,245,235,245,235,0,0,16,16,0,0,0,0,0,0,1
50,1,1,15.0,15.0,22.0,22.0,811,811,811,811,0,0,35,35,35,35,0,0,15,15,0,0,0,0,0,0,1
57,1,1,17.0,17.0,22.0,22.0,839,839,839,839,0,0,45,40,45,40,0,0,15,15,0,0,0,0,0,0,1
64,1,1,18.0,18.0,22.0,22.0,895,923,895,923,0,0,95,90,95,90,0,0,16,16,0,0,0,0,0,0,1
71,1,1,17.0,17.0,22.0,22.0,923,895,923,895,0,0,185,175,185,175,0,0,17,17,0,0,0,0,0,0,1
79,1,1,17.0,17.0,22.0,22.0,923,951,923,951,0,0,45,40,45,40,0,0,16,16,0,0,0,0,0,0,1
86,1,1,18.0,18.0,22.0,22.0,979,979,979,979,0,0,115,100,115,100,0,0,16,16,0,0,0,0,0,0,1
93,1,1,19.0,19.0,22.0,22.0,917,979,895,979,22,0,169,165,165,165,4,0,18,18,0,0,0,0,0,0,1
100,1,1,20.0,20.0,22.0,22.0,978,1006,867,895,111,111,235,235,215,215,20,20,19,19,0,0,0,0,0,0,1
107,1,1,20.0,20.0,22.0,22.0,1051,1102,895,923,156,179,370,360,330,320,40,40,19,19,0,0,0,0,0,0,1
114,1,1,21.0,20.0,22.0,22.0,1079,1102,923,923,156,179,450,490,390,430,60,60,20,20,0,0,0,0,0,0,1
121,1,1,26.0,26.0,28.0,28.0,1135,1130,979,951,156,179,135,225,55,145,80,80,20,20,0,0,250,250,0,0,1
129,1,1,26.0,26.0,28.0,28.0,1186,1107,1007,951,179,156,275,261,175,165,100,96,21,20,0,0,250,250,0,0,1
136,1,1,28.0,28.0,28.0,28.0,1169,1163,1035,1007,134,156,107,101,95,85,12,16,21,21,0,0,250,250,0,0,1
143,1,1,30.0,30.0,36.0,36.0,1230,1141,1119,1007,111,134,144,137,120,105,24,32,23,22,50,50,250,250,0,0,1
150,1,1,30.0,30.0,36.0,36.0,1225,1258,1091,1147,134,111,300,299,260,255,40,44,23,23,50,50,250,250,0,0,1
157,1,1,30.0,32.0,36.0,36.0,1258,1230,1147,1119,111,111,92,340,40,280,52,60,24,24,350,350,250,250,0,0,1
164,1,1,33.0,32.0,36.0,36.0,1320,1309,1231,1175,89,134,109,151,45,75,64,76,24,24,350,400,250,250,0,0,1
171,1,1,32.0,31.0,36.0,36.0,1342,1314,1231,1203,111,111,120,58,90,20,30,38,24,24,350,400,250,250,0,0,1
179,1,1,33.0,33.0,36.0,36.0,1426,1398,1315,1287,111,111,142,139,100,85,42,54,26,25,400,400,250,250,0,0,1
186,1,1,35.0,36.0,36.0,36.0,1454,1505,1343,1371,111,134,218,110,160,40,58,70,26,25,400,400,250,250,0,0,1
193,1,1,39.0,40.0,44.0,44.0,1566,1561,1455,1427,111,134,200,91,130,5,70,86,27,27,400,400,250,250,0,0,1
200,1,1,41.0,41.0,44.0,44.0,1477,1555,1343,1399,134,156,166,136,80,30,86,106,30,28,400,400,250,250,0,0,1
207,1,1,42.0,43.0,44.0,44.0,1566,1746,1455,1567,111,179,143,231,45,105,98,126,30,30,400,500,250,250,0,0,1
214,1,1,45.0,44.0,52.0,44.0,1695,1695,1539,1539,156,156,203,287,85,145,118,142,32,31,500,500,450,450,0,0,1
221,1,1,47.5,48.0,52.0,52.0,1807,1779,1651,1623,156,156,259,252,125,90,134,162,34,31,475,700,450,450,25,0,1
229,1,1,51.5,52.0,58.0,52.0,1807,1807,1651,1651,156,156,79,262,25,80,54,182,35,32,475,700,575,450,25,0,1
236,1,1,53.5,51.0,58.0,58.0,1975,1863,1819,1707,156,156,124,212,50,110,74,102,41,37,475,700,575,450,25,0,1
243,1,1,56.5,51.0,58.0,58.0,2031,1835,1875,1679,156,156,224,127,130,105,94,22,42,40,625,700,575,575,25,0,1
250,1,1,57.5,52.0,58.0,58.0,2115,1914,1959,1735,156,179,314,107,200,65,114,42,45,39,625,700,575,575,25,0,1
257,1,1,59.5,57.0,66.0,66.0,2334,2026,2155,1847,179,179,59,102,25,40,34,62,46,39,625,700,575,575,25,0,1
264,1,1,59.5,58.0,66.0,66.0,2362,2132,2183,1931,179,201,94,141,40,55,54,86,45,41,625,700,575,575,25,0,1
271,1,1,62.5,61.0,74.0,66.0,2395,2188,2239,1875,156,313,235,261,165,135,70,126,49,45,625,700,575,575,25,0,1
279,1,1,66.5,63.0,74.0,66.0,2647,2356,2491,2043,156,313,275,347,185,185,90,162,50,48,675,700,575,575,25,0,1
286,1,1,70.0,62.0,82.0,74.0,2642,2440,2463,2127,179,313,389,487,275,310,114,177,52,50,650,700,575,775,50,0,1
293,1,1,74.0,64.0,82.0,82.0,2692,2496,2379,2183,313,313,148,437,90,320,58,117,56,50,650,650,775,1025,50,50,1
300,1,1,73.0,74.0,90.0,82.0,2843,2686,2351,2239,492,447,388,173,270,125,118,48,60,51,650,700,775,1025,50,50,1
307,1,1,74.0,80.0,90.0,82.0,3011,2726,2519,2211,492,515,318,179,140,150,178,29,62,54,650,700,775,1025,50,50,1
314,1,1,75.0,82.0,98.0,82.0,3185,2882,2715,2211,470,671,519,332,285,240,234,92,63,54,650,700,1025,1025,50,50,1
321,1,1,78.0,83.0,106.0,90.0,3297,3045,2715,2239,582,806,664,403,354,290,310,113,63,54,650,1200,1025,1025,50,50,1
329,1,1,78.5,88.5,106.0,90.0,3330,3101,2659,2295,671,806,758,140,414,124,344,16,64,53,625,1475,1025,1025,75,99,1
336,1,1,86.5,92.5,114.0,98.0,3353,2961,2435,2155,918,806,523,295,234,229,289,66,66,53,775,1575,1025,1025,75,99,1
343,1,1,96.5,100.5,114.0,114.0,3504,2989,2519,2183,985,806,393,156,84,94,309,62,66,53,875,1875,1150,1025,75,99,1
350,1,1,96.5,106.5,122.0,114.0,3666,3011,2659,2183,1007,828,744,201,319,114,425,87,66,53,875,1975,1150,1025,75,99,1
357,1,1,110.5,113.5,122.0,114.0,3722,3011,2715,2183,1007,828,470,172,104,89,366,83,66,52,1475,2375,1150,1025,75,149,1
364,1,1,118.0,119.0,130.0,122.0,3627,2961,2687,2155,940,806,413,214,39,114,374,100,66,52,1550,2600,1150,1375,100,149,1
371,1,1,122.0,121.0,130.0,122.0,3678,3045,2715,2239,963,806,598,124,204,24,394,100,66,52,1600,3000,1150,1375,200,149,1
379,1,1,127.0,120.5,138.0,122.0,3616,2966,2631,2183,985,783,423,386,109,194,314,192,65,52,2300,3175,1150,1375,200,174,1
386,1,1,129.0,119.0,138.0,122.0,3482,3106,2519,2323,963,783,545,602,194,389,351,213,61,52,2700,3400,1150,1525,331,249,1
393,1,1,116.5,122.0,138.0,138.0,2720,2910,1959,2127,761,783,730,140,324,39,406,101,60,52,2675,2850,1150,1525,1206,899,1
400,1,1,122.0,114.0,152.0,146.0,2558,3073,1931,2267,627,806,438,166,114,94,324,72,60,52,2450,2250,1150,1675,1531,1499,1
407,1,1,121.0,122.0,152.0,146.0,2350,2994,1903,2211,447,783,411,124,114,64,297,60,53,52,2750,2450,1150,1675,1881,1499,1
414,1,1,123.0,122.0,152.0,146.0,2104,3028,1791,2267,313,761,361,271,99,169,262,102,53,52,2750,2850,1300,1675,2081,1849,1
421,1,1,115.0,115.0,152.0,146.0,2076,3028,1763,2267,313,761,306,138,79,94,227,44,51,52,2450,2550,1300,1675,2881,2549,1
429,1,1,117.0,118.0,152.0,146.0,2294,2910,1959,2127,335,783,291,139,99,74,192,65,51,52,2650,2650,1300,1675,3081,2749,1
436,1,1,117.0,122.0,152.0,146.0,2742,3056,2407,2295,335,761,312,107,159,54,153,53,51,53,2650,2850,1300,1675,3456,3099,1
443,1,1,110.0,114.0,152.0,146.0,2854,3050,2519,2267,335,783,247,168,154,94,93,74,50,54,2150,2250,1300,1675,4206,3799,1
450,1,1,104.0,102.0,152.0,146.0,2356,3084,2043,2323,313,761,98,226,69,139,29,87,48,54,1800,1550,1300,1525,4956,4849,1
457,1,1,105.0,104.0,152.0,146.0,2048,3140,1735,2379,313,761,198,318,129,214,69,104,46,54,2400,1850,1300,1375,5056,5199,1
464,1,1,110.0,108.0,152.0,146.0,2126,3022,1791,2239,335,783,148,209,39,159,109,50,46,54,2700,2150,1300,1375,5056,5299,1
471,1,1,113.0,118.0,152.0,146.0,2065,3162,1707,2379,358,783,247,101,94,84,153,17,51,54,2900,2250,1300,1375,5056,5299,1
479,1,1,117.0,122.0,152.0,146.0,2479,3056,1987,2295,492,761,47,268,34,209,13,59,53,54,2900,2550,1300,1525,5056,5299,1
486,1,1,123.0,122.0,152.0,146.0,2664,3078,2127,2295,537,783,80,301,74,162,6,139,55,54,2900,3050,1300,1525,5056,5323,1
493,1,1,134.0,128.0,152.0,146.0,2866,3067,2239,2239,627,828,26,221,19,82,7,139,55,54,2900,3450,1300,1525,5056,5323,1
500,1,1,138.0,128.0,152.0,146.0,2938,2994,2267,2211,671,783,181,128,144,47,37,81,55,53,3550,3450,1300,1525,5056,5423,1
507,1,1,142.0,136.0,146.0,146.0,3000,3123,2351,2295,649,828,227,103,164,22,63,81,55,60,3800,3450,1300,1675,5406,5423,1
514,1,1,146.0,137.0,146.0,146.0,2972,3045,2323,2239,649,806,363,339,274,187,89,152,55,59,4200,3550,1300,1675,5406,5423,1
521,1,1,141.0,139.0,154.0,146.0,2972,3325,2323,2519,649,806,323,550,304,327,19,223,54,59,4100,3550,1300,1675,5606,5423,1
529,1,1,144.0,145.0,146.0,146.0,2888,3269,2239,2463,649,806,414,520,344,272,70,248,54,59,4250,3950,1300,1525,5806,5573,1
536,1,1,146.0,145.0,154.0,146.0,2961,3235,2267,2407,694,828,663,406,534,162,129,244,54,59,4450,4150,1300,1525,5806,5573,1
543,1,1,155.0,147.0,162.0,154.0,2922,3157,2183,2351,739,806,306,587,239,297,67,290,55,59,4450,4150,1300,1525,5806,5573,1
550,1,1,158.0,161.0,162.0,178.0,3101,3364,2183,2491,918,873,487,185,304,87,183,98,55,59,4750,4450,1300,1525,5806,5573,1
557,1,1,160.5,164.0,170.0,186.0,3050,3420,2155,2435,895,985,685,200,394,82,291,118,61,61,4825,4550,1300,1375,5831,5723,1
564,1,1,163.0,167.0,170.0,186.0,3157,3364,2239,2379,918,985,322,386,69,252,253,134,61,61,4800,4850,1300,1375,5856,5723,1
571,1,1,168.0,177.0,170.0,184.0,3342,3504,2379,2519,963,985,423,212,129,87,294,125,66,61,4800,5550,1300,1375,5856,5823,1
579,1,1,166.0,177.0,170.0,200.0,3297,3504,2379,2519,918,985,858,223,464,182,394,41,66,61,4950,5750,1300,1375,5856,5823,1
586,1,1,170.0,187.0,170.0,200.0,3526,3532,2631,2547,895,985,595,144,339,112,256,32,66,61,4950,5750,1300,1375,5856,5823,1
593,1,1,170.0,195.0,170.0,208.0,3577,3482,2659,2519,918,963,762,155,419,107,343,48,66,61,5250,6250,1300,1375,5856,5823,1
600,1,1,178.0,197.0,178.0,208.0,3521,3538,2603,2575,918,963,589,471,359,307,230,164,66,61,5450,6250,1300,1375,5856,5823,1
607,1,1,190.0,199.0,202.0,208.0,3403,3420,2463,2435,940,985,275,531,104,372,171,159,66,61,5350,6650,1300,1375,5956,5923,1
614,1,1,197.0,199.0,210.0,208.0,3420,3370,2435,2407,985,963,296,733,109,512,187,221,65,63,5550,6850,1300,1375,5956,6123,1
621,1,1,192.0,200.0,210.0,208.0,3414,3252,2407,2267,1007,985,602,523,299,407,303,116,64,62,5650,6850,1300,1525,6206,6123,1
629,1,1,191.0,200.0,210.0,208.0,2860,3392,1987,2407,873,985,613,910,289,682,324,228,61,62,6150,7050,1300,1525,6556,6123,1
636,1,1,185.0,198.0,210.0,208.0,2311,3364,1595,2379,716,985,292,1035,34,762,258,273,61,62,5550,6850,1300,1525,7556,6523,1
643,1,1,157.0,194.0,224.0,216.0,2373,3538,1567,2575,806,963,473,1252,144,917,329,335,55,62,4650,6550,1300,1525,9056,6923,1
650,1,1,141.0,200.0,218.0,216.0,2311,3532,1595,2547,716,985,353,772,44,542,309,230,50,62,3650,6050,1300,1525,10656,7523,1
7,2,2,13.0,13.0,15.0,15.0,335,335,335,335,0,0,40,40,40,40,0,0,12,12,0,0,0,0,0,0,0
14,2,2,14.0,14.0,15.0,15.0,643,671,643,671,0,0,65,70,65,70,0,0,13,13,0,0,0,0,0,0,0
21,2,2,14.0,14.0,15.0,15.0,727,643,727,643,0,0,50,45,50,45,0,0,13,13,0,0,0,0,0,0,0
29,2,2,15.0,15.0,15.0,15.0,699,699,699,699,0,0,45,45,45,45,0,0,14,14,0,0,0,0,0,0,0
36,2,2,15.0,15.0,15.0,23.0,811,783,811,783,0,0,140,140,140,140,0,0,14,14,0,0,0,0,0,0,0
43,2,2,16.0,16.0,23.0,23.0,783,755,783,755,0,0,30,25,30,25,0,0,15,15,0,0,0,0,0,0,0
50,2,2,17.0,17.0,23.0,23.0,839,839,839,839,0,0,5,0,5,0,0,0,16,16,0,0,0,0,0,0,0
57,2,2,18.0,18.0,23.0,23.0,895,839,895,839,0,0,120,60,120,60,0,0,17,17,0,0,0,0,0,0,0
64,2,2,19.0,19.0,23.0,23.0,923,951,923,951,0,0,95,100,95,100,0,0,18,18,0,0,0,0,0,0,0
71,2,2,19.0,19.0,23.0,23.0,945,923,923,923,22,0,69,50,65,50,4,0,18,18,0,0,0,0,0,0,0
79,2,2,20.0,20.0,23.0,23.0,883,1023,839,979,44,44,118,183,110,175,8,8,19,19,0,0,0,0,0,0,0
86,2,2,21.0,20.0,31.0,31.0,911,1034,867,923,44,111,86,149,70,125,16,24,20,19,0,0,150,150,0,0,0
93,2,2,24.0,23.0,31.0,31.0,1090,945,979,811,111,134,82,105,50,65,32,40,21,20,0,0,150,150,0,0,0
100,2,2,24.0,24.0,31.0,31.0,1152,956,951,755,201,201,150,174,90,110,60,64,21,21,0,0,150,150,0,0,0
107,2,2,25.0,24.0,31.0,31.0,1197,984,951,783,246,201,247,293,155,205,92,88,22,21,0,0,150,150,0,0,0
114,2,2,26.0,21.0,31.0,31.0,1214,1040,923,839,291,201,388,177,260,65,128,112,23,21,0,0,150,150,0,0,0
121,2,2,28.0,21.0,31.0,31.0,1270,1051,979,895,291,156,305,293,170,165,135,128,23,21,100,0,300,300,0,0,0
129,2,2,28.0,24.0,31.0,31.0,1264,1146,951,923,313,223,145,211,120,105,25,106,24,21,100,0,300,300,0,0,0
136,2,2,28.0,24.0,39.0,31.0,1236,1130,923,951,313,179,190,171,125,95,65,76,24,21,100,0,300,300,0,0,0
143,2,2,28.0,26.0,39.0,31.0,1180,1012,867,811,313,201,135,180,30,80,105,100,24,22,100,175,300,300,0,0,0
150,2,2,27.0,26.0,39.0,31.0,1286,844,951,643,335,201,185,279,40,155,145,124,23,22,225,175,300,300,50,0,0
157,2,2,27.0,24.0,39.0,31.0,1230,878,895,699,335,179,326,284,145,140,181,144,23,20,225,175,300,300,50,100,0
164,2,2,26.0,24.0,39.0,31.0,1314,906,979,727,335,179,336,343,165,175,171,168,23,19,125,350,400,300,150,150,0
171,2,2,30.0,26.0,39.0,39.0,1264,883,951,727,313,156,132,209,75,75,57,134,24,19,125,350,900,400,150,150,0
179,2,2,29.0,27.0,39.0,39.0,1264,934,951,755,313,179,332,228,235,70,97,158,24,20,125,350,1000,400,150,150,0
186,2,2,29.0,27.0,39.0,54.0,1236,928,923,727,313,201,477,332,340,150,137,182,24,21,125,350,1000,400,150,150,0
193,2,2,30.0,27.0,39.0,54.0,1258,822,923,643,335,179,582,377,405,175,177,202,24,20,125,350,1000,400,150,200,0
200,2,2,31.0,30.0,39.0,54.0,1258,934,923,755,335,179,277,217,60,45,217,172,25,20,125,525,900,400,250,200,0
207,2,2,34.0,32.0,39.0,54.0,1258,1074,923,895,335,179,123,251,20,55,103,196,25,22,425,525,900,500,250,200,0
214,2,2,36.0,32.0,39.0,54.0,1236,1113,923,867,313,246,94,228,5,50,89,178,26,22,425,525,900,500,250,250,0
221,2,2,37.0,33.0,39.0,54.0,1208,1146,895,811,313,335,189,313,60,95,129,218,26,23,425,700,900,500,250,250,0
229,2,2,37.0,36.0,39.0,54.0,1292,1096,979,783,313,313,204,279,35,75,169,204,26,24,425,700,900,500,250,250,0
236,2,2,38.0,37.0,39.0,54.0,1354,1152,1063,839,291,313,320,379,115,135,205,244,27,25,425,700,900,500,250,250,0
243,2,2,38.0,39.0,39.0,54.0,1292,1230,979,895,313,335,225,279,80,95,145,184,27,27,725,700,900,500,250,250,0
250,2,2,39.0,42.0,39.0,54.0,1292,1314,979,979,313,335,331,394,150,170,181,224,28,28,900,875,900,500,250,250,0
257,2,2,37.0,43.0,39.0,54.0,1370,1320,1035,1007,335,313,436,455,215,195,221,260,28,29,775,875,900,500,375,250,0
264,2,2,38.0,41.0,39.0,54.0,1320,1426,1007,1091,313,335,547,575,290,275,257,300,29,27,775,875,900,500,375,400,0
271,2,2,39.0,42.0,54.0,54.0,1376,1320,1063,1007,313,313,387,631,140,295,247,336,30,28,475,1025,900,500,675,400,0
279,2,2,39.0,44.0,46.0,54.0,1454,1292,1119,979,335,313,517,431,230,155,287,276,30,30,650,1025,1300,500,775,400,0
286,2,2,41.0,48.0,46.0,54.0,1684,1454,1371,1119,313,335,228,306,55,90,173,216,32,32,650,1025,1200,500,875,400,0
293,2,2,42.0,49.0,46.0,54.0,1634,1656,1343,1343,291,313,269,302,60,50,209,252,33,33,650,1025,1100,500,975,400,0
300,2,2,45.0,50.0,46.0,54.0,1762,1684,1427,1371,335,313,264,467,65,175,199,292,34,34,650,1025,1000,500,1075,400,0
307,2,2,46.0,52.0,46.0,54.0,1768,1846,1455,1511,313,335,270,637,35,305,235,332,36,36,825,1025,1100,500,1075,400,0
314,2,2,47.0,52.0,54.0,62.0,1852,1874,1539,1539,313,335,486,252,215,180,271,72,36,37,825,1175,1100,750,1075,400,0
321,2,2,50.0,52.0,54.0,62.0,1880,1970,1567,1679,313,291,496,484,235,380,261,104,37,38,1000,1175,1100,750,1075,400,0
329,2,2,53.0,54.0,54.0,62.0,1908,1964,1595,1651,313,313,506,224,255,80,251,144,38,38,1175,1175,1100,750,1075,400,0
336,2,2,53.0,56.0,62.0,62.0,2014,2042,1679,1707,335,335,356,184,65,50,291,134,39,38,1175,1350,1250,900,1075,400,0
343,2,2,53.0,58.0,62.0,62.0,2065,1908,1707,1595,358,313,441,305,110,135,331,170,40,40,1175,1350,1250,900,1075,400,0
350,2,2,55.0,59.0,62.0,62.0,2070,1824,1735,1511,335,313,597,365,230,205,367,160,40,39,1175,1525,1250,900,1075,450,0
357,2,2,61.0,62.0,62.0,62.0,2104,2098,1791,1763,313,335,318,255,65,105,253,150,40,41,1525,1525,1250,900,1075,450,0
364,2,2,62.0,63.0,62.0,70.0,2132,2154,1819,1819,313,335,318,280,25,90,293,190,42,41,1700,1700,1250,900,1075,450,0
371,2,2,62.0,66.0,62.0,70.0,2104,2132,1791,1819,313,313,493,201,160,25,333,176,42,42,1700,1700,1250,900,1075,450,0
379,2,2,64.0,68.0,70.0,78.0,2160,2216,1847,1903,313,313,663,367,290,155,373,212,43,44,1700,1875,1250,900,1075,450,0
386,2,2,70.0,70.0,78.0,78.0,2210,2182,1875,1847,335,335,403,206,140,100,263,106,43,44,1700,2050,1250,1200,1075,450,0
393,2,2,72.0,72.0,78.0,78.0,2317,2210,1959,1763,358,447,428,277,125,115,303,162,45,46,2225,2050,1400,1200,1075,450,0
400,2,2,72.0,73.0,78.0,93.0,2378,2317,1931,1847,447,470,669,337,310,165,359,172,45,47,2225,2050,1400,1300,1075,625,0
407,2,2,76.0,73.0,93.0,93.0,2395,2451,1903,1959,492,492,670,373,305,195,365,178,47,48,2400,1750,1400,1200,1075,1025,0
413,2,2,76.0,67.0,93.0,101.0,2395,2451,1903,1959,492,492,670,521,305,295,365,226,47,44,2400,1750,1400,1200,1075,1450,0
7,2,1,13.0,13.0,15.0,14.0,419,377,419,377,0,0,50,45,50,45,0,0,12,12,0,0,0,0,0,0,1
14,2,1,14.0,13.0,15.0,14.0,671,671,671,671,0,0,70,20,70,20,0,0,13,13,0,0,0,0,0,0,1
21,2,1,14.0,14.0,15.0,14.0,699,699,699,699,0,0,50,50,50,50,0,0,13,13,0,0,0,0,0,0,1
29,2,1,15.0,14.0,15.0,14.0,727,783,727,783,0,0,40,150,40,150,0,0,14,13,0,0,0,0,0,0,1
36,2,1,15.0,16.0,15.0,22.0,783,755,783,755,0,0,135,145,135,145,0,0,14,14,0,0,0,0,0,0,1
43,2,1,16.0,16.0,23.0,22.0,783,811,783,811,0,0,70,235,70,235,0,0,15,15,0,0,0,0,0,0,1
50,2,1,17.0,15.0,23.0,22.0,811,783,811,783,0,0,40,30,40,30,0,0,16,15,0,0,0,0,0,0,1
57,2,1,18.0,17.0,23.0,22.0,839,867,839,867,0,0,100,45,100,45,0,0,17,15,0,0,0,0,0,0,1
64,2,1,19.0,18.0,23.0,22.0,867,867,867,867,0,0,145,90,145,90,0,0,18,16,0,0,0,0,0,0,1
71,2,1,19.0,17.0,23.0,22.0,917,895,895,895,22,0,204,170,200,170,4,0,18,17,0,0,0,0,0,0,1
79,2,1,20.0,17.0,23.0,22.0,978,951,867,951,111,0,330,35,310,35,20,0,19,16,0,0,0,0,0,0,1
86,2,1,20.0,18.0,23.0,22.0,950,923,839,923,111,0,37,95,5,95,32,0,19,16,0,0,0,0,0,0,1
93,2,1,20.0,19.0,23.0,22.0,973,895,839,895,134,0,162,145,110,145,52,0,20,18,0,0,150,0,0,0,1
100,2,1,21.0,20.0,23.0,22.0,995,934,839,867,156,67,83,217,15,205,68,12,20,19,0,0,150,0,0,0,1
107,2,1,21.0,20.0,23.0,22.0,995,1057,839,923,156,134,133,348,45,320,88,28,20,19,0,0,150,0,0,0,1
114,2,1,22.0,20.0,23.0,22.0,1023,1023,867,867,156,156,203,368,95,320,108,48,21,20,0,0,150,0,0,0,1
121,2,1,22.0,20.0,23.0,28.0,1079,1051,923,895,156,156,188,493,60,425,128,68,21,20,0,0,150,250,0,0,1
129,2,1,23.0,26.0,23.0,36.0,1158,1135,979,979,179,156,323,228,175,140,148,88,22,20,0,0,150,250,0,0,1
136,2,1,23.0,28.0,23.0,36.0,1230,1113,1007,979,223,134,291,60,140,60,151,0,23,20,0,0,300,250,0,0,1
143,2,1,26.0,30.0,31.0,36.0,1242,1029,951,1007,291,22,78,80,45,80,33,0,23,20,0,100,300,250,0,0,1
150,2,1,27.0,30.0,31.0,36.0,1270,1091,979,1091,291,0,129,215,110,215,19,0,24,22,0,100,300,250,0,0,1
157,2,1,29.0,30.0,46.0,36.0,1264,1147,951,1147,313,0,49,10,40,10,9,0,24,23,125,100,300,250,0,0,1
164,2,1,31.0,31.0,46.0,36.0,1320,1203,1007,1203,313,0,104,110,55,110,49,0,25,23,125,400,300,250,0,0,1
171,2,1,33.0,33.0,46.0,36.0,1264,1259,951,1259,313,0,159,20,70,20,89,0,27,25,125,400,300,250,0,0,1
179,2,1,35.0,36.0,46.0,36.0,1505,1315,1147,1315,358,0,284,30,155,30,129,0,29,25,125,400,300,250,0,0,1
186,2,1,39.0,36.0,46.0,36.0,1505,1427,1147,1427,358,0,119,115,100,115,19,0,30,26,125,400,600,250,0,0,1
193,2,1,40.0,38.0,46.0,44.0,1572,1511,1259,1511,313,0,211,145,160,145,51,0,31,28,300,400,600,250,0,0,1
200,2,1,42.0,43.0,46.0,44.0,1628,1595,1315,1595,313,0,161,80,70,80,91,0,33,28,300,400,600,250,0,0,1
207,2,1,42.0,46.0,46.0,52.0,1684,1623,1371,1623,313,0,221,75,90,75,131,0,33,31,300,550,600,250,0,0,1
214,2,1,44.0,47.0,46.0,52.0,1740,1746,1427,1679,313,67,81,142,60,130,21,12,35,34,600,550,600,250,0,0,1
221,2,1,44.0,48.0,46.0,52.0,1824,1919,1511,1763,313,156,266,322,205,290,61,32,35,34,600,550,600,250,0,0,1
229,2,1,49.0,52.0,54.0,66.0,1869,1891,1511,1735,358,156,431,157,330,105,101,52,37,35,600,700,600,250,0,0,1
236,2,1,51.0,54.0,54.0,66.0,2042,1947,1707,1791,335,156,452,177,315,105,137,72,39,35,600,700,600,250,0,0,1
243,2,1,51.0,55.0,54.0,66.0,2020,1970,1707,1791,313,179,643,357,470,265,173,92,39,37,600,850,600,250,0,0,1
250,2,1,52.0,60.0,54.0,66.0,2020,2026,1707,1847,313,179,173,237,110,125,63,112,41,40,900,850,750,375,0,0,1
257,2,1,53.0,62.5,62.0,66.0,2054,2143,1763,1987,291,156,239,253,140,125,99,128,41,41,900,825,750,500,0,25,1
264,2,1,56.0,63.5,62.0,74.0,2149,2339,1791,2183,358,156,157,378,110,230,47,148,43,44,900,1075,750,500,0,25,1
271,2,1,58.0,64.5,62.0,82.0,2390,2339,1875,2183,515,156,227,393,120,225,107,168,44,45,900,1125,750,500,0,25,1
279,2,1,61.0,68.5,62.0,90.0,2362,2339,1847,2183,515,156,152,478,85,290,67,188,45,47,1150,1125,750,500,0,25,1
286,2,1,62.0,71.5,62.0,90.0,2457,2311,1987,2155,470,156,354,428,235,220,119,208,46,51,1150,1125,750,500,0,25,1
293,2,1,63.0,73.5,70.0,90.0,2373,2558,1791,2379,582,179,234,278,135,150,99,128,47,53,1150,1125,1050,500,0,25,1
300,2,1,68.0,74.5,70.0,90.0,2446,2535,1819,2379,627,156,244,174,165,30,79,144,48,52,1400,1125,1150,500,0,25,1
307,2,1,69.0,72.5,70.0,98.0,2434,2675,1763,2519,671,156,489,179,330,15,159,164,49,52,1400,1125,1150,825,0,25,1
314,2,1,70.0,75.5,70.0,98.0,2468,2619,1819,2463,649,156,740,219,505,35,235,184,51,50,1400,1125,1150,825,0,75,1
321,2,1,78.0,79.5,93.0,106.0,2546,2390,1875,2211,671,179,236,283,175,75,61,208,52,50,1650,1275,1150,825,0,75,1
329,2,1,81.0,82.5,93.0,106.0,2630,2670,1959,2379,671,291,261,313,120,65,141,248,52,54,2150,1275,1150,825,0,75,1
336,2,1,84.0,87.5,93.0,106.0,2670,2843,2043,2463,627,380,43,386,30,90,13,296,55,57,2150,1425,1150,825,0,75,1
343,2,1,90.0,86.5,93.0,106.0,2888,2882,2239,2323,649,559,158,484,65,120,93,364,57,59,2650,1425,1150,825,0,75,1
350,2,1,91.0,85.5,93.0,106.0,3062,3190,2435,2519,627,671,179,650,110,310,69,340,59,61,2650,1425,1150,1200,0,75,1
357,2,1,93.0,87.5,93.0,114.0,3112,3196,2463,2547,649,649,279,431,130,290,149,141,60,59,2900,1575,1300,1200,0,75,1
364,2,1,98.0,101.0,101.0,122.0,3252,3134,2603,2463,649,671,425,100,300,50,125,50,62,59,3150,1550,1300,1200,0,100,1
371,2,1,100.0,107.0,109.0,122.0,3386,3308,2715,2547,671,761,365,211,260,140,105,71,63,59,3150,1700,1300,1200,0,100,1
379,2,1,100.0,113.0,109.0,128.0,3308,3218,2659,2435,649,783,152,286,75,190,77,96,65,59,3150,2200,1300,1200,0,100,1
386,2,1,96.0,115.0,109.0,128.0,3151,3314,2547,2463,604,851,619,441,420,245,199,196,65,59,2900,2500,1300,1200,250,100,1
393,2,1,100.0,125.0,109.0,120.0,3314,3342,2575,2491,739,851,544,171,395,75,149,96,66,59,2900,2950,1300,1800,250,200,1
400,2,1,100.0,125.0,109.0,120.0,3566,3185,2603,2379,963,806,861,259,600,75,261,184,66,59,3150,3250,1300,1800,250,200,1
407,2,1,104.0,125.5,109.0,128.0,3543,3196,2603,2323,940,873,488,492,265,200,223,292,66,59,3025,3175,1450,1950,375,275,1
414,2,1,109.0,128.0,109.0,144.0,3168,3230,2295,2267,873,963,525,528,260,295,265,233,68,59,3025,3650,2000,1950,375,300,1
421,2,1,110.0,137.0,117.0,152.0,2423,3202,1707,2239,716,963,689,318,390,265,299,53,68,59,3775,3800,2000,1950,375,300,1
429,2,1,99.0,147.0,117.0,152.0,2429,3314,1735,2351,694,963,1282,129,745,110,537,19,68,59,3100,4100,1950,2100,1350,400,1
7,0,0,13.0,13.0,15.0,15.0,335,251,335,251,0,0,40,30,40,30,0,0,12,12,0,0,0,0,0,0,0
14,0,0,13.0,14.0,15.0,15.0,643,643,643,643,0,0,15,65,15,65,0,0,13,13,0,0,0,0,0,0,0
21,0,0,14.0,14.0,15.0,15.0,615,643,615,643,0,0,30,40,30,40,0,0,13,13,0,0,0,0,0,0,0
29,0,0,14.0,15.0,15.0,15.0,587,643,587,643,0,0,55,75,55,75,0,0,13,14,0,0,0,0,0,0,0
36,0,0,15.0,15.0,15.0,15.0,587,671,587,671,0,0,130,45,130,45,0,0,14,14,0,0,0,0,0,0,0
43,0,0,14.0,16.0,23.0,23.0,615,643,615,643,0,0,25,115,25,115,0,0,14,15,0,0,0,0,0,0,0
50,0,0,14.0,16.0,23.0,23.0,643,783,643,783,0,0,105,70,105,70,0,0,14,15,0,0,0,0,0,0,0
57,0,0,14.0,17.0,23.0,23.0,615,721,615,699,0,22,30,29,30,25,0,4,14,16,0,0,0,0,0,0,0
64,0,0,15.0,18.0,23.0,23.0,615,833,615,699,0,134,50,79,50,55,0,24,14,17,0,0,0,0,0,0,0
71,0,0,15.0,18.0,23.0,23.0,648,827,559,671,89,156,86,124,70,80,16,44,14,17,0,0,0,0,0,0,0
79,0,0,16.0,19.0,23.0,23.0,687,855,531,699,156,156,171,234,135,170,36,64,15,18,0,0,0,0,0,0,0
86,0,0,18.0,19.0,23.0,23.0,721,917,587,671,134,246,102,345,100,245,2,100,16,18,0,0,150,0,0,0,0
93,0,0,17.0,20.0,23.0,23.0,766,1006,587,671,179,335,27,205,5,115,22,90,16,19,0,0,150,150,0,0,0
100,0,0,17.0,20.0,23.0,23.0,738,956,559,643,179,313,112,71,70,45,42,26,16,19,0,0,150,150,0,0,0
107,0,0,18.0,20.0,23.0,23.0,743,973,587,727,156,246,103,89,95,35,8,54,16,19,0,0,300,150,0,0,0
114,0,0,19.0,20.0,23.0,23.0,771,962,615,783,156,179,53,199,25,125,28,74,16,19,0,0,300,150,0,0,0
121,0,0,20.0,21.0,23.0,23.0,894,1068,671,867,223,201,65,273,55,175,10,98,16,19,100,0,300,150,0,0,0
129,0,0,21.0,22.0,23.0,31.0,1096,1180,783,979,313,201,135,322,85,250,50,72,17,19,100,100,300,150,0,0,0
136,0,0,22.0,23.0,31.0,31.0,1197,1270,839,1091,358,179,120,402,80,310,40,92,17,20,200,100,300,150,0,0,0
143,0,0,23.0,26.0,31.0,31.0,1202,1270,867,1091,335,179,251,407,175,295,76,112,18,21,200,100,300,400,0,0,0
150,0,0,24.0,26.0,31.0,31.0,1264,1135,951,979,313,156,342,532,230,400,112,132,19,21,200,100,300,400,0,0,0
157,0,0,24.0,24.0,31.0,31.0,1264,889,951,755,313,134,192,388,140,290,52,98,19,20,300,0,300,400,0,200,0
164,0,0,26.0,25.0,31.0,31.0,1152,922,839,811,313,111,232,415,190,305,42,110,20,18,300,200,300,400,0,300,0
171,0,0,26.0,25.0,31.0,31.0,1152,945,839,811,313,134,237,636,155,510,82,126,20,19,400,200,300,400,0,300,0
179,0,0,28.0,26.0,31.0,31.0,1258,1057,923,923,335,134,302,322,230,180,72,142,21,19,400,200,300,400,0,300,0
186,0,0,29.0,27.0,31.0,31.0,1169,1062,811,951,358,111,377,254,265,100,112,154,22,19,400,300,300,400,0,350,0
193,0,0,29.0,29.0,39.0,31.0,1174,1062,839,951,335,111,408,245,310,125,98,120,22,19,400,400,300,400,0,350,0
200,0,0,31.0,30.0,39.0,31.0,1432,1225,1119,1091,313,134,474,71,365,35,109,36,23,20,500,400,550,400,0,350,0
207,0,0,31.0,30.0,39.0,39.0,1516,1191,1203,1035,313,156,249,136,100,105,149,31,23,20,500,500,550,400,0,350,0
214,0,0,32.0,31.0,39.0,39.0,1488,1186,1175,895,313,291,369,221,180,150,189,71,24,21,600,500,625,400,0,350,0
221,0,0,34.0,31.0,39.0,39.0,1488,1236,1175,923,313,313,44,361,15,250,29,111,25,21,500,500,625,400,100,350,0
229,0,0,35.0,35.0,39.0,39.0,1454,1292,1119,979,335,313,159,136,90,110,69,26,25,22,600,600,625,475,100,350,0
236,0,0,35.0,35.0,39.0,39.0,1533,1342,1175,1007,358,335,239,281,130,215,109,66,25,22,600,600,625,725,100,350,0
243,0,0,36.0,36.0,39.0,39.0,1488,1426,1175,1091,313,335,111,396,70,290,41,106,26,23,600,600,625,725,100,350,0
250,0,0,37.0,36.0,39.0,54.0,1404,1510,1091,1175,313,335,241,407,160,265,81,142,27,23,850,600,625,800,100,350,0
257,0,0,40.0,40.0,47.0,54.0,1460,1488,1147,1175,313,313,301,253,180,200,121,53,27,24,850,850,625,800,100,350,0
264,0,0,41.0,40.0,47.0,54.0,1516,1516,1203,1203,313,313,421,258,260,215,161,43,28,24,850,850,875,800,100,350,0
271,0,0,43.0,41.0,47.0,54.0,1566,1488,1231,1175,335,313,346,373,245,290,101,83,28,25,850,850,875,800,100,350,0
279,0,0,44.0,41.0,62.0,54.0,1617,1516,1259,1203,358,313,161,553,145,430,16,123,29,25,850,850,875,800,100,350,0
286,0,0,48.0,42.0,62.0,54.0,1706,1734,1371,1399,335,335,307,313,255,150,52,163,30,26,1100,850,875,800,100,350,0
293,0,0,48.0,42.0,62.0,54.0,1779,1729,1399,1371,380,358,515,453,415,250,100,203,30,26,1100,1125,875,800,100,350,0
300,0,0,49.0,47.0,62.0,54.0,1925,1729,1455,1371,470,358,220,213,85,170,135,43,31,27,1300,1125,725,900,250,350,0
307,0,0,50.0,49.0,62.0,54.0,1835,1583,1343,1203,492,380,250,272,105,185,145,87,31,28,1300,1125,725,900,250,350,0
314,0,0,51.0,53.0,62.0,54.0,1891,1656,1399,1231,492,425,120,109,40,95,80,14,32,29,1300,1125,725,900,250,350,0
321,0,0,56.0,54.0,62.0,54.0,2059,1544,1567,1119,492,425,191,160,55,90,136,70,34,30,1575,1225,800,900,250,350,0
329,0,0,55.0,57.0,62.0,62.0,2054,1818,1539,1371,515,447,321,166,200,40,121,126,34,31,1575,1225,800,900,250,350,0
336,0,0,57.0,52.0,62.0,62.0,2255,1891,1763,1399,492,492,567,341,390,155,177,186,36,32,1575,925,800,900,250,650,0
343,0,0,61.0,56.0,70.0,70.0,2149,2003,1679,1511,470,492,438,183,330,145,108,38,37,34,1575,1225,900,900,250,650,0
350,0,0,64.0,58.0,70.0,78.0,2390,2037,1875,1567,515,470,586,339,410,245,176,94,38,34,1575,1600,900,900,250,650,0
357,0,0,64.0,63.0,70.0,93.0,2552,2261,1903,1791,649,470,371,119,115,90,256,29,38,36,1575,1600,900,900,250,650,0
364,0,0,68.0,66.0,70.0,93.0,2457,2429,1763,1959,694,470,645,259,311,170,334,89,40,37,1675,1700,900,900,250,650,0
371,0,0,75.0,67.0,78.0,93.0,2434,2597,1763,2127,671,470,222,369,151,220,71,149,42,38,2250,1700,900,900,250,650,0
379,0,0,75.0,68.0,93.0,93.0,2580,2558,1931,2043,649,515,334,399,199,190,135,209,42,39,2250,1700,900,900,250,650,0
386,0,0,79.0,70.0,93.0,93.0,2306,2558,1679,2043,627,515,329,405,120,190,209,215,44,40,2350,2375,900,900,250,650,0
393,0,0,79.0,76.0,93.0,93.0,2446,2787,1819,2295,627,492,394,141,105,95,289,46,44,42,2350,2375,900,900,250,650,0
400,0,0,81.0,77.0,93.0,93.0,2446,2989,1819,2519,627,470,619,287,250,185,369,102,46,43,2450,2375,900,900,250,650,0
407,0,0,86.0,79.0,93.0,101.0,2630,2961,1959,2491,671,470,369,342,145,180,224,162,48,45,2725,2375,1200,900,250,650,0
414,0,0,87.0,82.0,101.0,101.0,2770,3101,2099,2631,671,470,460,407,160,185,300,222,49,47,3025,2425,1200,900,250,650,0
421,0,0,89.0,86.0,101.0,101.0,2798,3067,2127,2575,671,492,696,357,320,200,376,157,51,49,3025,2700,1450,1200,250,650,0
429,0,0,90.0,88.0,101.0,101.0,3140,3090,2491,2463,649,627,642,667,390,430,252,237,51,50,3025,2750,1450,1200,250,650,0
436,0,0,92.0,90.0,109.0,101.0,2894,3241,2267,2547,627,694,308,793,180,530,128,263,53,51,3025,2750,1450,1450,250,650,0
443,0,0,92.0,93.0,109.0,109.0,2726,3190,2099,2519,627,671,498,899,290,560,208,339,52,52,3300,2650,1650,1450,300,750,0
450,0,0,102.0,93.0,109.0,109.0,2832,2832,2183,2183,649,649,243,805,105,390,138,415,54,53,3350,2700,1650,1450,300,800,0
457,0,0,104.0,96.0,125.0,109.0,2966,2698,2295,2071,671,627,483,896,265,405,218,491,57,55,3350,2875,1650,1450,300,1000,0
464,0,0,108.0,101.0,125.0,109.0,2882,3118,2211,2491,671,627,164,836,95,390,69,446,57,55,3400,2925,1650,1450,300,1000,0
471,0,0,113.0,105.0,125.0,117.0,3050,3224,2379,2575,671,649,190,426,45,100,145,326,57,58,3550,3025,1650,1450,300,1000,0
479,0,0,115.0,107.0,125.0,117.0,3426,3302,2799,2631,627,671,472,667,255,265,217,402,60,59,3900,3075,1875,1450,400,1000,0
486,0,0,114.0,113.0,125.0,117.0,3482,3470,2855,2799,627,671,457,373,160,95,297,278,62,61,3650,2900,1875,1450,700,1275,0
493,0,0,123.0,114.0,141.0,117.0,3314,3532,2687,2883,627,649,257,529,180,275,77,254,63,62,3900,3225,1875,1650,700,1325,0
500,0,0,126.0,115.0,141.0,125.0,3498,3011,2827,2407,671,604,522,741,365,415,157,326,65,62,4175,3325,1875,1650,700,1375,0
507,0,0,125.0,112.0,141.0,117.0,3493,2255,2799,1651,694,604,382,792,245,440,137,352,65,58,4225,3375,1875,1800,900,1775,0
514,0,0,126.0,116.0,141.0,117.0,3498,2031,2827,1427,671,604,254,713,170,410,84,303,68,59,3725,3825,1875,1950,1400,1775,0
521,0,0,134.0,117.0,141.0,117.0,3560,2003,2911,1399,649,604,420,764,260,389,160,375,70,60,4125,3825,1875,1950,1400,1775,0
529,0,0,130.0,117.0,141.0,117.0,3118,2132,2491,1483,627,649,556,511,445,260,111,251,70,61,3925,3925,1875,1950,1716,1775,0
536,0,0,124.0,117.0,126.0,117.0,2502,2328,1875,1679,627,649,736,728,545,405,191,323,65,61,3925,3975,1875,1950,2566,1775,0
543,0,0,126.0,117.0,126.0,109.0,2412,2171,1763,1567,649,604,381,601,110,335,271,266,65,61,3975,4250,1875,2050,2766,1875,0
550,0,0,126.0,116.0,126.0,109.0,2518,2289,1847,1707,671,582,671,838,320,500,351,338,65,61,4450,4200,1875,2050,2766,1925,0
557,0,0,126.0,110.0,126.0,109.0,2686,2205,2015,1623,671,582,842,890,415,480,427,410,65,59,4600,3875,2025,2050,2816,2350,0
564,0,0,126.0,109.0,126.0,109.0,2742,2205,2071,1623,671,582,733,956,355,470,378,486,65,56,4600,3325,2425,2050,2816,3050,0
571,0,0,134.0,109.0,134.0,109.0,2664,2166,2015,1539,649,627,454,967,300,405,154,562,65,56,4650,3325,2425,1900,2816,3200,0
579,0,0,138.0,109.0,142.0,109.0,2586,2166,1959,1539,627,627,560,1234,330,600,230,634,65,58,4650,3325,2425,1900,2816,3200,0
586,0,0,142.0,109.0,142.0,109.0,2642,2362,2015,1735,627,627,120,1411,35,705,85,706,65,58,4850,3525,2425,1900,2816,3300,0
593,0,0,142.0,109.0,142.0,109.0,2574,2647,1903,2043,671,604,120,1569,55,795,65,774,65,58,4850,3525,2425,1800,2866,3400,0
600,0,0,142.0,120.0,158.0,133.0,2518,2401,1847,1819,671,582,330,2111,185,1115,145,996,65,60,5125,3525,2425,1800,2866,3400,0
607,0,0,149.0,121.0,158.0,133.0,2462,2591,1791,1987,671,604,187,1920,95,867,92,1053,65,61,5725,3525,2725,1800,2866,3400,0
614,0,0,148.0,121.0,158.0,133.0,2524,2726,1875,2099,649,627,573,2191,405,1066,168,1125,64,62,5775,3725,2500,1800,3066,3550,0
621,0,0,145.0,118.0,181.0,133.0,2502,2922,1875,2295,627,627,394,2548,275,1351,119,1197,63,62,5400,3575,2500,1800,3541,3700,0
629,0,0,142.0,116.0,181.0,133.0,2418,3034,1791,2407,627,627,104,2600,30,1331,74,1269,63,62,4900,3350,2500,1800,4191,3900,0
636,0,0,146.0,118.0,181.0,149.0,2300,3039,1651,2435,649,604,154,2958,75,1621,79,1337,63,62,5100,3500,2500,1800,4416,3900,0
643,0,0,140.0,115.0,181.0,149.0,2272,2989,1623,2407,649,582,220,3120,65,1711,155,1409,62,61,4775,3400,2500,1800,5041,4250,0
650,0,0,136.0,110.0,181.0,149.0,2222,2367,1595,1763,627,604,512,2976,210,1616,302,1360,62,59,4625,2875,2250,1950,5491,4975,0
657,0,0,133.0,110.0,165.0,141.0,1964,2143,1427,1539,537,604,373,2561,115,1325,258,1236,61,58,4575,2625,2250,1950,5941,5375,0
664,0,0,122.0,98.0,165.0,133.0,1594,2087,1147,1483,447,604,369,2608,55,1300,314,1308,55,57,4225,1925,2250,1800,6691,6675,0
671,0,0,119.0,83.0,165.0,133.0,1622,2076,1175,1427,447,649,465,2649,95,1265,370,1384,56,47,4250,1350,2250,1800,7091,7850,0
679,0,0,119.0,88.0,165.0,133.0,1482,1914,1035,1287,447,627,491,2147,65,920,426,1227,56,47,4400,1775,2250,1800,7091,7900,0
686,0,0,117.0,83.0,165.0,133.0,1617,1975,1147,1371,470,604,702,2370,220,1075,482,1295,56,48,4400,1925,2250,1800,7191,8300,0
693,0,0,99.0,71.0,165.0,133.0,2289,1919,1819,1315,470,604,724,2301,315,930,409,1371,56,48,2775,1325,2500,1800,8866,8900,0
700,0,0,103.0,67.0,165.0,133.0,2580,2037,2155,1455,425,582,447,2298,115,855,332,1443,56,48,2725,650,2500,1800,9191,9825,0
7,1,0,13.0,13.0,14.0,15.0,167,251,167,251,0,0,20,30,20,30,0,0,12,12,0,0,0,0,0,0,0
14,1,0,13.0,14.0,14.0,15.0,671,671,671,671,0,0,20,70,20,70,0,0,13,13,0,0,0,0,0,0,0
21,1,0,14.0,14.0,14.0,15.0,699,727,699,727,0,0,45,40,45,40,0,0,13,13,0,0,0,0,0,0,0
29,1,0,14.0,15.0,14.0,15.0,727,699,727,699,0,0,130,25,130,25,0,0,13,14,0,0,0,0,0,0,0
36,1,0,16.0,15.0,22.0,15.0,727,755,727,755,0,0,135,125,135,125,0,0,14,14,0,0,0,0,0,0,0
43,1,0,16.0,16.0,22.0,23.0,755,755,755,755,0,0,225,50,225,50,0,0,14,15,0,0,0,0,0,0,0
50,1,0,15.0,16.0,22.0,23.0,755,783,755,783,0,0,10,25,10,25,0,0,15,15,0,0,0,0,0,0,0
57,1,0,17.0,17.0,22.0,23.0,783,727,783,727,0,0,15,110,15,110,0,0,15,16,0,0,0,0,0,0,0
64,1,0,18.0,18.0,22.0,23.0,839,811,839,811,0,0,65,155,65,155,0,0,15,17,0,0,0,0,0,0,0
71,1,0,17.0,18.0,22.0,23.0,839,827,839,783,0,44,145,208,145,200,0,8,16,17,0,0,0,0,0,0,0
79,1,0,16.0,19.0,22.0,23.0,839,883,839,727,0,156,45,313,45,285,0,28,16,18,0,0,0,0,0,0,0
86,1,0,18.0,19.0,22.0,23.0,895,967,895,811,0,156,60,433,60,385,0,48,16,18,0,0,0,0,0,0,0
93,1,0,19.0,20.0,22.0,23.0,811,939,811,783,0,156,110,293,110,275,0,18,17,19,0,0,0,150,0,0,0
100,1,0,20.0,20.0,22.0,23.0,939,967,895,811,44,156,183,413,175,375,8,38,18,19,0,0,0,150,0,0,0
107,1,0,20.0,20.0,22.0,23.0,1034,1018,923,839,111,179,309,128,285,70,24,58,19,19,0,0,0,150,0,0,0
114,1,0,21.0,20.0,22.0,23.0,1079,1018,923,839,156,179,384,143,340,65,44,78,20,19,0,0,0,150,0,0,0
121,1,0,21.0,22.0,28.0,23.0,1012,939,923,783,89,156,507,149,455,55,52,94,20,19,0,100,0,150,0,0,0
129,1,0,27.0,23.0,28.0,23.0,1130,1079,1063,923,67,156,245,229,185,115,60,114,21,20,0,100,250,150,0,0,0
136,1,0,28.0,23.0,28.0,31.0,1130,1079,1063,923,67,156,228,119,160,85,68,34,21,20,0,100,250,150,0,0,0
143,1,0,28.0,24.0,28.0,31.0,1135,1163,1091,1007,44,156,362,109,290,105,72,4,21,21,100,150,250,150,0,0,0
150,1,0,27.5,24.0,28.0,31.0,1158,1303,1091,1147,67,156,160,184,80,160,80,24,21,21,75,150,250,150,25,0,0
157,1,0,30.5,25.0,36.0,31.0,1186,1270,1119,1091,67,179,143,324,55,280,88,44,21,22,75,150,250,150,25,0,0
164,1,0,32.0,25.0,36.0,31.0,1214,1410,1147,1231,67,179,136,89,40,25,96,64,23,23,350,50,250,150,50,100,0
171,1,0,32.0,25.0,36.0,31.0,1298,1303,1231,1147,67,156,4,230,0,150,4,80,25,23,350,50,250,150,50,100,0
179,1,0,35.0,26.0,36.0,46.0,1382,1415,1315,1259,67,156,12,200,0,100,12,100,25,24,350,50,250,500,50,100,0
186,1,0,36.0,26.0,44.0,46.0,1466,1303,1399,1147,67,156,140,95,120,75,20,20,25,24,350,50,250,500,50,100,0
193,1,0,40.0,29.0,44.0,46.0,1410,1359,1343,1203,67,156,103,45,75,5,28,40,28,25,350,50,250,500,50,100,0
200,1,0,42.0,32.0,44.0,46.0,1550,1359,1483,1203,67,156,151,65,115,5,36,60,30,26,500,50,250,500,50,100,0
207,1,0,44.0,33.0,44.0,46.0,1606,1438,1539,1259,67,179,89,195,45,115,44,80,33,26,500,50,250,500,50,100,0
214,1,0,44.0,35.0,44.0,46.0,1695,1594,1651,1371,44,223,193,298,145,190,48,108,33,28,500,150,250,500,50,100,0
221,1,0,50.0,41.0,50.0,46.0,1863,1768,1819,1455,44,313,76,98,20,25,56,73,33,28,500,250,250,750,50,100,0
229,1,0,50.0,42.0,66.0,46.0,1914,1818,1847,1483,67,335,184,203,120,115,64,88,33,30,500,250,250,750,50,100,0
236,1,0,57.0,43.0,66.0,46.0,1998,1986,1931,1651,67,335,82,358,10,230,72,128,37,30,650,250,250,750,50,100,0
243,1,0,59.0,49.0,66.0,61.0,1914,2048,1847,1735,67,313,200,209,120,45,80,164,37,32,800,450,250,825,50,100,0
250,1,0,63.0,50.0,74.0,61.0,2054,2098,1987,1763,67,335,98,264,10,60,88,204,42,33,950,450,250,825,50,100,0
257,1,0,67.0,54.0,74.0,61.0,2110,2154,2043,1819,67,335,161,218,65,124,96,94,43,34,1100,675,250,825,50,100,0
264,1,0,69.0,57.0,66.0,61.0,2418,2104,2351,1791,67,313,204,320,100,190,104,130,46,35,1100,875,250,825,150,100,0
271,1,0,72.0,61.0,74.0,69.0,2468,2216,2379,1903,89,313,166,350,50,180,116,170,49,36,1100,875,250,825,150,100,0
279,1,0,72.0,64.0,74.0,69.0,2541,2658,2407,2323,134,335,217,485,85,275,132,210,47,38,1100,925,250,825,150,100,0
286,1,0,76.0,64.0,90.0,69.0,2619,2686,2463,2351,156,335,177,495,25,245,152,250,50,38,1350,925,250,825,150,100,0
293,1,0,76.0,65.0,90.0,69.0,2810,2636,2631,2323,179,313,187,246,15,60,172,186,47,40,1350,1125,250,825,150,100,0
300,1,0,79.5,68.0,106.0,77.0,2619,2686,2463,2351,156,335,288,226,100,0,188,226,49,41,1525,1475,500,825,175,100,0
307,1,0,83.5,70.0,106.0,77.0,2703,2602,2547,2267,156,335,408,446,200,180,208,266,52,42,1525,1475,500,1075,175,100,0
314,1,0,83.5,71.0,106.0,77.0,2843,2552,2687,2239,156,313,763,127,535,125,228,2,55,43,1525,1525,500,1075,175,100,0
321,1,0,87.5,74.0,106.0,85.0,2972,2552,2771,2239,201,313,431,187,325,145,106,42,56,45,1775,1525,750,1075,175,100,0
329,1,0,88.0,72.0,106.0,85.0,3034,2597,2743,2239,291,358,437,211,395,125,42,86,57,46,1750,1300,750,1075,200,325,0
336,1,0,94.0,73.0,114.0,85.0,3134,2412,2799,1987,335,425,512,378,430,240,82,138,57,48,1750,1300,750,1075,200,325,0
343,1,0,92.0,74.0,114.0,93.0,2580,2339,2267,1847,313,492,373,513,255,315,118,198,53,48,2000,1250,750,1225,400,425,0
350,1,0,93.0,77.0,122.0,93.0,1874,2395,1651,1903,223,492,187,553,145,295,42,258,55,49,2050,1250,750,1475,450,475,0
357,1,0,93.5,72.0,122.0,93.0,2194,2367,2015,1875,179,492,267,634,255,370,12,264,57,49,2075,1050,750,1475,475,825,0
364,1,0,96.5,73.0,122.0,93.0,2586,2373,2407,1903,179,470,342,715,310,395,32,320,59,50,2025,1050,750,1475,525,825,0
371,1,0,99.5,82.0,122.0,93.0,2698,2395,2407,1903,291,492,432,235,360,55,72,180,60,52,2025,1150,750,1475,525,825,0
379,1,0,101.5,85.0,122.0,101.0,2894,2563,2491,2071,403,492,634,240,510,100,124,140,63,54,2025,1150,750,1775,525,825,0
386,1,0,98.0,87.0,122.0,101.0,2989,3269,2519,2799,470,470,804,241,620,145,184,96,64,56,1900,1250,750,1775,800,825,0
393,1,0,100.0,92.0,122.0,101.0,3213,3375,2743,2883,470,492,800,168,560,116,240,52,65,58,2000,1350,750,1775,800,825,0
400,1,0,103.0,95.0,130.0,101.0,2927,3342,2435,2715,492,627,990,210,690,97,300,113,69,59,2000,1750,750,1875,800,825,0
407,1,0,108.0,101.0,130.0,109.0,3319,3420,2715,2771,604,649,460,213,380,85,80,128,67,61,2000,1900,1200,1875,800,825,0
414,1,0,113.0,104.0,130.0,109.0,3442,3454,2659,2827,783,627,352,484,305,280,47,204,76,63,2050,2000,1200,2075,800,825,0
421,1,0,115.0,109.0,136.0,117.0,3521,3644,2715,2995,806,649,447,249,300,65,147,184,75,65,2150,2000,1200,2075,800,825,0
429,1,0,116.0,116.0,136.0,125.0,3739,3594,2911,2967,828,627,413,481,395,275,18,206,75,66,2400,2200,1200,2075,800,825,0
436,1,0,123.0,116.0,144.0,125.0,3997,3672,3191,3023,806,649,475,295,365,105,110,190,77,67,2650,2450,1450,2325,800,825,0
443,1,0,125.0,114.0,144.0,125.0,3918,3571,3135,2855,783,716,741,328,535,225,206,103,77,67,3150,2400,1450,2325,800,925,0
450,1,0,123.5,104.0,144.0,141.0,3252,3470,2491,2687,761,783,418,596,345,405,73,191,78,67,2825,1950,1450,2325,1250,1580,0
457,1,0,121.0,109.0,144.0,141.0,3157,3577,2351,2771,806,806,730,371,565,230,165,141,77,67,2700,1700,1575,2325,1525,2090,0
464,1,0,123.0,107.0,152.0,141.0,3414,3605,2631,2799,783,806,677,792,570,555,107,237,78,67,2550,1750,1575,2325,1675,2190,0
471,1,0,130.0,113.0,152.0,141.0,3896,3935,3135,3107,761,828,154,88,105,30,49,58,78,67,2800,2000,1575,2325,1675,2190,0
479,1,0,134.0,117.0,158.0,141.0,4198,4305,3303,3499,895,806,270,379,180,275,90,104,78,67,2950,2200,1575,2325,1675,2190,0
486,1,0,141.0,120.0,158.0,141.0,4182,4282,3219,3499,963,783,230,251,120,155,110,96,79,67,2950,2600,1575,2575,1675,2190,0
493,1,0,143.0,122.0,174.0,141.0,4266,4271,3303,3443,963,828,496,86,345,65,151,21,84,67,3100,2600,1575,2575,1675,2190,0
500,1,0,151.0,127.0,174.0,141.0,4406,4193,3443,3387,963,806,427,517,210,400,217,117,84,67,3750,3050,1575,2650,1675,2190,0
507,1,0,156.0,131.0,174.0,149.0,4400,4198,3415,3415,985,783,483,614,300,530,183,84,83,67,4150,3175,1575,2650,1675,2190,0
514,1,0,164.0,134.0,182.0,164.0,4338,4025,3331,3219,1007,806,309,544,235,535,74,9,83,68,4650,3275,1575,2875,1675,2190,0
521,1,0,169.0,145.0,182.0,164.0,4249,4047,3331,3219,918,828,563,704,385,595,178,109,85,68,4650,3475,1575,3175,1675,2190,0
529,1,0,174.0,146.0,182.0,164.0,3521,4030,2715,3247,806,783,233,607,205,535,28,72,83,69,4900,3400,1575,3325,1925,2490,0
536,1,0,175.0,145.0,182.0,164.0,4131,3717,3191,2911,940,806,458,737,360,565,98,172,81,69,5600,3450,1575,3325,2025,2790,0
543,1,0,178.0,152.0,182.0,164.0,4422,3543,3415,2715,1007,828,478,662,385,490,93,172,81,72,5800,3650,1575,3475,2025,2790,0
550,1,0,179.0,155.0,182.0,164.0,4551,3493,3499,2687,1052,806,455,874,330,610,125,264,82,72,5850,4225,1575,3550,2025,2790,0
557,1,0,182.0,158.0,198.0,164.0,4450,3330,3331,2547,1119,783,248,495,195,385,53,110,82,75,7100,4275,1575,3550,2025,2790,0
564,1,0,186.5,164.0,198.0,172.0,4478,3347,3359,2519,1119,828,269,510,180,350,89,160,82,75,7275,4525,1575,3550,2050,2790,0
571,1,0,190.5,171.0,206.0,172.0,4154,3549,3079,2743,1075,806,262,477,195,300,67,177,82,78,7625,4650,1575,3550,2075,2790,0
579,1,0,199.5,175.0,214.0,188.0,4165,3493,3023,2687,1142,806,277,808,120,560,157,248,82,79,7925,4750,1575,3550,2075,2790,0
586,1,0,190.0,179.0,214.0,188.0,4277,3806,3135,2911,1142,895,797,960,500,650,297,310,74,79,8350,5100,1575,3550,2600,2790,0
593,1,0,191.0,188.0,214.0,188.0,3717,4098,2575,3135,1142,963,605,248,180,80,425,168,63,79,8700,5350,1575,3550,3150,2790,0
600,1,0,187.5,188.0,214.0,188.0,3213,4187,2071,3247,1142,940,736,739,175,455,561,284,71,79,8125,5200,1575,3550,3875,3140,0
607,1,0,183.5,184.0,214.0,196.0,3101,4294,1959,3331,1142,963,597,560,0,260,597,300,77,79,7425,4725,1575,3550,4500,3890,0
614,1,0,179.5,179.0,214.0,196.0,3106,4344,1987,3359,1119,985,779,660,50,240,729,420,78,79,7075,4700,1575,3550,4875,4415,0
621,1,0,183.0,185.0,214.0,196.0,3246,4204,2239,3219,1007,985,869,246,20,160,849,86,76,79,7350,5225,1575,3550,5000,4415,0
629,1,0,187.0,189.0,214.0,196.0,3140,4462,2267,3499,873,963,962,599,55,405,907,194,76,79,7500,5550,1575,3550,5000,4515,0
636,1,0,185.5,188.0,220.0,196.0,3840,4764,2967,3779,873,985,982,654,75,590,907,64,76,79,7275,5550,1575,3550,5675,4765,0
643,1,0,171.0,194.0,220.0,196.0,4019,4854,3191,3891,828,963,1011,630,0,525,1011,105,76,79,6150,5875,1575,3550,7000,4765,0
650,1,0,160.5,140.0,220.0,196.0,4249,4859,3331,3919,918,940,1029,687,60,470,969,217,76,79,5225,3025,1575,3550,7650,6715,0
657,1,0,163.0,143.0,220.0,196.0,4254,4876,3359,3891,895,985,988,67,40,55,948,12,76,79,5350,2625,1575,3550,7725,7365,0
664,1,0,171.0,150.0,220.0,196.0,4322,4271,3471,3443,851,828,1093,50,45,25,1048,25,76,78,5500,2950,1575,3475,7725,7490,0
671,1,0,173.5,147.0,220.0,188.0,4282,3454,3387,2827,895,627,1211,522,155,400,1056,122,76,76,5925,3225,1575,3475,7975,7740,0
679,1,0,171.0,135.0,220.0,188.0,4366,3448,3471,2799,895,649,1229,477,115,325,1114,152,76,61,5900,3500,1575,3475,8525,8765,0
686,1,0,164.5,104.0,220.0,180.0,4294,3045,3443,2575,851,470,1175,541,65,395,1110,146,76,51,5025,2025,1575,3475,9525,11065,0
7,0,0,13.0,13.0,15.0,15.0,377,251,377,251,0,0,45,30,45,30,0,0,12,12,0,0,0,0,0,0,0
14,0,0,14.0,14.0,15.0,15.0,671,671,671,671,0,0,70,70,70,70,0,0,13,13,0,0,0,0,0,0,0
21,0,0,14.0,14.0,15.0,15.0,671,643,671,643,0,0,45,40,45,40,0,0,13,13,0,0,0,0,0,0,0
29,0,0,15.0,15.0,15.0,15.0,643,643,643,643,0,0,5,0,5,0,0,0,14,14,0,0,0,0,0,0,0
36,0,0,15.0,15.0,15.0,15.0,671,699,671,699,0,0,50,40,50,40,0,0,14,14,0,0,0,0,0,0,0
43,0,0,16.0,16.0,23.0,23.0,699,699,699,699,0,0,135,125,135,125,0,0,15,15,0,0,0,0,0,0,0
50,0,0,16.0,16.0,23.0,23.0,755,755,755,755,0,0,20,20,20,20,0,0,15,15,0,0,0,0,0,0,0
57,0,0,17.0,17.0,23.0,23.0,771,777,727,755,44,22,73,34,65,30,8,4,16,16,0,0,0,0,0,0,0
64,0,0,18.0,18.0,23.0,23.0,883,805,727,671,156,134,173,79,145,55,28,24,17,17,0,0,0,0,0,0,0
71,0,0,18.0,18.0,23.0,23.0,883,883,727,727,156,156,229,184,185,140,44,44,17,17,0,0,0,0,0,0,0
79,0,0,19.0,19.0,23.0,23.0,883,855,727,699,156,156,334,234,270,170,64,64,18,18,0,0,0,0,0,0,0
86,0,0,19.0,19.0,23.0,23.0,967,928,811,727,156,201,459,347,375,255,84,92,18,18,0,0,0,0,0,0,0
93,0,0,20.0,20.0,23.0,23.0,967,1012,811,699,156,313,324,367,270,285,54,82,19,19,0,0,150,150,0,0,0
100,0,0,20.0,20.0,23.0,23.0,1023,1057,867,699,156,358,444,82,370,60,74,22,19,19,0,0,150,150,0,0,0
107,0,0,20.0,20.0,23.0,23.0,990,1079,811,811,179,268,164,106,70,60,94,46,19,19,0,0,150,150,0,0,0
114,0,0,20.0,20.0,23.0,23.0,1018,990,839,811,179,179,39,216,25,150,14,66,19,19,0,0,150,150,0,0,0
121,0,0,21.0,21.0,23.0,23.0,939,1018,783,839,156,179,100,286,70,200,30,86,19,19,0,0,150,150,0,0,0
129,0,0,21.0,22.0,23.0,31.0,995,1096,839,895,156,201,80,325,30,265,50,60,19,19,100,100,150,150,0,0,0
136,0,0,22.0,23.0,23.0,31.0,1163,1214,1007,1035,156,179,50,415,30,335,20,80,20,20,100,100,150,150,0,0,0
143,0,0,23.0,23.0,23.0,31.0,1219,1225,1063,1091,156,134,140,161,100,65,40,96,21,20,100,100,150,400,0,0,0
150,0,0,23.0,26.0,31.0,31.0,1051,1303,895,1147,156,156,220,170,160,50,60,120,21,21,100,100,150,400,0,0,0
157,0,0,24.0,26.0,31.0,31.0,1102,1398,923,1175,179,223,365,128,285,30,80,98,22,21,100,100,400,400,0,0,0
164,0,0,24.0,28.0,31.0,31.0,1197,1365,951,1119,246,246,222,140,210,10,12,130,22,22,100,200,400,400,0,0,0
171,0,0,29.0,30.0,31.0,31.0,1292,1359,979,1091,313,268,183,247,135,85,48,162,23,22,100,300,500,400,0,0,0
179,0,0,30.0,31.0,46.0,31.0,1460,1264,1147,951,313,313,94,162,35,60,59,102,24,23,100,300,500,400,0,0,0
186,0,0,30.0,32.0,46.0,39.0,1432,1314,1119,979,313,335,204,277,105,135,99,142,24,24,100,300,500,400,0,0,0
193,0,0,35.0,32.0,46.0,39.0,1460,1376,1147,1063,313,313,189,278,50,175,139,103,25,24,300,500,575,400,0,0,0
200,0,0,35.0,33.0,46.0,39.0,1594,1482,1259,1147,335,335,214,313,35,170,179,143,25,25,300,500,825,400,0,0,0
207,0,0,37.0,33.0,46.0,39.0,1673,1566,1315,1231,358,335,309,443,90,260,219,183,26,25,300,500,825,475,0,0,0
214,0,0,40.0,36.0,46.0,54.0,1768,1432,1455,1119,313,313,161,204,110,85,51,119,27,25,500,500,825,725,0,50,0
221,0,0,39.0,38.0,46.0,54.0,1774,1572,1483,1259,291,313,197,189,110,130,87,59,24,26,500,500,825,725,200,50,0
229,0,0,38.0,38.0,46.0,54.0,1275,1426,1119,1091,156,335,178,219,75,120,103,99,23,25,500,300,825,825,350,300,0
236,0,0,38.0,36.0,46.0,54.0,1471,1471,1315,1091,156,380,254,352,135,205,119,147,23,24,500,200,825,825,350,450,0
243,0,0,40.0,40.0,54.0,54.0,1555,1398,1399,1063,156,335,404,253,265,195,139,58,25,25,600,450,825,825,350,450,0
250,0,0,39.0,42.0,54.0,54.0,1667,1454,1511,1119,156,335,434,178,275,80,159,98,25,24,500,750,825,825,450,500,0
257,0,0,43.0,44.0,54.0,54.0,1594,1589,1371,1231,223,358,116,257,25,140,91,117,27,26,800,750,825,825,450,500,0
264,0,0,45.0,46.0,54.0,54.0,1678,1852,1343,1427,335,425,162,234,60,65,102,169,29,27,800,800,825,825,450,500,0
271,0,0,46.0,50.0,54.0,54.0,1594,1835,1259,1343,335,492,208,94,66,65,142,29,29,28,800,850,825,900,450,500,0
279,0,0,49.0,51.0,54.0,54.0,1522,1807,1119,1315,403,492,337,230,143,145,194,85,31,29,800,1125,825,900,450,500,0
286,0,0,49.0,54.0,54.0,62.0,1617,1813,1147,1343,470,470,188,31,134,15,54,16,31,30,800,1225,825,900,450,500,0
293,0,0,54.0,56.0,54.0,62.0,1813,1550,1343,1147,470,403,73,214,59,150,14,64,33,31,1100,1225,900,900,450,550,0
300,0,0,52.0,57.0,54.0,62.0,1230,782,895,559,335,223,126,218,84,130,42,88,31,30,1100,1325,900,900,650,600,0
307,0,0,54.0,57.0,54.0,62.0,676,922,587,699,89,223,105,251,59,135,46,116,29,30,1100,1275,900,900,750,650,0
314,0,0,54.0,56.0,54.0,70.0,1146,1376,1035,1063,111,313,130,456,64,300,66,156,31,31,1200,1475,900,900,750,750,0
321,0,0,58.0,57.0,62.0,70.0,1466,1902,1063,1455,403,447,240,252,114,40,126,212,31,33,1200,1800,900,900,750,750,0
329,0,0,57.0,60.0,62.0,70.0,1561,2233,1091,1763,470,470,325,177,139,105,186,72,31,33,1150,1800,900,900,800,750,0
336,0,0,62.0,59.0,62.0,70.0,1589,2261,1119,1791,470,470,200,327,79,195,121,132,33,31,1700,1800,900,900,800,900,0
343,0,0,63.0,64.0,85.0,70.0,1639,2227,1147,1735,492,492,395,152,214,85,181,67,35,32,1800,1800,900,900,800,900,0
350,0,0,58.0,62.0,85.0,70.0,1718,2250,1203,1735,515,515,556,312,319,185,237,127,35,33,1400,1650,900,900,1212,1100,0
357,0,0,59.0,62.0,85.0,70.0,1813,2278,1343,1763,470,515,523,358,234,175,289,183,36,34,1400,1600,900,900,1212,1150,0
364,0,0,62.0,62.0,85.0,70.0,1869,2143,1399,1651,470,492,198,499,49,260,149,239,37,36,1300,1350,900,900,1315,1450,0
371,0,0,67.0,64.0,85.0,70.0,2037,2261,1567,1791,470,470,178,725,94,430,84,295,39,36,1575,1975,900,900,1315,1450,0
379,0,0,68.0,66.0,85.0,78.0,2149,2205,1679,1735,470,470,358,460,214,230,144,230,40,38,1575,1975,900,900,1315,1450,0
386,0,0,70.0,68.0,85.0,78.0,2250,2233,1735,1651,515,582,329,421,147,215,182,206,41,38,1675,1975,900,900,1315,1450,0
393,0,0,73.0,70.0,85.0,93.0,2003,2485,1511,1791,492,694,342,486,121,275,221,211,42,39,1675,1975,900,900,1315,1450,0
400,0,0,68.0,70.0,85.0,93.0,1264,2496,951,1847,313,649,420,773,171,490,249,283,42,40,1325,1975,900,900,1765,1450,0
407,0,0,71.0,77.0,93.0,93.0,1527,2636,1259,1987,268,649,442,339,161,180,281,159,45,40,1900,2300,900,900,1765,1450,0
414,0,0,75.0,78.0,93.0,93.0,2227,2642,1735,2015,492,627,449,590,221,355,228,235,46,42,2000,2300,900,900,1765,1450,0
421,0,0,76.0,79.0,93.0,93.0,2334,2726,1707,2099,627,627,445,555,141,240,304,315,48,42,2000,2525,900,1050,1765,1450,0
429,0,0,80.0,82.0,93.0,93.0,2894,2804,2267,2155,627,649,390,520,156,225,234,295,49,44,2000,2525,900,1200,1765,1450,0
436,0,0,82.0,84.0,93.0,93.0,2916,2630,2267,1959,649,671,440,555,226,255,214,300,50,44,2000,2750,900,1200,1765,1450,0
443,0,0,86.0,89.0,93.0,93.0,2798,2714,2127,2043,671,671,225,606,56,355,169,251,50,46,2275,3025,900,1200,1765,1450,0
450,0,0,87.0,93.0,93.0,93.0,2782,2574,2155,1903,627,671,422,72,181,20,241,52,51,47,2325,3075,900,1450,1765,1450,0
457,0,0,89.0,93.0,93.0,93.0,2938,2552,2267,1903,671,649,702,328,381,200,321,128,53,48,2775,3075,900,1450,1765,1450,0
464,0,0,91.0,93.0,93.0,93.0,2955,2810,2351,2183,604,627,550,574,311,370,239,204,52,50,2675,3200,1025,1650,1976,1550,0
471,0,0,92.0,93.0,101.0,93.0,3370,2894,2855,2267,515,627,705,524,406,315,299,209,52,50,2725,2800,1450,1650,1976,1950,0
479,0,0,95.0,94.0,101.0,101.0,3358,2972,2799,2323,559,649,809,639,561,350,248,289,55,52,3000,3250,1450,1650,1976,2050,0
486,0,0,96.0,88.0,101.0,101.0,3297,2966,2715,2295,582,671,808,919,622,550,186,369,55,53,2900,2675,1450,1650,2076,2625,0
493,0,0,91.0,86.0,101.0,101.0,3280,3084,2743,2435,537,649,583,1151,487,710,96,441,55,54,2350,2325,1450,1650,3226,3125,0
500,0,0,92.0,94.0,101.0,109.0,3039,3252,2547,2603,492,649,210,727,169,410,41,317,56,54,2350,2375,1450,1650,3226,3125,0
507,0,0,94.0,99.0,101.0,109.0,2776,3202,2239,2575,537,627,234,288,171,195,63,93,58,56,2400,2650,1450,1650,3226,3125,0
514,0,0,99.0,101.0,101.0,109.0,2787,3090,2295,2463,492,627,374,558,282,385,92,173,61,57,2400,2700,1650,1650,3226,3125,0
521,0,0,97.0,100.0,101.0,117.0,2698,3112,2183,2463,515,649,435,838,381,585,54,253,61,59,3025,2575,1650,1650,3326,3400,0
529,0,0,101.0,101.0,101.0,125.0,3050,3134,2491,2463,559,671,443,733,396,525,47,208,64,60,3075,2350,1650,1650,3376,4175,0
536,0,0,102.0,101.0,109.0,125.0,2983,3050,2267,2379,716,671,260,739,219,455,41,284,65,60,3075,2550,1650,1650,3376,4175,0
543,0,0,105.0,106.0,109.0,125.0,3011,3358,2183,2687,828,671,343,455,226,195,117,260,67,63,3075,2650,1650,1650,3376,4175,0
550,0,0,107.0,108.0,109.0,125.0,3006,3280,2043,2631,963,649,255,351,158,115,97,236,68,63,3125,2700,1650,1650,3376,4175,0
557,0,0,108.0,113.0,109.0,125.0,3084,3342,2099,2715,985,627,359,497,150,185,209,312,70,66,3350,2900,1875,1650,3376,4175,0
564,0,0,113.0,114.0,117.0,125.0,3241,3286,2323,2659,918,627,298,847,210,455,88,392,71,66,3350,3275,1875,1650,3376,4175,0
571,0,0,114.0,117.0,117.0,125.0,3482,3364,2631,2715,851,649,382,932,290,585,92,347,69,69,3450,3525,1975,1650,3476,4225,0
579,0,0,107.0,110.0,140.0,125.0,3442,3504,2659,2743,783,761,634,1273,450,830,184,443,68,69,2425,2825,2125,1650,4690,4925,0
586,0,0,108.0,109.0,148.0,125.0,3487,3644,2771,2883,716,761,658,1462,490,1035,168,427,68,69,2200,2625,2275,1950,4915,5225,0
593,0,0,104.0,110.0,156.0,125.0,3297,3750,2603,2967,694,783,847,1754,595,1235,252,519,68,69,2175,2525,2275,2200,5613,5325,0
600,0,0,111.0,121.0,156.0,125.0,2782,3588,2155,2827,627,761,525,802,430,645,95,157,69,69,2525,2900,2275,2200,5663,5325,0
607,0,0,113.0,123.0,156.0,125.0,2166,3381,1651,2575,515,806,381,561,330,475,51,86,70,70,2525,2950,2050,2200,5888,5325,0
614,0,0,117.0,125.0,156.0,125.0,2373,3398,1903,2435,470,963,682,331,575,225,107,106,70,72,2725,3150,2050,2200,5888,5325,0
621,0,0,120.0,130.0,156.0,140.0,3168,3470,2631,2463,537,1007,595,757,545,535,50,222,70,73,2775,3200,2250,2400,5888,5325,0
629,0,0,127.0,135.0,156.0,156.0,2888,3560,2239,2575,649,985,620,924,490,590,130,334,70,73,3150,3750,2250,2400,5888,5325,0
636,0,0,126.0,136.0,156.0,164.0,2950,3700,2323,2715,627,985,966,1210,760,760,206,450,67,75,3700,4075,2250,2400,6088,5425,0
643,0,0,125.0,123.0,156.0,172.0,2709,3650,2015,2687,694,963,1251,951,965,585,286,366,66,76,3800,2425,2250,2400,6188,7075,0
650,0,0,137.0,131.0,164.0,172.0,2742,3711,2071,2771,671,940,522,657,460,425,62,232,66,76,4000,2725,2250,2400,6263,7075,0
657,0,0,137.0,137.0,164.0,172.0,3090,3734,2463,2771,627,963,599,142,465,65,134,77,66,77,4325,2875,2250,2400,6263,7075,0
664,0,0,139.0,139.0,164.0,172.0,2978,3974,2351,2967,627,1007,344,507,280,310,64,197,68,79,4625,3075,2250,2400,6263,7075,0
671,0,0,144.0,145.0,164.0,172.0,3000,4086,2351,3079,649,1007,249,698,105,385,144,313,68,80,4675,3175,2250,2625,6263,7075,0
679,0,0,151.0,152.0,164.0,172.0,3123,4260,2407,3275,716,985,242,460,135,235,107,225,70,81,5075,3675,2250,2725,6263,7075,0
686,0,0,153.0,158.0,180.0,172.0,3437,4344,2519,3359,918,985,524,551,367,335,157,216,73,83,5275,4050,2250,2825,6263,7075,0
693,0,0,154.0,159.0,180.0,172.0,3504,4266,2519,3303,985,963,704,607,455,275,249,332,73,84,5275,4250,2250,2925,6263,7075,0
700,0,0,163.0,160.0,180.0,180.0,3812,4243,2603,3303,1209,940,816,1103,420,655,396,448,76,84,5375,4300,2500,3275,6263,7075,0
707,0,0,160.0,157.0,180.0,172.0,3958,4299,2659,3359,1299,940,1127,1595,583,1035,544,560,76,82,5075,4700,2500,3050,6563,7675,0
714,0,0,163.0,170.0,180.0,172.0,4042,4238,2743,3387,1299,851,200,785,183,450,17,335,80,82,5600,4700,2500,3050,6563,7725,0
721,0,0,165.0,171.0,180.0,172.0,4182,4019,2883,3191,1299,828,360,1171,283,740,77,431,80,82,5750,5025,2500,3050,6563,7725,0
729,0,0,165.0,172.0,180.0,172.0,4103,4053,2827,3247,1276,806,792,1398,563,875,229,523,80,82,5700,5375,2500,3050,6613,7775,0
736,0,0,162.0,179.0,180.0,196.0,4215,3941,2939,3135,1276,806,867,844,628,350,239,494,80,82,5350,5150,2825,3050,6963,8050,0
743,0,0,162.0,181.0,180.0,196.0,4148,3935,2827,3107,1321,828,723,1218,428,620,295,598,80,82,5450,5525,2825,3050,6963,8050,0
750,0,0,163.0,186.0,180.0,196.0,4098,3823,2799,2995,1299,828,771,73,328,50,443,23,80,82,5775,6075,2825,3050,6963,8050,0
757,0,0,163.0,188.0,180.0,196.0,3851,3834,2575,2939,1276,895,722,426,323,295,399,131,80,82,5775,6275,2825,3050,6963,8050,0
764,0,0,167.0,189.0,180.0,211.0,3846,3946,2547,2939,1299,1007,728,810,323,555,405,255,80,81,6275,6425,3050,3050,6963,8325,0
771,0,0,160.0,167.0,180.0,196.0,3739,4148,2463,2939,1276,1209,1047,1300,503,905,544,395,80,80,5450,5625,3475,3050,8013,9950,0
779,0,0,158.0,170.0,180.0,196.0,3381,4070,2239,2883,1142,1187,830,1578,458,968,372,610,80,79,5350,5850,3475,3050,8113,10412,0
786,0,0,165.0,177.0,180.0,188.0,4030,4075,2911,2911,1119,1164,677,1468,423,968,254,500,79,79,5450,5850,3250,3300,8388,10512,0
793,0,0,170.0,167.0,180.0,188.0,3560,4182,2575,2995,985,1187,965,1727,607,1083,358,644,79,79,5850,5150,3750,3300,8438,11512,0
800,0,0,169.0,163.0,180.0,188.0,2776,4154,2015,2967,761,1187,862,1800,416,1133,446,667,75,79,5575,4775,3750,3300,8963,11987,0
807,0,0,159.0,150.0,180.0,188.0,2894,4282,2155,3051,739,1231,494,1419,206,783,288,636,67,79,5475,3325,3750,3300,9513,13537,0
814,0,0,160.0,160.0,195.0,188.0,2972,3986,2211,2799,761,1187,1204,330,620,8,584,322,68,79,6050,4125,3750,3300,9513,13537,0
821,0,0,161.0,164.0,195.0,188.0,3403,4030,2575,2799,828,1231,871,203,339,33,532,170,69,79,6325,4325,3750,3300,9513,13537,0
829,0,0,170.0,167.0,195.0,188.0,3381,4126,2351,2827,1030,1299,722,230,311,58,411,172,72,81,6325,4575,3750,3375,9513,13537,0
836,0,0,175.0,172.0,195.0,188.0,3650,4406,2351,3107,1299,1299,353,331,205,203,148,128,73,81,6325,4900,4125,3825,9513,13537,0
843,0,0,183.0,180.0,195.0,188.0,3952,4495,2631,3219,1321,1276,306,238,163,108,143,130,77,81,6725,5275,4125,3825,9513,13537,0
850,0,0,183.0,180.0,195.0,188.0,3913,4719,2659,3443,1254,1276,747,559,464,373,283,186,77,81,6725,5650,4125,3825,9513,13537,0
857,0,0,184.0,186.0,195.0,188.0,3963,4792,2687,3471,1276,1321,1209,739,774,518,435,221,81,81,7275,6175,4125,3825,9513,13537,0
864,0,0,184.0,188.0,195.0,188.0,3958,4792,2659,3471,1299,1321,1292,991,698,618,594,373,82,81,7275,6175,4125,3825,9513,13537,0
871,0,0,178.0,187.0,203.0,188.0,4148,4646,2827,3303,1321,1343,1203,1472,853,943,350,529,82,81,7325,6525,4125,3825,9913,13687,0
879,0,0,153.0,160.0,203.0,188.0,4338,4686,2995,3387,1343,1299,1434,1974,1128,1293,306,681,82,81,6175,5025,4125,3825,11663,15587,0
886,0,0,152.0,150.0,203.0,219.0,4422,4434,3079,3135,1343,1299,851,2175,743,1413,108,762,82,81,5575,4350,4125,3975,12263,16737,0
893,0,0,150.0,162.0,203.0,219.0,4355,4154,3079,2855,1276,1299,894,1160,788,713,106,447,82,81,5475,4450,4125,3975,12363,16737,0
900,0,0,150.0,167.0,203.0,219.0,4165,3790,2911,2491,1254,1299,890,1071,728,543,162,528,82,81,5475,4600,4125,3975,12363,16737,0
907,0,0,155.0,168.0,203.0,219.0,4271,3722,2995,2379,1276,1343,835,1466,688,778,147,688,82,81,5825,4800,4125,3975,12363,16737,0
914,0,0,155.0,168.0,203.0,219.0,4182,3532,2939,2211,1243,1321,551,1543,258,803,293,740,82,81,6275,4850,4325,4050,12363,16737,0
921,0,0,165.0,170.0,203.0,219.0,4327,3476,3051,2155,1276,1321,293,1070,98,578,195,492,82,81,7125,5725,4650,4050,12363,16737,0
929,0,0,165.0,169.0,203.0,219.0,4602,3476,3191,2155,1411,1321,863,1415,508,763,355,652,82,81,7125,5675,4650,4050,12363,16837,0
936,0,0,166.0,180.0,218.0,219.0,4870,3745,3415,2379,1455,1366,661,733,482,363,179,370,82,81,7125,6050,4650,4050,12363,16987,0
943,0,0,172.0,184.0,218.0,219.0,4708,4036,3275,2715,1433,1321,244,674,149,298,95,376,82,81,7425,5900,4650,4575,12363,17187,0
950,0,0,172.0,186.0,218.0,219.0,4921,3946,3443,2827,1478,1119,849,1046,574,538,275,508,82,81,7425,6050,4650,4575,12363,17187,0
957,0,0,170.0,177.0,218.0,219.0,4887,4058,3387,2827,1500,1231,925,1523,674,863,251,660,82,81,7375,5400,4550,4675,12563,18037,0
964,0,0,141.0,137.0,218.0,219.0,4557,4047,3079,2771,1478,1276,1428,2004,1009,1188,419,816,82,81,5825,3850,4550,4675,14713,20487,0
971,0,0,148.0,149.0,218.0,234.0,4221,4064,2743,2743,1478,1321,644,1330,524,808,120,522,82,81,5850,4300,4550,4675,15262,20587,0
979,0,0,151.0,154.0,218.0,234.0,3599,4092,2323,2771,1276,1321,739,1171,629,793,110,378,82,81,5850,4600,4550,4675,15262,20587,0
986,0,0,151.0,160.0,233.0,234.0,3353,4047,2211,2771,1142,1276,640,738,544,408,96,330,81,81,5850,4800,4575,4675,16312,20587,0
993,0,0,157.0,162.0,233.0,234.0,3302,4064,2183,2743,1119,1321,934,1134,752,648,182,486,81,81,6300,4950,4825,4675,16199,20587,0
1000,0,0,164.0,164.0,233.0,234.0,3218,3958,2099,2659,1119,1299,845,740,652,398,193,342,81,81,6525,5325,4825,4675,16199,20587,0
1007,0,0,164.0,167.0,233.0,234.0,3392,3515,2183,2239,1209,1276,617,772,372,403,245,369,81,81,6725,6200,4825,4675,16199,20587,0
1014,0,0,164.0,172.0,248.0,234.0,3879,3420,2715,2099,1164,1321,478,603,372,403,106,200,81,81,7525,6600,4825,4675,16199,20587,0
1021,0,0,165.0,176.0,248.0,234.0,4109,3392,2967,2071,1142,1321,920,573,682,363,238,210,81,81,7825,6600,4825,4675,16199,20587,0
1029,0,0,171.0,182.0,248.0,234.0,4271,3599,3107,2323,1164,1276,1174,721,900,363,274,358,81,81,8375,6900,4825,4675,16236,20587,0
1036,0,0,177.0,182.0,248.0,234.0,4299,3706,3135,2407,1164,1299,814,1156,650,638,164,518,81,81,8375,7175,4900,4775,16236,20587,0
1043,0,0,177.0,185.0,248.0,234.0,4316,3812,3107,2491,1209,1321,842,1187,780,713,62,474,81,81,8425,7050,4900,5275,16236,20812,0
1050,0,0,176.0,185.0,248.0,234.0,4338,4182,3107,2883,1231,1299,1018,1689,925,1063,93,626,80,81,8675,7975,4900,5525,16561,20812,0
1057,0,0,170.0,174.0,233.0,234.0,3846,4075,2659,2799,1187,1276,1110,1960,1049,1253,61,707,76,81,8400,7450,4900,5525,18139,21787,0
1064,0,0,180.0,173.0,225.0,249.0,3202,4176,2239,2855,963,1321,1137,1746,964,1233,173,513,76,81,8675,7200,4900,5525,18314,22037,0
1071,0,0,182.0,169.0,225.0,249.0,3185,4008,2267,2687,918,1321,1331,1926,1054,1403,277,523,76,81,8725,6875,4900,5525,18314,22362,0
1079,0,0,183.0,168.0,225.0,249.0,3857,3767,2827,2491,1030,1276,1788,1814,1379,1393,409,421,76,81,9075,6275,4900,5600,18314,22962,0
1086,0,0,190.0,181.0,225.0,249.0,3879,3790,2715,2547,1164,1243,941,1220,784,1053,157,167,76,81,9175,6800,4900,5600,18314,22962,0
1093,0,0,195.0,181.0,225.0,249.0,3857,3711,2603,2547,1254,1164,903,1675,594,1368,309,307,76,81,9775,7025,4900,5600,18314,22962,0
1100,0,0,198.0,187.0,225.0,249.0,4042,3722,2631,2603,1411,1119,619,1033,509,998,110,35,76,81,10175,6850,4900,5600,18314,23187,0
1107,0,0,198.0,187.0,225.0,249.0,4058,3885,2603,2743,1455,1142,1103,953,829,778,274,175,76,81,10225,7550,4900,5600,18314,23187,0
1114,0,0,192.0,178.0,225.0,249.0,4081,3773,2659,2631,1422,1142,1583,1094,1139,983,444,111,76,81,9575,7350,4900,5600,19222,23937,0
1121,0,0,197.0,176.0,225.0,249.0,3935,3834,2603,2715,1332,1119,644,1306,494,1063,150,243,76,81,9750,6750,4900,5600,19322,24537,0
1129,0,0,186.0,144.0,225.0,249.0,3980,3801,2659,2659,1321,1142,770,1776,464,1393,306,383,76,81,9050,5275,4900,5600,20622,27512,0
7,2,0,13.0,13.0,15.0,15.0,293,251,293,251,0,0,35,30,35,30,0,0,12,12,0,0,0,0,0,0,1
14,2,0,14.0,14.0,15.0,15.0,671,671,671,671,0,0,70,70,70,70,0,0,13,13,0,0,0,0,0,0,1
21,2,0,14.0,14.0,15.0,15.0,699,699,699,699,0,0,50,45,50,45,0,0,13,13,0,0,0,0,0,0,1
29,2,0,15.0,15.0,15.0,15.0,699,671,699,671,0,0,85,30,85,30,0,0,14,14,0,0,0,0,0,0,1
36,2,0,15.0,15.0,23.0,15.0,783,755,783,755,0,0,135,130,135,130,0,0,14,14,0,0,0,0,0,0,1
43,2,0,16.0,16.0,23.0,23.0,811,783,811,783,0,0,30,70,30,70,0,0,15,15,0,0,0,0,0,0,1
50,2,0,17.0,16.0,23.0,23.0,867,755,867,755,0,0,10,35,10,35,0,0,16,15,0,0,0,0,0,0,1
57,2,0,18.0,17.0,23.0,23.0,951,727,951,727,0,0,80,5,80,5,0,0,17,16,0,0,0,0,0,0,1
64,2,0,19.0,18.0,23.0,23.0,979,755,979,755,0,0,135,95,135,95,0,0,18,17,0,0,0,0,0,0,1
71,2,0,19.0,18.0,23.0,23.0,973,766,951,699,22,67,254,142,250,130,4,12,18,17,0,0,0,0,0,0,1
79,2,0,20.0,19.0,23.0,23.0,1046,850,979,671,67,179,367,246,355,210,12,36,19,18,0,0,0,0,0,0,1
86,2,0,20.0,19.0,23.0,23.0,1046,934,979,643,67,291,350,362,330,290,20,72,19,18,0,0,150,0,0,0,1
93,2,0,20.0,20.0,23.0,23.0,990,928,923,615,67,313,53,132,25,70,28,62,20,19,0,0,150,150,0,0,1
100,2,0,21.0,20.0,23.0,23.0,1113,1012,979,699,134,313,139,262,95,160,44,102,20,19,0,0,150,150,0,0,1
107,2,0,21.0,20.0,23.0,23.0,1029,1023,895,755,134,268,110,135,50,105,60,30,20,19,0,0,150,150,0,0,1
114,2,0,22.0,21.0,23.0,31.0,1057,1012,923,811,134,201,111,200,35,150,76,50,21,19,0,0,150,150,0,0,1
121,2,0,25.0,21.0,31.0,31.0,1051,990,895,811,156,179,116,170,45,150,71,20,22,19,0,100,300,150,0,0,1
129,2,0,25.0,22.0,31.0,31.0,1130,1303,951,1147,179,156,156,350,115,310,41,40,22,20,0,100,300,150,0,0,1
136,2,0,26.0,22.0,31.0,31.0,1146,1376,923,1175,223,201,144,104,75,40,69,64,23,20,0,100,300,150,0,0,1
143,2,0,28.0,23.0,31.0,31.0,1208,1382,895,1203,313,179,65,209,10,125,55,84,23,21,125,100,300,150,0,0,1
150,2,0,29.0,24.0,39.0,31.0,1202,1326,867,1147,335,179,215,63,120,55,95,8,24,22,125,100,300,400,0,0,1
157,2,0,30.0,26.0,39.0,31.0,1264,1359,951,1091,313,268,161,19,30,0,131,19,25,22,125,100,300,500,0,0,1
164,2,0,30.0,28.0,54.0,31.0,1264,1303,951,1035,313,268,326,71,155,20,171,51,25,23,300,100,300,500,0,0,1
171,2,0,31.0,29.0,54.0,31.0,1292,1404,979,1091,313,313,276,137,65,50,211,87,26,23,300,100,300,500,0,0,1
179,2,0,32.0,32.0,54.0,39.0,1398,1258,1063,923,335,335,296,193,45,95,251,98,26,24,300,200,300,500,0,0,1
186,2,0,34.0,34.0,54.0,39.0,1460,1180,1147,867,313,313,472,239,185,105,287,134,28,25,300,300,300,750,0,0,1
193,2,0,35.0,37.0,54.0,39.0,1488,1348,1175,1035,313,313,293,164,70,90,223,74,29,25,300,300,300,750,0,0,1
200,2,0,36.0,39.0,54.0,39.0,1566,1432,1231,1119,335,313,373,194,110,105,263,89,30,25,300,400,450,750,0,0,1
207,2,0,37.0,42.0,54.0,54.0,1650,1348,1315,1035,335,313,419,269,120,140,299,129,31,26,300,500,450,750,0,0,1
214,2,0,38.0,42.0,54.0,54.0,1684,1449,1371,1091,313,358,630,399,295,230,335,169,32,26,300,500,600,750,0,0,1
221,2,0,45.0,42.0,54.0,54.0,1796,1421,1483,1063,313,358,310,564,85,355,225,209,34,27,650,750,600,750,0,50,1
229,2,0,45.0,44.0,62.0,54.0,1824,1404,1511,1091,313,313,380,491,115,300,265,191,35,27,700,850,850,750,125,50,1
236,2,0,46.0,45.0,62.0,54.0,1846,1656,1511,1343,335,313,505,661,200,430,305,231,36,28,700,850,850,750,125,50,1
243,2,0,47.0,49.0,62.0,54.0,2014,1572,1679,1259,335,313,396,311,205,165,191,146,37,28,700,900,850,900,125,100,1
250,2,0,52.0,50.0,62.0,54.0,2014,1460,1679,1147,335,313,291,131,160,45,131,86,38,29,1050,800,850,900,125,200,1
257,2,0,52.0,50.0,62.0,54.0,1740,1370,1427,1035,313,335,237,344,170,218,67,126,38,29,1050,700,850,900,175,337,1
264,2,0,52.0,50.0,62.0,54.0,1320,1393,1007,1035,313,358,297,359,190,193,107,166,38,29,1050,700,850,900,275,437,1
271,2,0,56.0,50.0,62.0,54.0,1544,1398,1231,1063,313,335,107,190,60,113,47,77,38,29,1050,700,850,900,275,487,1
279,2,0,58.0,56.0,62.0,62.0,2042,1320,1707,1007,335,313,127,240,40,127,87,113,40,30,1400,1075,850,900,275,487,1
286,2,0,61.0,56.0,62.0,62.0,2121,1432,1763,1119,358,313,162,220,85,67,77,153,41,30,1575,1075,850,900,275,487,1
293,2,0,62.0,55.0,62.0,62.0,2182,1516,1847,1203,335,313,168,359,55,166,113,193,42,30,1575,1275,850,900,275,537,1
300,2,0,61.0,60.0,70.0,62.0,1824,1572,1511,1259,313,313,194,69,45,36,149,33,41,31,1575,1375,1100,900,375,537,1
307,2,0,61.0,59.0,70.0,62.0,1460,1729,1147,1371,313,358,369,219,180,146,189,73,41,32,1575,1450,1100,900,425,737,1
314,2,0,65.0,57.0,78.0,62.0,2076,1477,1763,1119,313,358,334,224,105,111,229,113,43,32,1575,1350,1100,900,425,937,1
321,2,0,66.0,61.0,78.0,62.0,2194,1600,1791,1287,403,313,185,101,50,81,135,20,44,33,1575,1350,1100,900,425,937,1
329,2,0,64.0,62.0,78.0,62.0,2255,2216,1763,1903,492,313,454,126,255,66,199,60,44,33,1575,1350,1100,1050,425,937,1
336,2,0,70.0,62.0,70.0,62.0,2373,2272,1791,1959,582,313,217,271,100,171,117,100,44,34,1925,1450,1100,1050,525,937,1
343,2,0,67.0,59.0,70.0,62.0,2429,1768,1847,1455,582,313,355,251,245,111,110,140,43,34,2000,1200,1100,1050,925,1537,1
350,2,0,65.0,56.0,78.0,70.0,2300,1516,1763,1203,537,313,561,246,395,66,166,180,43,35,1825,1225,1200,1050,1150,1787,1
357,2,0,64.0,60.0,78.0,70.0,1796,2093,1259,1735,537,358,664,146,430,51,234,95,43,36,1650,1225,1200,1050,1375,1787,1
364,2,0,66.0,64.0,78.0,70.0,2048,2098,1511,1763,537,335,268,252,70,121,198,131,43,38,1750,1375,1500,1050,1375,1787,1
371,2,0,68.0,66.0,78.0,70.0,2278,2300,1763,1987,515,313,452,133,190,91,262,42,43,38,2100,1375,1500,1050,1375,1787,1
379,2,0,74.0,66.0,78.0,70.0,2250,2412,1735,2099,515,313,220,243,90,161,130,82,43,40,2100,1375,1500,1200,1375,1887,1
386,2,0,74.0,65.0,78.0,70.0,2457,2244,1875,1931,582,313,518,183,320,86,198,97,45,41,2100,975,1500,1200,1375,2287,1
393,2,0,76.0,69.0,78.0,70.0,2350,2356,1791,2043,559,313,592,133,330,121,262,12,45,42,2100,1375,1500,1200,1375,2287,1
400,2,0,78.0,73.0,78.0,78.0,2440,2210,1903,1875,537,335,557,108,285,81,272,27,47,44,2275,1375,1500,1300,1375,2287,1
407,2,0,78.0,74.0,78.0,78.0,2384,2149,1847,1791,537,358,781,83,445,16,336,67,47,43,2275,1475,1500,1425,1375,2337,1
414,2,0,78.0,75.0,78.0,78.0,2440,2076,1903,1763,537,313,414,185,260,86,154,99,47,44,2275,1475,1500,1425,1375,2337,1
421,2,0,80.0,81.0,86.0,86.0,2367,2076,1875,1763,492,313,514,95,300,6,214,89,47,46,2775,1700,1500,1500,1375,2337,1
429,2,0,86.0,81.0,86.0,86.0,2490,2244,1931,1931,559,313,150,130,60,101,90,29,49,46,2775,1975,1500,1600,1375,2337,1
436,2,0,87.0,83.0,102.0,86.0,2518,2418,1847,2015,671,403,340,351,170,266,170,85,49,48,2675,1975,1500,1600,1475,2337,1
443,2,0,93.0,84.0,117.0,86.0,2462,2714,1791,2267,671,447,382,502,340,411,42,91,51,47,2675,2175,1500,1600,1475,2437,1
450,2,0,94.0,85.0,125.0,86.0,2602,2826,1931,2267,671,559,302,595,180,486,122,109,51,48,2975,2175,1500,1600,1475,2437,1
457,2,0,95.0,86.0,125.0,86.0,2535,2994,1931,2323,604,671,490,850,300,661,190,189,54,49,2975,2275,1650,1600,1475,2437,1
464,2,0,98.0,93.0,125.0,94.0,2535,2955,1931,2351,604,604,516,368,250,311,266,57,55,50,3475,2275,1650,1500,1475,2462,1
471,2,0,104.0,93.0,125.0,94.0,2591,2978,1987,2351,604,627,392,328,50,191,342,137,55,50,3475,2275,1650,1500,1475,2462,1
479,2,0,105.0,94.0,125.0,94.0,2658,2916,1987,2267,671,649,672,374,250,261,422,113,56,50,3475,2275,1650,1500,1575,2462,1
486,2,0,103.0,98.0,125.0,102.0,2154,2720,1483,2071,671,649,897,584,395,391,502,193,55,51,3775,2625,1650,1500,1725,2462,1
493,2,0,108.0,101.0,125.0,110.0,2014,2558,1455,1931,559,627,428,446,70,231,358,215,53,51,3775,2375,1750,1600,1875,2712,1
500,2,0,110.0,105.0,125.0,110.0,2261,2462,1791,1791,470,671,659,141,245,96,414,45,55,53,3775,2575,2050,1600,1875,2712,1
507,2,0,111.0,106.0,125.0,110.0,2569,2524,2099,1875,470,649,570,179,200,114,370,65,56,54,3775,2575,2050,1600,1875,2712,1
514,2,0,115.0,111.0,125.0,118.0,2474,2502,1959,1875,515,627,555,461,125,324,430,137,59,55,3600,3075,2200,1600,2050,2762,1
521,2,0,117.0,113.0,125.0,118.0,2619,2468,2015,1819,604,649,526,467,20,254,506,213,59,56,4000,3075,2200,1900,2050,2762,1
529,2,0,117.0,117.0,133.0,118.0,2804,2412,2155,1763,649,649,867,157,285,14,582,143,59,56,4000,3275,2200,1900,2050,2762,1
536,2,0,121.0,118.0,133.0,118.0,3084,2306,2435,1679,649,627,733,338,75,119,658,219,59,58,4200,3525,2200,1900,2050,2762,1
543,2,0,119.0,122.0,141.0,149.0,3034,2485,2407,1791,627,694,1104,523,370,249,734,274,59,58,4525,3675,2200,1900,2225,2812,1
550,2,0,129.0,128.0,149.0,149.0,2944,2686,2295,2015,649,671,599,374,10,74,589,300,59,60,4925,3900,2200,1900,2225,2812,1
557,2,0,127.0,123.0,157.0,149.0,3039,2838,2435,2211,604,627,962,501,305,154,657,347,59,60,4750,3625,2200,1900,2400,3087,1
564,2,0,126.0,127.0,173.0,149.0,2586,2894,2071,2267,515,627,1056,711,335,309,721,402,55,60,5050,3875,2100,2150,2750,3087,1
571,2,0,124.0,137.0,165.0,149.0,2199,3134,1819,2463,380,671,975,391,310,84,665,307,53,59,4850,4200,2250,2150,3150,3137,1
579,2,0,116.0,136.0,165.0,149.0,2177,3140,1819,2491,358,649,1230,377,525,19,705,358,53,59,4650,4100,2250,2150,3700,3237,1
586,2,0,116.0,141.0,165.0,149.0,2160,3174,1847,2547,313,627,1396,463,655,104,741,359,53,60,4650,4450,2250,2150,3700,3237,1
593,2,0,124.0,144.0,149.0,149.0,2210,3414,1875,2743,335,671,646,713,15,274,631,439,53,61,4650,4675,2250,2150,3900,3237,1
600,2,0,124.0,149.0,149.0,149.0,2490,3610,2155,2939,335,671,946,514,275,299,671,215,55,62,5175,5125,2250,2150,3900,3237,1
607,2,0,129.0,149.0,149.0,149.0,2563,3258,2071,2631,492,627,869,336,280,149,589,187,55,64,5275,5375,2250,2150,3900,3237,1
614,2,0,129.0,155.0,157.0,173.0,2776,3258,2127,2631,649,627,1189,336,520,144,669,192,55,64,5275,5500,2250,2375,3900,3237,1
621,2,0,132.0,159.0,149.0,173.0,2804,3364,2155,2715,649,649,1081,421,490,174,591,247,55,64,5275,5500,2250,2475,4000,3237,1
629,2,0,138.0,161.0,149.0,181.0,2832,3370,2183,2743,649,627,851,337,305,189,546,148,57,64,5575,5900,2400,2475,4150,3237,1
636,2,0,140.0,167.0,149.0,197.0,2776,3437,2127,2743,649,694,1092,231,470,149,622,82,58,64,5825,6375,2400,2475,4150,3237,1
643,2,0,148.0,169.0,149.0,197.0,2832,3297,2183,2491,649,806,922,411,220,304,702,107,59,64,6225,6475,2400,2475,4150,3237,1
650,2,0,148.0,173.0,149.0,197.0,2742,3218,2183,2435,559,783,711,368,95,219,616,149,61,64,6225,6475,2400,2475,4150,3237,1
657,2,0,149.0,171.0,149.0,197.0,2714,2966,2155,2183,559,783,1028,598,340,349,688,249,61,61,6425,6475,2650,2475,4250,3512,1
664,2,0,139.0,164.0,172.0,197.0,2866,2681,2239,1875,627,806,1093,770,475,454,618,316,61,55,5775,7100,2650,2475,4900,3662,1
671,2,0,147.0,172.0,180.0,197.0,3056,2266,2407,1483,649,783,764,361,170,249,594,112,60,56,5525,7575,2650,2475,5200,3662,1
679,2,0,139.0,168.0,180.0,197.0,3056,2860,2519,2099,537,761,984,703,330,499,654,204,58,56,5875,7375,2650,2725,5750,3862,1
686,2,0,141.0,167.0,180.0,197.0,3090,2854,2575,2071,515,783,840,655,280,409,560,246,58,58,6075,6975,2800,2725,5850,4387,1
693,2,0,144.0,171.0,180.0,197.0,3146,2849,2631,2043,515,806,645,332,125,244,520,88,59,58,6075,6975,2800,2725,5850,4387,1
700,2,0,147.0,174.0,180.0,197.0,3045,2698,2575,1847,470,851,872,466,300,274,572,192,63,58,6075,7575,2800,2725,5850,4387,1
707,2,0,148.0,180.0,180.0,205.0,3157,2821,2687,1903,470,918,1187,193,555,89,632,104,64,58,6075,7975,2800,2725,5850,4387,1
714,2,0,155.0,169.0,188.0,205.0,3235,2978,2743,2015,492,963,1177,544,485,324,692,220,65,58,6775,7225,2950,2825,6000,5312,1
721,2,0,158.0,169.0,180.0,205.0,3347,2927,2855,1987,492,940,1377,637,700,359,677,278,66,58,6775,7525,2950,2825,6100,5362,1
729,2,0,160.0,177.0,180.0,205.0,3409,3090,2939,2127,470,963,1588,568,855,324,733,244,66,58,6875,7950,2950,2825,6100,5362,1
736,2,0,150.0,174.0,180.0,205.0,3482,3112,2967,2127,515,985,1993,813,1200,474,793,339,68,58,6025,7800,2800,2825,7100,5637,1
743,2,0,156.0,161.0,172.0,205.0,3157,3062,2687,2099,470,963,1415,914,820,509,595,405,67,58,6250,7125,2700,2825,7875,6362,1
750,2,0,128.0,158.0,149.0,205.0,2541,3000,2071,2015,470,985,1305,746,650,404,655,342,55,58,5100,6675,2700,2825,10225,7062,1
757,2,0,130.0,162.0,149.0,205.0,2373,3022,1903,2015,470,1007,980,746,265,334,715,412,55,58,5200,7250,2700,2825,10225,7062,1
764,2,0,130.0,162.0,149.0,205.0,2423,2978,1931,2015,492,963,1070,718,395,169,675,549,55,58,5500,7125,2700,2825,10225,7187,1
771,2,0,138.0,164.0,149.0,205.0,2395,3011,1903,2071,492,940,655,1089,120,424,535,665,55,58,5500,7375,2700,2825,10325,7187,1
779,2,0,123.0,150.0,157.0,205.0,2530,2972,2015,1987,515,985,946,1125,355,394,591,731,49,58,5600,6400,2700,3025,11225,8362,1
786,2,0,119.0,148.0,157.0,205.0,2362,3028,1847,2043,515,985,736,1150,235,349,501,801,47,58,5100,6350,2700,3025,11825,8487,1
793,2,0,119.0,151.0,157.0,205.0,2149,2978,1679,2015,470,963,878,727,325,189,553,538,47,58,5300,6475,2850,3025,11825,8487,1
800,2,0,107.0,144.0,149.0,205.0,2149,3056,1679,2071,470,985,743,907,130,274,613,633,47,58,3800,6125,2850,3025,13575,9112,1
807,2,0,101.0,144.0,149.0,205.0,2121,2994,1651,1987,470,1007,748,1133,200,409,548,724,45,58,4075,6175,2850,3025,14050,9112,1
7,2,0,13.0,13.0,15.0,15.0,209,167,209,167,0,0,25,20,25,20,0,0,12,12,0,0,0,0,0,0,1
14,2,0,14.0,14.0,15.0,15.0,671,671,671,671,0,0,70,70,70,70,0,0,13,13,0,0,0,0,0,0,1
21,2,0,14.0,14.0,15.0,15.0,727,727,727,727,0,0,45,45,45,45,0,0,13,13,0,0,0,0,0,0,1
29,2,0,15.0,14.0,15.0,15.0,755,699,755,699,0,0,30,120,30,120,0,0,14,14,0,0,0,0,0,0,1
36,2,0,15.0,14.0,15.0,15.0,783,727,783,727,0,0,135,220,135,220,0,0,14,14,0,0,0,0,0,0,1
43,2,0,16.0,14.0,23.0,23.0,755,727,755,727,0,0,70,305,70,305,0,0,15,14,0,0,0,0,0,0,1
50,2,0,17.0,14.0,23.0,23.0,783,727,783,727,0,0,40,230,40,230,0,0,16,14,0,0,0,0,0,0,1
57,2,0,18.0,14.0,23.0,23.0,783,699,783,699,0,0,85,315,85,315,0,0,17,14,0,0,0,0,0,0,1
64,2,0,19.0,14.0,23.0,23.0,895,699,895,699,0,0,145,405,145,405,0,0,18,14,0,0,0,0,0,0,1
71,2,0,19.0,14.0,23.0,23.0,917,699,895,699,22,0,159,80,155,80,4,0,18,14,0,0,0,0,0,0,1
79,2,0,20.0,14.0,23.0,23.0,984,671,895,671,89,0,276,160,260,160,16,0,19,14,0,0,0,0,0,0,1
86,2,0,21.0,14.0,23.0,23.0,1001,671,867,671,134,0,247,245,215,245,32,0,20,14,0,0,150,0,0,0,1
93,2,0,21.0,14.0,23.0,23.0,1001,671,867,671,134,0,368,225,320,225,48,0,21,14,0,0,150,0,0,0,1
100,2,0,21.0,15.0,23.0,23.0,1051,671,895,671,156,0,108,30,40,30,68,0,21,14,0,0,150,150,0,0,1
107,2,0,21.0,15.0,23.0,23.0,1051,643,895,643,156,0,119,95,35,95,84,0,21,14,0,0,150,150,0,0,1
114,2,0,22.0,15.0,23.0,23.0,1023,615,867,615,156,0,129,100,25,100,104,0,21,14,0,50,150,150,0,0,1
121,2,0,22.0,16.0,23.0,31.0,1051,531,895,531,156,0,209,110,85,110,124,0,21,14,0,50,300,150,0,0,1
129,2,0,25.0,16.0,31.0,31.0,1051,620,895,531,156,89,209,141,90,125,119,16,22,14,0,50,300,150,0,0,1
136,2,0,25.0,17.0,31.0,31.0,1180,687,979,531,201,156,307,216,160,180,147,36,22,15,0,50,300,150,0,0,1
143,2,0,26.0,18.0,31.0,46.0,1186,715,895,447,291,268,139,166,110,140,29,26,23,15,0,50,300,150,0,0,1
150,2,0,29.0,20.0,31.0,46.0,1264,900,951,587,313,313,110,226,70,160,40,66,24,16,125,50,300,150,0,0,1
157,2,0,29.0,21.0,31.0,46.0,1236,1012,923,699,313,313,106,317,80,215,26,102,24,18,125,50,300,150,0,0,1
164,2,0,30.0,22.0,31.0,46.0,1208,1090,895,755,313,335,246,397,180,255,66,142,25,18,125,50,300,150,0,0,1
171,2,0,31.0,23.0,46.0,46.0,1264,1096,951,783,313,313,311,473,205,295,106,178,25,20,125,150,300,150,0,0,1
179,2,0,32.0,24.0,46.0,46.0,1426,1152,1091,839,335,313,481,503,335,285,146,218,26,20,250,150,300,150,0,0,1
186,2,0,36.0,26.0,46.0,46.0,1314,1074,979,783,335,291,131,539,95,285,36,254,27,22,250,150,600,150,0,0,1
193,2,0,37.0,27.0,46.0,46.0,1454,1404,1119,1091,335,313,112,679,40,385,72,294,28,23,250,150,600,150,0,0,1
200,2,0,39.0,28.0,46.0,46.0,1510,1561,1175,1203,335,358,207,558,95,320,112,238,30,24,250,150,600,150,0,0,1
207,2,0,39.0,29.0,46.0,46.0,1572,1550,1259,1147,313,403,278,691,130,405,148,286,30,25,250,200,600,150,0,0,1
214,2,0,44.0,29.0,46.0,46.0,1600,1594,1287,1147,313,447,78,867,40,525,38,342,32,26,550,200,600,150,0,0,1
221,2,0,44.0,29.0,46.0,46.0,1684,1701,1371,1231,313,470,138,1054,60,660,78,394,32,26,550,200,600,150,0,0,1
229,2,0,46.0,30.0,46.0,46.0,1790,1645,1455,1175,335,470,298,1106,180,660,118,446,34,26,550,200,600,150,0,0,1
236,2,0,46.0,32.0,46.0,46.0,1813,1650,1455,1203,358,447,318,1192,160,690,158,502,35,26,550,200,750,150,0,0,1
243,2,0,48.0,33.0,54.0,46.0,1902,1572,1567,1147,335,425,339,1219,295,665,44,554,36,27,550,200,900,150,0,0,1
250,2,0,51.0,34.0,62.0,46.0,1908,1382,1595,979,313,403,410,1086,330,580,80,506,36,28,850,250,900,400,0,0,1
257,2,0,58.0,35.0,62.0,46.0,2020,1359,1707,867,313,492,285,1215,240,645,45,570,38,29,850,250,900,400,0,0,1
264,2,0,58.0,36.0,62.0,54.0,2104,1572,1791,1035,313,537,525,1355,440,725,85,630,39,30,1225,250,900,400,0,0,1
271,2,0,58.0,35.0,62.0,54.0,2160,1835,1847,1231,313,604,385,1511,260,805,125,706,39,30,1225,200,900,400,0,100,1
279,2,0,66.0,31.0,70.0,54.0,2238,1650,1903,1091,335,559,120,1459,30,689,90,770,39,27,1525,0,900,400,0,501,1
7,1,0,13.0,13.0,14.0,15.0,293,293,293,293,0,0,35,35,35,35,0,0,12,12,0,0,0,0,0,0,0
14,1,0,13.0,14.0,14.0,15.0,643,671,643,671,0,0,15,70,15,70,0,0,13,13,0,0,0,0,0,0,0
21,1,0,14.0,14.0,14.0,15.0,671,671,671,671,0,0,45,45,45,45,0,0,13,13,0,0,0,0,0,0,0
29,1,0,14.0,15.0,14.0,15.0,755,671,755,671,0,0,155,80,155,80,0,0,13,14,0,0,0,0,0,0,0
36,1,0,16.0,15.0,22.0,15.0,755,727,755,727,0,0,145,130,145,130,0,0,14,14,0,0,0,0,0,0,0
43,1,0,16.0,16.0,22.0,23.0,839,755,839,755,0,0,235,60,235,60,0,0,14,15,0,0,0,0,0,0,0
50,1,0,15.0,16.0,22.0,23.0,839,811,839,811,0,0,40,35,40,35,0,0,15,15,0,0,0,0,0,0,0
57,1,0,17.0,17.0,22.0,23.0,839,755,839,755,0,0,40,130,40,130,0,0,15,16,0,0,0,0,0,0,0
64,1,0,18.0,18.0,22.0,23.0,923,839,923,839,0,0,90,170,90,170,0,0,16,17,0,0,0,0,0,0,0
71,1,0,17.0,18.0,22.0,23.0,951,827,951,783,0,44,175,273,175,265,0,8,17,17,0,0,0,0,0,0,0
79,1,0,17.0,19.0,22.0,23.0,979,911,979,755,0,156,40,338,40,310,0,28,16,18,0,0,0,0,0,0,0
86,1,0,18.0,19.0,22.0,23.0,979,995,979,839,0,156,100,453,100,405,0,48,16,18,0,0,0,0,0,0,0
93,1,0,19.0,20.0,22.0,23.0,951,995,951,839,0,156,150,318,150,300,0,18,18,19,0,0,0,150,0,0,0
100,1,0,20.0,20.0,22.0,23.0,990,1051,923,895,67,156,227,443,215,405,12,38,18,19,0,0,0,150,0,0,0
107,1,0,20.0,20.0,22.0,23.0,1057,1074,923,895,134,179,343,163,315,105,28,58,19,19,0,0,0,150,0,0,0
114,1,0,21.0,21.0,22.0,23.0,1051,995,895,839,156,156,428,124,380,50,48,74,20,19,0,0,0,150,0,0,0
121,1,0,25.0,22.0,28.0,23.0,1012,967,923,811,89,156,237,184,185,90,52,94,20,19,0,100,250,150,0,0,0
129,1,0,25.0,23.0,28.0,23.0,1046,1135,979,979,67,156,370,279,310,165,60,114,21,20,0,100,250,150,0,0,0
136,1,0,28.0,23.0,28.0,31.0,1074,1163,1007,1007,67,156,263,179,195,145,68,34,21,20,0,100,250,150,0,0,0
143,1,0,29.0,24.0,28.0,31.0,1130,1303,1063,1147,67,156,340,199,264,195,76,4,23,21,0,150,250,150,0,0,0
150,1,0,28.0,25.0,36.0,31.0,1102,1298,1035,1119,67,179,183,294,99,270,84,24,22,22,50,150,250,150,0,0,0
157,1,0,30.0,25.0,36.0,31.0,1219,1354,1175,1175,44,179,227,449,139,405,88,44,22,22,350,150,250,150,0,0,0
164,1,0,32.0,26.0,36.0,31.0,1303,1303,1259,1147,44,156,245,145,149,85,96,60,23,23,400,150,250,150,0,0,0
171,1,0,33.0,26.0,36.0,31.0,1298,1275,1231,1119,67,156,38,300,34,220,4,80,24,23,400,150,250,150,0,0,0
179,1,0,36.0,27.0,36.0,46.0,1494,1387,1427,1231,67,156,71,270,59,170,12,100,24,24,400,150,250,500,0,0,0
186,1,0,37.0,27.0,44.0,46.0,1382,1275,1315,1119,67,156,179,90,159,70,20,20,25,24,400,150,250,500,0,0,0
193,1,0,41.0,28.0,44.0,46.0,1578,1331,1511,1175,67,156,172,210,144,170,28,40,28,25,400,150,250,500,0,0,0
200,1,0,43.0,34.0,44.0,46.0,1527,1522,1483,1343,44,179,91,40,59,5,32,35,30,26,550,150,250,500,0,0,0
207,1,0,44.0,34.0,44.0,46.0,1690,1522,1623,1343,67,179,249,105,209,50,40,55,33,26,550,150,250,500,0,0,0
214,1,0,44.0,36.0,44.0,46.0,1718,1891,1651,1623,67,268,207,146,159,55,48,91,34,28,550,150,250,575,0,0,0
221,1,0,51.0,40.0,58.0,46.0,1858,1964,1791,1651,67,313,125,367,69,240,56,127,34,28,550,350,250,825,0,0,0
229,1,0,56.0,46.0,58.0,46.0,1942,2132,1875,1819,67,313,118,202,54,135,64,67,34,30,550,350,250,825,0,0,0
236,1,0,59.0,46.0,66.0,61.0,1975,2216,1931,1903,44,313,97,297,29,190,68,107,37,30,700,350,250,825,0,0,0
243,1,0,61.0,50.0,66.0,61.0,2087,2317,2043,1959,44,358,145,147,69,100,76,47,43,32,700,600,250,825,0,0,0
250,1,0,63.0,52.0,66.0,61.0,2194,2238,2127,1903,67,335,148,108,64,50,84,58,45,32,700,600,250,825,0,0,0
257,1,0,69.0,54.0,74.0,61.0,2278,2244,2211,1931,67,313,226,264,134,170,92,94,45,34,1100,600,250,825,0,0,0
264,1,0,74.0,57.0,74.0,61.0,2446,2188,2379,1875,67,313,129,69,29,35,100,34,47,36,1100,700,250,825,31,0,0
271,1,0,74.0,65.0,74.0,69.0,2507,2440,2463,2127,44,313,323,179,219,105,104,74,51,36,1100,1050,250,900,31,0,0
279,1,0,74.0,68.0,74.0,69.0,2630,2798,2519,2463,111,335,273,279,149,165,124,114,52,39,1100,1050,250,900,31,0,0
286,1,0,74.0,68.0,82.0,69.0,2731,2860,2575,2547,156,313,233,280,89,230,144,50,49,40,1100,1050,250,900,31,0,0
293,1,0,76.0,68.0,90.0,69.0,2759,2798,2603,2463,156,335,193,190,29,150,164,40,52,42,1250,1250,250,900,31,0,0
300,1,0,82.0,69.0,98.0,69.0,2619,2742,2463,2407,156,335,253,350,69,270,184,80,51,43,1400,1250,375,900,31,0,0
307,1,0,86.0,71.0,98.0,85.0,2821,2664,2575,2351,246,313,344,176,124,60,220,116,52,43,1500,1250,750,900,31,0,0
314,1,0,85.0,71.0,98.0,85.0,2798,2602,2463,2267,335,335,519,476,259,320,260,156,58,45,1500,1500,875,900,131,0,0
321,1,0,89.0,75.0,98.0,85.0,2826,2692,2491,2379,335,313,144,392,94,250,50,142,60,45,1500,1550,1000,900,131,0,0
329,1,0,90.0,76.0,106.0,93.0,3000,2580,2687,2267,313,313,380,372,294,190,86,182,60,48,1550,1550,1000,1150,131,0,0
336,1,0,91.0,77.0,106.0,93.0,3174,2513,2771,2155,403,358,152,110,114,80,38,30,62,48,1800,1550,1000,1250,131,0,0
343,1,0,92.0,81.0,114.0,93.0,3045,3022,2575,2463,470,559,108,167,64,115,44,52,61,50,1800,1600,1000,1550,131,0,0
350,1,0,95.0,82.0,114.0,101.0,3179,3140,2687,2491,492,649,203,333,99,205,104,128,62,50,1800,1600,1000,1550,131,0,0
357,1,0,97.0,87.0,114.0,101.0,3263,3252,2771,2603,492,649,384,464,224,260,160,204,66,52,1800,1600,1000,1550,131,0,0
364,1,0,98.0,91.0,122.0,101.0,3039,3302,2547,2631,492,671,604,654,384,370,220,284,66,54,1800,1700,1000,1550,231,0,0
371,1,0,102.0,97.0,122.0,101.0,2849,3364,2379,2715,470,649,640,510,364,350,276,160,67,55,1800,1750,1000,1550,331,0,0
379,1,0,105.0,104.0,130.0,109.0,3347,3482,2743,2855,604,627,795,726,439,490,356,236,71,58,1800,1950,1000,1550,331,0,0
386,1,0,106.0,105.0,130.0,109.0,3655,3442,2827,2771,828,671,1090,446,634,330,456,116,75,59,1800,1950,1200,1950,331,0,0
393,1,0,107.0,109.0,130.0,109.0,3745,3336,2939,2687,806,649,1327,382,829,340,498,42,74,61,1950,2100,1450,1950,381,0,0
400,1,0,113.0,109.0,138.0,109.0,3577,3112,2771,2463,806,649,633,488,439,370,194,118,74,63,2000,2600,1450,1950,381,0,0
407,1,0,116.0,116.0,146.0,117.0,3745,3140,2939,2491,806,649,929,758,639,560,290,198,74,63,2200,2600,1450,1950,381,0,0
414,1,0,121.0,117.0,146.0,117.0,3857,3336,3051,2687,806,649,944,224,604,75,340,149,74,63,3000,2750,1450,1950,431,0,0
421,1,0,122.0,125.0,152.0,125.0,3750,3286,2967,2547,783,739,1240,59,804,19,436,40,76,65,3000,2900,1450,1950,431,0,0
429,1,0,128.0,125.0,160.0,125.0,3963,3566,3135,2827,828,739,1415,307,879,212,536,95,76,66,3350,3000,1450,2150,431,0,0
436,1,0,132.0,132.0,168.0,133.0,4025,3560,3219,2799,806,761,602,359,449,180,153,179,75,68,3400,3000,1450,2400,431,0,0
443,1,0,131.0,133.0,168.0,133.0,4137,3560,3331,2799,806,761,828,594,679,352,149,242,73,68,3550,3100,1450,2400,431,0,0
450,1,0,139.5,133.0,176.0,133.0,3773,3694,3079,2911,694,783,778,982,549,656,229,326,74,69,3825,3500,1450,2400,506,0,0
457,1,0,142.5,141.0,176.0,141.0,4075,3795,3359,2967,716,828,1016,737,699,536,317,201,74,69,3925,3650,1450,2475,506,200,0
464,1,0,147.5,145.0,176.0,149.0,4014,3795,3275,2967,739,828,818,854,409,686,409,168,78,69,4175,3650,1450,2725,506,200,0
471,1,0,151.5,146.0,176.0,149.0,4159,3890,3331,2995,828,895,1233,1176,824,896,409,280,81,69,4175,3700,1950,2725,506,300,0
479,1,0,154.0,148.0,184.0,149.0,4288,4053,3415,3135,873,918,1605,1533,1084,1141,521,392,83,69,4150,3900,1950,2725,531,350,0
486,1,0,160.5,143.0,184.0,164.0,4210,3823,3359,2883,851,940,1402,1779,889,1271,513,508,81,69,3875,3900,2075,2725,731,800,0
493,1,0,159.0,148.0,184.0,164.0,4389,3678,3583,2715,806,963,1528,576,1069,481,459,95,81,70,3900,3950,2075,2725,756,1150,0
500,1,0,158.5,142.0,184.0,164.0,4473,3655,3667,2715,806,940,1919,954,1364,751,555,203,81,70,3825,3500,2075,2725,981,1600,0
507,1,0,157.5,147.0,184.0,164.0,4333,3689,3527,2771,806,918,1754,832,1249,721,505,111,81,71,4725,3700,2075,2725,1006,1750,0
514,1,0,161.5,147.0,192.0,164.0,4501,3599,3695,2659,806,940,1545,1003,1094,776,451,227,80,71,4525,3700,2075,2725,1206,1900,0
521,1,0,160.5,153.0,192.0,180.0,4417,3571,3611,2631,806,940,1686,1125,1239,836,447,289,79,74,4675,4075,2075,2725,931,1900,0
529,1,0,168.5,159.0,192.0,180.0,4226,3644,3331,2659,895,985,1128,645,944,511,184,134,77,74,5425,4125,2075,2725,981,1900,0
536,1,0,172.5,164.0,200.0,180.0,4137,3650,3107,2687,1030,963,1113,936,959,686,154,250,79,76,5425,4725,2075,2725,981,1900,0
543,1,0,176.5,176.0,192.0,180.0,4165,3896,3135,2911,1030,985,1233,572,959,456,274,116,76,77,5475,4975,2075,2725,1231,1900,0
550,1,0,181.5,170.0,192.0,188.0,3941,3896,3135,2911,806,985,1449,647,1079,511,370,136,76,79,6375,4525,2075,2725,1231,2450,0
557,1,0,179.0,167.0,184.0,188.0,4137,4008,3331,3023,806,985,1634,694,1214,571,420,123,83,81,5750,4500,2075,2725,1706,2850,0
564,1,0,179.0,169.0,184.0,188.0,4030,4086,3135,3079,895,1007,1406,1104,1074,861,332,243,83,81,5500,4850,2075,2725,2206,2850,0
571,1,0,178.0,167.0,176.0,196.0,4254,4103,3135,3163,1119,940,1517,1347,1099,1046,418,301,87,81,5350,4900,2075,2725,2456,3200,0
579,1,0,175.5,173.0,176.0,196.0,4495,4126,3331,3163,1164,963,1899,1287,1349,1066,550,221,87,81,5025,5000,2425,2725,2881,3250,0
586,1,0,149.5,141.0,192.0,196.0,4445,4075,3303,3135,1142,940,2120,1788,1434,1451,686,337,87,81,3225,3250,2425,2725,4456,5082,0
593,1,0,138.5,136.0,214.0,196.0,4484,4148,3387,3163,1097,985,2022,1068,1404,786,618,282,87,81,2625,2675,2425,2725,5506,6182,0
600,1,0,147.5,139.0,222.0,196.0,4596,4030,3499,3023,1097,1007,912,984,754,586,158,398,90,81,2775,2725,2425,2725,5506,6182,0
607,1,0,152.5,144.0,222.0,196.0,4557,3952,3415,2967,1142,985,797,1156,499,646,298,510,89,83,2825,3225,2425,2725,5506,6182,0
614,1,0,160.5,148.0,222.0,196.0,4669,4070,3415,3107,1254,963,809,1197,559,771,250,426,89,83,3475,3525,2425,2725,5506,6282,0
621,1,0,160.5,146.0,216.0,196.0,4579,4238,3303,3275,1276,963,493,1288,374,796,119,492,89,84,4025,3175,2425,2725,5856,6782,0
629,1,0,168.5,152.0,216.0,196.0,4355,4154,3079,3191,1276,963,165,558,144,321,21,237,88,84,4225,3650,2550,2725,5856,6782,0
636,1,0,177.5,154.0,216.0,196.0,4557,4114,3303,3107,1254,1007,178,444,34,341,144,103,88,85,4975,3750,2550,2725,5956,6782,0
643,1,0,184.5,159.0,216.0,196.0,4002,4120,2771,3135,1231,985,160,675,64,456,96,219,88,85,5375,4450,2550,2875,5956,6782,0
650,1,0,186.5,166.0,216.0,196.0,4221,4014,2967,2939,1254,1075,221,718,119,446,102,272,88,86,6125,4550,2550,3625,6006,6782,0
657,1,0,189.5,169.0,216.0,196.0,4254,4294,2911,2995,1343,1299,581,943,319,561,262,382,88,86,6425,4850,2550,3825,6006,6782,0
664,1,0,189.5,180.0,216.0,196.0,4366,4221,3023,2967,1343,1254,1078,161,664,56,414,105,88,86,6825,5225,2550,3825,6006,6782,0
671,1,0,199.0,180.0,216.0,196.0,4238,4294,2939,2995,1299,1299,676,687,314,426,362,261,90,86,7250,5475,2550,3975,6031,6782,0
679,1,0,199.0,187.0,208.0,211.0,4350,4355,3051,3079,1299,1276,997,368,529,251,468,117,90,86,6950,5625,2550,3975,6331,6782,0
686,1,0,200.0,186.0,208.0,219.0,4137,4210,2883,2911,1254,1299,1449,814,829,541,620,273,90,86,7350,5625,2550,4250,6356,6882,0
693,1,0,196.5,189.0,208.0,219.0,4333,4154,3079,2855,1254,1299,934,1049,529,641,405,408,90,86,7375,5800,2550,4250,7031,6982,0
700,1,0,199.5,189.0,220.0,219.0,4540,4400,3219,3079,1321,1321,1324,1281,759,871,565,410,90,86,7375,6150,2550,4250,7031,6982,0
707,1,0,198.5,195.0,220.0,219.0,4529,4428,3163,3107,1366,1321,1874,1458,1149,921,725,537,90,86,8425,6800,2550,4250,7081,6982,0
714,1,0,199.5,200.0,220.0,219.0,4904,4378,3583,3079,1321,1299,1732,665,1059,351,673,314,90,86,8575,7075,2550,4250,7081,6982,0
721,1,0,198.5,199.0,220.0,219.0,4848,4439,3527,3163,1321,1276,1659,1198,1134,728,525,470,90,88,8475,7025,2550,4250,7181,7032,0
729,1,0,175.0,169.0,220.0,219.0,4971,4411,3695,3135,1276,1276,1526,1309,849,733,677,576,90,88,5700,4825,2550,4250,9131,9357,0
736,1,0,176.0,161.0,220.0,219.0,4837,4406,3583,3107,1254,1299,1107,557,424,96,683,461,92,88,4350,3275,2550,4250,10406,11007,0
743,1,0,178.5,160.0,220.0,219.0,4714,4422,3415,3079,1299,1343,1422,509,579,346,843,163,92,88,3975,3350,2550,4450,10556,11207,0
750,1,0,189.5,163.0,220.0,219.0,4590,4198,3247,2855,1343,1343,332,260,229,166,103,94,92,88,4975,3700,2550,4450,10556,11207,0
757,1,0,192.0,165.0,220.0,219.0,4904,4243,3583,2967,1321,1276,559,363,404,271,155,92,92,88,5700,3950,2550,4450,10581,11207,0
764,1,0,194.0,169.0,220.0,219.0,5100,4047,3779,2771,1321,1276,661,434,554,236,107,198,92,93,7400,3950,2900,4450,10731,11207,0
771,1,0,197.5,175.0,220.0,219.0,5078,4551,3779,3275,1299,1276,763,464,654,356,109,108,94,93,7675,5050,2900,4775,10756,11207,0
779,1,0,187.5,169.0,212.0,219.0,5083,4596,3807,3275,1276,1321,869,515,679,476,190,39,93,91,6625,4875,2900,4550,12256,11732,0
786,1,0,180.5,157.0,212.0,219.0,5145,5100,3891,3779,1254,1321,1080,1121,734,926,346,195,93,90,5325,4400,2900,4700,13406,12782,0
793,1,0,185.0,152.0,212.0,234.0,5106,5240,3807,3919,1299,1321,805,1088,449,991,356,97,93,90,4950,3750,3050,4900,13906,13432,0
800,1,0,187.0,144.0,212.0,234.0,5369,5184,4003,3863,1366,1321,1095,1689,654,1436,441,253,93,90,5500,3550,2900,4900,14256,14457,0
807,1,0,183.5,142.0,218.0,234.0,5212,4327,3891,3051,1321,1276,283,1455,199,1335,84,120,93,90,4875,3250,2900,4900,15391,14757,0
814,1,0,175.5,151.0,218.0,234.0,5296,3566,3975,2267,1321,1299,455,1150,394,1060,61,90,93,90,4325,3350,3050,4900,16591,15032,0
821,1,0,179.5,154.0,218.0,234.0,5218,3829,3919,2575,1299,1254,561,862,344,645,217,217,93,90,5525,3625,2900,4900,16741,15032,0
829,1,0,188.5,155.0,218.0,234.0,4921,4714,3667,3415,1254,1299,153,537,109,260,44,277,93,90,5825,4100,2900,4900,16891,15032,0
836,1,0,192.5,159.0,218.0,234.0,4949,4484,3695,3163,1254,1321,368,685,239,453,129,232,92,90,6175,5000,2900,4900,16891,15032,0
843,1,0,197.5,164.0,210.0,234.0,5100,4394,3779,3051,1321,1343,363,968,224,633,139,335,92,90,6925,5000,2900,4975,17141,15032,0
850,1,0,178.0,140.0,210.0,234.0,5206,4400,3863,3079,1343,1321,999,1493,704,1008,295,485,92,89,5350,4000,3050,5175,18191,16632,0
857,1,0,166.5,119.0,210.0,234.0,5268,4075,3947,2799,1321,1276,912,1851,469,1241,443,610,92,80,3975,3000,3050,5075,19816,18307,0
864,1,0,158.0,118.0,210.0,234.0,5324,3403,4003,2127,1321,1276,998,1508,549,933,449,575,92,70,2900,3200,3050,5075,21041,18857,0
871,1,0,157.5,135.0,202.0,234.0,5139,3319,3863,2043,1276,1276,900,715,499,218,401,497,92,68,2575,3600,3050,5075,22066,18957,0
879,1,0,161.5,140.0,202.0,234.0,4949,3459,3695,2183,1254,1276,435,602,378,45,57,557,92,71,2575,3800,3050,5075,22177,18957,0
886,1,0,165.5,140.0,202.0,234.0,5078,3638,3779,2295,1299,1343,690,516,548,57,142,459,92,73,3225,4200,2900,5075,22327,18957,0
893,1,0,175.0,147.0,202.0,234.0,5206,4232,3863,2911,1343,1321,350,628,273,71,77,557,92,74,3850,4750,2900,5075,22352,18957,0
900,1,0,181.0,149.0,202.0,249.0,5150,4187,3807,2967,1343,1220,297,967,68,299,229,668,93,74,5050,5400,2900,5400,22402,18957,0
907,1,0,176.0,145.0,208.0,249.0,5246,4243,3947,3135,1299,1108,520,1451,143,651,377,800,92,74,5150,5350,2900,5300,23052,19157,0
914,1,0,176.5,155.0,208.0,249.0,5134,4568,3835,3471,1299,1097,896,972,413,236,483,736,92,74,5075,5000,2900,5300,23177,19707,0
921,1,0,165.5,134.0,200.0,249.0,5313,4635,4059,3471,1254,1164,1318,1487,683,611,635,876,92,71,4325,4050,2900,4875,24027,21210,0
929,1,0,160.5,110.0,192.0,249.0,5145,3487,3891,2323,1254,1164,988,1816,193,811,795,1005,92,57,2325,3525,2900,4875,25427,22585,0
936,1,0,166.5,130.0,192.0,249.0,5190,2591,3891,1427,1299,1164,1023,893,268,13,755,880,92,57,2375,4050,2900,4875,25577,22585,0
943,1,0,171.5,131.0,192.0,249.0,5061,2910,3695,1791,1366,1119,118,1171,78,171,40,1000,92,57,2375,4050,2900,4875,25577,22585,0
950,1,0,174.0,137.0,192.0,249.0,4960,3622,3639,2547,1321,1075,346,984,158,34,188,950,92,61,3200,4525,2900,4875,25802,22585,0
957,1,0,180.0,144.0,192.0,249.0,4960,3902,3639,2827,1321,1075,393,1161,178,85,215,1076,92,61,5200,5100,2900,4875,25827,22585,0
964,1,0,184.0,150.0,192.0,249.0,5055,3683,3779,2631,1276,1052,220,1266,203,113,17,1153,92,62,5450,5375,2900,4875,25827,22585,0
971,1,0,181.0,146.0,192.0,249.0,5145,3980,3891,2883,1254,1097,236,1447,63,290,173,1157,92,62,4900,5225,2900,4550,26452,23285,0
979,1,0,175.0,139.0,198.0,225.0,5274,4266,3975,3191,1299,1075,526,1853,193,587,333,1266,92,60,4150,5575,3050,4550,27102,24009,0
986,1,0,181.0,148.0,206.0,225.0,5262,4226,3919,3219,1343,1007,271,1413,78,409,193,1004,92,60,4400,5775,3050,4550,27102,24009,0
993,1,0,175.5,140.0,206.0,225.0,5464,3958,4143,2995,1321,963,518,1846,173,736,345,1110,92,59,3975,5275,3050,4450,28377,24659,0
1000,1,0,165.5,132.0,206.0,217.0,5436,3694,4115,2911,1321,783,735,1989,338,816,397,1173,92,52,3625,4975,3050,4450,29527,25384,0
1007,1,0,167.0,132.0,206.0,209.0,5414,2882,4115,2211,1299,671,482,1647,108,711,374,936,92,51,3100,4925,2900,4450,30227,25959,0
1014,1,0,173.5,139.0,206.0,209.0,5447,2485,4171,1791,1276,694,118,1346,63,476,55,870,92,51,3775,5800,2900,4450,30402,25959,0
1021,1,0,175.0,145.0,206.0,209.0,5341,2283,4087,1567,1254,716,584,755,373,76,211,679,92,51,4050,6050,2900,4450,30477,25959,0
1029,1,0,176.0,136.0,206.0,209.0,5330,2244,4031,1483,1299,761,679,1027,308,256,371,771,96,54,4000,5525,2900,4450,31052,26634,0
1036,1,0,156.5,125.0,206.0,209.0,5481,2569,4115,1763,1366,806,869,744,413,106,456,638,96,50,3025,5275,2900,4450,32177,28434,0
1043,1,0,172.5,131.0,206.0,209.0,5408,2692,4087,1931,1321,761,487,622,33,46,454,576,96,50,3575,5325,2900,4450,32177,28434,0
1050,1,0,177.5,132.0,206.0,209.0,5302,2692,4059,1931,1243,761,560,894,118,226,442,668,96,51,3875,5425,3050,4450,32177,28434,0
1057,1,0,184.0,133.0,206.0,209.0,4949,2630,3807,1847,1142,783,626,1014,48,246,578,768,95,51,4400,5525,2900,4450,32502,28709,0
1064,1,0,185.0,124.0,200.0,209.0,4764,2524,3667,1763,1097,761,1068,1262,358,406,710,856,95,48,4700,5575,2900,4450,32977,29184,0
1071,1,0,185.5,130.0,200.0,209.0,4876,2440,3779,1679,1097,761,1093,681,318,41,775,640,95,49,5025,5425,2900,4450,33352,29334,0
1079,1,0,190.5,124.0,200.0,209.0,4837,2334,3695,1595,1142,739,1073,979,158,251,915,728,95,49,5125,5125,2900,4325,33702,30184,0
1086,1,0,195.5,126.0,200.0,201.0,4921,2927,3779,2211,1142,716,1025,936,203,336,822,600,95,49,5325,5075,2900,4200,33902,30509,0
1093,1,0,188.5,119.0,200.0,201.0,4999,3084,3835,2435,1164,649,1426,1291,468,611,958,680,95,48,5175,5075,2900,4200,34577,30859,0
7,0,1,13.0,13.0,15.0,14.0,335,377,335,377,0,0,40,45,40,45,0,0,12,12,0,0,0,0,0,0,1
14,0,1,14.0,13.0,15.0,14.0,699,671,699,671,0,0,75,20,75,20,0,0,13,13,0,0,0,0,0,0,1
21,0,1,14.0,14.0,15.0,14.0,699,755,699,755,0,0,55,60,55,60,0,0,13,13,0,0,0,0,0,0,1
29,0,1,15.0,14.0,15.0,14.0,699,811,699,811,0,0,90,155,90,155,0,0,14,13,0,0,0,0,0,0,1
36,0,1,15.0,16.0,15.0,22.0,783,755,783,755,0,0,145,145,145,145,0,0,14,14,0,0,0,0,0,0,1
43,0,1,16.0,16.0,23.0,22.0,783,839,783,839,0,0,5,240,5,240,0,0,15,16,0,0,0,0,0,0,1
50,0,1,16.0,15.0,23.0,22.0,783,839,783,839,0,0,45,40,45,40,0,0,15,15,0,0,0,0,0,0,1
57,0,1,17.0,17.0,23.0,22.0,783,867,783,867,0,0,95,45,95,45,0,0,16,15,0,0,0,0,0,0,1
64,0,1,18.0,18.0,23.0,22.0,811,895,811,895,0,0,190,100,190,100,0,0,17,16,0,0,0,0,0,0,1
71,0,1,18.0,17.0,23.0,22.0,850,895,783,895,67,0,247,180,235,180,12,0,17,17,0,0,0,0,0,0,1
79,0,1,19.0,17.0,23.0,22.0,934,951,755,951,179,0,362,45,330,45,32,0,18,16,0,0,0,0,0,0,1
86,0,1,19.0,18.0,23.0,22.0,962,923,783,923,179,0,477,115,425,115,52,0,18,16,0,0,0,0,0,0,1
93,0,1,20.0,19.0,23.0,22.0,995,973,839,951,156,22,398,169,330,165,68,4,19,18,0,0,150,0,0,0,1
100,0,1,20.0,20.0,23.0,22.0,995,962,839,895,156,67,123,237,35,225,88,12,19,19,0,0,150,0,0,0,1
107,0,1,20.0,20.0,23.0,22.0,1023,1085,867,951,156,134,248,372,140,340,108,32,19,19,50,0,150,0,0,0,1
114,0,1,21.0,21.0,23.0,22.0,939,1107,783,951,156,156,63,453,35,405,28,48,19,20,50,0,150,0,0,0,1
121,0,1,21.0,27.0,23.0,28.0,1079,1079,923,923,156,156,83,178,35,110,48,68,19,21,50,0,150,250,0,0,1
129,0,1,22.0,27.0,23.0,28.0,1270,1163,1091,1007,179,156,128,328,110,240,18,88,20,21,50,0,150,250,0,0,1
136,0,1,22.0,28.0,23.0,28.0,1242,1062,1063,951,179,111,113,300,75,200,38,100,20,21,50,0,150,250,0,0,1
143,0,1,23.0,27.0,23.0,28.0,1247,1102,1091,1035,156,67,249,128,195,20,54,108,21,20,50,100,150,250,0,0,1
150,0,1,23.0,29.0,23.0,36.0,1208,1158,1007,1091,201,67,337,171,255,55,82,116,22,21,50,100,150,250,0,0,1
157,0,1,26.0,31.0,31.0,36.0,1348,1219,1035,1175,313,44,147,215,125,95,22,120,22,22,50,400,400,250,0,0,1
164,0,1,29.0,31.0,31.0,36.0,1404,1219,1091,1175,313,44,157,168,95,140,62,28,23,24,50,400,500,250,0,0,1
171,0,1,29.0,33.0,46.0,36.0,1398,1354,1063,1287,335,67,132,81,30,45,102,36,23,25,50,400,500,250,0,0,1
179,0,1,32.0,36.0,46.0,36.0,1393,1382,1035,1315,358,67,202,94,85,50,117,44,24,25,250,400,500,250,0,0,1
186,0,1,34.0,35.5,46.0,36.0,1314,1471,979,1427,335,44,253,163,100,115,153,48,24,26,250,375,500,250,0,25,1
193,0,1,37.0,39.5,46.0,44.0,1320,1438,1007,1371,313,67,169,136,80,80,89,56,25,28,250,375,750,250,0,25,1
200,0,1,39.0,41.5,46.0,44.0,1572,1550,1259,1483,313,67,184,179,55,115,129,64,26,28,450,375,750,250,0,25,1
207,0,1,40.0,42.5,46.0,52.0,1712,1656,1399,1567,313,89,344,101,175,25,169,76,26,31,450,525,750,250,0,25,1
214,0,1,46.0,43.5,46.0,58.0,1992,1611,1679,1455,313,156,224,187,15,95,209,92,28,30,450,525,750,250,0,25,1
221,0,1,46.0,44.5,46.0,58.0,2121,1695,1763,1539,358,156,359,352,110,240,249,112,28,32,450,525,750,250,0,25,1
229,0,1,49.0,48.5,54.0,58.0,2177,1807,1819,1651,358,156,369,262,105,130,264,132,30,35,700,525,750,250,0,25,1
236,0,1,54.0,51.5,54.0,58.0,2160,1824,1847,1623,313,201,406,225,110,65,296,160,31,39,900,675,750,250,0,25,1
243,0,1,54.0,51.5,54.0,66.0,2244,2014,1931,1679,313,335,461,480,125,280,336,200,32,39,900,675,825,250,0,25,1
250,0,1,58.0,63.5,62.0,66.0,2104,2126,1791,1791,313,335,261,135,110,45,151,90,33,39,950,775,825,450,0,25,1
257,0,1,58.0,65.5,62.0,74.0,2020,2132,1707,1819,313,313,481,196,290,95,191,101,33,39,1150,825,825,450,0,25,1
264,0,1,60.0,61.0,62.0,74.0,2076,1936,1763,1623,313,313,696,406,465,265,231,141,35,35,1150,800,900,450,0,250,1
271,0,1,61.0,70.0,70.0,74.0,2233,1874,1875,1539,358,335,386,191,215,85,171,106,37,35,1050,1400,900,450,100,250,1
279,0,1,61.0,72.0,70.0,82.0,2149,1964,1791,1651,358,313,471,172,260,105,211,67,37,35,1050,1500,900,450,100,250,1
286,0,1,64.0,77.0,70.0,82.0,2132,2070,1819,1735,313,335,318,117,175,85,143,32,39,35,1100,1500,900,450,100,250,1
293,0,1,67.0,77.0,70.0,90.0,1516,1930,1203,1595,313,335,253,247,95,175,158,72,39,35,1400,2200,900,450,100,250,1
300,0,1,68.0,82.0,70.0,90.0,1460,2076,1147,1763,313,313,453,188,255,155,198,33,41,35,1400,2200,900,450,100,250,1
307,0,1,69.0,85.0,62.0,90.0,1572,1936,1259,1623,313,313,593,173,355,100,238,73,42,35,1450,2500,975,450,125,250,1
314,0,1,69.0,86.0,54.0,98.0,1454,2014,1119,1679,335,335,303,303,150,265,153,38,43,35,1450,2700,975,450,325,250,1
321,0,1,64.0,91.0,62.0,106.0,1645,1986,1287,1651,358,335,508,198,315,120,193,78,41,35,1300,2700,975,450,575,350,1
329,0,1,64.0,91.0,62.0,106.0,1522,2048,1231,1735,291,313,541,439,320,325,221,114,41,35,1300,2850,1125,450,675,350,1
336,0,1,67.0,93.5,78.0,106.0,1438,1958,1259,1623,179,335,921,424,580,270,341,154,40,35,1500,3075,1050,450,850,475,1
343,0,1,56.0,85.5,78.0,106.0,1208,2042,1119,1707,89,335,919,459,570,265,349,194,32,35,1300,2425,1050,450,1450,1125,1
350,0,1,43.0,81.5,78.0,106.0,895,1936,895,1623,0,313,679,390,430,160,249,230,20,35,1100,2175,1050,450,2350,1625,1
357,0,1,34.0,78.5,78.0,106.0,559,1964,559,1651,0,313,634,535,385,265,249,270,16,35,850,2125,1050,450,2850,1875,1
364,0,1,26.0,65.0,78.0,106.0,0,1986,0,1651,0,335,484,585,235,375,249,210,9,35,1075,1450,1050,450,3250,2650,1
371,0,1,25.0,66.0,78.0,106.0,0,1986,0,1651,0,335,468,500,227,250,241,250,8,35,1075,1250,1050,450,3450,2900,1
379,0,1,24.0,68.0,70.0,106.0,55,1992,55,1679,0,313,413,406,179,120,234,286,8,35,1025,1200,1050,450,3650,3150,1
386,0,1,24.0,64.5,70.0,106.0,0,1986,0,1651,0,335,318,641,104,315,214,326,6,35,1125,1325,1050,450,3750,3325,1
393,0,1,25.0,65.5,70.0,106.0,475,2076,475,1763,0,313,253,732,39,370,214,362,7,42,1375,1275,1050,450,3750,3375,1
400,0,1,25.0,67.5,70.0,106.0,839,2076,839,1763,0,313,321,732,113,330,208,402,7,42,1375,1225,1050,450,3750,3425,1
407,0,1,27.0,67.5,70.0,106.0,867,2266,867,1931,0,335,348,912,144,470,204,442,8,47,1475,1225,1050,450,3750,3425,1
414,0,1,28.0,81.5,70.0,98.0,923,2378,923,2043,0,335,424,507,226,200,198,307,9,47,1475,1225,1050,450,3700,3525,1
421,0,1,30.0,81.5,70.0,98.0,979,2490,979,2155,0,335,299,492,201,295,98,197,10,47,1475,1225,1050,700,3700,3525,1
429,0,1,32.0,89.0,70.0,106.0,1147,2524,1147,1987,0,537,394,304,296,185,98,119,12,47,1475,1200,1050,700,3700,3550,1
436,0,1,32.0,93.0,70.0,106.0,1147,2664,1147,2015,0,649,189,119,91,20,98,99,12,47,1525,2100,1050,700,3700,3550,1
443,0,1,37.0,93.0,70.0,106.0,1511,2642,1511,2015,0,627,159,435,61,260,98,175,14,47,1525,2500,1050,700,3700,3550,1
450,0,1,38.0,97.0,70.0,106.0,1735,2642,1735,2015,0,627,231,295,137,115,94,180,15,45,1525,2500,1050,700,3700,3650,1
457,0,1,36.0,98.0,70.0,106.0,1455,2126,1455,1455,0,671,254,70,166,35,88,35,16,40,1275,2500,1050,700,3950,3900,1
464,0,1,41.0,98.0,70.0,106.0,1399,1762,1399,1091,0,671,247,286,165,175,82,111,18,40,1425,2800,1050,700,3950,3900,1
471,0,1,41.0,101.0,70.0,106.0,1287,2250,1287,1623,0,627,246,473,167,365,79,108,18,43,1425,3400,1050,700,3950,3900,1
479,0,1,42.0,106.0,70.0,106.0,1399,2356,1399,1707,0,649,231,503,152,315,79,188,18,43,1525,3500,1050,700,4100,3900,1
7,1,2,13.0,13.0,14.0,15.0,419,335,419,335,0,0,50,40,50,40,0,0,12,12,0,0,0,0,0,0,0
14,1,2,13.0,14.0,14.0,15.0,699,671,699,671,0,0,25,70,25,70,0,0,13,13,0,0,0,0,0,0,0
21,1,2,14.0,14.0,14.0,15.0,783,671,783,671,0,0,65,45,65,45,0,0,13,13,0,0,0,0,0,0,0
29,1,2,14.0,15.0,14.0,15.0,839,755,839,755,0,0,165,95,165,95,0,0,13,14,0,0,0,0,0,0,0
36,1,2,16.0,15.0,22.0,23.0,811,727,811,727,0,0,150,125,150,125,0,0,14,14,0,0,0,0,0,0,0
43,1,2,16.0,16.0,22.0,23.0,839,727,839,727,0,0,245,10,245,10,0,0,16,15,0,0,0,0,0,0,0
50,1,2,17.0,17.0,22.0,23.0,783,839,783,839,0,0,285,30,285,30,0,0,16,16,0,0,0,0,0,0,0
57,1,2,16.0,18.0,22.0,23.0,867,867,867,867,0,0,20,90,20,90,0,0,15,17,0,0,0,0,0,0,0
64,1,2,18.0,19.0,22.0,23.0,895,951,895,951,0,0,30,145,30,145,0,0,16,18,0,0,0,0,0,0,0
71,1,2,19.0,19.0,22.0,23.0,923,979,923,979,0,0,80,210,80,210,0,0,17,18,0,0,0,0,0,0,0
79,1,2,18.0,20.0,22.0,23.0,895,967,895,923,0,44,170,328,170,320,0,8,17,19,0,0,0,0,0,0,0
86,1,2,18.0,20.0,22.0,23.0,867,990,867,923,0,67,20,46,20,30,0,16,17,19,0,0,0,150,0,0,0
93,1,2,19.0,21.0,22.0,23.0,867,1012,867,923,0,89,75,118,75,90,0,28,17,20,0,0,0,150,0,0,0
100,1,2,20.0,21.0,22.0,23.0,895,950,895,839,0,111,135,85,135,45,0,40,18,21,0,0,0,150,0,0,0
107,1,2,20.0,22.0,22.0,23.0,967,1057,923,923,44,134,248,91,240,35,8,56,19,21,0,0,0,150,0,0,0
114,1,2,21.0,22.0,22.0,23.0,1006,1079,895,923,111,156,329,131,305,55,24,76,20,21,0,0,0,150,0,0,0
121,1,2,21.0,23.0,22.0,23.0,1085,1102,951,923,134,179,360,211,320,115,40,96,21,22,0,0,0,150,0,0,0
129,1,2,21.0,23.0,28.0,23.0,1107,1152,951,951,156,201,490,300,430,180,60,120,21,22,0,0,0,150,0,0,0
136,1,2,27.0,26.0,28.0,31.0,1107,1214,951,923,156,291,220,266,140,135,80,131,21,23,0,0,250,300,0,0,0
143,1,2,29.0,27.0,36.0,31.0,1107,1292,951,979,156,313,55,126,55,105,0,21,21,24,0,0,250,300,0,0,0
150,1,2,29.0,28.0,36.0,31.0,1102,1208,1035,895,67,313,175,117,175,110,0,7,22,25,50,0,250,300,0,0,0
157,1,2,30.0,32.0,36.0,46.0,1063,1342,1063,1007,0,335,255,52,255,30,0,22,24,26,50,125,250,300,0,0,0
164,1,2,31.0,32.0,36.0,46.0,1287,1370,1287,1035,0,335,20,172,20,110,0,62,23,26,50,125,250,300,0,0,0
171,1,2,33.0,34.0,36.0,46.0,1315,1426,1315,1091,0,335,20,228,20,130,0,98,23,28,350,125,250,300,0,0,0
179,1,2,33.5,35.0,36.0,46.0,1371,1566,1371,1231,0,335,35,323,35,185,0,138,25,29,375,125,250,300,25,0,0
186,1,2,33.5,37.0,36.0,46.0,1365,1544,1343,1231,22,313,74,444,70,270,4,174,24,31,375,250,250,600,25,0,0
193,1,2,34.5,41.0,36.0,46.0,1410,1712,1343,1399,67,313,214,319,202,255,12,64,25,32,375,250,250,600,25,0,0
200,1,2,39.5,42.0,44.0,46.0,1550,1684,1483,1371,67,313,82,204,62,100,20,104,26,33,425,250,250,600,25,0,0
207,1,2,40.5,43.0,44.0,46.0,1438,1818,1371,1483,67,335,70,389,42,245,28,144,26,34,575,250,250,600,25,0,0
214,1,2,45.0,44.0,52.0,54.0,1438,1846,1371,1511,67,335,90,269,54,235,36,34,30,35,550,250,250,600,50,0,0
221,1,2,47.0,49.0,52.0,54.0,1639,1986,1595,1651,44,335,189,445,149,375,40,70,33,37,550,550,250,600,50,0,0
229,1,2,51.0,49.0,52.0,54.0,1628,1958,1539,1623,89,335,116,695,64,585,52,110,36,38,550,550,250,600,50,0,0
236,1,2,54.0,51.0,58.0,54.0,1863,2104,1707,1791,156,313,141,836,69,690,72,146,37,39,700,550,250,600,50,0,0
243,1,2,57.0,52.0,58.0,54.0,2003,2132,1847,1819,156,313,196,521,104,485,92,36,37,40,650,550,250,600,100,0,0
250,1,2,56.0,54.0,58.0,54.0,1975,2126,1819,1791,156,335,296,371,184,295,112,76,36,41,750,725,250,750,100,125,0
257,1,2,58.0,55.0,58.0,62.0,1533,2154,1399,1819,134,335,268,481,144,365,124,116,36,43,900,725,250,750,100,125,0
264,1,2,58.0,60.0,58.0,62.0,1718,2188,1651,1875,67,313,366,342,234,265,132,77,35,43,1050,725,250,750,100,125,0
271,1,2,58.0,62.0,58.0,62.0,1835,2362,1791,1959,44,403,385,114,249,85,136,29,39,45,1200,1025,250,750,100,125,0
279,1,2,58.0,61.0,58.0,70.0,1970,2429,1903,1959,67,470,323,340,279,255,44,85,40,44,1200,1025,375,750,100,175,0
286,1,2,58.0,65.0,74.0,70.0,2126,2457,2015,1987,111,470,379,535,319,415,60,120,40,46,1200,1325,500,750,100,125,0
293,1,2,63.5,67.0,82.0,70.0,2227,2317,2071,1847,156,470,244,625,164,470,80,155,40,46,1075,1575,500,750,225,125,0
300,1,2,68.0,69.0,90.0,70.0,2255,2418,2099,1903,156,515,264,820,164,605,100,215,41,48,1050,1575,500,750,250,125,0
307,1,2,70.0,68.0,98.0,70.0,2227,2255,2071,1763,156,492,329,736,209,465,120,271,48,49,950,1450,500,1000,350,250,0
314,1,2,73.0,69.0,98.0,70.0,2283,2339,2127,1847,156,492,174,432,84,105,90,327,48,50,1100,1450,500,1000,350,250,0
321,1,2,70.0,71.0,98.0,78.0,2446,2457,2267,1875,179,582,319,683,209,280,110,403,47,52,1250,1450,500,1150,400,250,0
329,1,2,76.0,71.0,98.0,86.0,2614,2580,2435,1931,179,649,324,749,194,270,130,479,50,52,1250,1450,500,1150,400,250,0
336,1,2,79.0,79.0,98.0,94.0,2675,2552,2519,1903,156,649,400,629,254,145,146,484,50,54,1300,1825,500,1150,400,250,0
343,1,2,79.0,76.0,98.0,94.0,2871,2720,2715,2071,156,649,340,965,174,405,166,560,54,55,850,1575,750,1150,850,500,0
350,1,2,78.0,71.0,98.0,102.0,2765,2770,2519,2099,246,671,498,1240,296,600,202,640,52,56,1000,1200,750,1300,950,875,0
357,1,2,82.0,76.0,106.0,102.0,2793,2782,2547,2155,246,627,610,742,376,255,234,487,55,57,1100,1450,950,1450,950,1000,0
364,1,2,86.0,79.0,106.0,102.0,2916,2692,2603,2043,313,649,470,677,296,135,174,542,55,58,1200,1450,950,1450,950,1000,0
371,1,2,87.5,80.0,106.0,102.0,2994,2782,2659,2155,335,627,410,718,196,200,214,518,62,59,1175,1575,950,1450,975,1000,0
379,1,2,90.5,86.0,106.0,102.0,3101,2748,2743,2099,358,649,485,588,231,90,254,498,62,61,1325,1575,950,1450,975,1000,0
386,1,2,89.5,87.0,106.0,117.0,3078,2524,2743,1875,335,649,851,878,561,300,290,578,65,62,1375,1925,950,1550,975,1000,0
393,1,2,93.5,92.0,106.0,117.0,3196,2490,2883,1819,313,671,992,884,666,280,326,604,67,62,1325,1925,950,1650,1025,1000,0
400,1,2,94.5,91.0,106.0,117.0,3246,2546,2911,1875,335,671,891,1279,521,595,370,684,66,64,1325,2175,950,1650,1025,1000,0
407,1,2,94.5,95.0,106.0,117.0,3325,2692,2855,2043,470,649,1295,696,861,140,434,556,66,64,1325,2525,950,1650,1025,1000,0
414,1,2,101.5,95.0,114.0,117.0,3538,3112,2799,2463,739,649,1260,791,726,155,534,636,68,64,1575,2525,950,1650,1025,1000,0
421,1,2,102.5,99.0,114.0,117.0,3689,3370,2883,2743,806,627,1365,832,831,220,534,612,67,64,1575,2875,1200,1650,1025,1000,0
429,1,2,107.0,103.0,122.0,117.0,3655,3504,2827,2855,828,649,1805,717,1171,125,634,592,68,64,1550,2875,1200,1650,1050,1000,0
436,1,2,108.0,103.0,122.0,117.0,3823,3442,2995,2771,828,671,1852,1037,1126,365,726,672,71,64,1900,3225,1200,1650,1050,1000,0
443,1,2,110.0,103.0,122.0,117.0,3767,3246,2939,2575,828,671,2092,1328,1266,580,826,748,71,64,1900,3225,1200,1650,1050,1000,0
450,1,2,114.0,109.0,122.0,133.0,3834,3308,3051,2659,783,649,1930,1134,1116,410,814,724,71,64,1900,3575,1450,1650,1050,1000,0
457,1,2,122.0,114.0,130.0,133.0,3588,3392,2827,2743,761,649,1346,1085,786,460,560,625,71,64,2250,3925,1450,2200,1050,1000,0
464,1,2,121.5,114.0,146.0,133.0,3706,3476,2967,2715,739,761,1388,805,836,180,552,625,75,66,2025,3925,1450,2500,1275,1000,0
471,1,2,122.0,109.0,152.0,141.0,3689,3459,2883,2631,806,828,1469,801,871,305,598,496,75,66,1950,3650,1450,2500,1350,1375,0
479,1,2,122.5,109.0,168.0,141.0,3762,3515,2911,2687,851,828,1495,1241,901,645,594,596,75,66,2375,3650,1450,2650,1525,1375,0
486,1,2,126.5,121.0,168.0,149.0,3655,3521,2827,2715,828,806,1682,663,996,225,686,438,75,66,2325,4625,1450,2650,1575,1375,0
493,1,2,128.0,125.0,184.0,149.0,3666,3627,2883,2799,783,828,1714,583,936,145,778,438,75,66,2450,5075,1450,2650,1900,1375,0
500,1,2,131.5,128.0,184.0,149.0,3722,3465,2939,2659,783,806,1864,475,1086,145,778,330,75,66,2675,5075,1450,2650,1925,1375,0
507,1,2,131.5,128.0,174.0,149.0,3582,3353,2799,2547,783,806,1994,880,1266,450,728,430,75,66,3175,5075,1450,2650,1925,1375,0
514,1,2,141.5,129.0,174.0,149.0,3683,3218,2855,2435,828,783,1719,946,991,420,728,526,74,69,3375,5075,1450,2650,1925,1375,0
521,1,2,142.5,131.0,174.0,149.0,3734,3263,2883,2435,851,828,2014,1251,1186,625,828,626,76,69,3675,5075,1450,2650,1925,1375,0
529,1,2,143.5,133.0,174.0,149.0,3622,3151,2771,2323,851,828,1481,1511,661,785,820,726,70,71,3675,5075,1450,2650,2225,1375,0
536,1,2,153.5,132.0,182.0,149.0,3487,3235,2659,2407,828,828,452,1798,61,980,391,818,70,73,4225,4775,1575,3000,2225,1675,0
543,1,2,160.5,140.0,190.0,149.0,3582,3252,2799,2379,783,873,534,996,51,870,483,126,78,74,4225,5575,1575,3250,2225,1675,0
550,1,2,162.5,141.0,190.0,149.0,3638,3342,2855,2379,783,963,334,897,26,655,308,242,78,76,4975,5575,1575,3250,2225,1675,0
557,1,2,166.5,144.0,190.0,149.0,3801,3398,2995,2435,806,963,579,1062,171,850,408,212,78,76,5175,5775,1575,3250,2225,1675,0
564,1,2,173.5,147.0,190.0,164.0,3986,3381,3135,2463,851,918,629,1064,171,740,458,324,78,77,6525,5775,1575,3250,2300,1675,0
571,1,2,175.5,161.0,190.0,164.0,4131,3504,3303,2519,828,985,330,454,126,310,204,144,78,78,6825,5775,1575,3250,2300,1675,0
579,1,2,181.5,161.0,190.0,164.0,4243,3790,3415,2827,828,963,322,492,126,240,196,252,78,81,6925,6675,1575,3550,2300,1675,0
586,1,2,180.0,159.0,190.0,172.0,4159,3762,3331,2799,828,963,627,548,431,180,196,368,77,81,7950,6575,1575,3700,2350,1775,0
593,1,2,190.0,162.0,190.0,172.0,4086,3784,3303,2799,783,985,309,478,21,90,288,388,77,81,8050,6475,1575,3850,2350,1875,0
600,1,2,189.0,166.0,190.0,196.0,4002,4165,3219,2911,783,1254,344,403,181,255,163,148,77,81,8300,6475,1575,3850,2400,1875,0
607,1,2,174.5,166.0,196.0,204.0,4053,4316,3247,2995,806,1321,824,919,561,615,263,304,77,81,7475,6475,1575,3950,3725,1875,0
614,1,2,158.5,161.0,220.0,196.0,4042,4266,3191,2967,851,1299,1214,381,851,225,363,156,77,80,5875,4975,1575,3950,5350,3400,0
621,1,2,175.5,155.0,212.0,196.0,3986,4299,3135,3023,851,1276,841,1022,386,610,455,412,77,80,5675,6025,1825,4100,5550,3850,0
629,1,2,182.0,155.0,212.0,196.0,4131,4260,3303,2939,828,1321,197,938,21,370,176,568,77,80,5600,6025,1825,4250,5625,3850,0
636,1,2,182.0,165.0,212.0,196.0,4058,4378,3275,3079,783,1299,314,549,196,125,118,424,77,80,6550,6425,1825,4250,5625,3850,0
643,1,2,181.0,165.0,212.0,196.0,3862,4266,3079,2967,783,1299,534,896,441,320,93,576,77,80,7250,6725,1825,4250,5725,3850,0
650,1,2,188.5,165.0,212.0,196.0,3913,4232,3107,2911,806,1321,559,786,366,500,193,286,77,80,7575,7200,1825,4250,5800,4225,0
657,1,2,196.5,169.0,212.0,196.0,3874,4154,3023,2855,851,1299,89,908,21,570,68,338,76,80,7825,6800,1825,4400,5825,4225,0
664,1,2,193.5,175.0,212.0,196.0,4019,4182,3191,2883,828,1299,375,894,311,700,64,194,79,80,7975,7750,1825,4650,6125,4225,0
671,1,2,165.0,154.0,212.0,196.0,4187,4120,3359,2799,828,1321,872,1030,716,780,156,250,79,79,5850,5200,1825,4500,8100,6925,0
679,1,2,170.5,134.0,212.0,196.0,4327,4064,3499,2743,828,1321,452,1196,196,790,256,406,79,72,5525,4300,1825,4400,8925,9025,0
686,1,2,167.5,112.0,212.0,196.0,4254,3403,3471,2239,783,1164,304,1013,156,575,148,438,77,58,4825,3550,1825,4150,9500,11125,0
693,1,2,153.5,107.0,212.0,165.0,3874,2916,3247,1931,627,985,731,1009,511,555,220,454,76,58,3975,3300,1825,4150,10325,12325,0
700,1,2,131.5,99.0,212.0,165.0,3504,2832,2967,1847,537,985,1150,934,866,360,284,574,76,60,3425,2825,1825,4150,11750,13575,0
707,1,2,141.5,101.0,212.0,165.0,3554,2866,2995,1903,559,963,529,880,181,190,348,690,76,60,3325,2775,2175,4150,12425,14025,0
7,0,2,13.0,13.0,15.0,15.0,251,335,251,335,0,0,30,40,30,40,0,0,12,12,0,0,0,0,0,0,0
14,0,2,14.0,14.0,15.0,15.0,615,699,615,699,0,0,60,75,60,75,0,0,13,13,0,0,0,0,0,0,0
21,0,2,14.0,14.0,15.0,15.0,643,699,643,699,0,0,30,50,30,50,0,0,13,13,0,0,0,0,0,0,0
29,0,2,15.0,15.0,15.0,15.0,643,783,643,783,0,0,65,105,65,105,0,0,14,14,0,0,0,0,0,0,0
36,0,2,15.0,16.0,15.0,23.0,727,811,727,811,0,0,155,0,155,0,0,0,14,15,0,0,0,0,0,0,0
43,0,2,16.0,16.0,23.0,23.0,727,895,727,895,0,0,30,55,30,55,0,0,15,15,0,0,0,0,0,0,0
50,0,2,16.0,17.0,23.0,23.0,811,811,811,811,0,0,55,20,55,20,0,0,15,16,0,0,0,0,0,0,0
57,0,2,17.0,18.0,23.0,23.0,811,839,811,839,0,0,25,80,25,80,0,0,16,17,0,0,0,0,0,0,0
64,0,2,18.0,19.0,23.0,23.0,811,951,811,951,0,0,60,200,60,200,0,0,17,18,0,0,0,0,0,0,0
71,0,2,18.0,19.0,23.0,23.0,827,945,783,923,44,22,158,249,150,245,8,4,17,18,0,0,0,0,0,0,0
79,0,2,19.0,20.0,23.0,23.0,883,1018,727,951,156,67,213,382,185,370,28,12,18,19,0,0,0,0,0,0,0
86,0,2,19.0,20.0,23.0,23.0,967,945,699,923,268,22,329,347,265,335,64,12,18,19,0,0,0,150,0,0,0
93,0,2,20.0,20.0,23.0,23.0,978,967,643,923,335,44,185,55,135,35,50,20,19,20,0,0,150,150,0,0,0
100,0,2,20.0,20.0,23.0,23.0,1034,984,699,895,335,89,315,77,225,45,90,32,19,20,0,0,150,150,0,0,0
107,0,2,20.0,21.0,23.0,23.0,984,1029,671,895,313,134,181,78,155,30,26,48,19,20,0,0,150,150,0,0,0
114,0,2,21.0,22.0,23.0,23.0,967,1029,699,895,268,134,148,154,90,90,58,64,19,21,0,0,150,150,0,0,0
121,0,2,21.0,24.0,23.0,31.0,950,1046,727,867,223,179,261,99,175,65,86,34,19,21,100,0,150,300,0,0,0
129,0,2,22.0,25.0,23.0,31.0,1068,1074,867,895,201,179,295,79,185,75,110,4,20,22,100,0,150,300,0,0,0
136,0,2,22.0,25.0,31.0,31.0,1096,861,895,615,201,246,443,176,305,140,138,36,20,22,100,0,150,300,0,0,0
143,0,2,22.0,27.0,31.0,31.0,1309,816,1063,503,246,313,616,46,450,20,166,26,21,22,0,175,150,300,100,50,0
150,0,2,25.0,27.0,31.0,31.0,1337,850,1091,559,246,291,209,102,40,40,169,62,22,22,0,175,400,300,100,50,0
157,0,2,25.0,28.0,31.0,31.0,1365,1152,1119,839,246,313,122,202,25,100,97,102,22,23,0,175,400,300,100,50,0
164,0,2,26.0,30.0,31.0,46.0,1460,1236,1147,923,313,313,227,52,90,10,137,42,23,24,0,175,400,300,100,50,0
171,0,2,28.0,31.0,31.0,46.0,1404,1365,1091,1007,313,358,187,112,35,30,152,82,23,25,100,350,400,300,100,50,0
179,0,2,29.0,32.0,31.0,46.0,1404,1421,1091,1063,313,358,197,227,55,105,142,122,24,26,100,350,400,300,100,50,0
186,0,2,29.0,34.0,31.0,46.0,1342,1516,1007,1203,335,313,297,209,115,55,182,154,24,28,100,350,400,300,100,50,0
193,0,2,34.0,35.0,39.0,46.0,1370,1488,1035,1175,335,313,163,284,70,90,93,194,25,29,200,350,650,300,100,50,0
200,0,2,35.0,36.0,39.0,46.0,1376,1628,1063,1315,313,313,134,484,5,250,129,234,26,30,200,350,650,300,100,50,0
207,0,2,35.0,38.0,39.0,46.0,1404,1600,1091,1287,313,313,319,39,150,15,169,24,26,32,200,350,650,550,100,50,0
214,0,2,36.0,39.0,39.0,46.0,1376,1734,1063,1399,313,335,364,84,180,20,184,64,27,33,300,350,650,550,100,50,0
221,0,2,36.0,40.0,54.0,46.0,1404,1813,1091,1455,313,358,544,254,320,150,224,104,27,34,300,350,650,550,100,50,0
229,0,2,39.0,41.0,54.0,46.0,1482,1824,1147,1511,335,313,509,266,270,130,239,136,28,35,500,350,750,550,100,50,0
236,0,2,43.0,42.0,54.0,54.0,1533,1902,1175,1567,358,335,214,446,60,270,154,176,29,36,500,350,825,700,100,50,0
243,0,2,43.0,47.0,54.0,54.0,1566,2014,1231,1679,335,335,315,141,125,25,190,116,29,37,500,700,825,700,100,50,0
250,0,2,46.0,48.0,54.0,54.0,1684,2048,1371,1735,313,313,366,282,140,130,226,152,30,38,600,700,1050,700,100,50,0
257,0,2,49.0,52.0,54.0,54.0,1796,2048,1483,1735,313,313,136,282,70,90,66,192,30,40,600,700,1050,950,100,50,0
264,0,2,53.0,56.0,54.0,62.0,1908,2126,1595,1791,313,335,141,187,35,55,106,132,31,41,975,700,1050,950,100,50,0
271,0,2,56.0,56.0,62.0,62.0,1908,2238,1595,1903,313,335,126,357,105,185,21,172,32,42,1025,1050,1050,1100,100,50,0
279,0,2,58.0,56.0,62.0,62.0,2154,2272,1819,1959,335,313,181,618,120,410,61,208,33,42,1025,1050,1050,1100,100,50,0
286,0,2,62.0,59.0,70.0,62.0,2261,2238,1903,1903,358,335,231,223,130,100,101,123,34,42,1125,1475,1050,1100,100,50,0
293,0,2,63.0,63.0,70.0,70.0,2182,2294,1847,1959,335,335,352,148,215,85,137,63,35,42,1125,1650,1050,1100,100,50,0
300,0,2,65.0,65.0,70.0,70.0,2272,2244,1959,1931,313,313,538,209,365,110,173,99,37,42,1575,1825,1050,1100,100,50,0
307,0,2,70.0,67.0,78.0,70.0,2328,2272,2015,1959,313,313,353,319,265,230,88,89,37,42,1850,1925,1050,1100,100,50,0
314,0,2,72.0,71.0,86.0,78.0,2188,2294,1875,1959,313,335,348,319,220,240,128,79,39,44,1850,2275,1050,1100,100,50,0
321,0,2,74.0,71.0,86.0,78.0,2098,2328,1763,2015,335,313,148,585,80,470,68,115,39,44,1950,2275,1050,1100,100,50,0
329,0,2,75.0,69.0,86.0,78.0,2177,2300,1819,1987,358,313,288,770,105,615,183,155,41,46,1950,1925,975,1100,175,400,0
336,0,2,78.0,73.0,78.0,78.0,2154,1986,1819,1651,335,335,429,525,210,430,219,95,43,46,2225,2275,1075,1100,275,400,0
343,0,2,77.0,74.0,86.0,78.0,2132,1354,1819,1063,313,291,375,632,120,505,255,127,43,47,2175,2275,1075,1100,375,450,0
350,0,2,78.0,73.0,78.0,78.0,2233,1354,1875,1063,358,291,293,543,140,480,153,63,45,46,2075,2275,1150,1100,575,550,0
357,0,2,75.0,75.0,78.0,93.0,2283,1998,1903,1707,380,291,466,619,265,520,201,99,45,47,1825,2275,1300,1100,875,550,0
364,0,2,78.0,77.0,86.0,93.0,2266,2143,1819,1875,447,268,391,216,180,85,211,131,47,49,1875,2275,1300,1100,875,550,0
371,0,2,79.0,79.0,86.0,93.0,2160,2479,1735,2211,425,268,634,432,375,265,259,167,47,51,1975,2275,1300,1100,925,550,0
379,0,2,78.0,80.0,94.0,93.0,2037,2558,1679,2267,358,291,794,524,495,325,299,199,46,54,2025,2100,1300,1100,1100,725,0
386,0,2,84.0,81.0,94.0,93.0,2490,2770,2155,2435,335,335,590,664,305,425,285,239,46,56,2075,2100,1300,1100,1100,725,0
393,0,2,89.0,88.0,102.0,93.0,2832,2832,2519,2519,313,313,201,555,180,280,21,275,48,57,2125,2100,1300,1100,1100,725,0
400,0,2,90.0,90.0,110.0,93.0,2804,3028,2491,2715,313,313,426,315,365,200,61,115,48,58,2175,2400,1300,1100,1100,725,0
407,0,2,93.0,91.0,110.0,93.0,2821,2944,2463,2631,358,313,404,460,345,380,59,80,48,59,2475,2300,1400,1100,1100,825,0
414,0,2,100.0,97.0,118.0,101.0,2793,2916,2323,2491,470,425,339,410,270,270,69,140,48,62,2525,2300,1400,1700,1100,825,0
421,0,2,100.0,103.0,118.0,109.0,2754,3168,2239,2519,515,649,269,405,140,185,129,220,48,62,2925,2600,1400,1700,1100,825,0
429,0,2,103.0,105.0,126.0,117.0,2950,3269,2435,2575,515,694,290,685,180,385,110,300,48,62,3100,3100,1400,1850,1100,825,0
436,0,2,110.0,113.0,126.0,117.0,2905,3364,2435,2715,470,649,212,297,75,125,137,172,48,62,3475,3100,1400,2200,1100,825,0
443,0,2,111.0,111.0,126.0,117.0,2877,3224,2407,2575,470,649,477,446,280,198,197,248,48,62,3525,3400,1400,2300,1100,925,0
450,0,2,113.0,109.0,134.0,117.0,2653,3280,2183,2631,470,649,282,541,250,363,32,178,48,60,3400,3225,1400,2300,1400,1200,0
457,0,2,120.0,108.0,134.0,141.0,2597,2614,2127,2099,470,515,242,832,200,598,42,234,48,59,3725,3425,1400,2300,1400,1250,0
464,0,2,119.0,108.0,142.0,141.0,2614,2877,2099,2295,515,582,437,1207,335,893,102,314,48,59,3550,3425,1400,2300,1500,1250,0
471,0,2,113.0,116.0,142.0,141.0,1986,3302,1539,2631,447,671,391,902,295,508,96,394,48,59,3050,3675,1400,2300,2000,1800,0
479,0,2,109.0,84.0,142.0,141.0,1482,3336,1147,2687,335,649,132,1179,125,713,7,466,50,59,3125,1600,1400,2300,2775,3875,0
486,0,2,105.0,81.0,142.0,141.0,1404,2810,1091,2183,313,627,112,1295,90,703,22,592,50,54,2575,1575,1700,1950,3325,4612,0
493,0,2,106.0,74.0,157.0,141.0,1986,2412,1651,1763,335,649,377,980,315,458,62,522,52,54,2550,1500,1700,1700,3450,5862,0
500,0,2,105.0,69.0,157.0,141.0,2406,2384,2071,1735,335,649,306,705,275,303,31,402,53,53,2475,1225,1700,1700,3850,6337,0
507,0,2,100.0,62.0,157.0,133.0,2345,2362,1987,1735,358,627,490,796,415,318,75,478,53,46,2225,1225,1700,1700,4300,6887,0
514,0,2,92.0,60.0,157.0,133.0,2479,2434,2099,1763,380,671,544,1096,500,538,44,558,53,46,1925,1050,1700,1700,4700,7112,0
521,0,2,91.0,70.0,157.0,133.0,2434,2378,2099,1707,335,671,500,512,445,78,55,434,53,48,2025,1750,1700,1700,4950,7112,0
529,0,2,99.0,73.0,157.0,133.0,2322,2300,1987,1651,335,649,350,698,330,188,20,510,55,51,2025,1750,1775,1700,4950,7112,0
536,0,2,99.0,76.0,157.0,133.0,2132,2278,1707,1651,425,627,456,664,380,128,76,536,55,54,2125,1750,1775,2050,4950,7112,0
543,0,2,99.0,78.0,157.0,141.0,2451,2636,1847,1987,604,649,431,804,275,238,156,566,57,55,2150,2100,1775,2050,5050,7112,0
550,0,2,105.0,85.0,157.0,141.0,3532,2866,2883,2239,649,627,561,745,425,103,136,642,59,54,2475,2100,1875,2050,5050,7162,0
557,0,2,100.0,73.0,157.0,141.0,4193,2860,3499,2211,694,649,741,1100,575,378,166,722,59,54,1900,1525,1875,2050,5625,8237,0
564,0,2,106.0,74.0,157.0,141.0,4187,2905,3471,2211,716,694,566,760,470,108,96,652,61,54,1800,1575,1875,2050,5725,8712,0
571,0,2,109.0,71.0,157.0,141.0,4238,2832,3499,2183,739,649,705,892,575,168,130,724,61,53,2000,1225,1875,2050,5775,9212,0
579,0,2,112.0,69.0,157.0,133.0,4210,2838,3471,2211,739,627,691,1033,615,233,76,800,63,54,1725,900,1875,2050,6350,9737,0
586,0,2,110.0,63.0,157.0,133.0,4182,2776,3443,2127,739,649,613,1363,545,483,68,880,65,54,1375,650,1875,2050,6925,9837,0
593,0,2,111.0,71.0,157.0,133.0,4120,2860,3359,2211,761,649,599,913,435,153,164,760,65,54,1725,650,1875,2050,7125,9837,0
600,0,2,118.0,74.0,157.0,133.0,4137,2726,3331,2099,806,627,475,1024,340,188,135,836,67,54,2025,1350,1875,2050,7125,9837,0
607,0,2,118.0,74.0,157.0,133.0,3991,2714,3163,2043,828,671,742,954,515,238,227,716,67,54,2250,1350,1875,2050,7225,9837,0
614,0,2,127.0,83.0,157.0,141.0,3739,2888,2799,2239,940,649,143,611,75,123,68,488,67,57,2600,1750,1875,2050,7225,9837,0
621,0,2,129.0,81.0,157.0,141.0,3874,2950,2911,2323,963,627,475,952,295,388,180,564,67,57,2900,1850,1875,2050,7225,9937,0
629,0,2,136.0,85.0,165.0,141.0,4126,3062,3163,2435,963,627,105,928,55,288,50,640,67,58,2925,1450,1875,2050,7325,10437,0
7,1,2,13.0,13.0,14.0,15.0,377,293,377,293,0,0,45,35,45,35,0,0,12,12,0,0,0,0,0,0,1
14,1,2,13.0,14.0,14.0,15.0,671,671,671,671,0,0,20,70,20,70,0,0,13,13,0,0,0,0,0,0,1
21,1,2,14.0,14.0,14.0,15.0,727,699,727,699,0,0,55,0,55,0,0,0,13,13,0,0,0,0,0,0,1
29,1,2,14.0,15.0,14.0,15.0,783,699,783,699,0,0,155,30,155,30,0,0,13,14,0,0,0,0,0,0,1
36,1,2,16.0,15.0,22.0,15.0,811,755,811,755,0,0,155,140,155,140,0,0,14,14,0,0,0,0,0,0,1
43,1,2,16.0,16.0,22.0,23.0,783,811,783,811,0,0,235,35,235,35,0,0,16,15,0,0,0,0,0,0,1
50,1,2,15.0,17.0,22.0,23.0,839,839,839,839,0,0,40,50,40,50,0,0,15,16,0,0,0,0,0,0,1
57,1,2,17.0,18.0,22.0,23.0,839,867,839,867,0,0,40,65,40,65,0,0,15,17,0,0,0,0,0,0,1
64,1,2,18.0,18.0,22.0,23.0,839,979,839,979,0,0,95,135,95,135,0,0,16,17,0,0,0,0,0,0,1
71,1,2,17.0,19.0,22.0,23.0,923,979,923,979,0,0,180,245,180,245,0,0,17,18,0,0,0,0,0,0,1
79,1,2,17.0,20.0,22.0,23.0,923,1124,923,1035,0,89,40,376,40,360,0,16,16,19,0,0,0,0,0,0,1
86,1,2,18.0,20.0,22.0,23.0,923,1090,923,979,0,111,110,103,110,75,0,28,16,19,0,0,0,0,0,0,1
93,1,2,19.0,20.0,22.0,23.0,973,1113,951,979,22,134,169,73,165,25,4,48,18,20,0,0,0,150,0,0,1
100,1,2,20.0,21.0,22.0,23.0,934,1107,867,951,67,156,232,79,220,15,12,64,19,20,0,0,0,150,0,0,1
107,1,2,20.0,22.0,22.0,23.0,1085,1107,951,951,134,156,372,164,340,80,32,84,19,21,0,0,0,150,0,0,1
114,1,2,20.0,22.0,22.0,23.0,1023,1135,867,979,156,156,393,144,345,40,48,104,20,21,0,0,0,150,0,0,1
121,1,2,26.0,23.0,28.0,23.0,1079,1107,923,951,156,156,123,224,55,100,68,124,20,22,0,0,250,150,0,0,1
129,1,2,26.0,25.0,36.0,31.0,1135,1197,979,951,156,246,268,250,180,115,88,135,20,22,0,0,250,300,0,0,1
136,1,2,28.0,26.0,36.0,31.0,1057,1258,923,923,134,335,294,46,190,25,104,21,20,23,0,0,250,300,0,0,1
143,1,2,30.0,27.0,36.0,31.0,1079,1286,1035,951,44,335,324,46,220,35,104,11,22,24,100,0,250,300,0,0,1
150,1,2,30.0,28.0,36.0,31.0,1091,1236,1091,923,0,313,254,102,250,55,4,47,22,25,100,0,250,300,0,0,1
157,1,2,30.0,30.0,36.0,46.0,1203,1320,1203,1007,0,313,49,167,45,80,4,87,23,26,400,0,250,300,0,0,1
164,1,2,31.0,34.0,36.0,46.0,1315,1376,1315,1063,0,313,169,157,165,55,4,102,23,28,400,125,250,300,0,0,1
171,1,2,34.0,34.0,36.0,46.0,1315,1538,1315,1203,0,335,14,297,10,155,4,142,25,28,400,125,250,300,0,0,1
179,1,2,36.0,40.0,36.0,46.0,1371,1678,1371,1343,0,335,84,98,80,70,4,28,25,30,400,125,250,600,0,0,1
186,1,2,36.0,42.0,36.0,46.0,1427,1706,1427,1371,0,335,159,88,155,20,4,68,27,32,400,125,250,600,0,0,1
193,1,2,40.0,42.0,44.0,46.0,1567,1740,1567,1427,0,313,104,144,100,40,4,104,28,32,400,250,250,600,0,0,1
200,1,2,44.0,44.0,44.0,46.0,1623,1796,1623,1483,0,313,79,309,75,165,4,144,28,34,400,250,250,600,0,0,1
207,1,2,47.0,45.0,52.0,54.0,1617,1874,1595,1539,22,335,78,489,70,305,8,184,32,35,550,250,250,600,0,0,1
214,1,2,47.0,46.0,52.0,54.0,1762,1908,1651,1595,111,313,199,310,175,90,24,220,34,36,550,650,250,600,0,0,1
221,1,2,48.0,48.0,52.0,54.0,1863,1936,1707,1623,156,313,259,355,215,95,44,260,35,38,550,650,250,600,0,0,1
229,1,2,51.0,48.0,58.0,54.0,1998,1986,1819,1651,179,335,304,340,240,40,64,300,35,38,700,650,250,600,100,0,1
236,1,2,59.0,50.0,66.0,62.0,1947,2126,1791,1791,156,335,125,500,45,160,80,340,37,40,700,650,250,600,100,0,1
243,1,2,60.0,51.0,66.0,62.0,2003,2126,1847,1791,156,335,225,751,125,375,100,376,37,41,850,650,250,600,100,0,1
250,1,2,60.0,53.0,66.0,62.0,2087,2238,1931,1903,156,335,220,911,100,495,120,416,41,43,950,650,250,600,100,0,1
257,1,2,63.5,56.0,74.0,62.0,2003,2266,1847,1707,156,559,250,321,110,175,140,146,42,44,925,825,250,600,125,0,1
264,1,2,65.5,57.0,74.0,62.0,2087,2306,1931,1679,156,627,305,352,145,130,160,222,45,45,1075,825,250,600,125,0,1
271,1,2,65.5,59.0,74.0,62.0,2306,2384,2127,1735,179,649,385,543,205,245,180,298,46,47,1175,825,500,600,125,0,1
279,1,2,70.5,60.0,82.0,62.0,2362,2334,2183,1707,179,627,415,711,215,345,200,366,47,48,1175,825,500,600,125,0,1
286,1,2,71.5,62.0,82.0,77.0,2479,2496,2323,1847,156,649,346,991,230,545,116,446,50,50,1175,825,500,600,125,0,1
293,1,2,73.5,66.0,82.0,85.0,2591,2530,2435,1903,156,627,456,627,320,205,136,422,50,51,1225,825,500,600,125,0,1
300,1,2,74.0,72.0,82.0,85.0,2675,2530,2519,1903,156,627,326,257,170,55,156,202,52,53,1250,825,500,1300,150,0,1
307,1,2,74.5,76.0,90.0,85.0,2871,2832,2715,2183,156,649,476,207,300,25,176,182,53,55,1225,1075,500,1300,175,0,1
314,1,2,81.5,80.0,90.0,85.0,2927,3101,2771,2407,156,694,396,362,200,125,196,237,53,57,1275,1200,700,1300,175,0,1
321,1,2,78.0,82.0,106.0,93.0,2843,3185,2575,2491,268,694,567,418,335,105,232,313,58,59,1250,1200,700,1300,200,0,1
329,1,2,84.0,87.0,106.0,93.0,2882,3118,2547,2267,335,851,572,346,300,125,272,221,57,60,1250,1700,700,1300,200,0,1
336,1,2,89.0,91.0,106.0,93.0,2888,3286,2575,2323,313,963,448,193,140,60,308,133,64,62,1250,1950,700,1300,200,0,1
343,1,2,91.5,93.0,106.0,93.0,3000,3370,2575,2407,425,963,258,308,90,155,168,153,64,64,1275,1950,950,1400,225,0,1
350,1,2,94.0,92.0,106.0,93.0,3274,3409,2491,2491,783,918,407,520,135,255,272,265,67,66,1200,2200,1075,1400,300,250,1
357,1,2,94.0,93.0,114.0,93.0,3728,3459,2743,2519,985,940,352,395,160,210,192,185,67,67,1200,2450,1075,1400,300,250,1
364,1,2,101.0,96.0,114.0,109.0,3801,3610,2771,2603,1030,1007,447,221,135,20,312,201,72,67,1200,2450,1075,1400,300,300,1
371,1,2,101.5,98.0,106.0,109.0,3840,3566,2855,2603,985,963,670,149,250,40,420,109,71,68,1475,2700,1075,1400,425,300,1
379,1,2,103.5,98.0,112.0,109.0,3812,3515,2827,2575,985,940,631,82,95,65,536,17,72,68,1575,2700,1075,1400,725,300,1
386,1,2,100.0,100.0,112.0,125.0,3538,3644,2575,2659,963,985,987,722,335,485,652,237,68,67,1550,2950,1075,1400,950,350,1
393,1,2,99.0,102.0,128.0,125.0,3235,3627,2295,2687,940,940,1283,1174,515,825,768,349,73,67,1550,3450,1200,1400,950,350,1
400,1,2,106.0,104.0,128.0,125.0,3571,3689,2631,2771,940,918,908,626,20,365,888,261,73,68,1250,3450,1200,1550,1250,350,1
407,1,2,103.5,109.0,128.0,125.0,3890,3778,2883,2771,1007,1007,1088,121,80,40,1008,81,70,67,1225,3800,1200,1550,1425,400,1
414,1,2,106.0,109.0,120.0,125.0,3913,3784,2883,2799,1030,985,1304,677,180,480,1124,197,75,67,1150,4050,1325,1550,1650,800,1
421,1,2,105.0,111.0,120.0,133.0,3840,3627,2855,2687,985,940,1591,454,355,145,1236,309,77,67,1100,4300,1900,1550,1850,800,1
429,1,2,110.5,114.0,120.0,133.0,3986,3734,3023,2771,963,963,1261,589,213,260,1048,329,82,67,975,4550,2025,1550,1837,800,1
436,1,2,114.5,115.0,120.0,133.0,4182,3661,3219,2631,963,1030,1016,344,148,220,868,124,83,68,1425,4550,2025,2050,1937,800,1
443,1,2,115.5,119.0,128.0,141.0,4355,3627,3415,2687,940,940,1157,153,273,75,884,78,82,68,1425,4800,2025,2050,1937,800,1
450,1,2,121.0,123.0,128.0,141.0,4456,3762,3471,2799,985,963,947,173,243,75,704,98,82,70,1400,5050,2025,2200,1962,800,1
457,1,2,126.0,126.0,128.0,141.0,4590,3700,3583,2715,1007,985,932,359,308,145,624,214,82,71,2150,5300,2025,2200,1962,800,1
464,1,2,132.0,128.0,136.0,141.0,4568,3739,3583,2799,985,940,665,801,233,475,432,326,81,73,2900,5650,2025,2200,2012,800,1
471,1,2,128.0,127.0,136.0,141.0,4518,3734,3555,2771,963,963,1101,712,553,470,548,242,81,74,2650,4900,2025,2350,2512,1550,1
479,1,2,132.0,131.0,136.0,141.0,4495,3806,3555,2799,940,1007,638,557,378,395,260,162,82,76,2950,5150,2025,2350,3012,1550,1
486,1,2,130.0,130.0,144.0,141.0,4439,3706,3499,2743,940,963,1189,659,813,485,376,174,82,77,3200,4900,2025,2650,3262,1800,1
493,1,2,134.0,135.0,144.0,156.0,4411,3840,3471,2855,940,985,714,1015,618,725,96,290,82,79,3450,5150,2025,2650,3762,1800,1
500,1,2,126.0,140.0,144.0,156.0,4176,3902,3191,2939,985,963,699,646,483,540,216,106,78,80,2950,5400,2025,2650,4462,2050,1
507,1,2,125.0,135.0,144.0,156.0,4036,3986,2939,3023,1097,963,955,1012,603,790,352,222,76,83,3450,4400,2025,2800,4962,3050,1
514,1,2,133.0,137.0,176.0,156.0,4131,4081,2967,3163,1164,918,349,874,165,640,184,234,77,85,3450,4400,2025,2800,4962,3050,1
521,1,2,138.0,143.0,176.0,156.0,4165,4226,3023,3331,1142,895,251,582,85,340,166,242,84,87,4450,5250,2025,2800,4962,3050,1
529,1,2,138.0,145.0,176.0,156.0,4170,4210,3051,3247,1119,963,747,787,445,525,302,262,84,87,4450,5600,2025,2800,4962,3050,1
536,1,2,144.0,151.0,176.0,156.0,4058,3913,2827,2995,1231,918,488,496,330,430,158,66,88,89,4450,5850,2025,2800,4962,3050,1
543,1,2,150.5,153.0,176.0,156.0,4238,4008,2939,3023,1299,985,598,325,280,235,318,90,87,89,5025,6100,2025,2800,4987,3050,1
550,1,2,150.5,151.0,176.0,156.0,4198,4316,2967,3107,1231,1209,953,836,495,590,458,246,84,89,5025,5850,2025,3050,5137,3300,1
557,1,2,154.5,147.0,176.0,156.0,4238,4490,2939,3191,1299,1299,464,1127,250,825,214,302,84,89,4925,5600,2275,3050,5637,4050,1
564,1,2,154.5,143.0,176.0,156.0,4422,4607,3079,3331,1343,1276,340,1974,120,1420,220,554,87,89,5675,5850,2275,3500,5637,4050,1
571,1,2,158.5,155.0,176.0,156.0,4439,4708,3163,3387,1276,1321,504,715,190,705,314,10,87,89,5675,5600,2275,3650,5637,4300,1
579,1,2,150.5,145.0,176.0,156.0,4439,4714,3163,3415,1276,1299,1034,1263,560,1105,474,158,87,89,4825,4475,2275,3650,6487,5425,1
586,1,2,155.5,141.0,184.0,156.0,4579,4697,3303,3443,1276,1254,340,1080,210,1020,130,60,86,91,5325,3775,2275,3650,6987,6125,1
593,1,2,154.5,141.0,184.0,164.0,4462,4669,3163,3415,1299,1254,716,626,430,410,286,216,85,91,5525,3775,2275,3650,6987,6125,1
600,1,2,160.5,141.0,184.0,164.0,4428,4652,3107,3331,1321,1321,306,841,110,715,196,126,85,91,5525,3775,2275,3650,6987,5975,1
607,1,2,155.5,143.0,184.0,164.0,4506,4708,3163,3387,1343,1321,308,867,160,735,148,132,85,89,4475,3525,2400,4000,8037,6325,1
614,1,2,164.0,148.0,214.0,172.0,4428,4820,3107,3499,1321,1321,345,730,170,450,175,280,85,88,5850,4050,2400,4000,8112,6450,1
621,1,2,165.0,149.0,214.0,164.0,4131,4534,2855,3191,1276,1343,677,985,350,545,327,440,83,88,5850,5010,2400,4900,8112,6550,1
629,1,2,174.0,155.0,214.0,164.0,3879,4277,2603,3023,1276,1254,498,984,190,650,308,334,82,88,6100,5670,2400,5050,8112,6550,1
636,1,2,177.0,154.0,214.0,164.0,4036,4305,2760,3051,1276,1254,423,1069,305,575,118,494,85,88,7100,5700,2750,5050,8112,6600,1
643,1,2,177.5,166.0,214.0,172.0,4154,4411,2855,3135,1299,1276,748,871,474,225,274,646,84,88,7075,5730,2750,5050,8137,6600,1
650,1,2,189.0,165.0,214.0,172.0,4428,4372,3062,3051,1366,1321,669,1357,385,555,284,802,84,87,7550,7020,2750,5050,8162,6650,1
657,1,2,200.0,169.0,214.0,180.0,4719,4658,3376,3359,1343,1299,619,1275,333,525,286,750,86,87,7500,7050,2750,5050,8212,6350,1
664,1,2,197.0,177.0,220.0,188.0,4803,4568,3460,3247,1343,1321,1083,706,641,250,442,456,86,87,8100,7065,2750,5050,8212,6350,1
671,1,2,195.0,184.0,220.0,188.0,4775,4445,3208,3191,1567,1254,1168,574,626,220,542,354,84,87,8100,7080,3075,5050,8212,6350,1
679,1,2,200.0,188.0,220.0,188.0,4837,4557,3225,3303,1612,1254,803,404,415,190,388,214,84,87,8700,7095,3075,5200,8212,6350,1
686,1,2,199.0,190.0,228.0,196.0,4949,4490,3292,3191,1657,1299,1158,814,774,390,384,424,84,88,8700,7560,3075,5350,8212,6350,1
693,1,2,197.0,194.0,228.0,196.0,4916,4394,3281,3051,1635,1343,1742,1135,1162,555,580,580,84,88,8850,8245,3075,5350,8512,6365,1
700,1,2,198.0,186.0,228.0,196.0,5100,4316,3443,2995,1657,1321,1851,1636,1283,900,568,736,84,88,8700,7810,3075,5350,8662,7015,1
707,1,2,198.0,193.0,228.0,196.0,4821,4344,3186,3023,1635,1321,2292,1339,1528,1055,764,284,84,87,8700,7810,3625,5500,8662,7215,1
714,1,2,197.0,187.0,228.0,188.0,4551,4204,2939,2883,1612,1321,2117,2149,1490,1705,627,444,81,81,9200,7810,3625,5500,8662,7315,1
721,1,2,199.5,186.0,228.0,188.0,4613,4137,3001,2883,1612,1254,2385,2422,1762,1980,623,442,81,78,9125,8920,3625,5500,8737,7465,1
729,1,2,198.5,188.0,228.0,188.0,4798,4025,3208,2771,1590,1254,2963,2068,2144,1620,819,448,81,78,9575,11090,3625,5500,8787,7465,1
736,1,2,198.5,187.0,228.0,188.0,4770,3986,3135,2687,1635,1299,3508,2948,2493,2340,1015,608,81,76,9575,10735,3750,5500,8787,7565,1
743,1,2,191.5,185.0,228.0,196.0,4759,3918,2900,2575,1859,1343,2925,3369,2303,2605,622,764,81,76,9325,10605,3750,5500,9287,7740,1
750,1,2,179.5,189.0,228.0,196.0,4720,3935,2749,2659,1971,1276,3126,2683,2480,2475,646,208,79,77,9075,10800,3750,5350,9837,8190,1
757,1,2,177.5,187.0,228.0,196.0,4691,3851,2788,2575,1903,1276,3677,2294,2807,1930,870,364,79,77,8975,10695,3750,5350,9937,8490,1
764,1,2,186.5,187.0,228.0,196.0,4686,3717,2760,2463,1926,1254,3791,1937,2681,1425,1110,512,79,77,8975,11795,3750,5350,9937,8490,1
771,1,2,183.0,178.0,228.0,196.0,4753,3644,2827,2435,1926,1209,4152,2280,2806,1620,1346,660,79,66,8550,11795,3750,5350,10362,9140,1
779,1,2,199.0,187.0,228.0,196.0,4675,3252,2749,2043,1926,1209,3605,2203,2598,1395,1007,808,79,67,8550,11795,3750,5500,10362,9140,1
786,1,2,187.5,183.0,228.0,212.0,4764,3336,2771,2127,1993,1209,4168,2582,2925,1630,1243,952,79,69,9225,11935,3750,5650,10912,9400,1
793,1,2,173.0,179.0,228.0,212.0,4820,3330,2827,2099,1993,1231,4731,2940,3264,1840,1467,1100,79,69,8250,11510,4150,5650,11887,9825,1
800,1,2,191.5,197.0,228.0,212.0,4770,3302,2799,2071,1971,1231,3837,1511,2509,1025,1328,486,79,69,8075,11555,4150,5650,12562,9840,1
807,1,2,191.5,200.0,228.0,212.0,4809,3364,2883,2155,1926,1209,4399,1055,2843,575,1556,480,79,69,8075,11585,4150,5650,12562,9840,1
814,1,2,190.5,196.0,228.0,212.0,4736,3319,2788,2155,1948,1164,3615,526,2498,210,1117,316,79,71,9175,11400,4150,6250,12612,10040,1
821,1,2,183.5,194.0,228.0,212.0,4428,3319,2525,2155,1903,1164,3906,755,2661,295,1245,460,72,72,9175,11165,4600,6250,12962,10290,1
829,1,2,188.0,190.0,228.0,212.0,3863,3286,1937,2099,1926,1187,3866,1143,2393,535,1473,608,67,72,9100,10680,4600,6250,13287,10790,1
836,1,2,182.0,192.0,228.0,235.0,3913,3448,1965,2239,1948,1209,4337,656,2632,500,1705,156,77,72,8650,9855,4600,6650,13737,11715,1
843,1,2,180.0,190.0,228.0,235.0,3907,3577,2004,2323,1903,1254,4784,1079,2863,775,1921,304,77,72,9300,10280,4600,6800,13837,11965,1
850,1,2,194.0,189.0,228.0,235.0,3975,3683,2094,2407,1881,1276,4541,899,2396,455,2145,444,77,72,9300,12415,4450,6800,13880,12065,1
857,1,2,191.0,199.0,228.0,235.0,3896,3532,2060,2323,1836,1209,5029,790,2660,210,2369,580,74,72,9300,12445,4300,6800,14180,12065,1
864,1,2,186.0,197.0,228.0,235.0,3633,3711,1931,2547,1702,1164,5435,1225,2862,505,2573,720,71,73,9750,12860,4300,7050,14580,12165,1
871,1,2,175.5,187.0,228.0,235.0,3650,3711,1971,2547,1679,1164,5605,1298,2974,430,2631,868,71,73,8925,11745,4300,7050,15405,13625,1
879,1,2,171.5,173.0,228.0,243.0,4132,3683,2430,2519,1702,1164,5006,1637,2450,625,2556,1012,71,73,7175,10470,4050,7050,17405,14975,1
886,1,2,177.0,159.0,228.0,243.0,4132,3498,2385,2267,1747,1231,1237,840,177,180,1060,660,71,73,4350,7825,4050,7050,20605,17680,1
893,1,2,151.0,155.0,228.0,243.0,4137,3515,2458,2239,1679,1276,1427,925,254,125,1173,800,71,73,1250,6755,3925,7050,23830,18780,1
900,1,2,148.5,161.0,228.0,243.0,3941,3358,2441,2127,1500,1231,2090,1010,620,70,1470,940,71,73,2075,7085,3800,7050,24230,18795,1
907,1,2,158.0,159.0,220.0,243.0,3594,3151,2206,1987,1388,1164,1613,1266,204,190,1409,1076,71,73,1700,7170,3550,7050,24955,19025,1
914,1,2,159.0,166.0,208.0,243.0,3163,3297,2021,1987,1142,1310,868,1320,106,70,762,1250,68,73,5200,7170,3550,7050,26355,19025,1
921,1,2,157.0,162.0,208.0,243.0,2956,3582,1926,2183,1030,1399,1232,1658,342,240,890,1418,68,75,6850,6865,3550,7050,26680,19745,1
929,1,2,153.0,162.0,192.0,243.0,2911,3902,1881,2491,1030,1411,1163,1671,249,310,914,1361,67,76,6200,6880,3550,7050,27680,19745,1
936,1,2,155.0,167.0,168.0,258.0,2872,3902,1797,2491,1075,1411,1112,461,170,140,942,321,67,76,5900,7340,3350,7050,28480,20345,1
943,1,2,144.0,163.0,168.0,258.0,2956,3818,1881,2407,1075,1411,1460,866,394,385,1066,481,67,76,5400,7815,3350,7050,29380,20545,1
7,2,0,13.0,13.0,15.0,15.0,335,293,335,293,0,0,40,35,40,35,0,0,12,12,0,0,0,0,0,0,1
14,2,0,14.0,14.0,15.0,15.0,671,671,671,671,0,0,70,70,70,70,0,0,13,13,0,0,0,0,0,0,1
21,2,0,14.0,14.0,15.0,15.0,727,727,727,727,0,0,50,5,50,5,0,0,13,13,0,0,0,0,0,0,1
29,2,0,15.0,15.0,15.0,15.0,727,727,727,727,0,0,90,90,90,90,0,0,14,14,0,0,0,0,0,0,1
36,2,0,15.0,15.0,15.0,15.0,839,727,839,727,0,0,150,125,150,125,0,0,14,14,0,0,0,0,0,0,1
43,2,0,16.0,16.0,23.0,23.0,839,783,839,783,0,0,40,75,40,75,0,0,15,15,0,0,0,0,0,0,1
50,2,0,17.0,16.0,23.0,23.0,839,783,839,783,0,0,60,45,60,45,0,0,16,15,0,0,0,0,0,0,1
57,2,0,18.0,17.0,23.0,23.0,839,783,839,783,0,0,60,135,60,135,0,0,17,16,0,0,0,0,0,0,1
64,2,0,19.0,18.0,23.0,23.0,923,811,923,811,0,0,175,180,175,180,0,0,18,17,0,0,0,0,0,0,1
71,2,0,19.0,18.0,23.0,23.0,973,850,951,783,22,67,289,282,285,270,4,12,18,17,0,0,0,0,0,0,1
79,2,0,20.0,19.0,23.0,23.0,1018,911,951,755,67,156,362,343,350,315,12,28,19,18,0,0,0,0,0,0,1
86,2,0,20.0,19.0,23.0,23.0,1012,995,923,839,89,156,84,463,60,415,24,48,19,18,0,0,150,0,0,0,1
93,2,0,20.0,20.0,23.0,23.0,1085,967,951,811,134,156,59,333,15,315,44,18,20,19,0,0,150,150,0,0,1
100,2,0,21.0,20.0,23.0,23.0,1051,1051,895,895,156,156,65,58,5,20,60,38,20,19,0,0,150,150,0,0,1
107,2,0,22.0,20.0,23.0,23.0,1051,1051,895,895,156,156,131,183,55,125,76,58,21,19,0,0,150,150,0,0,1
114,2,0,22.0,21.0,23.0,23.0,1079,1018,923,839,156,179,116,103,20,25,96,78,21,19,0,0,150,150,0,0,1
121,2,0,23.0,21.0,23.0,23.0,1051,1018,895,839,156,179,241,118,125,70,116,48,22,19,0,100,150,150,0,0,1
129,2,0,23.0,22.0,31.0,23.0,1202,1135,979,979,223,156,339,209,195,145,144,64,22,20,0,100,300,150,0,0,1
136,2,0,25.0,22.0,31.0,23.0,1141,1331,895,1175,246,156,247,229,150,145,97,84,22,20,0,100,300,150,50,0,1
143,2,0,26.0,23.0,31.0,23.0,1264,1303,951,1147,313,156,107,124,70,120,37,4,23,21,0,100,300,150,50,0,1
150,2,0,28.0,23.0,31.0,23.0,1286,1303,951,1147,335,156,78,139,55,115,23,24,23,22,125,100,300,150,50,0,1
157,2,0,30.0,26.0,46.0,31.0,1264,1270,951,1091,313,179,74,179,15,135,59,44,24,22,125,100,300,400,50,0,1
164,2,0,32.0,27.0,46.0,31.0,1292,1326,979,1147,313,179,184,194,85,155,99,39,26,23,125,100,300,400,50,0,1
171,2,0,32.0,27.0,46.0,46.0,1348,1376,1035,1175,313,201,304,348,165,285,139,63,26,23,125,100,300,400,50,0,1
179,2,0,34.0,30.0,46.0,46.0,1460,1466,1147,1175,313,291,129,219,100,120,29,99,28,24,125,200,550,475,50,0,1
186,2,0,34.0,31.0,46.0,46.0,1538,1404,1203,1091,335,313,164,124,95,85,69,39,29,24,300,200,550,475,50,0,1
193,2,0,36.0,32.0,46.0,46.0,1645,1432,1287,1119,358,313,264,159,155,80,109,79,30,25,300,200,550,725,50,0,1
200,2,0,40.0,34.0,46.0,46.0,1678,1370,1343,1035,335,335,175,79,80,60,95,19,32,25,300,350,550,725,50,0,1
207,2,0,40.0,35.0,46.0,46.0,1684,1421,1371,1063,313,358,146,44,115,35,31,9,32,26,300,350,550,725,50,0,1
214,2,0,42.0,38.0,46.0,46.0,1712,1538,1399,1203,313,335,151,140,80,95,71,45,34,26,300,450,550,725,50,0,1
221,2,0,42.0,40.0,46.0,46.0,1712,1600,1399,1287,313,313,216,106,105,25,111,81,34,27,300,500,550,725,50,0,1
229,2,0,44.0,42.0,46.0,46.0,1824,1740,1511,1427,313,313,276,266,125,145,151,121,36,28,475,500,550,725,50,0,1
236,2,0,45.0,46.0,54.0,46.0,1930,1852,1595,1539,335,313,356,296,165,135,191,161,37,30,475,600,700,975,50,0,1
243,2,0,50.0,47.0,54.0,54.0,2042,1930,1707,1595,335,335,247,406,120,205,127,201,38,30,650,650,700,1075,50,0,1
250,2,0,52.0,54.0,54.0,54.0,2042,1846,1707,1511,335,335,337,81,245,40,92,41,39,32,825,700,1050,1075,50,0,1
257,2,0,53.0,54.0,54.0,54.0,2121,2266,1763,1931,358,335,421,157,285,105,136,52,40,32,825,750,1050,1075,50,0,1
264,2,0,54.0,58.0,62.0,62.0,2177,2216,1707,1903,470,313,536,103,340,15,196,88,41,34,825,800,1050,1075,50,0,1
271,2,0,55.0,59.0,62.0,62.0,2322,2160,1875,1847,447,313,418,218,370,90,48,128,42,34,925,850,1050,1150,50,0,1
279,2,0,58.0,61.0,62.0,62.0,2401,2132,1931,1819,470,313,453,378,345,210,108,168,44,36,925,1300,1050,1150,50,0,1
286,2,0,61.0,65.0,62.0,70.0,2373,2216,1791,1903,582,313,494,168,360,85,134,83,45,37,1100,1350,1050,1275,50,0,1
293,2,0,61.0,67.0,70.0,70.0,2462,2238,1791,1903,671,335,289,43,75,20,214,23,46,38,1100,1400,1050,1275,50,0,1
300,2,0,63.0,68.0,70.0,70.0,2524,2401,1875,1931,649,470,306,173,70,140,236,33,46,39,1100,1400,1050,1275,50,0,1
307,2,0,63.0,67.0,62.0,70.0,2462,2451,1791,1959,671,492,596,290,280,205,316,85,46,40,1275,1250,1400,1275,150,150,1
314,2,0,55.0,69.0,70.0,78.0,2373,2289,1791,1819,582,470,871,156,495,115,376,41,40,41,1350,1575,1400,1275,625,200,1
321,2,0,55.0,68.0,78.0,78.0,1550,2289,1147,1819,403,470,849,341,475,240,374,101,38,42,1350,1375,1400,1275,725,400,1
329,2,0,56.0,63.0,70.0,78.0,1342,2261,1007,1791,335,470,969,626,555,465,414,161,38,43,1525,1075,1400,1275,825,800,1
336,2,0,58.0,62.0,70.0,78.0,1370,2507,1035,1903,335,604,984,411,530,295,454,116,39,44,1525,625,1400,1425,825,1300,1
343,2,0,59.0,64.0,70.0,78.0,1090,2709,755,2015,335,694,1014,516,520,320,494,196,40,45,1525,625,1400,1425,825,1300,1
350,2,0,60.0,71.0,70.0,78.0,1482,2709,1147,2015,335,694,865,167,335,95,530,72,41,47,1525,675,1400,1425,825,1300,1
357,2,0,59.0,71.0,70.0,78.0,2048,2832,1623,2183,425,649,1066,464,480,320,586,144,42,47,1350,550,1400,1425,1000,1575,1
364,2,0,60.0,68.0,93.0,94.0,2334,2737,1707,2155,627,582,1292,482,630,270,662,212,43,46,1350,450,1400,1425,1000,1775,1
371,2,0,64.0,75.0,93.0,94.0,2412,2558,1763,2043,649,515,1293,366,605,215,688,151,44,46,1350,925,1400,1425,1000,1775,1
379,2,0,65.0,80.0,93.0,94.0,2468,2765,1819,2183,649,582,1048,111,480,80,568,31,45,47,1525,1375,1400,1425,1000,1775,1
386,2,0,68.0,79.0,93.0,94.0,2496,2910,1847,2239,649,671,1079,402,585,295,494,107,48,44,1550,1475,1400,1425,1175,1925,1
393,2,0,71.0,82.0,93.0,94.0,2496,2261,1847,1679,649,582,984,467,410,300,574,167,51,43,1550,1625,1400,1425,1175,1975,1
400,2,0,73.0,79.0,93.0,94.0,2558,2087,1931,1595,627,492,1087,619,445,400,642,219,53,43,1550,1350,1700,1425,1175,2250,1
407,2,0,79.0,87.0,93.0,94.0,2720,2210,2071,1651,649,559,907,516,335,350,572,166,54,44,1550,2025,1700,1425,1175,2250,1
414,2,0,76.0,88.0,101.0,102.0,2636,2614,1987,1987,649,627,1209,752,565,510,644,242,55,45,1875,2275,1700,1425,1525,2250,1
421,2,0,72.0,94.0,101.0,102.0,2395,2782,1791,2155,604,627,931,662,365,540,566,122,48,45,2050,2375,1700,1425,1875,2250,1
429,2,0,70.0,90.0,101.0,102.0,2418,2860,1791,2211,627,649,1126,852,480,650,646,202,48,45,1700,2175,1700,1425,2225,2600,1
436,2,0,77.0,87.0,101.0,102.0,2468,2910,1819,2239,649,671,806,957,230,775,576,182,49,45,1700,2200,1700,1425,2225,2850,1
443,2,0,74.0,91.0,101.0,102.0,1908,2854,1371,2183,537,671,997,993,365,735,632,258,48,45,2225,2200,1850,1425,2425,3050,1
450,2,0,74.0,91.0,101.0,102.0,441,2882,195,2211,246,671,626,404,70,295,556,109,44,45,2225,2350,1850,1425,2675,3350,1
457,2,0,71.0,93.0,101.0,102.0,323,2860,279,2211,44,649,826,690,170,505,656,185,44,47,2225,2450,1750,1425,3275,3350,1
464,2,0,66.0,93.0,101.0,102.0,1119,2810,1119,2183,0,627,661,976,55,715,606,261,46,47,1525,2325,1750,1425,4150,3625,1
471,2,0,56.0,90.0,101.0,102.0,1735,2770,1735,2099,0,671,881,1181,275,840,606,341,47,47,750,2175,1750,1425,5025,3775,1
7,1,0,13.0,13.0,14.0,15.0,335,335,335,335,0,0,40,40,40,40,0,0,12,12,0,0,0,0,0,0,1
14,1,0,13.0,14.0,14.0,15.0,671,671,671,671,0,0,20,70,20,70,0,0,13,13,0,0,0,0,0,0,1
21,1,0,14.0,14.0,14.0,15.0,671,671,671,671,0,0,50,45,50,45,0,0,13,13,0,0,0,0,0,0,1
29,1,0,14.0,15.0,14.0,15.0,755,671,755,671,0,0,155,40,155,40,0,0,13,14,0,0,0,0,0,0,1
36,1,0,16.0,15.0,22.0,15.0,727,755,727,755,0,0,140,135,140,135,0,0,14,14,0,0,0,0,0,0,1
43,1,0,16.0,16.0,22.0,23.0,839,811,839,811,0,0,240,75,240,75,0,0,16,15,0,0,0,0,0,0,1
50,1,0,15.0,16.0,22.0,23.0,783,783,783,783,0,0,30,40,30,40,0,0,15,15,0,0,0,0,0,0,1
57,1,0,17.0,17.0,22.0,23.0,783,783,783,783,0,0,25,90,25,90,0,0,15,16,0,0,0,0,0,0,1
64,1,0,18.0,18.0,22.0,23.0,895,867,895,867,0,0,85,180,85,180,0,0,16,17,0,0,0,0,0,0,1
71,1,0,17.0,18.0,22.0,23.0,839,850,839,783,0,67,160,287,160,275,0,12,17,17,0,0,0,0,0,0,1
79,1,0,17.0,19.0,22.0,23.0,923,934,923,755,0,179,20,347,20,315,0,32,16,18,0,0,0,0,0,0,1
86,1,0,18.0,19.0,22.0,23.0,951,990,951,811,0,179,85,462,85,410,0,52,16,18,0,0,0,0,0,0,1
93,1,0,19.0,20.0,22.0,23.0,923,995,923,839,0,156,135,328,135,310,0,18,18,19,0,0,0,150,0,0,1
100,1,0,19.0,20.0,22.0,23.0,1018,995,951,839,67,156,267,448,255,410,12,38,19,19,0,0,0,150,0,0,1
107,1,0,20.0,20.0,22.0,23.0,1051,967,895,811,156,156,337,158,305,100,32,58,19,19,0,0,0,150,0,0,1
114,1,0,21.0,21.0,22.0,23.0,1107,939,951,783,156,156,423,123,375,45,48,78,20,19,0,0,0,150,0,0,1
121,1,0,21.0,22.0,28.0,23.0,1012,1051,923,895,89,156,536,203,480,105,56,98,21,19,0,100,250,150,0,0,1
129,1,0,26.0,23.0,28.0,23.0,1074,1214,1007,1035,67,179,219,288,155,170,64,118,21,20,0,100,250,150,0,0,1
136,1,0,28.0,23.0,28.0,31.0,1186,1242,1119,1063,67,179,252,178,180,140,72,38,21,20,0,100,250,150,0,0,1
143,1,0,28.0,24.0,28.0,31.0,1186,1247,1119,1091,67,156,405,169,325,165,80,4,21,21,50,150,250,150,0,0,1
150,1,0,30.0,24.0,36.0,31.0,1214,1219,1147,1063,67,156,443,259,355,235,88,24,22,21,100,150,250,150,0,0,1
157,1,0,30.0,25.0,36.0,31.0,1186,1247,1119,1091,67,156,231,354,135,310,96,44,21,22,100,150,250,150,0,0,1
164,1,0,32.0,26.0,36.0,31.0,1191,1247,1147,1091,44,156,125,94,25,30,100,64,23,23,400,150,250,150,0,0,1
171,1,0,33.0,26.0,36.0,31.0,1247,1275,1203,1119,44,156,28,199,20,115,8,84,24,23,400,150,250,150,0,0,1
179,1,0,36.0,27.0,36.0,46.0,1298,1214,1231,1035,67,179,36,214,20,110,16,104,24,24,400,150,250,500,0,0,1
186,1,0,38.0,27.0,44.0,46.0,1354,1186,1287,1007,67,179,109,104,85,80,24,24,26,24,400,150,250,500,0,0,1
193,1,0,41.0,28.0,44.0,46.0,1382,1527,1315,1371,67,156,122,185,90,145,32,40,28,25,400,150,250,500,0,0,1
200,1,0,43.0,33.0,44.0,46.0,1382,1527,1315,1371,67,156,50,105,10,45,40,60,30,26,550,150,250,500,0,0,1
207,1,0,44.0,34.0,44.0,46.0,1634,1555,1567,1399,67,156,68,190,20,110,48,80,33,26,550,150,250,500,0,0,1
214,1,0,44.0,36.0,44.0,46.0,1639,1751,1595,1595,44,156,157,230,105,130,52,100,34,28,550,150,250,500,0,0,1
221,1,0,48.0,38.0,52.0,46.0,1807,1835,1763,1567,44,268,285,161,225,100,60,61,34,28,550,350,250,750,0,0,1
229,1,0,55.0,44.0,58.0,46.0,1858,2014,1791,1679,67,335,158,161,90,60,68,101,34,30,550,350,250,750,0,0,1
236,1,0,58.0,45.0,66.0,61.0,1858,2160,1791,1847,67,313,181,402,105,265,76,137,39,31,700,350,250,750,0,0,1
243,1,0,61.0,46.0,66.0,61.0,1970,2037,1903,1679,67,358,124,81,40,50,84,31,43,32,700,350,250,750,0,0,1
250,1,0,63.0,48.0,66.0,61.0,2082,2059,2015,1679,67,380,182,199,90,145,92,54,44,34,700,775,250,750,0,0,1
257,1,0,66.0,50.0,66.0,61.0,2278,2182,2211,1735,67,447,315,204,215,90,100,114,44,34,850,775,250,750,0,0,1
264,1,0,72.0,55.0,66.0,61.0,2446,2373,2379,1903,67,470,173,265,65,95,108,170,47,36,950,775,250,825,100,0,1
271,1,0,74.0,55.0,74.0,61.0,2507,2563,2463,2071,44,492,187,495,75,290,112,205,48,36,1100,775,250,825,100,0,1
279,1,0,76.0,57.0,82.0,69.0,2574,2782,2463,2267,111,515,213,605,85,340,128,265,51,39,1250,875,250,825,100,0,1
286,1,0,78.0,62.0,90.0,69.0,2625,2787,2491,2295,134,492,214,656,70,335,144,321,53,40,1250,975,250,825,100,0,1
293,1,0,81.0,68.0,98.0,69.0,2815,2955,2659,2463,156,492,194,297,30,220,164,77,52,41,1250,975,250,1125,100,0,1
300,1,0,84.0,71.0,98.0,77.0,2843,2955,2687,2463,156,492,275,222,95,185,180,37,52,42,1550,975,375,1200,100,0,1
307,1,0,91.5,75.0,106.0,77.0,2815,2793,2659,2323,156,470,215,253,15,160,200,93,55,42,1525,1175,500,1200,125,0,1
314,1,0,92.5,77.0,106.0,77.0,2899,2905,2743,2435,156,470,505,208,285,55,220,153,59,44,1675,1225,500,1200,125,0,1
321,1,0,91.5,77.0,106.0,77.0,2927,2619,2659,2127,268,492,530,373,270,160,260,213,66,44,1675,1225,625,1200,125,0,1
329,1,0,92.5,80.0,106.0,85.0,3056,2619,2743,2127,313,492,96,564,50,295,46,269,64,46,1725,1425,750,1200,125,0,1
336,1,0,95.5,81.0,106.0,85.0,3246,2563,2911,2071,335,492,276,424,190,145,86,279,64,47,1725,1425,750,1200,125,0,1
343,1,0,98.5,84.0,114.0,93.0,3101,2591,2743,2099,358,492,160,575,130,240,30,335,66,49,1725,1425,750,1450,125,0,1
350,1,0,104.5,86.0,114.0,101.0,3274,2843,2827,2351,447,492,106,455,70,260,36,195,68,52,1825,1425,750,1450,125,0,1
357,1,0,106.5,87.0,114.0,101.0,3258,2793,2631,2323,627,470,345,726,225,475,120,251,70,52,1825,2125,750,1450,125,0,1
364,1,0,107.5,88.0,122.0,101.0,3437,2899,2631,2407,806,492,315,516,95,205,220,311,70,54,1725,2075,750,1450,275,100,1
371,1,0,96.5,85.0,122.0,101.0,3280,3118,2519,2603,761,515,410,736,110,365,300,371,67,55,1325,1875,750,1450,1025,300,1
379,1,0,100.0,84.0,122.0,101.0,2378,2955,1819,2463,559,492,462,677,102,250,360,427,67,57,1400,1675,750,1550,1150,500,1
386,1,0,102.5,88.0,122.0,101.0,2244,3235,1819,2743,425,492,500,938,92,455,408,483,65,60,1475,1725,750,1850,1275,500,1
393,1,0,102.5,87.0,122.0,101.0,2339,3347,1959,2855,380,492,749,923,297,430,452,493,65,61,1775,1625,750,1850,1325,600,1
400,1,0,108.5,95.0,128.0,101.0,3101,3549,2743,3079,358,470,963,799,467,375,496,424,65,63,2075,1675,1200,1850,1325,600,1
407,1,0,111.5,97.0,128.0,101.0,3230,3633,2827,3163,403,470,1211,559,667,275,544,284,67,64,2375,1675,1200,2150,1325,600,1
414,1,0,111.0,98.0,128.0,117.0,3319,3683,2827,3191,492,492,1215,594,757,350,458,244,69,65,2350,1675,1200,2150,1350,600,1
421,1,0,112.0,102.0,128.0,117.0,3515,3678,2799,3163,716,515,1648,874,1102,570,546,304,72,68,2350,1875,1200,2150,1350,600,1
429,1,0,117.0,108.0,136.0,117.0,3661,3683,2855,3191,806,492,809,640,492,405,317,235,74,69,2350,2150,1200,2450,1350,600,1
436,1,0,116.0,110.0,136.0,125.0,3907,3941,3079,3359,828,582,954,692,637,535,317,157,72,70,2350,2200,1200,2600,1350,600,1
443,1,0,121.0,116.0,144.0,133.0,3885,3924,3079,3275,806,649,316,662,282,525,34,137,72,70,3000,2400,1200,2600,1375,600,1
450,1,0,123.0,122.0,144.0,141.0,3862,3790,3079,3163,783,627,602,648,472,535,130,113,71,71,3300,2400,1200,2800,1475,600,1
457,1,0,127.5,124.0,152.0,141.0,3857,3386,3051,2715,806,671,412,793,332,639,80,154,71,71,3275,2500,1200,3050,1500,600,1
464,1,0,134.5,130.0,152.0,149.0,3834,3302,2939,2631,895,671,309,324,217,247,92,77,75,71,3525,2925,1450,3050,1500,600,1
471,1,0,137.5,140.0,160.0,149.0,4070,3487,3107,2771,963,716,489,108,377,47,112,61,83,71,3625,3375,1450,3350,1500,600,1
479,1,0,144.5,143.0,160.0,149.0,4210,3678,3247,2939,963,739,335,410,107,257,228,153,83,71,3625,3775,1450,3350,1500,600,1
486,1,0,147.0,148.0,168.0,149.0,4478,3717,3471,2911,1007,806,555,240,307,162,248,78,84,71,3600,4075,1450,3350,1525,600,1
493,1,0,154.0,148.0,168.0,157.0,4596,3767,3611,2939,985,828,452,591,242,417,210,174,84,71,4150,4175,1450,3350,1525,600,1
500,1,0,149.0,153.0,168.0,157.0,4602,3610,3639,2715,963,895,849,398,577,237,272,161,84,71,3900,4575,1450,3350,1925,825,1
507,1,0,137.5,130.0,174.0,157.0,4680,3655,3695,2715,985,940,444,694,302,417,142,277,84,71,2825,3250,1450,3350,3500,2400,1
514,1,0,136.5,133.0,166.0,165.0,4686,3627,3723,2687,963,940,345,215,237,147,108,68,84,71,1925,2900,1450,3350,4450,3264,1
521,1,0,140.5,137.0,166.0,165.0,4411,3655,3471,2715,940,940,406,392,332,212,74,180,84,71,1925,2850,1450,3350,4600,3314,1
529,1,0,141.0,134.0,166.0,165.0,4400,3571,3415,2631,985,940,186,335,142,222,44,113,84,71,2600,2700,1450,3350,5275,3614,1
536,1,0,148.0,145.0,166.0,180.0,4282,3627,3275,2687,1007,940,87,156,52,27,35,129,84,72,2850,3425,1450,3350,5275,3614,1
543,1,0,151.0,146.0,166.0,180.0,4383,3633,3443,2715,940,918,465,493,322,252,143,241,84,72,3550,3825,1450,3350,5300,3614,1
550,1,0,156.0,155.0,166.0,180.0,4378,3325,3415,2407,963,918,400,380,312,127,88,253,84,74,4350,3975,1450,3350,5300,3614,1
557,1,0,165.0,158.0,172.0,180.0,4210,3319,3247,2379,963,940,246,252,142,112,104,140,84,75,4500,4275,1450,3350,5300,3614,1
564,1,0,172.0,162.0,172.0,180.0,4182,3627,3219,2687,963,940,431,245,207,147,224,98,84,76,5050,4850,1450,3350,5300,3614,1
571,1,0,171.5,165.0,172.0,180.0,4406,3706,3443,2743,963,963,752,341,412,227,340,114,84,76,5325,4850,1450,3350,5325,3614,1
579,1,0,179.5,173.0,180.0,180.0,4585,3952,3555,2967,1030,985,197,522,62,292,135,230,84,76,5575,5100,1450,3350,5375,3614,1
586,1,0,179.5,179.0,180.0,180.0,4730,4154,3723,3191,1007,963,568,733,317,387,251,346,84,76,6025,5350,1450,3350,5375,3614,1
593,1,0,186.5,179.0,196.0,188.0,4590,4126,3695,3163,895,963,514,939,167,602,347,337,81,76,6875,5800,1450,3350,5675,3614,1
600,1,0,184.5,178.0,204.0,188.0,4445,4120,3639,3135,806,985,989,880,542,427,447,453,81,76,6825,5700,1450,3350,5900,3989,1
607,1,0,169.0,163.0,212.0,188.0,4618,4092,3835,3107,783,985,950,681,407,237,543,444,81,76,5650,4800,1450,3350,7325,5289,1
614,1,0,173.0,163.0,212.0,188.0,4506,3986,3723,3023,783,963,790,912,397,452,393,460,81,76,5850,4850,1450,3350,7325,5289,1
621,1,0,175.0,162.0,212.0,196.0,4663,3980,3835,2995,828,985,1050,1343,557,767,493,576,81,76,6000,4800,1450,3350,7525,5389,1
629,1,0,180.5,168.0,212.0,196.0,4596,4058,3723,3051,873,1007,1145,1288,652,717,493,571,81,76,6775,5325,1450,3350,7700,5489,1
636,1,0,187.0,181.0,212.0,196.0,4607,3958,3779,2995,828,963,1197,306,612,77,585,229,81,76,7000,5325,1450,3350,7875,5539,1
643,1,0,191.5,177.0,212.0,196.0,4501,4075,3695,3135,806,940,1124,602,522,257,602,345,81,76,7025,5125,1450,3350,8050,5989,1
650,1,0,196.5,164.0,212.0,196.0,4585,3672,3779,2799,806,873,1139,511,537,62,602,449,81,67,7025,4650,1450,3350,8250,6914,1
657,1,0,178.5,163.0,212.0,196.0,4590,2955,3807,2239,783,716,1475,855,777,322,698,533,81,64,6075,4775,1450,3600,9875,7439,1
664,1,0,181.5,170.0,212.0,196.0,4473,3157,3667,2463,806,694,1300,489,702,122,598,367,81,67,6475,5300,1450,3600,10025,7439,1
671,1,0,188.5,171.0,212.0,211.0,4512,3398,3639,2659,873,739,1080,818,582,392,498,426,81,69,6925,6050,1450,3600,10025,7439,1
679,1,0,194.5,177.0,212.0,211.0,4574,3571,3723,2855,851,716,1346,477,752,292,594,185,81,71,7975,6050,1450,3600,10025,7439,1
686,1,0,199.5,183.0,212.0,211.0,4221,3633,3415,2939,806,694,1554,261,872,167,682,94,81,72,8375,6050,1450,3675,10075,7439,1
693,1,0,199.5,191.0,212.0,211.0,4221,3829,3415,3135,806,694,1674,450,1092,272,582,178,81,72,9025,6425,1450,3675,10075,7439,1
700,1,0,195.5,191.0,212.0,211.0,4058,3963,3275,3247,783,716,1710,558,1032,417,678,141,80,72,8475,6175,1450,3675,10725,7689,1
707,1,0,197.5,178.0,212.0,211.0,4450,3958,3667,3219,783,739,1745,982,1067,757,678,225,80,72,8025,5875,1450,3675,10875,8389,1
714,1,0,194.5,168.0,212.0,203.0,4529,3560,3723,2911,806,649,2045,576,1267,529,778,47,80,61,7175,6200,1450,3675,11550,9364,1
721,1,0,197.0,172.0,212.0,203.0,4596,3000,3723,2351,873,649,1990,526,1287,399,703,127,80,61,7650,6200,1450,3675,11675,9364,1
729,1,0,197.5,187.0,212.0,195.0,4523,3398,3695,2771,828,627,1917,167,1372,89,545,78,80,65,7975,6525,1450,3675,11750,9464,1
736,1,0,199.5,192.0,212.0,195.0,4557,3347,3751,2631,806,716,1599,563,1162,389,437,174,80,69,8525,7000,1700,3675,11750,9464,1
743,1,0,199.5,194.0,212.0,195.0,4529,3515,3723,2687,806,828,1779,878,1492,604,287,274,79,69,9225,7250,1700,3675,11900,9464,1
750,1,0,175.0,172.0,212.0,195.0,4506,3482,3723,2631,783,851,2325,1179,1942,809,383,370,79,71,7650,6250,1700,3675,13150,10664,1
757,1,0,159.0,158.0,204.0,195.0,4529,3599,3723,2771,806,828,2060,515,1577,299,483,216,79,71,5150,4850,1700,3675,16050,12164,1
764,1,0,156.0,133.0,204.0,195.0,4411,3465,3583,2659,828,806,1930,757,1397,449,533,308,79,71,3600,3250,1700,3675,17475,14139,1
771,1,0,163.0,146.0,204.0,195.0,4406,3465,3555,2659,851,806,1791,512,1162,279,629,233,79,71,4400,3750,1700,3675,17475,14139,1
779,1,0,168.0,150.0,204.0,195.0,4142,3437,3359,2631,783,806,1904,583,1187,254,717,329,77,71,4900,3900,1700,3675,17475,14139,1
786,1,0,171.0,155.0,204.0,195.0,4025,3454,3219,2603,806,851,774,581,682,144,92,437,77,71,5300,4000,1700,3675,17475,14139,1
793,1,0,178.5,165.0,204.0,195.0,3885,3409,3079,2491,806,918,814,528,622,104,192,424,77,71,5625,4775,1700,3675,17500,14139,1
800,1,0,183.5,168.0,204.0,195.0,4002,3515,3219,2575,783,940,1065,791,777,259,288,532,77,71,7175,5250,1700,3675,17525,14139,1
807,1,0,171.5,160.0,204.0,195.0,4221,3633,3303,2715,918,918,800,1178,392,534,408,644,76,71,5625,4900,2050,3675,19425,14689,1
814,1,0,152.5,130.0,204.0,195.0,4137,3655,3107,2715,1030,940,1010,1201,532,649,478,552,76,71,3875,3500,2050,3675,21250,16939,1
821,1,0,148.5,126.0,204.0,195.0,4058,3577,3051,2659,1007,918,1156,1518,562,854,594,664,76,71,3625,3300,2050,3675,21900,17239,1
829,1,0,153.5,139.0,204.0,195.0,4182,3498,3219,2603,963,895,314,761,312,114,2,647,76,71,3675,3475,2175,3675,22200,17389,1
836,1,0,164.5,143.0,204.0,195.0,4042,3521,3079,2603,963,918,74,508,27,74,47,434,76,71,4075,3525,2175,3675,22200,17389,1
843,1,0,162.5,153.0,204.0,195.0,4014,3566,3051,2603,963,963,286,589,260,39,26,550,83,71,4425,4075,2050,3675,22292,17439,1
850,1,0,169.5,159.0,210.0,195.0,4070,3538,3107,2575,963,963,391,707,245,149,146,558,82,71,4575,4575,2050,3675,22342,17439,1
857,1,0,177.0,163.0,210.0,195.0,4232,3515,3247,2575,985,940,287,771,125,109,162,662,82,71,5700,4675,2050,3675,22367,17439,1
864,1,0,172.5,169.0,210.0,195.0,4417,3465,3387,2547,1030,918,412,1043,305,269,107,774,82,71,5825,5500,2050,3675,22642,17439,1
871,1,0,148.0,157.0,210.0,195.0,4624,3470,3639,2575,985,895,509,1111,340,229,169,882,82,72,3950,4500,2050,3675,24892,18814,1
877,1,0,141.0,150.0,210.0,195.0,4714,3487,3751,2547,963,940,283,1028,130,54,153,974,82,72,3000,4175,2050,3675,26367,19639,1
7,1,0,13.0,13.0,14.0,15.0,377,335,377,335,0,0,45,40,45,40,0,0,12,12,0,0,0,0,0,0,1
14,1,0,13.0,14.0,14.0,15.0,643,671,643,671,0,0,15,70,15,70,0,0,13,13,0,0,0,0,0,0,1
21,1,0,14.0,14.0,14.0,15.0,699,643,699,643,0,0,50,40,50,40,0,0,13,13,0,0,0,0,0,0,1
29,1,0,14.0,15.0,14.0,15.0,755,671,755,671,0,0,150,85,150,85,0,0,13,14,0,0,0,0,0,0,1
36,1,0,16.0,15.0,22.0,15.0,811,727,811,727,0,0,150,125,150,125,0,0,14,14,0,0,0,0,0,0,1
43,1,0,16.0,16.0,22.0,23.0,839,811,839,811,0,0,235,70,235,70,0,0,16,15,0,0,0,0,0,0,1
50,1,0,15.0,16.0,22.0,23.0,811,755,811,755,0,0,35,35,35,35,0,0,15,15,0,0,0,0,0,0,1
57,1,0,17.0,17.0,22.0,23.0,867,755,867,755,0,0,40,125,40,125,0,0,15,16,0,0,0,0,0,0,1
64,1,0,18.0,18.0,22.0,23.0,951,783,951,783,0,0,95,10,95,10,0,0,16,17,0,0,0,0,0,0,1
71,1,0,17.0,18.0,22.0,23.0,923,799,923,755,0,44,175,63,175,55,0,8,17,17,0,0,0,0,0,0,1
79,1,0,17.0,19.0,22.0,23.0,979,883,979,727,0,156,35,163,35,135,0,28,16,18,0,0,0,0,0,0,1
86,1,0,18.0,19.0,22.0,23.0,951,906,951,727,0,179,100,278,100,230,0,48,16,18,0,0,0,0,0,0,1
93,1,0,19.0,20.0,22.0,23.0,973,934,951,755,22,179,164,138,160,120,4,18,18,19,0,0,0,150,0,0,1
100,1,0,20.0,20.0,22.0,23.0,1012,995,923,839,89,156,231,154,215,120,16,34,18,19,0,0,0,150,0,0,1
107,1,0,20.0,21.0,22.0,23.0,1001,967,867,811,134,156,347,164,315,160,32,4,19,19,0,0,0,300,0,0,1
114,1,0,21.0,22.0,22.0,23.0,1057,995,923,839,134,156,429,239,385,215,44,24,20,19,0,0,0,300,0,0,1
121,1,0,27.0,22.0,28.0,31.0,990,995,923,839,67,156,142,359,90,315,52,44,20,19,0,0,250,300,0,0,1
129,1,0,27.0,24.0,28.0,31.0,1102,1163,1035,1007,67,156,285,354,225,340,60,14,21,20,0,100,250,300,0,0,1
136,1,0,28.0,24.0,28.0,31.0,1102,1158,1035,979,67,179,273,94,205,60,68,34,21,20,0,100,250,300,0,0,1
143,1,0,28.0,25.0,28.0,31.0,1130,1359,1063,1203,67,156,406,130,330,130,76,0,21,21,100,200,250,300,0,0,1
150,1,0,28.0,25.0,28.0,31.0,1079,1359,1035,1203,44,156,190,95,110,75,80,20,21,21,100,200,250,300,0,0,1
157,1,0,29.5,26.0,36.0,31.0,1107,1331,1063,1175,44,156,223,185,135,145,88,40,21,22,375,300,250,300,25,0,1
164,1,0,30.5,27.0,36.0,31.0,1130,1359,1063,1203,67,156,311,220,215,185,96,35,23,23,375,300,250,300,25,0,1
171,1,0,30.5,27.0,36.0,31.0,1158,1303,1091,1147,67,156,176,275,172,220,4,55,23,23,375,300,250,300,75,0,1
179,1,0,33.5,28.0,36.0,31.0,1242,1326,1175,1147,67,179,19,260,7,185,12,75,23,24,425,300,250,475,75,0,1
186,1,0,35.5,31.0,36.0,31.0,1326,1214,1259,1035,67,179,77,250,57,155,20,95,23,24,475,300,250,475,75,0,1
193,1,0,35.5,31.0,36.0,39.0,1331,1191,1287,1035,44,156,191,156,167,145,24,11,24,25,425,300,250,475,125,0,1
200,1,0,39.5,33.0,44.0,39.0,1298,1387,1231,1231,67,156,129,206,97,175,32,31,26,25,425,450,250,625,125,0,1
207,1,0,42.5,36.0,44.0,54.0,1298,1387,1231,1231,67,156,87,221,47,170,40,51,26,26,425,450,250,625,125,0,1
214,1,0,43.5,37.0,44.0,54.0,1494,1527,1427,1371,67,156,115,106,67,35,48,71,30,26,625,450,250,625,125,0,1
221,1,0,45.5,40.0,50.0,54.0,1522,1555,1455,1399,67,156,138,231,82,140,56,91,30,27,625,600,250,625,125,0,1
229,1,0,49.5,41.0,50.0,54.0,1583,1634,1539,1455,44,179,142,146,82,60,60,86,31,27,675,600,250,775,125,0,1
236,1,0,53.5,44.0,58.0,54.0,1639,1807,1595,1651,44,156,95,222,27,120,68,102,31,28,675,700,250,775,125,0,1
243,1,0,56.5,48.0,58.0,54.0,1662,1639,1595,1483,67,156,128,57,52,35,76,22,35,29,825,750,250,850,125,0,1
250,1,0,56.5,50.0,58.0,54.0,1886,1863,1819,1707,67,156,121,102,37,60,84,42,37,30,825,850,250,850,125,0,1
257,1,0,56.5,54.0,58.0,62.0,2054,1891,1987,1735,67,156,259,72,167,10,92,62,40,31,975,950,250,850,125,0,1
264,1,0,59.5,57.0,66.0,62.0,2082,1919,2015,1763,67,156,252,157,152,75,100,82,40,32,975,1050,250,850,125,0,1
271,1,0,65.5,59.0,74.0,70.0,2171,1886,2127,1707,44,179,226,347,122,245,104,102,40,33,1125,1150,250,850,125,0,1
279,1,0,71.5,61.0,82.0,70.0,2250,2026,2183,1847,67,179,144,92,32,70,112,22,45,34,1125,1250,250,850,125,0,1
286,1,0,72.5,62.0,90.0,70.0,2350,2177,2239,1931,111,246,175,159,97,105,78,54,46,35,1125,1350,250,850,125,0,1
293,1,0,75.5,66.0,90.0,70.0,2429,2378,2295,2043,134,335,261,289,167,195,94,94,50,36,1075,1350,250,850,175,0,1
300,1,0,77.0,69.0,90.0,70.0,2479,2462,2323,2127,156,335,386,434,272,300,114,134,53,37,1200,1400,250,850,200,0,1
307,1,0,82.0,71.0,90.0,78.0,2675,2356,2519,2043,156,313,326,195,192,125,134,70,53,39,1250,1550,250,975,200,0,1
314,1,0,79.5,73.0,82.0,78.0,2871,2104,2715,1791,156,313,461,230,307,120,154,110,53,40,1275,1550,250,975,625,0,1
321,1,0,71.0,73.0,90.0,78.0,3011,2042,2855,1707,156,335,471,185,297,35,174,150,53,41,450,1350,250,1225,1600,300,1
7,2,0,13.0,13.0,15.0,15.0,251,335,251,335,0,0,30,40,30,40,0,0,12,12,0,0,0,0,0,0,0
14,2,0,14.0,14.0,15.0,15.0,671,671,671,671,0,0,70,70,70,70,0,0,13,13,0,0,0,0,0,0,0
21,2,0,14.0,14.0,15.0,15.0,671,699,671,699,0,0,45,50,45,50,0,0,13,13,0,0,0,0,0,0,0
29,2,0,15.0,15.0,15.0,15.0,699,699,699,699,0,0,40,85,40,85,0,0,14,14,0,0,0,0,0,0,0
36,2,0,15.0,15.0,15.0,15.0,755,727,755,727,0,0,130,130,130,130,0,0,14,14,0,0,0,0,0,0,0
43,2,0,16.0,16.0,23.0,23.0,727,783,727,783,0,0,15,75,15,75,0,0,15,15,0,0,0,0,0,0,0
50,2,0,17.0,16.0,23.0,23.0,867,811,867,811,0,0,45,45,45,45,0,0,16,15,0,0,0,0,0,0,0
57,2,0,18.0,17.0,23.0,23.0,839,755,839,755,0,0,40,85,40,85,0,0,17,16,0,0,0,0,0,0,0
64,2,0,19.0,18.0,23.0,23.0,979,811,979,811,0,0,110,190,110,190,0,0,18,17,0,0,0,0,0,0,0
71,2,0,19.0,18.0,23.0,23.0,979,839,979,839,0,0,220,285,220,285,0,0,18,17,0,0,0,0,0,0,0
79,2,0,20.0,19.0,23.0,23.0,1023,782,979,671,44,111,338,330,330,310,8,20,19,18,0,0,0,0,0,0,0
86,2,0,20.0,19.0,23.0,23.0,1040,827,951,671,89,156,460,445,440,405,20,40,19,18,0,0,150,0,0,0,0
93,2,0,20.0,20.0,23.0,23.0,956,911,867,755,89,156,417,305,385,295,32,10,20,19,0,0,150,150,0,0,0
100,2,0,20.0,20.0,23.0,23.0,1085,911,951,755,134,156,148,410,100,380,48,30,20,19,0,0,150,150,0,0,0
107,2,0,20.0,20.0,23.0,23.0,1006,962,895,783,111,179,90,125,30,75,60,50,20,19,0,0,150,150,0,0,0
114,2,0,21.0,20.0,23.0,23.0,1079,990,923,811,156,179,175,145,95,75,80,70,20,19,0,0,150,150,0,0,0
121,2,0,22.0,21.0,31.0,23.0,1074,995,895,839,179,156,245,146,145,60,100,86,21,19,0,0,150,150,0,0,0
129,2,0,24.0,23.0,31.0,23.0,1079,1079,923,923,156,156,146,231,55,125,91,106,21,20,0,100,300,150,0,0,0
136,2,0,25.0,23.0,31.0,31.0,1062,1079,839,923,223,156,228,121,105,95,123,26,22,20,0,100,300,150,0,0,0
143,2,0,25.0,25.0,31.0,31.0,1152,1079,839,923,313,156,184,56,50,10,134,46,22,21,0,150,300,150,0,0,0
150,2,0,28.0,25.0,31.0,31.0,1152,1135,839,979,313,156,29,81,5,15,24,66,23,21,125,150,300,150,0,0,0
157,2,0,29.0,26.0,31.0,31.0,1264,1102,951,923,313,179,135,206,75,120,60,86,24,22,125,150,400,150,0,0,0
164,2,0,30.0,26.0,31.0,31.0,1286,1242,951,1063,335,179,135,226,85,170,50,56,25,22,125,200,400,150,0,0,0
171,2,0,31.0,27.0,46.0,31.0,1314,1275,979,1119,335,156,106,322,45,250,61,72,26,23,125,200,400,250,0,0,0
179,2,0,35.0,27.0,46.0,46.0,1426,1320,1091,1119,335,201,181,75,80,75,101,0,27,23,250,200,400,500,0,0,0
186,2,0,36.0,30.0,46.0,46.0,1404,1326,1091,1035,313,291,302,126,165,90,137,36,29,24,250,200,400,500,0,0,0
193,2,0,37.0,31.0,46.0,46.0,1527,1365,1259,1119,268,246,339,254,170,190,169,64,29,25,250,200,700,500,0,0,0
200,2,0,40.0,33.0,46.0,46.0,1578,1600,1287,1287,291,313,175,299,70,195,105,104,30,25,250,200,700,600,50,0,0
207,2,0,39.0,37.0,46.0,46.0,1656,1650,1343,1315,313,335,235,284,90,165,145,119,29,26,375,300,700,600,100,0,0
214,2,0,41.0,36.0,54.0,46.0,1678,1460,1343,1147,335,313,335,375,150,220,185,155,31,26,625,300,700,850,100,100,0
221,2,0,43.0,40.0,54.0,46.0,1706,1572,1371,1259,335,313,21,150,0,30,21,120,31,28,625,300,700,850,100,100,0
229,2,0,45.0,44.0,54.0,46.0,1718,1930,1427,1595,291,335,138,190,85,30,53,160,33,30,625,400,700,850,100,100,0
236,2,0,47.0,44.0,54.0,54.0,1880,2020,1567,1707,313,313,123,301,30,130,93,171,35,30,625,400,700,850,100,100,0
243,2,0,47.0,46.0,54.0,54.0,1852,2104,1539,1791,313,313,228,341,95,130,133,211,35,32,625,400,700,850,100,100,0
250,2,0,51.0,48.0,62.0,54.0,1824,2126,1511,1791,313,335,98,386,25,135,73,251,37,32,875,725,700,925,100,100,0
257,2,0,51.0,53.0,62.0,54.0,1869,2126,1511,1791,358,335,272,216,155,50,117,166,37,34,875,725,700,925,100,100,0
264,2,0,55.0,53.0,62.0,54.0,2054,2160,1539,1847,515,313,176,237,95,35,81,202,39,34,1125,825,700,925,100,100,0
271,2,0,56.0,57.0,62.0,62.0,2199,2042,1595,1707,604,335,334,292,185,50,149,242,40,36,1125,825,1050,1150,100,100,0
279,2,0,57.0,57.0,62.0,62.0,2289,2238,1707,1903,582,335,111,547,40,265,71,282,41,36,1125,825,1050,1150,100,100,0
286,2,0,60.0,58.0,70.0,70.0,2339,2328,1735,2015,604,313,127,393,55,175,72,218,43,38,1125,1025,1050,1150,100,200,0
293,2,0,60.0,59.0,70.0,70.0,2300,2328,1763,2015,537,313,256,258,120,100,136,158,43,38,1375,1075,1050,1425,100,200,0
300,2,0,64.0,64.0,70.0,70.0,2345,2350,1763,2015,582,335,292,198,180,100,112,98,45,40,1375,1125,1050,1425,100,200,0
307,2,0,64.0,63.0,70.0,70.0,2664,2087,2015,1819,649,268,599,181,415,55,184,126,45,40,1475,1075,1050,1425,100,400,0
314,2,0,58.0,62.0,70.0,78.0,2479,1040,1875,839,604,201,887,194,635,40,252,154,47,38,1100,1125,1050,1425,475,500,0
321,2,0,60.0,65.0,70.0,78.0,2485,1774,1903,1483,582,291,639,125,415,35,224,90,47,40,1350,1225,1350,1425,475,500,0
329,2,0,66.0,67.0,70.0,78.0,2401,2266,1819,1819,582,447,276,250,180,100,96,150,47,40,1350,1275,1350,1425,475,500,0
336,2,0,66.0,68.0,70.0,78.0,2535,2244,1931,1819,604,425,598,368,430,170,168,198,47,39,1350,1375,1500,1425,475,650,0
343,2,0,64.0,69.0,70.0,78.0,2530,2070,1903,1735,627,335,895,501,655,276,240,225,47,39,1350,1475,1650,1425,725,700,0
350,2,0,66.0,71.0,70.0,78.0,2563,1824,1959,1511,604,313,152,510,90,266,62,244,47,40,1350,1525,1650,1425,725,700,0
357,2,0,66.0,78.0,70.0,78.0,2530,2244,1903,1707,627,537,444,267,310,26,134,241,47,40,1350,1575,1650,1525,725,800,0
364,2,0,70.0,78.0,70.0,78.0,2490,2502,1931,1875,559,627,344,254,150,141,194,113,47,40,1550,1675,1650,1425,725,825,0
371,2,0,70.0,78.0,70.0,78.0,2434,2356,1875,1707,559,649,137,224,75,56,62,168,47,42,2300,1725,1950,1425,725,825,0
379,2,0,78.0,78.0,86.0,78.0,2535,2418,1931,1791,604,627,98,290,60,71,38,219,47,42,2300,2050,2100,1425,725,825,0
386,2,0,80.0,86.0,102.0,86.0,2535,2334,1931,1707,604,627,264,445,250,171,14,274,47,41,2300,2050,2100,1425,725,875,0
393,2,0,84.0,93.0,102.0,94.0,2614,2384,1987,1735,627,649,375,560,285,231,90,329,47,43,2650,2050,2100,1425,725,875,0
400,2,0,84.0,95.0,110.0,102.0,2670,2490,2043,1819,627,671,442,461,380,56,62,405,47,43,2650,2100,2400,1425,725,875,0
407,2,0,86.0,98.0,110.0,102.0,2664,2244,2015,1595,649,649,749,539,615,69,134,470,47,45,2900,2300,2400,1425,725,875,0
414,2,0,88.0,98.0,110.0,102.0,2569,2126,1987,1567,582,559,553,552,455,93,98,459,47,45,3400,2800,2400,1425,725,875,0
421,2,0,98.0,100.0,110.0,102.0,2597,2205,2015,1623,582,582,309,494,235,88,74,406,47,47,3950,2850,2400,1425,725,875,0
429,2,0,100.0,102.0,110.0,102.0,2619,2434,2015,1875,604,559,630,483,480,63,150,420,47,47,4200,3000,2400,1425,725,925,0
436,2,0,104.0,103.0,110.0,110.0,2563,2412,1959,1875,604,537,606,512,530,28,76,484,47,47,4525,3000,2400,1425,725,925,0
443,2,0,106.0,106.0,110.0,110.0,2698,2412,2071,1875,627,537,757,580,655,103,102,477,47,48,4775,3125,2400,1425,725,925,0
450,2,0,110.0,108.0,110.0,110.0,2664,2496,2015,1959,649,537,779,644,655,178,124,466,47,50,5225,3250,2400,1425,725,925,0
457,2,0,110.0,110.0,110.0,110.0,2642,2714,2015,2155,627,559,837,492,745,83,92,409,47,50,5475,3250,2400,1600,725,925,0
464,2,0,110.0,117.0,110.0,118.0,2597,2625,2015,2043,582,582,850,470,690,43,160,427,47,50,5475,3025,2400,1600,725,1315,0
471,2,0,110.0,117.0,110.0,118.0,2546,2653,1987,2071,559,582,1147,643,915,148,232,495,47,52,5475,3250,2400,1600,725,1315,0
479,2,0,110.0,117.0,110.0,141.0,2591,2569,1987,1987,604,582,1459,585,1155,93,304,492,47,52,5475,3375,2400,1600,725,1415,0
486,2,0,124.0,118.0,134.0,141.0,2563,2625,1959,2043,604,582,720,517,640,53,80,464,47,52,5475,3525,2400,1600,725,1615,0
493,2,0,123.0,120.0,134.0,141.0,2395,2535,1791,1931,604,604,898,559,750,148,148,411,47,52,6425,3750,2400,1600,925,1665,0
500,2,0,117.0,118.0,134.0,141.0,2121,1740,1539,1203,582,537,1142,499,930,53,212,446,47,52,6125,3500,2400,1600,1225,1965,0
507,2,0,119.0,120.0,134.0,133.0,2014,1970,1455,1455,559,515,1207,623,985,142,222,481,47,52,6375,3850,2400,1600,1225,2065,0
514,2,0,131.0,120.0,134.0,125.0,2216,2205,1679,1847,537,358,471,559,385,71,86,488,47,52,7450,4075,2400,1600,1325,2165,0
521,2,0,125.0,119.0,134.0,125.0,2216,2093,1679,1847,537,246,744,555,590,110,154,445,47,52,6850,4025,2400,1900,1925,2440,0
529,2,0,107.0,90.0,134.0,125.0,2272,2334,1735,2043,537,291,787,496,665,65,122,431,47,52,5400,2225,2400,1900,3375,4640,0
536,2,0,119.0,89.0,134.0,125.0,2244,2390,1707,2099,537,291,120,619,80,156,40,463,47,50,5225,2000,2400,1900,3550,4965,0
543,2,0,113.0,80.0,134.0,110.0,2283,2283,1679,2015,604,268,393,537,285,171,108,366,47,47,5400,1600,2400,1900,4300,6367,0
7,0,2,13.0,13.0,15.0,15.0,251,335,251,335,0,0,30,40,30,40,0,0,12,12,0,0,0,0,0,0,0
14,0,2,13.0,14.0,15.0,15.0,643,671,643,671,0,0,65,70,65,70,0,0,12,13,0,0,0,0,0,0,0
21,0,2,14.0,14.0,15.0,15.0,643,671,643,671,0,0,40,45,40,45,0,0,13,13,0,0,0,0,0,0,0
29,0,2,15.0,15.0,15.0,15.0,671,699,671,699,0,0,80,45,80,45,0,0,14,14,0,0,0,0,0,0,0
36,0,2,15.0,16.0,15.0,23.0,699,755,699,755,0,0,125,135,125,135,0,0,14,15,0,0,0,0,0,0,0
43,0,2,16.0,16.0,23.0,23.0,783,783,783,783,0,0,60,25,60,25,0,0,15,15,0,0,0,0,0,0,0
50,0,2,16.0,17.0,23.0,23.0,811,811,811,811,0,0,35,55,35,55,0,0,15,16,0,0,0,0,0,0,0
57,0,2,17.0,18.0,23.0,23.0,755,783,755,783,0,0,40,55,40,55,0,0,16,17,0,0,0,0,0,0,0
64,0,2,17.0,19.0,23.0,23.0,755,923,755,923,0,0,80,165,80,165,0,0,16,18,0,0,0,0,0,0,0
71,0,2,18.0,19.0,23.0,23.0,771,917,727,895,44,22,118,229,110,225,8,4,17,18,0,0,0,0,0,0,0
79,0,2,19.0,20.0,23.0,23.0,743,990,587,923,156,67,208,352,180,340,28,12,18,19,0,0,0,0,0,0,0
86,0,2,19.0,20.0,23.0,23.0,799,1074,531,1007,268,67,314,480,250,460,64,20,18,19,0,0,0,0,0,0,0
93,0,2,20.0,20.0,23.0,23.0,788,1012,475,923,313,89,56,442,10,410,46,32,19,20,0,0,150,150,0,0,0
100,0,2,20.0,20.0,23.0,23.0,872,1062,559,951,313,111,166,164,80,120,86,44,19,20,0,0,150,150,0,0,0
107,0,2,20.0,21.0,23.0,23.0,900,1085,587,951,313,134,276,145,150,85,126,60,19,20,0,0,150,150,0,0,0
114,0,2,20.0,21.0,23.0,23.0,883,1034,615,923,268,111,139,132,85,60,54,72,19,20,0,0,150,150,0,0,0
121,0,2,21.0,22.0,31.0,31.0,1001,1085,755,951,246,134,206,262,120,170,86,92,19,21,100,0,150,150,0,0,0
129,0,2,22.0,24.0,31.0,31.0,1113,1079,867,923,246,156,189,72,125,60,64,12,20,21,100,0,150,300,0,0,0
136,0,2,22.0,25.0,31.0,31.0,1141,1068,895,867,246,201,291,195,195,155,96,40,20,22,100,0,150,300,0,0,0
143,0,2,23.0,26.0,31.0,31.0,1202,1152,979,839,223,313,440,101,320,75,120,26,21,23,100,0,150,300,0,0,0
150,0,2,23.0,28.0,31.0,31.0,1253,1236,1007,923,246,313,192,257,40,195,152,62,21,23,100,175,150,300,0,0,0
157,0,2,23.0,29.0,31.0,31.0,1365,1264,1119,951,246,313,375,348,195,250,180,98,22,24,100,175,400,300,0,0,0
164,0,2,28.0,29.0,31.0,31.0,1471,1214,1203,923,268,291,297,245,110,215,187,30,22,24,100,175,500,300,0,0,0
171,0,2,27.0,30.0,31.0,46.0,1477,1242,1231,951,246,291,305,351,90,285,215,66,22,25,0,350,500,300,100,0,0
179,0,2,29.0,30.0,31.0,46.0,1421,1214,1175,923,246,291,168,387,25,285,143,102,23,25,100,350,500,300,100,0,0
186,0,2,30.0,32.0,31.0,46.0,1197,1236,951,923,246,313,245,192,70,150,175,42,23,26,200,350,500,300,100,0,0
193,0,2,33.0,32.0,39.0,46.0,1258,1314,923,979,335,335,260,267,70,185,190,82,24,26,200,350,500,300,100,0,0
200,0,2,36.0,34.0,39.0,46.0,1309,1449,951,1091,358,358,275,382,45,260,230,122,25,28,300,350,500,300,100,0,0
207,0,2,36.0,36.0,39.0,46.0,1348,1482,1035,1147,313,335,282,513,20,355,262,158,25,30,300,350,500,650,100,0,0
214,0,2,39.0,36.0,39.0,46.0,1516,1516,1203,1203,313,313,287,404,85,360,202,44,26,30,450,350,750,650,100,0,0
221,0,2,40.0,38.0,54.0,46.0,1488,1600,1175,1287,313,313,332,134,115,50,217,84,26,32,500,350,750,650,100,0,0
229,0,2,41.0,38.0,54.0,46.0,1460,1656,1147,1343,313,313,452,289,195,165,257,124,27,32,500,350,750,900,100,0,0
236,0,2,42.0,42.0,54.0,46.0,1432,1818,1119,1483,313,335,417,209,120,45,297,164,27,34,500,350,825,900,100,0,0
243,0,2,47.0,43.0,54.0,46.0,1561,1874,1203,1539,358,335,252,309,65,105,187,204,28,35,750,350,925,900,100,0,0
250,0,2,48.0,44.0,54.0,46.0,1510,1930,1175,1595,335,335,268,340,45,100,223,240,29,36,800,350,925,900,100,0,0
257,0,2,48.0,45.0,54.0,46.0,1376,1880,1063,1567,313,313,334,296,75,20,259,276,29,37,850,600,925,900,100,0,0
264,0,2,52.0,46.0,54.0,54.0,1516,2009,1203,1651,313,358,124,491,25,175,99,316,29,38,850,600,1000,1050,100,0,0
271,0,2,52.0,48.0,54.0,62.0,1600,2014,1287,1679,313,335,234,687,95,335,139,352,29,40,1175,600,1000,1200,100,0,0
279,0,2,54.0,48.0,62.0,62.0,1572,1986,1259,1651,313,335,254,807,75,415,179,392,30,40,1175,600,1000,1200,100,0,0
286,0,2,59.0,56.0,62.0,62.0,1701,2098,1343,1539,358,559,139,277,45,180,94,97,32,42,1225,1350,1000,1500,100,0,0
293,0,2,59.0,57.0,62.0,62.0,1673,2300,1315,1651,358,649,179,362,45,185,134,177,32,43,1225,1350,1000,1500,100,50,0
300,0,2,58.0,58.0,62.0,62.0,1740,2362,1427,1735,313,627,281,634,115,385,166,249,31,45,1225,1350,1000,1500,250,50,0
307,0,2,54.0,56.0,70.0,62.0,631,2440,475,1791,156,649,193,419,15,90,178,329,26,46,1525,1100,1000,1500,500,300,0
314,0,2,53.0,52.0,70.0,62.0,99,1936,55,1287,44,649,207,615,25,210,182,405,25,42,1850,1100,1000,1500,675,500,0
321,0,2,49.0,49.0,70.0,62.0,55,1751,55,1147,0,604,212,342,30,15,182,327,26,42,1650,600,1000,1500,875,1000,0
329,0,2,51.0,51.0,70.0,62.0,699,2121,699,1539,0,582,107,485,50,90,57,395,26,43,1650,600,1000,1500,875,1000,0
336,0,2,53.0,55.0,70.0,62.0,1203,2334,1203,1707,0,627,172,275,115,50,57,225,26,44,1650,600,1000,1500,875,1000,0
343,0,2,54.0,57.0,70.0,70.0,1320,2345,1231,1763,89,582,133,404,60,115,73,289,27,45,1650,600,1150,1650,875,1000,0
350,0,2,58.0,58.0,70.0,70.0,1835,2423,1679,1819,156,604,178,296,85,35,93,261,28,46,1650,1050,1150,1650,875,1000,0
357,0,2,59.0,60.0,70.0,70.0,2059,2451,1903,1847,156,604,23,477,10,140,13,337,29,48,1650,1050,1150,1800,875,1000,0
364,0,2,59.0,61.0,70.0,70.0,1958,2558,1735,1931,223,627,196,598,155,185,41,413,29,49,1925,1050,1150,1800,875,1000,0
371,0,2,60.0,63.0,70.0,70.0,2014,2479,1679,1875,335,604,416,680,335,195,81,485,31,51,2075,1050,1150,2100,875,1000,0
379,0,2,64.0,70.0,70.0,70.0,2188,2586,1875,1959,313,627,163,432,100,75,63,357,31,52,2075,1050,1150,2100,875,1000,0
386,0,2,67.0,67.0,78.0,70.0,2054,2524,1651,1875,403,649,324,743,205,310,119,433,33,53,2125,600,1150,2100,875,1450,0
393,0,2,70.0,69.0,78.0,93.0,2289,2513,1819,1931,470,582,80,442,30,195,50,247,33,54,2125,600,1150,2200,875,1450,0
400,0,2,73.0,70.0,78.0,93.0,2255,2591,1763,1987,492,604,105,458,20,135,85,323,35,56,2225,600,1150,2350,875,1450,0
407,0,2,76.0,72.0,78.0,93.0,2390,2675,1875,2071,515,604,100,149,5,50,95,99,35,57,2275,750,1150,2350,875,1450,0
414,0,2,78.0,79.0,78.0,93.0,2110,2871,1595,2267,515,604,226,366,125,195,101,171,37,58,2275,1250,1150,2350,875,1450,0
421,0,2,84.0,87.0,86.0,93.0,2143,3101,1651,2519,492,582,117,329,60,90,57,239,38,58,2325,1350,1300,2350,875,1450,0
429,0,2,85.0,88.0,86.0,93.0,2070,3207,1511,2603,559,604,284,515,155,200,129,315,39,59,2775,1550,1300,2350,875,1450,0
436,0,2,86.0,93.0,86.0,101.0,2272,3174,1623,2547,649,627,124,401,40,110,84,291,41,61,2775,1550,1300,2350,875,1450,0
443,0,2,90.0,97.0,94.0,101.0,2166,3263,1539,2659,627,604,235,484,75,125,160,359,41,62,2825,2000,1300,2350,875,1450,0
450,0,2,92.0,97.0,94.0,101.0,2160,3185,1511,2603,649,582,365,687,150,310,215,377,42,61,3225,2100,1300,2650,875,1550,0
457,0,2,94.0,99.0,94.0,109.0,2216,2726,1567,2099,649,627,101,738,35,335,66,403,43,60,3225,2950,1300,2650,875,1600,0
464,0,2,98.0,106.0,110.0,117.0,2238,2782,1567,2155,671,627,351,424,180,195,171,229,43,59,3400,2950,1300,2650,875,1650,0
471,0,2,100.0,112.0,110.0,117.0,2244,3286,1595,2659,649,627,298,497,105,200,193,297,43,60,3525,3125,1300,2650,875,1650,0
479,0,2,103.0,110.0,110.0,117.0,2300,3230,1651,2603,649,627,248,883,50,510,198,373,43,62,3525,3225,1300,2800,875,1750,0
486,0,2,105.0,110.0,110.0,117.0,2278,3123,1651,2519,627,604,375,1076,88,635,287,441,43,62,3950,3225,1300,2800,875,1750,0
493,0,2,106.0,115.0,110.0,117.0,2244,3129,1595,2547,649,582,470,1143,128,630,342,513,44,61,4175,3525,1425,2800,875,1800,0
500,0,2,110.0,119.0,110.0,125.0,2272,2479,1623,1987,649,492,600,318,178,245,422,73,44,59,4300,3425,1500,2800,875,2000,0
507,0,2,109.0,119.0,118.0,117.0,2294,2322,1623,1875,671,447,871,499,373,370,498,129,45,59,4300,4175,1500,2800,975,2450,0
514,0,2,110.0,120.0,118.0,125.0,2328,2765,1679,2295,649,470,577,714,28,525,549,189,46,59,4350,4175,1500,2800,975,2450,0
521,0,2,110.0,118.0,118.0,125.0,2216,3174,1567,2659,649,515,783,984,158,735,625,249,46,61,4375,4425,1500,2800,1125,2700,0
529,0,2,99.0,111.0,118.0,125.0,2356,3056,1707,2631,649,425,658,1298,28,1005,630,293,47,63,3300,3950,1500,2800,2200,3175,0
536,0,2,97.0,123.0,118.0,133.0,2362,3056,1735,2631,627,425,1019,376,238,335,781,41,47,64,3350,3850,1500,2800,2200,3275,0
543,0,2,101.0,125.0,118.0,133.0,2300,2860,1651,2435,649,425,809,513,73,420,736,93,47,66,3400,4900,1500,2800,2200,3275,0
550,0,2,101.0,123.0,118.0,133.0,2266,2748,1595,2323,671,425,809,400,18,255,791,145,47,64,3475,4900,1500,2800,2250,3425,0
557,0,2,103.0,123.0,118.0,133.0,2266,2742,1595,2295,671,447,1075,591,208,390,867,201,47,66,3525,4900,1500,2800,2250,3425,0
564,0,2,107.0,124.0,118.0,133.0,2014,2770,1343,2211,671,559,921,568,103,445,818,123,47,67,3700,4900,1500,2800,2250,3425,0
571,0,2,111.0,130.0,118.0,133.0,1908,2860,1259,2099,649,761,942,408,73,185,869,223,48,67,3700,4900,1500,2800,2250,3425,0
579,0,2,114.0,132.0,118.0,133.0,2082,2899,1455,1959,627,940,923,290,103,155,820,135,48,68,3800,5200,1500,2800,2250,3425,0
586,0,2,117.0,132.0,141.0,133.0,2216,3202,1567,2239,649,963,923,471,48,220,875,251,49,68,3800,5375,1500,2950,2250,3425,0
593,0,2,118.0,134.0,141.0,149.0,2188,3174,1539,2211,649,963,858,207,28,90,830,117,50,65,4375,5275,1900,2950,2250,3675,0
600,0,2,116.0,130.0,141.0,149.0,2210,3090,1539,2127,671,963,944,577,63,340,881,237,50,65,4375,5425,1900,2950,2250,3875,0
607,0,2,119.0,132.0,149.0,165.0,2210,3314,1539,2351,671,963,918,738,10,510,908,228,50,65,4400,5425,1900,2950,2550,3875,0
614,0,2,120.0,134.0,149.0,165.0,2188,3190,1539,2183,649,1007,1005,378,32,330,973,48,50,65,4450,5675,1900,2950,2550,3875,0
621,0,2,122.0,134.0,149.0,165.0,2692,3112,2043,2127,649,985,1195,400,167,240,1028,160,51,65,4450,5850,2075,2950,2550,3875,0
629,0,2,124.0,137.0,149.0,180.0,2726,3252,2099,2267,627,985,1176,636,147,360,1029,276,51,65,4450,6150,2175,2950,2600,3875,0
636,0,2,129.0,143.0,149.0,180.0,3308,3342,2659,2379,649,963,1101,357,42,165,1059,192,52,65,4900,6600,2275,2950,2600,4125,0
643,0,2,135.0,148.0,149.0,188.0,3330,3426,2659,2463,671,963,946,423,32,165,914,258,52,65,5025,6775,2275,2950,2600,4125,0
650,0,2,138.0,149.0,149.0,188.0,3442,3594,2771,2631,671,963,1057,814,67,440,990,374,54,65,5150,6775,2275,3200,2600,4125,0
657,0,2,140.0,158.0,149.0,188.0,3661,3426,2967,2463,694,963,1171,625,222,235,949,390,56,68,5200,7225,2275,3350,2650,4125,0
664,0,2,144.0,165.0,149.0,188.0,3885,3594,3079,2631,806,963,1092,296,197,140,895,156,57,69,5150,7525,2475,3600,2700,4125,0
671,0,2,144.0,167.0,157.0,188.0,3801,3644,2995,2659,806,985,663,436,72,160,591,276,58,72,5600,7775,2475,3600,2700,4125,0
679,0,2,149.0,174.0,157.0,188.0,3493,3728,2687,2743,806,985,733,232,42,90,691,142,59,74,6000,8225,2475,3600,2700,4125,0
686,0,2,153.0,177.0,157.0,188.0,3101,3862,2295,2855,806,1007,824,393,162,285,662,108,59,75,6250,8525,2700,3600,2700,4125,0
693,0,2,157.0,177.0,157.0,188.0,3263,3958,2435,2995,828,963,739,605,177,385,562,220,62,75,6250,8425,2700,3600,2700,4225,0
700,0,2,157.0,177.0,157.0,188.0,3174,3902,2323,2939,851,963,949,821,237,485,712,336,62,75,6250,8425,2600,3600,2762,4225,0
707,0,2,162.0,177.0,165.0,188.0,3179,3840,2239,2855,940,985,846,436,147,330,699,106,64,77,6525,8425,2600,3850,2762,4225,0
714,0,2,164.0,188.0,165.0,188.0,3028,3868,2043,2883,985,985,630,217,68,195,562,22,64,77,7075,9075,2600,3850,2762,4225,0
721,0,2,164.0,188.0,165.0,196.0,2978,3924,2015,2939,963,985,846,298,52,160,794,138,64,77,7300,9725,2800,3850,2762,4225,0
729,0,2,163.0,188.0,173.0,196.0,3062,3812,2099,2827,963,985,1212,589,302,335,910,254,64,77,7250,9725,2800,3850,2812,4225,0
736,0,2,167.0,188.0,181.0,196.0,3090,3935,2127,2883,963,1052,842,682,37,300,805,382,64,77,7250,9725,2800,3850,2812,4225,0
743,0,2,169.0,188.0,181.0,204.0,3168,4008,2183,2911,985,1097,938,1183,142,665,796,518,64,77,8025,9725,2800,3850,2812,4225,0
750,0,2,173.0,189.0,189.0,204.0,3146,4075,2183,2911,963,1164,929,1602,217,940,712,662,66,77,8025,10025,2800,4150,2812,4225,0
757,0,2,175.0,189.0,189.0,204.0,3196,4154,2211,2855,985,1299,1035,1848,332,1030,703,818,66,77,8025,10025,2800,4600,2812,4225,0
764,0,2,182.0,189.0,189.0,204.0,3224,4126,2239,2827,985,1299,776,2335,132,1365,644,970,66,78,8300,10025,2925,4600,2812,4225,0
771,0,2,183.0,185.0,189.0,204.0,3258,4182,2295,2883,963,1299,1052,2856,317,1730,735,1126,68,78,8525,9600,2925,4600,2862,4650,0
779,0,2,183.0,191.0,189.0,204.0,3146,4148,2183,2827,963,1321,1103,2722,252,1740,851,982,68,78,8925,9600,2925,4600,2862,4650,0
786,0,2,183.0,189.0,189.0,204.0,3056,4204,2071,2883,985,1321,1218,3228,372,2090,846,1138,68,78,9100,9425,3175,4600,3087,4825,0
793,0,2,185.0,185.0,181.0,204.0,3168,4232,2183,2911,985,1321,559,3440,72,2300,487,1140,68,78,9225,9075,3175,4850,3187,5175,0
800,0,2,184.0,184.0,196.0,204.0,3084,4215,2099,2939,985,1276,740,3837,137,2620,603,1217,68,78,9050,8975,3175,4850,3637,5275,0
807,0,2,188.0,198.0,196.0,219.0,3112,4299,2127,3023,985,1276,881,2613,187,2115,694,498,68,78,9050,10725,3175,4850,3637,5275,0
814,0,2,187.0,200.0,196.0,219.0,2866,4187,1903,2911,963,1276,1168,2354,312,1550,856,804,70,78,9175,11325,3175,4850,3637,5275,0
821,0,2,195.0,198.0,212.0,219.0,2726,4019,1763,2743,963,1276,764,2975,117,2015,647,960,71,78,9175,11075,3175,4850,3637,5525,0
829,0,2,195.0,196.0,212.0,219.0,2586,4086,1623,2743,963,1343,754,2840,87,1720,667,1120,73,79,9175,10975,3175,4850,3637,5625,0
836,0,2,184.0,186.0,212.0,227.0,2944,4176,1959,2855,985,1321,805,3332,172,2060,633,1272,72,79,8350,10200,3475,4850,4862,6500,0
843,0,2,172.0,180.0,212.0,227.0,2916,4322,1931,3023,985,1299,1025,3849,297,2425,728,1424,64,79,7950,9450,3475,4850,5787,7250,0
850,0,2,166.0,164.0,212.0,243.0,2888,4210,1903,2911,985,1299,807,4255,17,2675,790,1580,61,79,7025,7850,3700,5300,6962,8850,0
857,0,2,160.0,155.0,212.0,243.0,2569,4126,1651,2827,918,1299,911,4761,92,3025,819,1736,62,79,6475,7050,3700,5450,7560,9650,0
864,0,2,153.0,153.0,212.0,243.0,2334,4288,1483,2967,851,1321,1100,4662,152,3070,948,1592,64,79,6475,6300,3700,5450,8285,10400,0
871,0,2,157.0,173.0,212.0,243.0,2546,4210,1763,2911,783,1299,1072,3224,82,2080,990,1144,65,79,6675,8050,3700,5450,8285,10400,0
879,0,2,159.0,173.0,204.0,243.0,2944,4316,2183,2995,761,1321,1145,3735,42,2435,1103,1300,67,79,6675,8050,3700,5750,8385,10400,0
886,0,2,160.0,174.0,204.0,251.0,2938,3851,2155,2575,783,1276,1387,3567,192,2115,1195,1452,68,79,6675,8050,3800,5900,8385,10400,0
893,0,2,165.0,199.0,204.0,251.0,3034,3616,2071,2295,963,1321,1217,2756,77,1140,1140,1616,71,79,7025,9250,3875,5900,8385,10400,0
900,0,2,169.0,199.0,204.0,259.0,3280,3974,2295,2407,985,1567,1428,3097,172,1285,1256,1812,73,81,7025,9850,4075,5900,8385,10400,0
907,0,2,175.0,199.0,204.0,259.0,3314,4193,2351,2603,963,1590,1224,3594,152,1590,1072,2004,75,81,7025,9850,4075,5900,8385,10400,0
914,0,2,177.0,199.0,204.0,259.0,3498,4355,2491,2743,1007,1612,1537,4120,362,1920,1175,2200,77,81,7150,9850,4150,6350,8385,10400,0
921,0,2,179.0,197.0,204.0,251.0,3734,4546,2547,2911,1187,1635,1900,4769,577,2373,1323,2396,77,81,7425,9750,4150,6350,8385,10600,0
929,0,2,161.0,193.0,204.0,251.0,3930,4512,2631,2855,1299,1657,1207,5295,32,2703,1175,2592,77,81,5750,9400,4150,6350,10060,10950,0
936,0,2,156.0,178.0,204.0,251.0,4047,4383,2771,2827,1276,1556,1225,5794,52,3028,1173,2766,77,81,4950,8050,4150,6350,11085,12300,0
943,0,2,152.0,169.0,204.0,251.0,3706,4310,2519,2855,1187,1455,1326,6312,42,3378,1284,2934,73,81,4725,7250,4150,6350,11510,13100,0
950,0,2,162.0,191.0,204.0,251.0,3498,4333,2379,2855,1119,1478,1367,4898,97,2338,1270,2560,74,81,5850,9175,4150,6350,11510,13100,0
957,0,2,172.0,191.0,204.0,251.0,3644,4282,2547,2827,1097,1455,1239,4769,37,2033,1202,2736,75,81,6075,9175,4150,6350,11510,13100,0
964,0,2,175.0,191.0,204.0,251.0,3806,3958,2631,2547,1175,1411,1561,5236,217,2328,1344,2908,75,81,6175,9175,4150,6350,11510,13100,0
971,0,2,175.0,181.0,204.0,251.0,3834,4333,2715,2855,1119,1478,1517,5591,287,2753,1230,2838,76,81,6950,8975,4150,6350,11510,13500,0
979,0,2,185.0,191.0,204.0,251.0,3728,4361,2687,2883,1041,1478,1270,4888,47,2228,1223,2660,76,81,7125,9925,4150,6350,11560,13775,0
986,0,2,162.0,186.0,204.0,251.0,3470,4417,2631,2939,839,1478,1506,5399,212,2563,1294,2836,73,81,5925,9450,4150,6350,13010,14250,0
993,0,2,154.0,179.0,204.0,251.0,3431,4310,2715,2855,716,1455,1705,5906,352,2898,1353,3008,72,81,5475,8800,4150,6200,13560,14937,0
1000,0,2,160.0,173.0,204.0,251.0,3448,4333,2799,2855,649,1478,1411,6432,82,3248,1329,3184,72,81,6225,8275,4150,6200,14085,15462,0
1007,0,2,165.0,173.0,204.0,259.0,3498,4277,2827,2799,671,1478,1381,6513,172,3153,1209,3360,72,81,6275,8275,4150,6200,14085,15462,0
1014,0,2,166.0,170.0,204.0,259.0,3515,4198,2799,2743,716,1455,1270,7006,152,3478,1118,3528,72,81,6325,7975,4150,6200,14085,15762,0
1021,0,2,168.0,196.0,204.0,259.0,3381,4333,2687,2855,694,1478,1375,4651,227,1893,1148,2758,72,81,6925,10250,4150,6200,14085,15762,0
1029,0,2,177.0,196.0,204.0,259.0,3336,4165,2687,2687,649,1478,1226,5123,102,2193,1124,2930,72,81,7025,10250,4150,6200,14085,15762,0
1036,0,2,177.0,194.0,204.0,259.0,3342,3935,2603,2603,739,1332,1498,4842,307,1758,1191,3084,72,79,7525,10250,4150,6200,14085,15862,0
1043,0,2,182.0,183.0,204.0,259.0,3605,3650,2687,2351,918,1299,1584,5253,377,2013,1207,3240,72,76,7650,9850,4150,6200,13785,16412,0
1050,0,2,191.0,190.0,204.0,259.0,3521,3314,2603,2015,918,1299,1192,4300,152,1508,1040,2792,72,76,7900,9675,4050,6200,14110,16587,0
1057,0,2,191.0,192.0,204.0,259.0,3549,3633,2631,2379,918,1254,848,4592,17,1648,831,2944,72,76,7625,9675,4050,6200,14385,16587,0
1064,0,2,184.0,181.0,204.0,251.0,3504,3706,2631,2407,873,1299,918,5567,12,2459,906,3108,72,81,7225,8475,4050,6200,15135,17811,0
1071,0,2,176.0,194.0,204.0,251.0,3386,3678,2603,2267,783,1411,1381,4089,387,1359,994,2730,69,74,7225,10225,4050,6800,15485,18636,0
1079,0,2,178.0,185.0,204.0,251.0,3084,3627,2323,2239,761,1388,953,4529,42,1639,911,2890,61,75,7425,9400,3950,6800,16085,19461,0
1086,0,2,182.0,188.0,204.0,251.0,3078,3661,2295,2295,783,1366,1010,4659,7,1759,1003,2900,61,75,7700,9700,3950,6800,16085,19461,0
1093,0,2,186.0,188.0,204.0,251.0,3078,3655,2295,2267,783,1388,1306,4705,207,1649,1099,3056,63,75,8300,9700,3950,6800,16085,19461,0
1100,0,2,189.0,200.0,204.0,251.0,2614,3756,1875,2435,739,1321,1339,3655,152,1189,1187,2466,63,75,8800,9700,3950,6800,16085,19461,0
1107,0,2,191.0,200.0,204.0,251.0,2261,3722,1455,2379,806,1343,1324,3904,137,1274,1187,2630,63,75,9175,11500,3950,6800,16085,19461,0
1114,0,2,196.0,196.0,204.0,251.0,2345,3515,1539,2295,806,1220,1591,3816,162,1244,1429,2572,66,75,9175,11000,4050,6800,16085,19961,0
1121,0,2,198.0,188.0,204.0,259.0,2524,3644,1651,2435,873,1209,1680,4060,168,1444,1512,2616,66,75,9625,10300,4050,6800,16085,20961,0
1129,0,2,200.0,188.0,219.0,259.0,2625,3560,1707,2351,918,1209,1406,4475,32,1719,1374,2756,68,75,9500,10300,4150,6800,16210,20961,0
1136,0,2,189.0,180.0,219.0,267.0,2625,3694,1707,2575,918,1119,1708,4922,222,2034,1486,2888,63,75,9150,9600,4150,6800,17160,21661,0
1143,0,2,189.0,174.0,219.0,267.0,2311,3504,1371,2295,940,1209,1584,5319,107,2279,1477,3040,59,75,9225,9075,4150,6800,17510,22186,0
1150,0,2,170.0,152.0,219.0,267.0,2423,3538,1483,2351,940,1187,1807,5458,222,2424,1585,3034,59,75,7950,6850,4150,6800,18785,24411,0
1157,0,2,172.0,152.0,219.0,267.0,2317,3454,1399,2267,918,1187,1580,3729,87,1109,1493,2620,59,75,8375,6275,4150,7300,18910,26911,0
1164,0,2,164.0,130.0,219.0,282.0,2563,3543,1623,2323,940,1220,1762,4151,182,1389,1580,2762,59,75,7975,4775,4150,7300,19485,28611,0
1171,0,2,159.0,102.0,219.0,282.0,2821,3594,1903,2463,918,1131,1729,4568,62,1674,1667,2894,59,73,7325,2500,4150,7300,20435,30986,0
1179,0,2,149.0,117.0,219.0,282.0,3101,3504,2183,2407,918,1097,1941,2301,162,179,1779,2122,59,73,6650,1225,4150,7050,21160,32511,0
1186,0,2,138.0,106.0,219.0,274.0,3230,3622,2267,2547,963,1075,1972,2129,77,179,1895,1950,59,73,6175,2400,4150,6900,22060,33986,0
1193,0,2,137.0,89.0,219.0,266.0,3269,3409,2351,2379,918,1030,2024,2318,75,244,1949,2074,59,66,5800,1350,4150,6750,22797,35736,0
1200,0,2,133.0,90.0,219.0,266.0,3202,3185,2239,2267,963,918,2095,2325,80,139,2015,2186,60,66,5325,825,4150,6500,23322,36561,0
1207,0,2,139.0,82.0,219.0,258.0,3235,2832,2295,1959,940,873,2317,2344,215,54,2102,2290,60,66,5725,275,4150,6500,23372,37561,0
1214,0,2,144.0,64.0,219.0,258.0,3129,2070,2267,1399,862,671,2255,2750,55,84,2200,2666,60,47,5950,575,4150,6500,23372,38811,0
1221,0,2,150.0,53.0,219.0,250.0,3213,1986,2407,1315,806,671,2176,2791,5,49,2171,2742,60,46,6175,300,4150,6500,23372,39961,0
1229,0,2,153.0,51.0,219.0,250.0,3420,2020,2659,1371,761,649,2395,2992,165,174,2230,2818,61,48,6300,0,4150,6350,23647,40411,0
1234,0,2,153.0,51.0,219.0,250.0,3420,2076,2659,1427,761,649,2395,3182,165,304,2230,2878,61,50,6300,0,4150,6350,23647,40411,0
7,1,2,13.0,13.0,14.0,15.0,293,293,293,293,0,0,35,35,35,35,0,0,12,12,0,0,0,0,0,0,1
14,1,2,13.0,14.0,14.0,15.0,643,643,643,643,0,0,15,65,15,65,0,0,13,13,0,0,0,0,0,0,1
21,1,2,14.0,14.0,14.0,15.0,727,671,727,671,0,0,45,35,45,35,0,0,13,13,0,0,0,0,0,0,1
29,1,2,14.0,15.0,14.0,15.0,755,699,755,699,0,0,140,25,140,25,0,0,13,14,0,0,0,0,0,0,1
36,1,2,16.0,15.0,22.0,15.0,727,727,727,727,0,0,125,120,125,120,0,0,14,14,0,0,0,0,0,0,1
43,1,2,16.0,16.0,22.0,23.0,783,699,783,699,0,0,215,40,215,40,0,0,14,15,0,0,0,0,0,0,1
50,1,2,17.0,17.0,22.0,23.0,755,755,755,755,0,0,260,15,260,15,0,0,16,16,0,0,0,0,0,0,1
57,1,2,17.0,18.0,22.0,23.0,811,783,811,783,0,0,5,10,5,10,0,0,15,17,0,0,0,0,0,0,1
64,1,2,18.0,19.0,22.0,23.0,839,923,839,923,0,0,55,65,55,65,0,0,16,18,0,0,0,0,0,0,1
71,1,2,17.0,19.0,22.0,23.0,895,895,895,895,0,0,140,180,140,180,0,0,16,18,0,0,0,0,0,0,1
79,1,2,16.0,20.0,22.0,23.0,895,934,895,867,0,67,45,292,45,280,0,12,16,19,0,0,0,0,0,0,1
86,1,2,18.0,20.0,22.0,23.0,923,945,923,811,0,134,55,408,55,380,0,28,16,19,0,0,0,0,0,0,1
93,1,2,19.0,20.0,22.0,23.0,923,973,923,839,0,134,120,124,120,80,0,44,17,20,0,0,0,150,0,0,1
100,1,2,20.0,20.0,22.0,23.0,934,1029,867,895,67,134,177,105,165,45,12,60,18,20,0,0,0,150,0,0,1
107,1,2,20.0,21.0,22.0,23.0,1051,1051,895,895,156,156,302,105,270,25,32,80,19,20,0,0,0,150,0,0,1
114,1,2,20.0,22.0,22.0,23.0,1051,1018,895,839,156,179,327,165,275,65,52,100,20,21,0,0,0,150,0,0,1
121,1,2,20.0,22.0,22.0,23.0,1102,1023,923,867,179,156,447,146,375,30,72,116,20,21,0,0,0,150,0,0,1
129,1,2,26.0,23.0,36.0,23.0,1051,1051,895,895,156,156,168,276,80,140,88,136,20,22,0,0,250,150,0,0,1
136,1,2,27.0,25.0,36.0,31.0,1034,1141,923,895,111,246,40,237,40,90,0,147,20,22,0,0,250,300,0,0,1
143,1,2,29.0,26.0,36.0,31.0,979,1152,979,839,0,313,70,83,70,50,0,33,21,23,0,0,250,300,0,0,1
150,1,2,30.0,27.0,36.0,31.0,1007,1208,1007,895,0,313,130,83,130,60,0,23,22,24,50,0,250,300,0,0,1
157,1,2,31.0,29.0,36.0,31.0,1147,1225,1147,867,0,358,235,98,235,60,0,38,23,24,100,125,250,300,0,0,1
164,1,2,31.0,31.0,36.0,46.0,1203,1281,1203,923,0,358,380,108,380,30,0,78,24,25,400,125,250,300,0,0,1
171,1,2,31.0,33.0,36.0,46.0,1259,1236,1259,923,0,313,70,160,70,50,0,110,24,27,400,125,250,300,0,0,1
179,1,2,32.5,35.0,36.0,46.0,1315,1432,1315,1119,0,313,140,285,140,135,0,150,24,29,375,125,250,300,25,0,1
186,1,2,34.5,39.0,36.0,46.0,1343,1460,1343,1147,0,313,160,65,160,25,0,40,25,30,375,250,250,600,25,0,1
193,1,2,39.5,42.0,44.0,46.0,1455,1628,1455,1315,0,313,30,45,30,15,0,30,26,31,375,250,250,600,25,0,1
200,1,2,40.5,43.0,44.0,46.0,1483,1706,1483,1371,0,335,45,95,45,25,0,70,26,32,425,250,250,600,25,0,1
207,1,2,43.5,44.0,44.0,46.0,1511,1757,1511,1399,0,358,90,200,90,90,0,110,27,33,475,250,250,600,25,0,1
214,1,2,43.0,45.0,52.0,46.0,1259,1852,1259,1539,0,313,202,322,202,180,0,142,30,34,500,550,250,600,50,0,1
221,1,2,48.0,49.0,52.0,54.0,1471,1852,1427,1539,44,313,155,237,147,205,8,32,31,35,650,725,250,600,50,0,1
229,1,2,46.0,49.0,52.0,54.0,1662,1880,1595,1567,67,313,343,472,327,400,16,72,32,37,700,600,250,600,150,125,1
236,1,2,49.0,49.0,52.0,54.0,1751,1936,1707,1623,44,313,352,162,332,50,20,112,36,37,650,600,250,600,200,125,1
243,1,2,54.0,50.0,58.0,54.0,1774,1964,1707,1651,67,313,99,252,67,100,32,152,39,39,650,600,250,600,200,125,1
250,1,2,56.0,52.0,58.0,54.0,1891,2037,1735,1679,156,358,94,142,42,50,52,92,39,40,650,600,250,600,200,125,1
257,1,2,58.0,52.0,58.0,62.0,2003,2205,1847,1847,156,358,239,257,167,125,72,132,40,40,650,900,250,600,200,125,1
264,1,2,58.0,54.0,58.0,62.0,2115,2216,1959,1903,156,313,269,164,177,100,92,64,43,42,650,900,375,600,200,125,1
271,1,2,58.0,54.0,58.0,62.0,2166,2261,1987,1791,179,470,219,282,207,150,12,132,44,42,650,900,500,600,200,125,1
279,1,2,62.0,56.0,66.0,62.0,2138,2300,1959,1651,179,649,74,293,42,85,32,208,44,44,950,900,500,600,200,125,1
286,1,2,66.0,56.0,66.0,62.0,2255,2311,2099,1707,156,604,105,330,57,50,48,280,43,44,950,900,625,750,250,125,1
293,1,2,71.0,58.0,74.0,62.0,2283,2311,2127,1707,156,604,110,200,42,40,68,160,48,46,950,900,625,1000,250,125,1
300,1,2,70.0,59.0,74.0,62.0,2507,2496,2351,1847,156,649,115,401,27,165,88,236,53,47,950,900,625,1000,250,125,1
307,1,2,72.0,61.0,74.0,77.0,2703,2418,2547,1791,156,627,225,560,117,248,108,312,56,48,950,900,625,1000,250,125,1
314,1,2,74.0,64.0,74.0,77.0,2810,2558,2631,1931,179,627,295,260,167,68,128,192,55,50,950,900,625,1250,250,125,1
321,1,2,74.0,66.0,74.0,77.0,3034,2602,2855,1931,179,671,100,371,52,103,48,268,54,51,1000,900,825,1550,250,125,1
329,1,2,74.0,69.0,74.0,77.0,2983,2692,2715,2043,268,649,226,547,142,203,84,344,57,54,1000,900,825,1550,250,125,1
336,1,2,76.0,69.0,82.0,77.0,3056,2726,2743,2099,313,627,417,564,297,148,120,416,57,54,1000,900,825,1700,250,125,1
343,1,2,82.5,72.0,106.0,85.0,3056,2944,2743,2295,313,649,432,874,272,378,160,496,57,57,1125,1150,950,1700,275,125,1
350,1,2,88.5,74.0,114.0,85.0,3134,3084,2799,2435,335,649,436,759,232,183,204,576,59,59,1125,1150,950,2050,275,125,1
357,1,2,90.5,82.0,114.0,85.0,3162,3062,2715,2435,447,627,556,301,292,253,264,48,59,60,1425,1150,950,2050,275,175,1
364,1,2,95.5,83.0,114.0,85.0,3330,3134,2771,2463,559,671,714,221,382,93,332,128,59,62,1475,1150,950,2150,275,175,1
371,1,2,98.5,85.0,114.0,85.0,3358,3090,2687,2463,671,627,850,238,442,113,408,125,60,63,1825,2050,950,2150,275,175,1
379,1,2,101.5,87.0,128.0,93.0,3342,3286,2715,2659,627,627,358,644,182,443,176,201,59,65,1975,2050,1200,2150,325,175,1
386,1,2,108.5,89.0,136.0,93.0,3179,3258,2575,2631,604,627,335,829,187,548,148,281,63,65,1975,2050,1200,2150,325,175,1
393,1,2,113.5,97.0,136.0,101.0,3386,3342,2715,2603,671,739,98,831,62,458,36,373,66,67,2125,2050,1200,2150,325,175,1
400,1,2,114.5,97.0,136.0,109.0,3470,3543,2687,2603,783,940,458,1220,322,731,136,489,66,68,2425,2550,1200,2450,325,175,1
407,1,2,125.5,99.0,136.0,109.0,3526,3571,2743,2631,783,940,169,1553,37,956,132,597,66,68,2375,2650,1200,2600,475,175,1
414,1,2,127.5,109.0,144.0,109.0,3487,3622,2659,2659,828,963,239,1360,57,651,182,709,66,68,2675,2750,1200,2750,475,175,1
421,1,2,126.5,107.0,136.0,109.0,3577,3644,2659,2659,918,985,657,1806,367,981,290,825,65,68,3075,3050,1200,2750,575,275,1
429,1,2,124.5,90.0,130.0,109.0,3532,3627,2547,2687,985,940,569,1859,167,1026,402,833,65,67,3175,1800,1200,2750,1225,1525,1
436,1,2,124.5,92.0,138.0,109.0,3538,3627,2575,2687,963,940,792,1800,282,1001,510,799,65,67,3175,1800,1200,2750,1225,1525,1
443,1,2,127.0,106.0,138.0,117.0,3431,3571,2491,2631,940,940,903,1525,277,606,626,919,68,67,3150,2500,1200,2750,1250,1525,1
450,1,2,123.5,106.0,154.0,117.0,3431,3728,2491,2743,940,985,1328,1372,582,641,746,731,72,69,2975,2500,1200,2750,1425,1525,1
457,1,2,123.5,109.0,162.0,117.0,3638,3610,2631,2603,1007,1007,1768,982,902,131,866,851,72,69,2975,2500,1650,2750,1425,1525,1
464,1,2,141.5,109.0,154.0,125.0,3778,3818,2771,2855,1007,963,424,1145,342,186,82,959,72,69,2975,2500,1850,2750,1525,1525,1
471,1,2,141.5,112.0,154.0,125.0,3750,3622,2743,2659,1007,963,551,1251,507,176,44,1075,72,72,2975,2875,1850,2750,1525,1525,1
479,1,2,148.5,114.0,154.0,125.0,3711,3711,2771,2771,940,940,624,1342,472,251,152,1091,72,72,2975,2875,1850,3050,1525,1525,1
486,1,2,149.5,120.0,154.0,125.0,3627,3622,2687,2659,940,963,965,1243,722,186,243,1057,71,75,4775,2875,1850,3050,1525,1525,1
493,1,2,153.5,120.0,154.0,125.0,3795,3790,2855,2827,940,963,1150,1079,837,56,313,1023,78,75,4775,2875,1850,3300,1525,1525,1
500,1,2,153.5,122.0,154.0,125.0,3711,3739,2771,2799,940,940,1145,1106,712,121,433,985,78,78,4775,3050,1850,3750,1525,1525,1
507,1,2,153.5,124.0,154.0,133.0,3582,3588,2575,2603,1007,985,1251,1318,702,221,549,1097,78,78,4875,3600,1850,3850,1525,1525,1
514,1,2,159.5,126.0,184.0,133.0,3812,3538,2715,2575,1097,963,1219,1235,642,126,577,1109,78,73,4775,3600,1850,3850,1825,1775,1
521,1,2,165.0,120.0,208.0,133.0,3963,3487,2911,2547,1052,940,1274,1126,577,51,697,1075,78,71,4650,3800,1850,4000,1950,2275,1
529,1,2,163.0,119.0,224.0,164.0,3980,3319,2883,2379,1097,940,1755,1307,922,116,833,1191,78,69,4850,3975,1850,4150,2150,2525,1
536,1,2,171.0,126.0,224.0,164.0,4148,3286,3051,2323,1097,963,1502,737,762,26,740,711,78,68,4450,4225,1850,4450,2550,2575,1
543,1,2,165.0,133.0,224.0,164.0,4002,3286,2883,2323,1119,963,1997,804,1117,131,880,673,78,72,4550,4225,1850,4450,3150,2575,1
550,1,2,185.0,135.0,224.0,164.0,3778,3470,2659,2463,1119,1007,1428,1189,662,396,766,793,78,76,5000,5125,1850,4450,3150,2575,1
557,1,2,189.0,135.0,224.0,164.0,3773,3532,2631,2547,1142,985,1244,1431,342,526,902,905,77,76,5150,5125,1850,4450,3150,2575,1
564,1,2,192.0,143.0,224.0,164.0,3969,3734,2827,2771,1142,963,1576,943,542,526,1034,417,77,78,5750,5125,1850,4450,3150,2575,1
571,1,2,195.5,146.0,224.0,164.0,4137,3521,2995,2603,1142,918,672,640,77,261,595,379,76,78,6325,6325,1850,4450,3175,2575,1
579,1,2,197.5,146.0,224.0,164.0,4221,3627,3079,2687,1142,940,653,506,72,311,581,195,76,78,6425,5925,1850,4450,3275,2975,1
586,1,2,197.0,146.0,224.0,164.0,4176,3582,3079,2575,1097,1007,706,935,197,616,509,319,76,78,7150,6125,1850,4450,3825,2975,1
593,1,2,184.0,146.0,224.0,172.0,4232,3946,3135,2715,1097,1231,1216,1026,567,851,649,175,76,78,6150,6375,2000,4450,5550,3175,1
600,1,2,163.5,135.0,224.0,172.0,4137,3980,2995,2659,1142,1321,1201,1093,412,766,789,327,76,78,4975,4525,2000,4900,7200,4925,1
607,1,2,152.5,120.0,224.0,172.0,4182,3991,2995,2715,1187,1276,1192,1571,267,1096,925,475,76,75,3525,4825,2000,4900,8125,5875,1
614,1,2,142.5,124.0,224.0,172.0,4159,3840,2995,2631,1164,1209,1694,1485,637,1016,1057,469,76,74,3325,4725,2000,4900,8825,6225,1
621,1,2,141.0,126.0,224.0,172.0,4086,3795,2967,2631,1119,1164,1927,1526,842,1071,1085,455,75,74,3500,4725,2000,4900,9100,6225,1
629,1,2,159.0,132.0,224.0,172.0,4092,3773,2995,2519,1097,1254,629,1391,312,1226,317,165,75,75,3550,4925,2000,4900,9100,6225,1
636,1,2,171.0,137.0,224.0,172.0,3980,3818,2883,2519,1097,1299,199,697,42,526,157,171,75,77,3550,5875,2000,4900,9100,6225,1
643,1,2,175.0,141.0,230.0,172.0,3896,3767,2799,2491,1097,1276,269,660,72,441,197,219,75,77,3550,5475,2000,4900,9100,6225,1
650,1,2,183.0,149.0,222.0,172.0,4025,3571,2771,2295,1254,1276,125,513,97,146,28,367,77,80,5550,5925,2000,4900,9200,6225,1
657,1,2,190.0,149.0,230.0,172.0,4260,3582,2939,2239,1321,1343,269,934,97,411,172,523,79,80,6550,6325,2000,4900,9200,6225,1
664,1,2,190.0,149.0,230.0,172.0,4238,3711,2939,2435,1299,1276,316,991,217,316,99,675,82,80,6850,6325,2000,4900,9200,6225,1
671,1,2,194.0,149.0,230.0,180.0,4266,3907,2967,2631,1299,1276,162,1158,107,331,55,827,81,80,7050,6700,2000,5300,9200,6225,1
679,1,2,199.5,154.0,230.0,180.0,4243,3790,2967,2491,1276,1299,369,1313,162,326,207,987,81,79,7825,7000,2000,5450,9225,6275,1
686,1,2,199.5,164.0,230.0,188.0,4271,3991,2995,2715,1276,1276,865,640,502,251,363,389,81,79,8075,7200,2000,5450,9225,6275,1
693,1,2,195.0,164.0,230.0,188.0,4378,4098,3079,2799,1299,1299,1126,1126,697,581,429,545,81,79,8250,7200,2000,5450,9430,6275,1
700,1,2,186.0,162.0,230.0,188.0,4445,3857,3079,2603,1366,1254,1241,1025,827,486,414,539,81,71,7850,8100,2000,5300,9930,6749,1
707,1,2,198.5,164.0,238.0,188.0,4406,3560,3107,2463,1299,1097,1088,958,469,491,619,467,81,69,7750,8625,2250,5300,10066,6849,1
714,1,2,193.0,168.0,238.0,188.0,4271,3538,2995,2463,1276,1075,1594,491,766,146,828,345,80,67,7250,8425,2250,5300,10602,7299,1
721,1,2,194.0,166.0,238.0,203.0,4260,3454,2939,2379,1321,1075,559,643,121,166,438,477,80,66,7300,9200,2250,5600,11402,7949,1
729,1,2,188.0,165.0,238.0,203.0,4243,3392,2967,2295,1276,1097,712,535,276,76,436,459,80,66,6800,8950,2250,5750,12002,8199,1
736,1,2,190.0,169.0,238.0,203.0,4221,3386,2967,2267,1254,1119,833,802,241,211,592,591,80,70,7750,8950,2250,5750,12627,8249,1
743,1,2,193.0,171.0,238.0,203.0,4238,3470,2939,2351,1299,1119,823,1114,146,391,677,723,80,72,7150,8950,2250,5750,13227,8299,1
750,1,2,197.0,182.0,238.0,203.0,4333,3560,2967,2463,1366,1097,993,288,156,141,837,147,80,74,7500,9050,2250,5750,13227,8299,1
757,1,2,200.0,189.0,238.0,203.0,3918,3510,2575,2435,1343,1075,971,360,286,231,685,129,83,79,8000,10150,2250,5750,13227,8299,1
764,1,2,199.5,195.0,238.0,203.0,3678,3622,2379,2547,1299,1075,1054,278,346,171,708,107,84,79,8375,9750,2250,5750,13252,8299,1
771,1,2,200.0,198.0,238.0,203.0,3879,3706,2603,2631,1276,1075,1335,225,471,186,864,39,84,84,8150,10825,2250,5750,13477,8299,1
779,1,2,197.5,200.0,238.0,203.0,4137,4014,2883,2939,1254,1075,787,467,301,296,486,171,85,85,8150,10825,2375,5900,13537,8299,1
786,1,2,197.0,200.0,246.0,203.0,4277,4058,3023,2939,1254,1119,997,954,351,651,646,303,85,87,8075,10925,2525,5900,13612,8299,1
793,1,2,196.5,196.0,254.0,203.0,4540,4282,3219,3163,1321,1119,1297,1466,491,1031,806,435,84,87,8750,10725,2525,5900,14262,8499,1
800,1,2,199.5,200.0,254.0,203.0,4602,4159,3303,2995,1299,1164,1681,1211,731,636,950,575,84,87,8750,10725,2875,5900,14262,8499,1
807,1,2,196.0,200.0,254.0,195.0,4686,4114,3387,2771,1299,1343,2222,1725,1116,986,1106,739,84,87,8825,10925,2875,5900,14437,8599,1
814,1,2,197.5,198.0,254.0,195.0,4602,4400,3303,2967,1299,1433,1158,2277,446,1366,712,911,84,87,8250,10825,2875,5900,15162,8699,1
821,1,2,151.0,188.0,254.0,195.0,4686,4428,3387,2995,1299,1433,984,1444,116,361,868,1083,84,87,3175,7825,2875,5900,19262,11499,1
7,0,0,13.0,13.0,15.0,15.0,293,251,293,251,0,0,35,30,35,30,0,0,12,12,0,0,0,0,0,0,0
14,0,0,13.0,14.0,15.0,15.0,587,671,587,671,0,0,5,70,5,70,0,0,13,13,0,0,0,0,0,0,0
21,0,0,14.0,14.0,15.0,15.0,615,699,615,699,0,0,30,50,30,50,0,0,13,13,0,0,0,0,0,0,0
29,0,0,14.0,15.0,15.0,15.0,615,755,615,755,0,0,115,15,115,15,0,0,13,14,0,0,0,0,0,0,0
36,0,0,14.0,15.0,15.0,15.0,615,727,615,727,0,0,180,45,180,45,0,0,14,14,0,0,0,0,0,0,0
43,0,0,14.0,16.0,23.0,23.0,671,755,671,755,0,0,30,135,30,135,0,0,14,15,0,0,0,0,0,0,0
50,0,0,14.0,16.0,23.0,23.0,643,755,643,755,0,0,115,25,115,25,0,0,14,15,0,0,0,0,0,0,0
57,0,0,14.0,17.0,23.0,23.0,671,794,671,727,0,67,35,72,35,60,0,12,14,16,0,0,0,0,0,0,0
64,0,0,15.0,18.0,23.0,23.0,643,906,643,727,0,179,60,177,60,145,0,32,14,17,0,0,0,0,0,0,0
71,0,0,16.0,18.0,23.0,23.0,670,883,559,727,111,156,100,282,80,230,20,52,15,17,0,0,0,0,0,0,0
79,0,0,16.0,19.0,23.0,23.0,715,934,559,755,156,179,181,352,145,280,36,72,15,18,0,0,0,0,0,0,0
86,0,0,17.0,19.0,23.0,23.0,771,990,615,811,156,179,21,467,15,375,6,92,16,18,0,0,150,0,0,0,0
93,0,0,17.0,20.0,23.0,23.0,771,995,615,839,156,156,46,333,20,275,26,58,16,19,0,0,150,150,0,0,0
100,0,0,17.0,20.0,23.0,23.0,771,1051,615,895,156,156,136,458,90,380,46,78,16,19,0,0,150,150,0,0,0
107,0,0,18.0,20.0,23.0,23.0,822,1079,643,923,179,156,126,188,110,90,16,98,16,19,0,0,300,150,0,0,0
114,0,0,19.0,20.0,23.0,23.0,743,1051,587,895,156,156,67,58,35,40,32,18,16,19,0,0,300,150,0,0,0
121,0,0,20.0,21.0,23.0,23.0,872,1023,671,867,201,156,25,53,15,15,10,38,16,19,100,0,300,150,0,0,0
129,0,0,21.0,21.0,23.0,23.0,1018,1074,727,895,291,179,0,88,0,80,0,8,17,19,100,100,300,150,0,0,0
136,0,0,23.0,22.0,23.0,23.0,922,1242,587,1063,335,179,70,73,30,45,40,28,18,20,200,100,300,150,0,0,0
143,0,0,23.0,22.0,31.0,23.0,984,1163,671,1007,313,156,151,144,75,100,76,44,18,20,200,100,300,150,0,50,0
7,2,1,13.0,13.0,15.0,14.0,293,293,293,293,0,0,35,35,35,35,0,0,12,12,0,0,0,0,0,0,1
14,2,1,14.0,13.0,15.0,14.0,615,643,615,643,0,0,60,15,60,15,0,0,13,13,0,0,0,0,0,0,1
21,2,1,14.0,14.0,15.0,14.0,671,727,671,727,0,0,45,55,45,55,0,0,13,13,0,0,0,0,0,0,1
29,2,1,15.0,14.0,15.0,14.0,727,783,727,783,0,0,35,150,35,150,0,0,14,13,0,0,0,0,0,0,1
36,2,1,15.0,16.0,23.0,22.0,699,811,699,811,0,0,115,150,115,150,0,0,14,14,0,0,0,0,0,0,1
43,2,1,16.0,17.0,23.0,22.0,699,811,699,811,0,0,5,190,5,190,0,0,15,14,0,0,0,0,0,0,1
50,2,1,17.0,17.0,23.0,22.0,783,811,783,811,0,0,25,280,25,280,0,0,16,16,0,0,0,0,0,0,1
57,2,1,18.0,17.0,23.0,22.0,839,839,839,839,0,0,25,35,25,35,0,0,17,16,0,0,0,0,0,0,1
64,2,1,19.0,18.0,23.0,22.0,979,923,979,923,0,0,95,100,95,100,0,0,18,16,0,0,0,0,0,0,1
71,2,1,19.0,17.0,23.0,22.0,979,951,979,951,0,0,210,175,210,175,0,0,18,17,0,0,0,0,0,0,1
79,2,1,20.0,17.0,23.0,22.0,990,895,923,895,67,0,317,35,305,35,12,0,19,16,0,0,0,0,0,0,1
86,2,1,20.0,18.0,23.0,22.0,1006,951,895,951,111,0,39,100,15,100,24,0,19,16,0,0,150,0,0,0,1
93,2,1,20.0,19.0,23.0,22.0,1006,923,895,923,111,0,155,160,115,160,40,0,20,18,0,0,150,0,0,0,1
100,2,1,21.0,20.0,23.0,22.0,1079,978,923,867,156,111,85,235,25,215,60,20,20,19,0,0,150,0,0,0,1
107,2,1,21.0,20.0,23.0,22.0,1051,1079,895,923,156,156,130,361,50,325,80,36,20,19,0,0,150,0,0,0,1
114,2,1,22.0,20.0,23.0,22.0,1051,1051,895,895,156,156,210,386,110,330,100,56,21,20,0,0,150,0,0,0,1
121,2,1,22.0,22.0,23.0,22.0,1023,1051,867,895,156,156,185,361,65,285,120,76,21,20,0,0,150,250,0,0,1
129,2,1,23.0,26.0,23.0,28.0,1046,1057,867,923,179,134,265,247,125,155,140,92,22,20,0,0,150,250,0,0,1
136,2,1,26.0,28.0,31.0,36.0,1130,1018,839,951,291,67,280,60,125,60,155,0,23,20,0,0,300,250,0,0,1
143,2,1,26.0,29.0,31.0,36.0,1180,1035,867,1035,313,0,76,145,35,145,41,0,23,21,0,50,300,250,0,0,1
150,2,1,27.0,30.0,31.0,36.0,1208,1091,895,1091,313,0,131,235,100,235,31,0,24,22,0,100,300,250,0,0,1
157,2,1,29.0,29.0,46.0,36.0,1236,1203,923,1203,313,0,102,80,60,80,42,0,24,22,125,250,300,250,0,0,1
164,2,1,31.0,30.0,46.0,36.0,1314,1203,979,1203,335,0,162,185,80,185,82,0,25,23,125,400,300,250,0,0,1
171,2,1,32.0,32.0,46.0,36.0,1398,1259,1063,1259,335,0,237,140,115,140,122,0,26,24,125,400,300,250,0,0,1
179,2,1,34.0,33.0,46.0,36.0,1488,1343,1175,1343,313,0,313,85,155,85,158,0,28,24,125,400,300,250,0,0,1
186,2,1,39.0,38.0,46.0,44.0,1656,1343,1343,1343,313,0,108,42,60,42,48,0,30,26,250,400,600,250,0,0,1
193,2,1,39.0,40.0,46.0,44.0,1622,1455,1287,1455,335,0,193,22,105,22,88,0,30,26,250,400,600,250,0,0,1
200,2,1,41.0,43.0,46.0,44.0,1678,1539,1343,1539,335,0,393,52,265,52,128,0,32,28,250,400,600,250,0,0,1
207,2,1,41.0,44.0,54.0,44.0,1712,1555,1399,1511,313,44,184,115,170,107,14,8,32,29,250,400,600,250,0,0,1
214,2,1,46.0,44.0,54.0,52.0,1734,1410,1399,1343,335,67,304,285,250,269,54,16,34,30,550,650,600,250,0,50,1
221,2,1,48.0,51.0,54.0,52.0,1880,1522,1567,1455,313,67,130,63,40,39,90,24,36,30,550,850,600,250,0,50,1
229,2,1,48.0,52.0,54.0,58.0,1908,1662,1595,1595,313,67,195,46,65,14,130,32,36,33,550,850,600,250,0,50,1
236,2,1,50.0,56.0,54.0,58.0,1880,1662,1567,1595,313,67,230,54,60,14,170,40,38,35,850,850,600,250,0,50,1
243,2,1,53.0,56.0,54.0,58.0,2070,1824,1735,1735,335,89,145,146,85,94,60,52,38,34,850,850,600,250,0,50,1
250,2,1,55.0,58.0,62.0,58.0,1992,1891,1679,1735,313,156,321,181,225,109,96,72,40,38,850,850,600,375,0,50,1
257,2,1,55.0,54.0,62.0,58.0,2082,1830,1567,1651,515,179,188,231,120,139,68,92,41,36,850,1000,600,375,0,200,1
264,2,1,54.0,58.0,62.0,58.0,2166,1662,1539,1483,627,179,359,176,215,64,144,112,42,36,550,1150,600,500,300,250,1
271,2,1,55.0,62.0,62.0,74.0,2250,1947,1623,1791,627,156,231,222,15,94,216,128,43,36,850,1150,600,500,300,250,1
279,2,1,56.0,66.0,62.0,74.0,2339,2031,1735,1875,604,156,377,62,85,14,292,48,44,41,850,1150,600,625,300,250,1
286,2,1,60.0,70.0,62.0,74.0,2334,2115,1707,1959,627,156,383,132,65,64,318,68,46,45,850,1150,600,625,300,250,1
293,2,1,60.0,67.0,77.0,74.0,2513,2143,1819,1987,694,156,293,187,45,149,248,38,46,45,1025,1150,1000,625,300,400,1
300,2,1,63.0,67.0,77.0,74.0,2496,2171,1847,2015,649,156,345,282,125,224,220,58,48,48,1025,1150,1000,625,300,400,1
307,2,1,66.0,71.0,77.0,66.0,2608,2530,1959,2351,649,179,411,282,115,204,296,78,51,49,1025,1150,1000,625,300,500,1
314,2,1,71.0,71.0,77.0,74.0,2720,2502,2071,2323,649,179,436,377,160,279,276,98,54,53,1175,1150,1000,625,300,500,1
321,2,1,71.0,70.0,77.0,82.0,2754,2787,2127,2631,627,156,372,158,20,144,352,14,56,53,1175,1150,1300,625,300,500,1
329,2,1,74.0,78.0,77.0,82.0,3000,2905,2351,2659,649,246,497,99,65,49,432,50,57,53,1175,1150,1450,625,300,500,1
336,2,1,74.0,83.0,77.0,98.0,3106,3056,2435,2743,671,313,797,154,285,64,512,90,57,56,1175,1150,1450,825,300,500,1
343,2,1,83.0,81.0,85.0,98.0,3140,2972,2491,2659,649,313,464,324,80,194,384,130,60,58,1700,1150,1450,825,300,500,1
350,2,1,85.0,88.0,93.0,98.0,3224,3017,2575,2659,649,358,655,302,195,138,460,164,61,61,1875,1150,1450,825,300,512,1
357,2,1,85.0,89.5,93.0,98.0,3140,3213,2491,2855,649,358,915,582,375,378,540,204,62,62,1875,1125,1450,825,300,537,1
364,2,1,96.0,97.5,101.0,98.0,3118,3062,2491,2659,627,403,446,495,30,243,416,252,63,66,1875,1375,1450,950,300,537,1
371,2,1,96.0,96.5,101.0,98.0,3151,3230,2547,2603,604,627,577,620,85,288,492,332,63,70,2575,1525,1450,950,300,537,1
379,2,1,96.0,96.0,101.0,98.0,3246,3342,2575,2715,671,627,732,620,160,208,572,412,64,71,2575,1500,1450,1200,400,562,1
386,2,1,96.0,95.5,109.0,114.0,3185,3420,2491,2771,694,649,802,625,150,233,652,392,64,70,2575,1425,1550,1200,400,737,1
393,2,1,101.0,99.5,109.0,144.0,3252,3409,2603,2715,649,694,609,530,85,58,524,472,66,70,2575,1425,1550,1200,400,737,1
400,2,1,106.0,105.5,124.0,160.0,3274,3633,2603,2939,671,694,605,631,105,83,500,548,67,70,3100,1425,1550,1200,400,737,1
407,2,1,109.0,107.5,124.0,160.0,3476,3812,2827,3163,649,649,676,688,100,218,576,470,67,75,3275,1575,1550,1200,400,737,1
414,2,1,107.0,114.0,124.0,160.0,3370,3946,2743,3275,627,671,932,802,280,248,652,554,65,75,3275,1650,1550,1450,550,762,1
421,2,1,118.0,117.0,124.0,160.0,3594,4064,2967,3303,627,761,677,957,145,403,532,554,68,75,3275,1950,1700,1450,550,762,1
429,2,1,119.0,127.0,124.0,160.0,3734,4249,3107,3443,627,806,573,962,115,308,458,654,70,78,3975,2100,2000,1450,550,762,1
436,2,1,119.0,130.5,124.0,160.0,3728,4187,3079,3359,649,828,608,1147,70,493,538,654,73,80,3975,2275,2300,1450,550,787,1
443,2,1,119.0,132.5,132.0,160.0,3840,4271,3191,3443,649,828,979,1004,365,458,614,546,73,80,3975,2275,2300,1450,550,787,1
450,2,1,130.0,144.5,140.0,160.0,3890,4210,3219,3359,671,851,895,449,205,103,690,346,73,79,3975,2675,2300,1450,550,787,1
457,2,1,136.0,144.5,148.0,160.0,4058,4226,3387,3443,671,783,925,652,155,368,770,284,73,79,4675,2975,2300,1450,550,787,1
464,2,1,136.0,157.5,148.0,176.0,4098,4282,3471,3499,627,783,1312,182,470,48,842,134,76,79,4675,3075,2300,1450,550,837,1
471,2,1,136.0,156.5,148.0,182.0,3986,4198,3359,3415,627,783,1692,542,770,308,922,234,76,79,4675,3925,2300,1450,550,1087,1
479,2,1,136.0,155.5,148.0,182.0,4002,4355,3331,3527,671,828,927,532,275,298,652,234,76,79,5000,3425,2300,1450,1450,1462,1
486,2,1,142.0,164.0,156.0,182.0,3924,4299,3275,3471,649,828,933,207,255,73,678,134,76,79,5175,4450,2450,1600,1450,1487,1
493,2,1,142.0,166.0,156.0,182.0,4058,4294,3387,3443,671,851,1404,614,650,388,754,226,76,79,5175,4700,2550,1600,1450,1487,1
500,2,1,154.0,170.5,156.0,182.0,3778,4243,3107,3415,671,828,619,815,135,493,484,322,80,79,5075,5475,2550,1600,1550,1562,1
507,2,1,156.0,170.0,171.0,182.0,3734,4114,3107,3331,627,783,791,1027,285,613,506,414,80,79,6300,5500,2550,1600,1550,1937,1
514,2,1,157.0,178.5,171.0,182.0,3706,4282,3079,3499,627,783,1191,842,605,428,586,414,80,79,6475,5725,2650,1600,1550,2012,1
521,2,1,171.0,180.5,171.0,182.0,4036,4165,3387,3359,649,806,851,1177,185,663,666,514,81,79,6475,5975,2650,1600,1550,2062,1
529,2,1,165.0,179.5,171.0,182.0,4506,4047,3835,3219,671,828,1241,772,495,558,746,214,85,79,6675,6025,2650,1600,1850,2212,1
536,2,1,171.0,174.5,171.0,182.0,4456,4126,3807,3275,649,851,992,1168,320,858,672,310,85,79,7200,5975,2650,1600,1850,2537,1
543,2,1,157.0,166.5,171.0,182.0,4338,4126,3667,3275,671,851,1493,1134,745,728,748,406,83,79,6525,5875,2400,1600,2975,3662,1
550,2,1,146.0,154.5,171.0,182.0,4030,4081,3359,3275,671,806,1293,921,565,623,728,298,74,79,6125,4525,2550,1600,4475,5112,1
557,2,1,140.0,140.5,171.0,182.0,3566,3974,2939,3191,627,783,1185,1097,535,803,650,294,72,80,5250,3725,2550,1600,5450,6337,1
564,2,1,125.0,136.5,171.0,182.0,3594,4114,2967,3331,627,783,965,487,235,393,730,94,68,80,4600,1725,2400,1600,7075,7862,1
571,2,1,128.0,146.5,171.0,182.0,3448,3935,2799,3107,649,828,695,247,135,153,560,94,69,80,4600,2325,2550,1600,7075,7862,1
579,2,1,130.0,146.0,171.0,182.0,3588,4103,2939,3275,649,828,1141,342,505,248,636,94,73,80,4600,2400,2550,1600,7250,8237,1
586,2,1,135.0,140.0,171.0,182.0,3672,4187,3023,3359,649,828,877,759,165,573,712,186,78,80,3725,3500,2550,1600,8125,8637,1
593,2,1,139.0,146.0,171.0,182.0,3790,4294,3051,3443,739,851,1129,694,325,508,804,186,78,79,4425,3750,2550,1600,8125,8687,1
600,2,1,139.0,145.5,171.0,182.0,4081,4170,3163,3387,918,783,1331,762,415,713,916,49,80,79,4425,3775,2750,1600,8125,8712,1
607,2,1,141.0,155.0,171.0,182.0,4271,4170,3331,3387,940,783,963,422,185,373,778,49,83,79,3800,4050,2750,1600,8750,8937,1
614,2,1,147.0,159.0,171.0,182.0,4316,4198,3331,3415,985,783,838,377,90,353,748,24,83,79,4675,4500,2750,1600,8750,8987,1
621,2,1,145.0,161.0,171.0,182.0,4512,4131,3527,3303,985,828,1199,522,335,398,864,124,83,79,5100,4600,2750,1600,8850,9212,1
629,2,1,141.0,166.0,171.0,182.0,4551,4294,3611,3443,940,851,1737,683,765,463,972,220,83,79,4750,4750,2750,1600,9200,9337,1
636,2,1,141.0,168.5,171.0,182.0,4714,4294,3751,3443,963,851,1393,244,555,203,838,41,83,79,4250,4875,2750,1600,9700,9537,1
643,2,1,147.0,169.0,179.0,182.0,4434,4473,3471,3667,963,806,1399,536,595,503,804,33,83,79,5125,5450,2900,1600,9700,9562,1
650,2,1,147.0,172.0,179.0,182.0,4439,4254,3499,3471,940,783,1955,527,1035,473,920,54,83,79,5650,5950,3150,1600,9700,9937,1
657,2,1,151.0,181.5,179.0,182.0,4411,4422,3471,3639,940,783,1921,362,985,308,936,54,83,79,6000,6275,3250,1600,9700,9962,1
664,2,1,161.0,180.5,179.0,182.0,4417,4305,3499,3499,918,806,1558,732,760,578,798,154,83,79,6875,6625,3250,1600,9700,10112,1
671,2,1,140.0,178.0,171.0,182.0,4378,4327,3415,3499,963,828,1989,902,1075,648,914,254,68,79,6175,6350,3250,1600,11250,10687,1
679,2,1,144.0,169.5,179.0,190.0,3812,4271,3051,3443,761,828,1440,1044,700,798,740,246,68,79,6375,5275,2950,1600,12225,12012,1
686,2,1,155.0,176.5,179.0,190.0,3588,4154,2939,3303,649,851,692,1189,80,843,612,346,70,79,6375,5375,3050,1600,12225,12012,1
693,2,1,160.0,178.5,179.0,190.0,3790,3862,3163,3079,627,783,993,992,355,558,638,434,73,79,7075,5375,3050,1600,12225,12237,1
700,2,1,162.0,176.5,179.0,190.0,3734,3834,3107,3051,627,783,1033,697,315,438,718,259,75,78,7250,5825,3050,1600,12225,12487,1
707,2,1,173.0,177.5,179.0,190.0,3952,3806,3303,3023,649,783,1108,327,310,318,798,9,78,78,7650,6025,3050,1600,12225,12637,1
714,2,1,179.0,182.5,179.0,190.0,3846,4019,3107,3191,739,828,1125,517,335,433,790,84,82,78,7650,6725,3050,1600,12225,12662,1
721,2,1,169.0,163.0,171.0,190.0,4215,4187,3387,3359,828,828,1556,1027,670,843,886,184,84,78,7400,5850,3050,1600,12775,13637,1
729,2,1,167.0,177.0,171.0,190.0,4131,4322,3303,3471,828,851,1552,734,570,458,982,276,84,78,7300,6050,3250,1600,12875,13712,1
736,2,1,171.0,175.5,179.0,190.0,4305,4053,3499,3247,806,806,1363,561,435,468,928,93,84,78,7500,5875,3250,1600,12875,13887,1
743,2,1,179.0,180.5,179.0,190.0,4338,4030,3555,3247,783,783,1254,440,230,357,1024,83,84,78,7500,6400,3250,1600,12875,14024,1
750,2,1,160.0,168.5,187.0,190.0,4238,4170,3499,3387,739,783,1212,645,250,462,962,183,81,78,6425,5650,3150,1600,14675,15474,1
757,2,1,143.0,161.0,203.0,190.0,3756,4170,3107,3387,649,783,1442,880,400,597,1042,283,74,78,6075,5475,3150,1600,15900,16374,1
764,2,1,133.0,155.5,203.0,190.0,3414,4215,2743,3387,671,828,1857,510,735,427,1122,83,74,78,5200,4600,3150,1600,16775,17274,1
771,2,1,143.0,156.5,195.0,196.0,3778,4238,3107,3387,671,851,1073,521,175,442,898,79,74,78,5725,4450,3150,1600,17400,17649,1
779,2,1,114.0,145.0,187.0,196.0,3610,4266,2939,3415,671,851,1114,557,240,382,874,175,65,78,4325,3075,3200,1600,20100,18899,1
786,2,1,104.0,137.0,187.0,196.0,3280,4165,2631,3359,649,806,1455,694,505,427,950,267,62,78,3625,2275,3200,1600,21050,19899,1
793,2,1,105.0,132.5,187.0,196.0,3174,4114,2547,3331,627,783,1686,345,660,282,1026,63,62,78,3450,2100,3300,1600,21225,20874,1
800,2,1,109.0,138.5,202.0,196.0,3174,4198,2547,3415,627,783,1646,440,540,277,1106,163,65,78,3450,2550,3300,1600,21225,20974,1
807,2,1,119.0,144.5,202.0,196.0,2776,4187,2127,3359,649,828,1136,435,150,272,986,163,66,78,4150,2800,3300,1600,21225,20974,1
814,2,1,125.0,151.5,202.0,196.0,3129,4243,2435,3415,694,828,1266,540,200,277,1066,263,70,78,4150,2750,3300,1600,21225,21024,1
821,2,1,131.0,154.5,210.0,196.0,3112,4350,2463,3499,649,851,1113,907,125,552,988,355,72,78,4350,4000,3300,1600,21225,21024,1
829,2,1,137.0,168.5,210.0,188.0,3140,4238,2491,3387,649,851,1189,352,125,247,1064,105,74,78,4875,4350,3400,1600,21225,21124,1
836,2,1,133.0,174.5,210.0,180.0,3314,4198,2687,3415,627,783,1610,465,470,272,1140,193,74,78,4900,4600,3400,1600,21500,21324,1
843,2,1,123.0,169.5,210.0,180.0,3510,4254,2883,3471,627,783,1310,710,290,417,1020,293,64,78,4975,4050,3250,1600,22775,21749,1
850,2,1,118.0,168.0,210.0,180.0,3056,4366,2407,3583,649,783,1225,660,125,467,1100,193,62,78,4225,4625,3150,1600,24025,22274,1
857,2,1,123.0,163.5,210.0,180.0,3134,4271,2463,3443,671,828,1270,905,140,612,1130,293,62,75,4225,4650,3150,1600,24025,22749,1
864,2,1,123.0,162.0,210.0,180.0,2966,3907,2295,3079,671,828,1091,1146,135,757,956,389,68,73,4300,4725,3150,1600,24125,23024,1
871,2,1,118.0,162.0,210.0,180.0,3000,3762,2351,2911,649,851,1203,1137,175,652,1028,485,68,70,4175,5275,3150,1600,24425,23474,1
879,2,1,126.0,163.0,210.0,180.0,2972,3661,2323,2855,649,806,694,1059,90,657,604,402,68,70,4725,5475,3150,1600,24625,23474,1
886,2,1,130.0,169.0,210.0,180.0,2860,3442,2211,2659,649,783,699,1005,115,507,584,498,69,69,4725,5825,3150,1600,24625,23574,1
893,2,1,130.0,168.0,195.0,180.0,2754,3582,2127,2799,627,783,1035,985,375,387,660,598,71,69,5075,5575,3150,1600,25025,24249,1
900,2,1,138.0,168.0,195.0,180.0,2972,3437,2323,2631,649,806,700,1260,160,562,540,698,71,69,5075,5675,3600,1600,25025,24399,1
907,2,1,129.0,167.5,195.0,180.0,2714,3683,2043,2855,671,828,855,1500,235,702,620,798,59,69,5775,5300,3600,1600,25725,24824,1
914,2,1,135.0,170.5,195.0,180.0,2541,3655,1903,2827,638,828,860,97,170,57,690,40,59,69,6075,5750,3600,1600,25725,24824,1
921,2,1,141.0,178.0,179.0,180.0,2776,3874,2295,3023,481,851,597,167,305,27,292,140,62,69,6075,6075,3600,1750,25925,24849,1
929,2,1,143.0,180.0,179.0,180.0,2793,3773,2323,2967,470,806,537,319,335,187,202,132,62,70,6075,7775,3600,1750,25925,24974,1
936,2,1,139.0,178.0,179.0,180.0,2653,3834,2183,3051,470,783,552,625,390,397,162,228,62,70,6625,7775,3600,1750,26275,25224,1
943,2,1,120.0,164.0,179.0,180.0,2703,3638,2211,2855,492,783,387,570,165,242,222,328,61,69,4225,6675,3500,1750,28775,26849,1
7,2,0,13.0,13.0,15.0,15.0,377,335,377,335,0,0,45,40,45,40,0,0,12,12,0,0,0,0,0,0,0
14,2,0,14.0,14.0,15.0,15.0,699,643,699,643,0,0,25,65,25,65,0,0,13,13,0,0,0,0,0,0,0
21,2,0,14.0,14.0,15.0,15.0,755,755,755,755,0,0,60,55,60,55,0,0,13,13,0,0,0,0,0,0,0
29,2,0,15.0,15.0,15.0,15.0,727,783,727,783,0,0,95,45,95,45,0,0,14,14,0,0,0,0,0,0,0
36,2,0,15.0,15.0,23.0,15.0,811,811,811,811,0,0,145,140,145,140,0,0,14,14,0,0,0,0,0,0,0
43,2,0,16.0,16.0,23.0,23.0,839,811,839,811,0,0,40,5,40,5,0,0,15,15,0,0,0,0,0,0,0
50,2,0,17.0,16.0,23.0,23.0,895,811,895,811,0,0,25,45,25,45,0,0,16,15,0,0,0,0,0,0,0
57,2,0,18.0,17.0,23.0,23.0,923,783,923,783,0,0,40,10,40,10,0,0,17,16,0,0,0,0,0,0,0
64,2,0,19.0,18.0,23.0,23.0,951,783,951,783,0,0,150,105,150,105,0,0,18,17,0,0,0,0,0,0,0
71,2,0,19.0,18.0,23.0,23.0,973,794,951,727,22,67,264,152,260,140,4,12,18,17,0,0,0,0,0,0,0
79,2,0,20.0,19.0,23.0,23.0,990,850,923,671,67,179,382,251,370,215,12,36,19,18,0,0,0,0,0,0,0
86,2,0,20.0,19.0,23.0,23.0,1040,956,951,643,89,313,359,371,335,295,24,76,19,18,0,0,150,150,0,0,0
93,2,0,21.0,20.0,23.0,23.0,1040,900,951,587,89,313,431,133,395,75,36,58,20,19,0,0,150,150,0,0,0
100,2,0,21.0,20.0,23.0,23.0,1113,1012,979,699,134,313,162,258,110,160,52,98,20,19,0,0,150,150,0,0,0
107,2,0,22.0,20.0,23.0,23.0,1113,1001,979,755,134,246,68,131,0,105,68,26,21,19,0,0,150,150,0,0,0
114,2,0,22.0,21.0,23.0,31.0,1113,1040,979,839,134,201,144,205,60,155,84,50,21,19,0,0,150,150,0,0,0
121,2,0,25.0,21.0,31.0,31.0,1135,1040,979,839,156,201,104,179,25,155,79,24,22,19,0,100,300,150,0,0,0
129,2,0,25.0,22.0,31.0,31.0,1085,1275,951,1119,134,156,80,345,35,305,45,40,23,20,0,100,300,150,0,0,0
136,2,0,26.0,22.0,31.0,31.0,1197,1326,951,1147,246,179,176,99,95,35,81,64,23,20,0,100,300,150,0,0,0
143,2,0,29.0,23.0,31.0,31.0,1320,1354,1007,1175,313,179,103,209,40,125,63,84,24,21,125,100,300,150,0,0,0
150,2,0,29.0,23.0,31.0,31.0,1264,1365,951,1119,313,246,198,111,95,95,103,16,24,22,125,100,300,400,0,0,0
157,2,0,30.0,26.0,31.0,31.0,1264,1438,951,1147,313,291,103,127,60,100,43,27,25,22,125,100,400,500,0,0,0
164,2,0,30.0,28.0,31.0,31.0,1264,1387,951,1119,313,268,208,180,125,125,83,55,25,23,300,100,400,500,0,0,0
171,2,0,32.0,29.0,46.0,31.0,1264,1387,951,1119,313,268,158,196,35,105,123,91,26,23,300,100,400,500,0,0,0
179,2,0,34.0,30.0,46.0,31.0,1365,1275,1007,1007,358,268,213,238,50,140,163,98,28,24,300,200,400,500,0,0,0
186,2,0,34.0,31.0,46.0,31.0,1449,1135,1091,867,358,268,288,74,85,40,203,34,28,24,300,300,400,750,0,0,0
193,2,0,36.0,35.0,46.0,39.0,1656,1370,1343,1035,313,335,130,204,45,130,85,74,30,25,300,300,650,750,0,0,0
200,2,0,36.0,35.0,46.0,39.0,1656,1398,1343,1063,313,335,275,370,150,260,125,110,30,25,300,350,650,825,0,0,0
207,2,0,38.0,39.0,46.0,54.0,1768,1488,1455,1175,313,313,435,131,270,110,165,21,32,26,300,250,650,825,0,100,0
214,2,0,39.0,40.0,46.0,54.0,1824,1460,1511,1147,313,313,255,256,150,195,105,61,34,26,300,300,650,825,0,100,0
221,2,0,40.0,43.0,46.0,54.0,1852,1516,1539,1203,313,313,155,116,10,90,145,26,34,27,300,500,650,825,0,100,0
229,2,0,40.0,45.0,46.0,54.0,1869,1572,1511,1259,358,313,235,161,50,95,185,66,36,27,175,600,800,825,125,100,0
236,2,0,44.0,46.0,46.0,54.0,2037,1650,1679,1315,358,335,180,211,55,105,125,106,36,28,175,875,800,825,125,100,0
243,2,0,45.0,49.0,54.0,54.0,2020,1617,1707,1259,313,358,252,81,95,60,157,21,38,28,525,925,800,825,125,100,0
250,2,0,46.0,51.0,54.0,54.0,1998,1678,1707,1343,291,335,388,182,195,125,193,57,38,28,525,975,800,825,125,100,0
257,2,0,44.0,51.0,54.0,62.0,1466,1628,1175,1315,291,313,444,388,215,295,229,93,36,29,525,1200,800,825,325,100,0
264,2,0,48.0,56.0,62.0,62.0,1236,1740,923,1427,313,313,254,243,85,185,169,58,36,29,875,1300,1200,825,375,100,0
271,2,0,49.0,58.0,62.0,62.0,1482,1796,1147,1483,335,313,339,263,130,165,209,98,37,30,875,1300,1350,825,375,100,0
279,2,0,50.0,58.0,62.0,62.0,1874,2020,1539,1707,335,313,464,318,215,180,249,138,38,31,875,1525,1350,825,375,200,0
286,2,0,53.0,57.0,62.0,62.0,1958,2154,1623,1819,335,335,450,288,165,235,285,53,39,32,875,1175,1350,825,375,600,0
293,2,0,55.0,57.0,62.0,70.0,2104,2177,1791,1819,313,358,476,143,155,125,321,18,41,33,875,1125,1350,825,375,650,0
300,2,0,59.0,62.0,62.0,70.0,2104,2048,1791,1735,313,313,386,230,125,180,261,50,42,34,875,1450,1350,825,375,650,0
307,2,0,62.0,64.0,62.0,70.0,2188,2104,1875,1791,313,313,431,225,180,135,251,90,43,36,1400,1450,1350,825,375,650,0
314,2,0,60.0,65.0,70.0,70.0,2294,2020,1959,1707,335,313,695,450,400,320,295,130,43,37,1475,1775,1350,825,550,650,0
321,2,0,62.0,71.0,70.0,78.0,2205,1992,1735,1679,470,313,685,200,380,155,305,45,44,38,1650,1825,1350,825,550,650,0
329,2,0,68.0,71.0,70.0,78.0,2362,1824,1847,1511,515,313,455,406,240,328,215,78,44,39,2175,2050,1350,825,550,650,0
336,2,0,64.0,66.0,70.0,78.0,2479,1981,1987,1623,492,358,591,397,320,287,271,110,44,39,1650,1500,1350,825,1075,1336,0
343,2,0,60.0,61.0,78.0,78.0,2429,1874,1959,1539,470,335,772,479,445,333,327,146,44,41,1300,1025,1350,825,1425,1861,0
350,2,0,69.0,61.0,78.0,78.0,2423,1684,1931,1371,492,313,457,285,270,178,187,107,46,41,1300,1250,1350,825,1425,1961,0
357,2,0,66.0,61.0,78.0,78.0,2479,1964,1987,1651,492,313,707,294,460,147,247,147,47,42,1650,1025,1350,975,1775,2236,0
364,2,0,61.0,60.0,78.0,78.0,2457,2300,1987,1987,470,313,888,79,585,51,303,28,47,40,1125,800,1350,975,2300,2626,0
371,2,0,60.0,59.0,78.0,78.0,2535,2356,2043,2043,492,313,1188,129,825,61,363,68,49,41,950,575,1350,975,2475,2914,0
379,2,0,69.0,59.0,78.0,78.0,2451,2294,1959,1959,492,335,199,204,55,96,144,108,49,42,1650,750,1350,975,2475,3064,0
386,2,0,69.0,62.0,78.0,78.0,2574,2709,2127,2351,447,358,506,274,310,151,196,123,50,42,1650,800,1350,1050,2475,3164,0
393,2,0,71.0,63.0,78.0,78.0,2373,2714,1903,2379,470,335,331,335,275,251,56,84,50,42,1750,1125,1350,1050,2475,3164,0
400,2,0,71.0,66.0,78.0,78.0,2513,2720,2043,2407,470,313,442,181,330,161,112,20,52,42,1750,1125,1350,1325,2475,3164,0
407,2,0,72.0,72.0,78.0,78.0,2535,2653,1931,2295,604,358,698,209,510,191,188,18,52,42,1750,1300,1350,1325,2475,3164,0
414,2,0,79.0,74.0,86.0,86.0,2709,2647,2015,2267,694,380,339,262,225,196,114,66,53,43,2275,1350,1350,1425,2475,3264,0
421,2,0,80.0,76.0,94.0,86.0,2686,2227,2015,1847,671,380,565,365,375,251,190,114,53,45,2275,1575,1350,1425,2475,3314,0
429,2,0,82.0,76.0,94.0,86.0,2614,2406,1987,1959,627,447,822,235,560,215,262,20,55,45,2275,1700,1700,1425,2475,3364,0
436,2,0,82.0,80.0,102.0,86.0,2614,2238,1987,1791,627,447,852,191,610,144,242,47,56,47,2175,1975,1700,1425,2575,3414,0
443,2,0,83.0,80.0,102.0,86.0,2642,2233,2015,1763,627,470,1122,213,800,106,322,107,57,46,2175,2025,1700,1425,2575,3476,0
450,2,0,84.0,79.0,117.0,86.0,2770,2210,2099,1651,671,559,412,186,210,36,202,150,58,48,2175,1975,1700,1425,2575,3576,0
457,2,0,87.0,84.0,117.0,94.0,2810,2171,2183,1567,627,604,499,92,300,20,199,72,59,47,2175,2150,1700,1425,2575,3726,0
464,2,0,89.0,80.0,117.0,94.0,2894,1432,2267,1007,627,425,737,213,470,101,267,112,61,43,2175,2150,1700,1500,2575,3926,0
471,2,0,97.0,81.0,117.0,94.0,3056,1925,2407,1567,649,358,467,252,220,146,247,106,61,45,2525,2150,1700,1500,2625,3926,0
479,2,0,100.0,81.0,117.0,94.0,3314,2188,2687,1651,627,537,619,433,300,251,319,182,63,45,2825,2100,1700,1500,2625,4151,0
486,2,0,99.0,84.0,125.0,94.0,3319,2328,2715,1679,604,649,945,34,550,1,395,33,65,46,2825,2150,1700,1500,2625,4376,0
493,2,0,103.0,85.0,125.0,94.0,3207,2334,2603,1707,604,627,731,65,560,56,171,9,65,46,3225,2250,1700,1500,2625,4376,0
500,2,0,107.0,88.0,125.0,102.0,3202,2412,2575,1763,627,649,552,280,455,191,97,89,66,46,3525,2300,1700,1700,2625,4403,0
507,2,0,107.0,92.0,125.0,102.0,3336,2882,2687,2211,649,671,559,145,390,76,169,69,66,46,3525,2350,2150,1800,2625,4403,0
514,2,0,109.0,98.0,133.0,102.0,3168,2888,2519,2239,649,649,785,147,640,106,145,41,66,46,3525,2550,2300,1800,2625,4403,0
521,2,0,113.0,101.0,149.0,102.0,3118,2832,2491,2183,627,649,674,192,528,96,146,96,66,46,3775,2925,2550,1800,2725,4403,0
529,2,0,113.0,98.0,149.0,102.0,3118,2720,2491,2071,627,649,1045,343,823,171,222,172,66,46,3775,2775,2550,1800,2725,4603,0
536,2,0,125.0,104.0,149.0,110.0,3230,2558,2603,1931,627,627,660,139,458,41,202,98,66,46,4275,3125,2550,1800,2725,4603,0
543,2,0,129.0,107.0,149.0,118.0,3308,1757,2659,1175,649,582,750,212,468,46,282,166,68,46,4200,3500,2550,1800,2900,4603,0
550,2,0,130.0,107.0,149.0,118.0,3134,1527,2463,1035,671,492,1075,302,713,76,362,226,68,46,4500,3500,2550,1800,2900,4753,0
557,2,0,140.0,111.0,149.0,118.0,3252,1460,2603,1035,649,425,652,214,518,36,134,178,68,46,4800,3600,2550,1800,2900,4753,0
564,2,0,138.0,108.0,149.0,118.0,3218,1298,2547,1007,671,291,1042,157,828,51,214,106,69,45,5150,3850,2700,1800,3000,5003,0
571,2,0,120.0,69.0,149.0,118.0,3202,1169,2575,923,627,246,1409,289,1123,151,286,138,69,30,3975,2525,2850,1800,4075,6853,0
579,2,0,128.0,70.0,164.0,118.0,3314,1247,2687,979,627,268,819,196,753,26,66,170,69,30,4025,2250,2850,1800,4525,7178,0
7,1,2,13.0,13.0,14.0,15.0,377,293,377,293,0,0,45,35,45,35,0,0,12,12,0,0,0,0,0,0,0
14,1,2,13.0,14.0,14.0,15.0,671,671,671,671,0,0,20,70,20,70,0,0,13,13,0,0,0,0,0,0,0
21,1,2,14.0,14.0,14.0,15.0,699,699,699,699,0,0,50,55,50,55,0,0,13,13,0,0,0,0,0,0,0
29,1,2,14.0,15.0,14.0,15.0,755,755,755,755,0,0,145,95,145,95,0,0,13,14,0,0,0,0,0,0,0
36,1,2,16.0,15.0,22.0,15.0,727,811,727,811,0,0,130,140,130,140,0,0,14,14,0,0,0,0,0,0,0
43,1,2,16.0,16.0,22.0,23.0,755,811,755,811,0,0,210,40,210,40,0,0,16,15,0,0,0,0,0,0,0
50,1,2,16.0,17.0,22.0,23.0,755,867,755,867,0,0,300,60,300,60,0,0,16,16,0,0,0,0,0,0,0
57,1,2,17.0,18.0,22.0,23.0,811,867,811,867,0,0,0,55,0,55,0,0,15,17,0,0,0,0,0,0,0
64,1,2,17.0,18.0,22.0,23.0,839,923,839,923,0,0,90,125,90,125,0,0,15,17,0,0,0,0,0,0,0
71,1,2,17.0,19.0,22.0,23.0,839,951,839,951,0,0,185,230,185,230,0,0,17,18,0,0,0,0,0,0,0
79,1,2,17.0,20.0,22.0,23.0,923,939,923,895,0,44,5,343,5,335,0,8,17,19,0,0,0,0,0,0,0
86,1,2,17.0,19.0,22.0,23.0,1007,1018,1007,951,0,67,65,421,65,405,0,16,16,19,0,0,0,0,0,0,0
93,1,2,17.0,22.0,22.0,23.0,951,978,951,867,0,111,165,28,165,0,0,28,16,19,0,0,0,150,0,0,0
100,1,2,17.0,22.0,22.0,23.0,979,978,979,867,0,111,35,45,35,5,0,40,16,19,0,0,0,150,0,0,0
107,1,2,19.0,25.0,22.0,31.0,895,922,895,811,0,111,35,161,35,105,0,56,16,20,0,100,0,150,0,0,0
114,1,2,19.0,26.0,22.0,31.0,923,1023,923,867,0,156,70,241,70,165,0,76,17,21,0,100,0,150,0,0,0
121,1,2,20.0,26.0,22.0,31.0,923,1051,923,895,0,156,130,271,130,175,0,96,18,21,0,100,0,150,0,0,0
129,1,2,21.0,27.0,28.0,31.0,979,1102,979,923,0,179,190,126,190,85,0,41,19,22,0,100,0,300,0,0,0
136,1,2,21.0,31.0,28.0,31.0,951,1051,951,895,0,156,210,42,210,10,0,32,21,22,0,200,0,450,0,0,0
143,1,2,21.0,31.0,28.0,39.0,1006,1135,895,979,111,156,335,177,315,125,20,52,21,23,0,200,250,450,0,0,0
150,1,2,28.0,31.0,28.0,39.0,1191,1135,1035,979,156,156,320,167,280,95,40,72,22,23,0,200,250,450,0,0,0
157,1,2,31.0,33.0,36.0,39.0,1219,1158,1063,979,156,179,310,166,250,95,60,71,22,23,0,325,250,450,0,0,0
164,1,2,31.0,33.0,36.0,39.0,1242,1253,1063,1007,179,246,305,89,225,15,80,74,21,23,50,325,250,450,0,0,0
171,1,2,32.0,35.0,36.0,39.0,1214,1219,1035,951,179,268,400,230,300,120,100,110,22,23,200,450,250,450,0,0,0
179,1,2,34.0,35.0,36.0,39.0,1208,1236,1119,923,89,313,229,120,225,70,4,50,22,23,200,450,250,450,0,0,0
186,1,2,36.0,36.0,36.0,39.0,1119,1208,1119,895,0,313,204,215,200,125,4,90,22,23,600,450,250,450,0,0,0
193,1,2,36.0,36.0,36.0,39.0,1315,1208,1315,895,0,313,159,235,155,130,4,105,22,24,650,450,250,550,0,125,0
200,1,2,35.0,36.0,36.0,39.0,1259,1236,1259,923,0,313,299,190,295,45,4,145,21,24,700,575,400,700,0,125,0
207,1,2,36.0,36.0,36.0,39.0,1287,1253,1287,895,0,358,399,330,395,145,4,185,21,24,700,575,400,700,0,125,0
214,1,2,44.0,36.0,52.0,39.0,1203,1202,1203,867,0,335,84,381,80,160,4,221,21,24,700,575,400,700,0,125,0
221,1,2,48.0,36.0,52.0,39.0,1231,1180,1231,867,0,313,34,527,30,270,4,257,21,24,900,575,400,950,0,125,0
229,1,2,48.0,36.0,52.0,39.0,1231,1208,1231,895,0,313,79,307,75,110,4,197,21,24,1200,700,400,950,0,125,0
236,1,2,49.0,44.0,52.0,55.0,1203,1208,1203,895,0,313,169,182,165,70,4,112,21,24,1250,700,400,1050,0,125,0
243,1,2,51.0,44.0,52.0,55.0,1203,1208,1203,895,0,313,214,187,210,135,4,52,21,24,1400,875,400,1050,0,225,0
250,1,2,54.0,44.0,60.0,55.0,1231,1230,1231,895,0,335,114,237,110,145,4,92,21,24,1600,1025,400,1050,0,225,0
257,1,2,55.5,46.0,60.0,55.0,1203,1281,1203,923,0,358,59,112,55,105,4,7,21,24,1625,925,400,950,75,525,0
264,1,2,53.5,46.0,60.0,55.0,1203,1264,1203,951,0,313,154,259,150,220,4,39,21,24,1475,1575,400,850,225,625,0
271,1,2,55.0,41.0,68.0,55.0,1147,1292,1147,979,0,313,49,419,45,340,4,79,21,23,1550,1325,400,850,350,925,0
279,1,2,52.5,41.0,68.0,47.0,1203,1320,1203,1007,0,313,99,444,95,350,4,94,21,23,1375,1325,400,850,575,1150,0
286,1,2,54.0,41.0,68.0,47.0,1203,1292,1203,979,0,313,139,589,135,455,4,134,21,23,1400,1325,400,850,600,1150,0
293,1,2,53.5,35.0,68.0,47.0,1203,1236,1203,923,0,313,34,489,30,365,4,124,21,23,1425,800,400,850,825,1925,0
300,1,2,50.5,29.0,68.0,47.0,1203,1281,1203,923,0,358,134,234,130,70,4,164,21,23,1375,400,400,600,1025,2575,0
307,1,2,49.0,25.0,68.0,47.0,1175,1253,1175,895,0,358,19,84,15,30,4,54,20,23,1600,125,400,600,1050,2850,0
314,1,2,50.0,26.0,68.0,39.0,1063,1208,1063,895,0,313,94,121,90,35,4,86,21,23,1650,125,400,450,1050,3100,0
321,1,2,50.0,27.0,68.0,39.0,1147,1236,1147,923,0,313,194,221,190,95,4,126,21,24,1650,125,400,450,1050,3100,0
329,1,2,53.0,29.0,68.0,39.0,1231,1236,1231,923,0,313,134,201,130,60,4,141,23,25,1600,250,400,450,1100,3100,0
336,1,2,52.0,32.0,68.0,39.0,1203,1236,1203,923,0,313,124,156,120,75,4,81,27,25,1500,400,400,450,1200,3100,0
343,1,2,53.0,32.0,68.0,39.0,1371,1286,1371,951,0,335,94,211,90,90,4,121,28,26,1350,400,400,150,1350,3400,0
350,1,2,54.0,32.0,68.0,39.0,1427,1337,1427,979,0,358,224,216,220,55,4,161,28,26,1350,400,400,450,1350,3400,0
357,1,2,55.0,33.0,76.0,47.0,1567,1314,1567,979,0,335,354,332,350,135,4,197,32,26,1350,400,400,550,1350,3400,0
364,1,2,62.0,36.0,76.0,47.0,1667,1292,1623,979,44,313,172,118,160,35,12,83,34,26,1350,400,400,550,1350,3400,0
371,1,2,64.0,37.0,76.0,62.0,1807,1292,1651,979,156,313,72,233,40,110,32,123,34,27,1350,400,400,550,1350,3400,0
379,1,2,67.0,39.0,76.0,62.0,1947,1348,1791,1035,156,313,103,203,55,40,48,163,38,28,1350,400,400,550,1350,3400,0
386,1,2,67.0,39.0,76.0,62.0,2031,1516,1875,1203,156,313,398,383,330,180,68,203,42,28,1350,400,400,550,1350,3400,0
393,1,2,73.0,45.0,90.0,62.0,2115,1645,1959,1287,156,358,173,123,85,30,88,93,42,30,1350,700,400,550,1350,3400,0
400,1,2,73.0,46.0,90.0,70.0,2171,1785,2015,1427,156,358,153,188,145,55,8,133,44,31,1500,700,525,700,1350,3400,0
407,1,2,78.0,48.0,90.0,70.0,2059,1684,1903,1371,156,313,93,270,65,105,28,165,47,33,1500,700,525,700,1350,3400,0
414,1,2,76.0,48.0,90.0,70.0,1942,1852,1763,1539,179,313,158,450,110,245,48,205,43,33,1500,700,650,700,1350,3400,0
421,1,2,81.0,47.0,90.0,70.0,1914,1880,1735,1567,179,313,138,530,70,285,68,245,49,35,1500,400,650,700,1350,3700,0
429,1,2,78.0,49.0,82.0,70.0,2031,1936,1875,1623,156,313,344,710,260,425,84,285,50,37,1500,800,775,700,1425,3700,0
436,1,2,80.0,49.0,82.0,70.0,2311,1908,2155,1595,156,313,149,440,45,115,104,325,54,37,1500,800,900,700,1425,3700,0
443,1,2,80.0,51.0,90.0,78.0,2563,2037,2407,1679,156,358,229,535,205,170,24,365,55,39,1500,800,900,700,1425,3700,0
450,1,2,83.0,47.0,98.0,78.0,2692,2126,2491,1791,201,335,262,1191,210,790,52,401,56,39,1400,525,900,700,1525,4025,0
457,1,2,84.0,49.0,98.0,78.0,2804,2082,2491,1791,313,291,287,428,195,345,92,83,59,41,1400,525,900,700,1525,4025,0
464,1,2,87.0,50.0,98.0,78.0,2933,2031,2463,1763,470,268,342,239,190,120,152,119,58,42,1400,525,900,700,1525,4025,0
471,1,2,88.5,53.0,98.0,78.0,2899,2222,2407,1931,492,291,438,275,230,145,208,130,61,43,1375,525,900,700,1550,4025,0
479,1,2,88.5,55.0,98.0,78.0,3157,2238,2687,1903,470,335,684,348,470,170,214,178,66,45,1375,650,900,700,1550,4025,0
486,1,2,85.5,55.0,106.0,78.0,3325,2294,2743,1735,582,559,1080,824,790,570,290,254,65,45,1275,650,900,700,1650,3725,0
493,1,2,91.5,56.0,106.0,86.0,3470,2462,2799,1791,671,671,1125,764,755,430,370,334,65,46,1225,650,1100,700,1700,3775,0
500,1,2,101.5,56.0,106.0,86.0,3594,2440,2743,1791,851,649,567,1045,410,635,157,410,65,47,1225,650,1350,1000,1700,3775,0
507,1,2,104.5,67.0,106.0,86.0,3566,2434,2603,1763,963,671,732,320,480,180,252,140,65,47,1325,650,1350,1500,1750,3825,0
514,1,2,106.0,68.0,106.0,86.0,3672,2356,2687,1707,985,649,414,297,300,85,114,212,64,48,2150,650,1350,1500,1775,3825,0
521,1,2,106.0,69.0,120.0,94.0,3426,2294,2463,1735,963,559,810,421,580,145,230,276,64,49,2350,650,1350,1500,1775,3825,0
529,1,2,117.0,73.0,120.0,94.0,3482,2395,2519,1791,963,604,531,522,185,195,346,327,64,51,2500,775,1550,1500,1775,3825,0
536,1,2,123.0,73.0,128.0,102.0,3308,2384,2323,1735,985,649,512,497,175,190,337,307,64,51,2500,775,1550,1500,1775,3825,0
543,1,2,128.0,71.0,128.0,102.0,3448,2255,2463,1651,985,604,523,715,120,340,403,375,64,49,3050,1625,1550,1500,1825,4025,0
550,1,2,128.0,73.0,136.0,102.0,3342,2244,2379,1595,963,649,844,630,325,175,519,455,64,49,3050,1625,1550,1750,1825,4025,0
557,1,2,130.5,79.0,136.0,102.0,3398,2306,2435,1679,963,627,936,516,305,135,631,381,61,51,3525,1725,1550,1750,2000,4025,0
564,1,2,132.0,79.0,144.0,102.0,3308,2166,2323,1539,985,627,1146,381,395,70,751,311,59,53,3750,1475,1550,1750,2125,4275,0
570,1,2,132.0,74.0,144.0,117.0,3308,2216,2323,1567,985,649,1146,600,395,225,751,375,59,53,3750,1050,1550,1750,2125,4700,0
7,1,1,13.0,13.0,14.0,14.0,377,335,377,335,0,0,45,40,45,40,0,0,12,12,0,0,0,0,0,0,0
14,1,1,13.0,13.0,14.0,14.0,643,671,643,671,0,0,15,20,15,20,0,0,13,13,0,0,0,0,0,0,0
21,1,1,14.0,14.0,14.0,14.0,699,699,699,699,0,0,50,45,50,45,0,0,13,13,0,0,0,0,0,0,0
29,1,1,14.0,14.0,14.0,14.0,727,727,727,727,0,0,145,140,145,140,0,0,13,13,0,0,0,0,0,0,0
36,1,1,16.0,16.0,22.0,22.0,755,755,755,755,0,0,140,140,140,140,0,0,14,14,0,0,0,0,0,0,0
43,1,1,16.0,16.0,22.0,22.0,783,783,783,783,0,0,225,220,225,220,0,0,16,16,0,0,0,0,0,0,0
50,1,1,15.0,15.0,22.0,22.0,755,755,755,755,0,0,25,15,25,15,0,0,15,15,0,0,0,0,0,0,0
57,1,1,17.0,17.0,22.0,22.0,811,811,811,811,0,0,30,20,30,20,0,0,15,15,0,0,0,0,0,0,0
64,1,1,18.0,18.0,22.0,22.0,895,867,895,867,0,0,85,70,85,70,0,0,16,15,0,0,0,0,0,0,0
71,1,1,17.0,17.0,22.0,22.0,867,895,867,895,0,0,165,150,165,150,0,0,17,17,0,0,0,0,0,0,0
79,1,1,17.0,17.0,22.0,22.0,923,923,923,923,0,0,30,15,30,15,0,0,16,16,0,0,0,0,0,0,0
86,1,1,18.0,18.0,22.0,22.0,923,951,923,951,0,0,90,80,90,80,0,0,16,16,0,0,0,0,0,0,0
93,1,1,19.0,19.0,22.0,22.0,951,951,951,951,0,0,150,135,150,135,0,0,18,18,0,0,0,0,0,0,0
100,1,1,20.0,20.0,22.0,22.0,984,967,895,923,89,44,216,203,200,195,16,8,19,19,0,0,0,0,0,0,0
107,1,1,20.0,20.0,22.0,22.0,1046,1057,867,923,179,134,341,329,305,305,36,24,19,19,0,0,0,0,0,0,0
114,1,1,21.0,21.0,22.0,22.0,1130,1051,951,895,179,156,426,404,370,360,56,44,20,20,0,0,0,0,0,0,0
121,1,1,24.0,25.0,28.0,28.0,1079,1051,923,895,156,156,242,229,170,165,72,64,21,21,0,0,250,250,0,0,0
129,1,1,26.0,26.0,28.0,28.0,1135,1079,979,923,156,156,242,219,150,135,92,84,21,21,0,0,250,250,0,0,0
136,1,1,28.0,28.0,28.0,28.0,1141,1158,1007,979,134,179,78,64,70,60,8,4,21,21,0,0,250,250,0,0,0
143,1,1,30.0,30.0,36.0,36.0,1141,1197,1007,1063,134,134,109,106,85,90,24,16,21,21,50,50,250,250,0,0,0
150,1,1,30.0,30.0,36.0,36.0,1253,1169,1119,1035,134,134,265,252,225,220,40,32,23,23,50,50,250,250,0,0,0
157,1,1,30.0,32.0,36.0,36.0,1202,1281,1091,1147,111,134,62,308,10,260,52,48,24,25,200,350,250,250,0,0,0
164,1,1,31.0,32.0,36.0,36.0,1365,1258,1231,1147,134,111,173,110,105,50,68,60,24,24,350,350,250,250,0,0,0
171,1,1,32.0,31.0,36.0,36.0,1314,1398,1203,1287,111,111,75,36,45,10,30,26,25,24,350,400,250,250,0,0,0
179,1,1,33.0,33.0,36.0,36.0,1337,1370,1203,1259,134,111,96,83,50,45,46,38,25,25,350,400,250,250,0,0,0
186,1,1,35.0,35.0,36.0,36.0,1449,1482,1315,1371,134,111,167,104,105,50,62,54,27,25,350,400,250,250,0,0,0
193,1,1,39.0,39.0,44.0,44.0,1510,1533,1399,1399,111,134,149,95,75,25,74,70,28,27,350,400,250,250,0,0,0
200,1,1,41.0,40.0,44.0,44.0,1510,1583,1399,1427,111,156,130,120,40,30,90,90,30,27,350,400,250,250,0,0,0
207,1,1,44.0,43.0,44.0,44.0,1706,1611,1595,1455,111,156,142,155,40,45,102,110,33,30,350,450,250,250,0,0,0
214,1,1,44.0,44.0,44.0,44.0,1650,1606,1539,1427,111,179,218,175,100,45,118,130,32,29,500,450,450,450,0,0,0
221,1,1,46.0,46.0,52.0,52.0,1869,1751,1735,1595,134,156,339,281,205,135,134,146,33,32,500,700,450,450,0,0,0
229,1,1,50.0,52.0,58.0,52.0,1869,1667,1735,1511,134,156,220,171,95,5,125,166,35,34,500,700,450,450,0,0,0
236,1,1,54.0,51.0,58.0,58.0,1930,1779,1819,1623,111,156,242,261,105,75,137,186,37,36,500,700,450,450,0,0,0
243,1,1,55.0,52.0,66.0,58.0,1981,1807,1847,1651,134,156,128,241,75,135,53,106,40,40,700,700,575,575,0,0,0
250,1,1,55.0,54.0,66.0,58.0,2037,1975,1903,1819,134,156,139,181,70,55,69,126,42,39,800,700,575,575,0,0,0
257,1,1,59.0,57.0,66.0,66.0,2166,2020,1987,1819,179,201,159,180,70,30,89,150,41,40,800,700,575,575,0,0,0
264,1,1,61.0,59.5,74.0,66.0,2311,2216,2155,1903,156,313,225,195,120,5,105,190,44,45,800,675,575,575,0,25,0
271,1,1,62.0,63.0,74.0,66.0,2367,2356,2211,2043,156,313,220,286,195,60,25,226,48,46,800,650,575,575,0,50,0
279,1,1,62.5,65.0,74.0,74.0,2434,2462,2211,2127,223,335,177,221,120,55,57,166,49,48,775,700,575,575,25,50,0
286,1,1,64.0,67.0,82.0,82.0,2636,2630,2323,2295,313,335,302,341,205,135,97,206,49,53,750,700,575,775,50,50,0
293,1,1,71.0,70.0,90.0,82.0,2720,2636,2407,2323,313,313,117,312,55,70,62,242,50,52,750,700,775,775,50,50,0
300,1,1,76.0,69.5,98.0,90.0,2905,2720,2547,2407,358,313,147,417,120,135,27,282,52,54,650,675,775,775,75,75,0
307,1,1,80.0,74.0,106.0,90.0,2871,2938,2491,2603,380,335,286,532,240,210,46,322,54,59,650,650,775,775,75,100,0
314,1,1,85.0,75.0,114.0,90.0,2849,2944,2379,2631,470,313,382,623,280,365,102,258,56,61,1050,650,775,775,75,100,0
321,1,1,91.0,79.5,114.0,98.0,3067,3017,2463,2435,604,582,432,382,250,90,182,292,57,63,1250,625,775,775,75,125,0
329,1,1,93.0,86.5,114.0,98.0,3084,3454,2435,2491,649,963,552,443,315,60,237,383,60,65,1350,625,1025,775,75,125,0
336,1,1,92.5,90.5,114.0,98.0,3090,3515,2463,2575,627,940,524,611,365,195,159,416,67,65,1325,625,1025,1025,100,125,0
343,1,1,94.0,97.5,114.0,98.0,3336,3403,2687,2463,649,940,524,836,285,375,239,461,67,66,1400,1075,1025,1025,125,125,0
350,1,1,92.5,96.5,114.0,98.0,3358,3700,2687,2715,671,985,469,681,350,150,119,531,65,65,1475,1325,1025,1025,150,125,0
357,1,1,92.5,97.5,122.0,98.0,3498,3610,2715,2603,783,1007,604,566,535,65,69,501,68,65,1475,1725,1025,1025,150,125,0
364,1,1,100.5,103.5,122.0,122.0,3706,3644,2743,2659,963,985,439,438,350,25,89,413,68,65,1475,1925,1025,1025,150,125,0
371,1,1,112.5,103.5,122.0,122.0,3722,3700,2715,2715,1007,985,274,680,190,255,84,425,68,66,1475,1925,1025,1025,150,125,0
379,1,1,120.5,113.5,122.0,138.0,3722,3644,2715,2659,1007,985,215,610,115,190,100,420,68,66,1875,1925,1025,1150,150,125,0
386,1,1,119.0,112.5,138.0,138.0,3812,3627,2827,2687,985,940,582,657,370,275,212,382,70,66,2200,2175,1025,1150,225,175,0
393,1,1,133.0,118.5,146.0,138.0,3812,3594,2827,2631,985,963,328,592,175,165,153,427,70,66,2300,2175,1025,1150,225,175,0
400,1,1,133.0,122.5,154.0,138.0,3874,3672,2911,2687,963,985,579,442,310,45,269,397,70,66,2700,2675,1025,1150,225,175,0
407,1,1,137.0,125.5,154.0,154.0,3767,3694,2827,2687,940,1007,840,673,455,160,385,513,70,65,2700,2775,1025,1150,225,175,0
414,1,1,137.0,132.0,162.0,162.0,3812,3610,2827,2603,985,1007,1090,709,635,180,455,529,70,66,3400,3000,1025,1150,225,250,0
421,1,1,153.0,144.0,176.0,168.0,3862,3672,2855,2687,1007,985,115,396,65,5,50,391,73,69,3400,3000,1475,1150,225,250,0
429,1,1,159.0,143.0,184.0,168.0,3924,3711,2939,2771,985,940,167,758,80,255,87,503,76,68,3500,3000,1475,1150,275,250,0
436,1,1,163.0,151.0,184.0,168.0,3930,3571,2967,2631,963,940,139,670,90,147,49,523,76,68,3500,3900,1475,1150,275,250,0
443,1,1,162.0,149.0,176.0,168.0,4148,3454,3163,2491,985,963,534,695,365,52,169,643,76,58,4550,4300,1475,1400,375,475,0
450,1,1,176.0,153.0,184.0,176.0,4210,3224,3247,2239,963,985,335,770,225,157,110,613,76,58,4750,4300,1475,1400,375,475,0
457,1,1,182.0,155.0,200.0,168.0,4182,3252,3107,2267,1075,985,375,777,275,77,100,700,75,66,5100,5050,1475,1525,375,575,0
464,1,1,184.0,156.0,200.0,160.0,4355,3274,3191,2267,1164,1007,685,883,595,92,90,791,75,67,5300,5050,1475,1525,375,675,0
471,1,1,194.0,159.0,200.0,176.0,4299,3560,3135,2575,1164,985,382,739,260,132,122,607,80,66,6200,5050,1475,1525,375,675,0
479,1,1,199.0,161.0,200.0,168.0,3347,3515,2407,2575,940,940,332,951,210,232,122,719,77,66,6200,5250,1475,1525,525,775,0
486,1,1,198.0,164.0,200.0,176.0,3302,3571,2519,2631,783,940,639,1036,425,197,214,839,78,66,6600,5050,1475,1650,525,975,0
493,1,1,198.0,170.0,200.0,184.0,3907,3476,3079,2491,828,985,577,1151,505,267,72,884,77,71,6800,5050,1475,1775,525,975,0
500,1,1,197.0,175.0,208.0,176.0,4131,3554,3079,2547,1052,1007,1082,977,870,177,212,800,77,71,7000,5050,1475,1775,575,1125,0
507,1,1,196.0,168.0,208.0,192.0,4271,3510,2995,2547,1276,963,1389,789,1075,27,314,762,76,69,6800,4700,1475,1775,825,2225,0
514,1,1,197.0,148.0,208.0,192.0,4254,3566,2911,2715,1343,851,1575,1211,1180,357,395,854,75,68,6600,3800,1475,1775,1075,3300,0
521,1,1,195.0,142.0,208.0,192.0,4109,3605,2855,2799,1254,806,666,846,485,92,181,754,75,68,5000,2900,1475,1775,2675,4400,0
7,2,1,13.0,13.0,15.0,14.0,293,377,293,377,0,0,35,45,35,45,0,0,12,12,0,0,0,0,0,0,0
14,2,1,14.0,13.0,15.0,14.0,643,671,643,671,0,0,65,20,65,20,0,0,13,13,0,0,0,0,0,0,0
21,2,1,14.0,14.0,15.0,14.0,699,727,699,727,0,0,50,55,50,55,0,0,13,13,0,0,0,0,0,0,0
29,2,1,15.0,14.0,15.0,14.0,727,671,727,671,0,0,30,140,30,140,0,0,14,13,0,0,0,0,0,0,0
36,2,1,15.0,16.0,23.0,22.0,783,783,783,783,0,0,135,145,135,145,0,0,14,14,0,0,0,0,0,0,0
43,2,1,16.0,16.0,23.0,22.0,755,755,755,755,0,0,15,225,15,225,0,0,15,14,0,0,0,0,0,0,0
50,2,1,17.0,17.0,23.0,22.0,783,727,783,727,0,0,30,270,30,270,0,0,16,16,0,0,0,0,0,0,0
57,2,1,18.0,17.0,23.0,22.0,811,783,811,783,0,0,35,25,35,25,0,0,17,16,0,0,0,0,0,0,0
64,2,1,19.0,18.0,23.0,22.0,923,839,923,839,0,0,100,80,100,80,0,0,18,16,0,0,0,0,0,0,0
71,2,1,19.0,17.0,23.0,22.0,951,867,951,867,0,0,205,160,205,160,0,0,18,17,0,0,0,0,0,0,0
79,2,1,20.0,17.0,23.0,22.0,939,839,895,839,44,0,323,15,315,15,8,0,19,16,0,0,0,0,0,0,0
86,2,1,20.0,18.0,23.0,22.0,990,867,923,867,67,0,46,70,30,70,16,0,19,16,0,0,0,0,0,0,0
93,2,1,20.0,19.0,23.0,22.0,1012,895,923,895,89,0,168,130,140,130,28,0,20,17,0,0,150,0,0,0,0
100,2,1,21.0,20.0,23.0,22.0,1113,990,979,923,134,67,99,197,55,185,44,12,20,18,0,0,150,0,0,0,0
107,2,1,21.0,20.0,23.0,22.0,1068,978,979,867,89,111,102,314,50,290,52,24,20,19,0,0,150,0,0,0,0
114,2,1,22.0,20.0,23.0,22.0,1029,995,895,839,134,156,72,339,0,295,72,44,21,20,0,0,150,0,0,0,0
121,2,1,23.0,22.0,23.0,22.0,1051,1023,895,867,156,156,207,314,115,250,92,64,22,20,0,0,150,250,0,0,0
129,2,1,23.0,26.0,23.0,36.0,1146,1051,923,895,223,156,295,184,175,100,120,84,22,20,0,0,150,250,0,0,0
136,2,1,26.0,28.0,31.0,36.0,1208,1079,895,923,313,156,166,20,85,20,81,0,23,20,0,0,300,250,0,0,0
143,2,1,26.0,29.0,31.0,36.0,1186,995,895,951,291,44,308,90,195,90,113,0,23,21,0,100,300,250,0,0,0
150,2,1,27.0,30.0,31.0,36.0,1208,979,895,979,313,0,163,160,110,160,53,0,24,22,0,100,300,250,0,0,0
157,2,1,30.0,30.0,46.0,36.0,1191,1063,923,1063,268,0,135,295,100,295,35,0,25,23,125,250,300,250,0,0,0
164,2,1,31.0,29.0,46.0,36.0,1275,1119,1007,1119,268,0,92,125,25,125,67,0,25,23,125,400,300,250,0,0,0
171,2,1,33.0,32.0,46.0,36.0,1421,1259,1175,1259,246,0,280,95,185,95,95,0,27,23,300,400,300,250,0,0,0
179,2,1,34.0,33.0,46.0,36.0,1454,1287,1231,1287,223,0,403,190,280,190,123,0,28,23,300,400,300,250,0,0,0
186,2,1,36.0,36.0,46.0,36.0,1583,1231,1315,1231,268,0,240,75,85,75,155,0,30,24,300,400,550,250,0,0,0
193,2,1,36.0,36.0,46.0,36.0,1561,1231,1315,1231,246,0,178,80,95,80,83,0,30,23,300,450,550,250,0,50,0
200,2,1,39.0,40.0,46.0,44.0,1701,1343,1455,1343,246,0,161,35,75,35,86,0,31,26,300,450,550,250,0,50,0
207,2,1,41.0,43.0,46.0,44.0,1863,1539,1595,1539,268,0,133,80,115,80,18,0,33,27,300,600,550,250,0,50,0
214,2,1,42.0,44.5,46.0,52.0,1902,1589,1679,1567,223,22,252,109,210,105,42,4,34,31,300,575,550,250,0,75,0
221,2,1,42.0,48.5,46.0,52.0,1925,1757,1679,1623,246,134,534,69,460,45,74,24,35,34,300,575,550,250,0,75,0
229,2,1,42.0,51.5,46.0,52.0,1925,1891,1679,1735,246,156,317,150,215,110,102,40,36,34,425,575,700,250,0,75,0
236,2,1,44.0,53.5,46.0,58.0,1930,1891,1707,1735,223,156,445,75,315,15,130,60,36,36,425,575,850,250,0,75,0
243,2,1,46.0,54.5,46.0,58.0,2093,1919,1847,1763,246,156,357,155,245,75,112,80,36,38,675,575,850,250,0,75,0
250,2,1,46.0,58.0,46.0,58.0,2093,2031,1847,1875,246,156,505,220,365,120,140,100,36,41,675,700,850,250,0,100,0
257,2,1,50.0,58.0,54.0,58.0,2048,2199,1847,2043,201,156,399,485,235,365,164,120,36,42,675,850,1100,250,0,100,0
264,2,1,56.0,63.5,62.0,66.0,2048,2334,1847,2155,201,179,268,170,155,130,113,40,36,42,1050,925,1100,250,0,125,0
271,2,1,58.0,62.5,62.0,66.0,2093,2306,1847,2127,246,179,421,285,280,225,141,60,38,41,1050,1025,1100,250,0,125,0
279,2,1,58.0,66.5,70.0,74.0,2110,2199,1819,2043,291,156,502,336,325,210,177,126,38,39,1050,1325,1550,450,0,125,0
286,2,1,68.0,71.5,70.0,74.0,2160,2255,1847,2099,313,156,137,256,45,135,92,121,40,39,1300,1325,1550,450,0,125,0
293,2,1,68.0,71.5,78.0,82.0,2154,2227,1819,2071,335,156,388,426,260,285,128,141,40,39,1925,1425,1550,575,0,125,0
300,2,1,68.0,78.5,78.0,82.0,2154,2255,1819,2099,335,156,543,331,375,220,168,111,40,39,1925,1725,1550,700,0,125,0
307,2,1,74.0,85.0,78.0,98.0,2171,2255,1791,2099,380,156,196,201,105,170,91,31,40,39,1800,1800,1550,700,250,200,0
314,2,1,74.0,86.0,86.0,98.0,2216,2222,1791,2043,425,179,448,271,305,245,143,26,40,39,2300,1850,1550,700,250,250,0
321,2,1,68.0,71.5,86.0,98.0,2294,2278,1847,2099,447,179,729,446,530,425,199,21,40,32,1925,1625,1550,700,625,1075,0
329,2,1,76.0,66.0,86.0,106.0,2345,1589,1875,1455,470,134,260,483,155,475,105,8,40,26,1675,1950,1550,700,875,1450,0
336,2,1,74.0,58.5,86.0,106.0,2345,514,1875,447,470,67,356,511,195,495,161,16,40,23,2175,1925,1550,700,1125,1825,0
343,2,1,71.0,64.0,86.0,106.0,2294,99,1847,55,447,44,574,70,365,50,209,20,42,20,1925,1900,1550,700,1375,2000,0
350,2,1,60.0,58.0,86.0,106.0,2317,391,1847,391,470,0,890,35,625,15,265,20,42,19,1300,1750,1550,700,2000,2400,0
357,2,1,64.0,58.0,86.0,106.0,2322,755,1875,755,447,0,122,80,105,60,17,20,42,26,1550,1750,1550,700,2500,2450,0
364,2,1,65.0,57.0,86.0,106.0,2362,1023,1959,979,403,44,345,108,280,80,65,28,42,26,1550,1650,1550,700,2500,2600,0
371,2,1,63.0,51.0,86.0,106.0,2378,598,1931,531,447,67,386,87,315,55,71,32,43,21,1175,1650,1550,700,2875,2950,0
379,2,1,59.0,51.0,86.0,106.0,2401,111,1931,111,470,0,522,47,395,15,127,32,43,22,1050,1650,1550,700,3250,3000,0
386,2,1,62.0,50.0,86.0,106.0,2440,447,1903,447,537,0,656,72,540,40,116,32,45,23,1050,1550,1550,700,3250,3100,0
393,2,1,64.0,53.0,86.0,106.0,2474,979,1847,979,627,0,723,42,560,10,163,32,45,23,1175,1550,1550,700,3250,3100,0
400,2,1,68.0,55.0,86.0,106.0,2412,1119,1763,1119,649,0,259,77,70,45,189,32,47,25,1525,1550,1550,700,3250,3100,0
407,2,1,72.0,57.0,86.0,106.0,2574,1343,1903,1343,671,0,224,147,105,115,119,32,47,28,1525,1550,1850,700,3250,3100,0
414,2,1,76.0,61.0,86.0,106.0,2468,1539,1819,1539,649,0,260,127,115,95,145,32,47,30,1525,1550,1850,700,3250,3100,0
421,2,1,74.0,66.0,86.0,106.0,2636,1595,1987,1595,649,0,371,72,250,40,121,32,48,34,1650,1550,1850,700,3375,3100,0
429,2,1,80.0,68.0,94.0,106.0,2524,1701,1875,1567,649,134,191,181,90,150,101,31,48,37,2000,1550,1950,700,3375,3100,0
436,2,1,84.0,71.0,94.0,106.0,2664,1947,2015,1679,649,268,137,167,110,100,27,67,49,40,2300,1550,1950,700,3375,3100,0
443,2,1,85.0,75.0,94.0,106.0,2546,2104,1875,1791,671,313,392,213,285,110,107,103,50,40,2300,1550,1950,700,3375,3100,0
450,2,1,86.0,78.0,94.0,106.0,2692,2328,2043,2015,649,313,658,308,475,265,183,43,51,40,2300,1800,1950,700,3375,3100,0
457,2,1,87.0,76.0,94.0,114.0,2608,2042,1959,1707,649,335,919,503,660,420,259,83,52,42,2300,1900,1950,700,3375,3200,0
464,2,1,87.0,84.0,94.0,114.0,2586,2238,1959,1903,627,335,820,93,635,70,185,23,54,41,2475,2000,1950,700,3500,3250,0
471,2,1,94.0,87.0,94.0,114.0,2720,2272,2071,1959,649,313,585,204,395,145,190,59,55,50,2850,2000,1950,700,3500,3250,0
479,2,1,98.0,89.0,109.0,114.0,2636,2574,1987,2239,649,335,620,399,400,325,220,74,56,50,2850,2000,1950,700,3500,3250,0
486,2,1,102.0,95.5,109.0,114.0,2720,2798,2071,2463,649,335,606,224,410,210,196,14,57,52,3025,1975,1950,700,3500,3275,0
493,2,1,105.0,99.5,117.0,114.0,2854,2804,2183,2491,671,313,441,345,265,295,176,50,58,52,3725,1975,1950,700,3550,3275,0
500,2,1,106.0,102.5,117.0,114.0,3022,2770,2351,2435,671,335,757,485,505,470,252,15,58,52,3725,2375,1950,700,3550,3275,0
507,2,1,106.0,99.5,117.0,114.0,3112,2843,2463,2463,649,380,1024,713,700,675,324,38,58,52,3600,2375,2050,700,3675,3675,0
514,2,1,112.0,96.0,117.0,114.0,3146,2882,2519,2435,627,447,335,595,235,530,100,65,60,50,4225,2050,2050,700,4100,4300,0
521,2,1,99.0,103.5,117.0,114.0,3146,2832,2519,2407,627,425,675,102,495,60,180,42,61,49,3300,1775,2200,950,5025,4625,0
529,2,1,96.0,99.0,117.0,114.0,3168,2731,2519,2239,649,492,1005,227,745,175,260,52,62,49,3000,1850,2200,950,5325,5100,0
536,2,1,102.0,97.5,117.0,114.0,3134,2754,2463,2239,671,515,490,347,400,285,90,62,62,49,2650,1775,2200,950,5675,5325,0
543,2,1,107.0,106.5,117.0,114.0,2966,2737,2295,2267,671,470,356,114,240,75,116,39,63,48,3700,1975,2200,950,5675,5325,0
550,2,1,105.0,100.0,117.0,114.0,2882,2675,2211,2183,671,492,587,389,495,290,92,99,64,48,3700,1900,2200,950,5675,5700,0
557,2,1,101.0,100.5,117.0,114.0,2860,2759,2211,2267,649,492,928,359,760,300,168,59,64,57,3350,2425,2200,950,6025,5825,0
564,2,1,109.0,102.5,117.0,114.0,2910,2843,2239,2351,671,492,167,609,115,490,52,119,64,57,3875,2475,2200,950,6025,5825,0
571,2,1,109.0,109.0,117.0,114.0,3106,3202,2211,2575,895,627,557,534,385,410,172,124,64,57,4050,2550,2200,950,6025,5900,0
579,2,1,106.0,106.5,117.0,114.0,3420,3224,2435,2575,985,649,872,701,580,530,292,171,64,56,3575,2425,2200,950,6500,6275,0
586,2,1,112.0,106.5,117.0,114.0,3420,2686,2435,2127,985,559,463,800,305,615,158,185,64,55,3800,2225,2200,950,6625,6525,0
593,2,1,113.0,109.5,117.0,114.0,3358,2905,2351,2323,1007,582,354,606,180,345,174,261,66,55,3800,2625,2200,950,6975,6675,0
600,2,1,117.0,107.0,117.0,114.0,3420,3056,2435,2407,985,649,321,667,135,344,186,323,67,55,4150,2600,2200,950,6975,6724,0
607,2,1,119.0,106.0,125.0,122.0,3375,2922,2435,2295,940,627,723,408,425,59,298,349,68,55,4150,2100,2200,950,6975,7424,0
614,2,1,116.0,109.0,133.0,122.0,3403,2910,2463,2239,940,671,1043,458,625,104,418,354,68,54,4100,2000,2200,950,7325,7524,0
621,2,1,129.0,113.5,133.0,122.0,3476,2737,2491,2043,985,694,408,283,170,174,238,109,70,54,4800,2275,2200,950,7325,7574,0
629,2,1,127.0,109.5,133.0,122.0,3504,2720,2519,2071,985,649,833,425,475,294,358,131,72,54,4975,2925,2200,950,7500,8024,0
636,2,1,127.0,121.0,148.0,122.0,3588,2922,2603,2295,985,627,860,181,390,124,470,57,72,54,4625,3200,2200,950,7850,8049,0
643,2,1,135.0,122.0,148.0,122.0,3745,3028,2715,2379,1030,649,540,456,150,394,390,62,72,54,5325,3500,2200,950,7850,8049,0
650,2,1,140.0,119.0,148.0,122.0,3840,3084,2855,2435,985,649,692,441,240,299,452,142,76,53,5150,3900,2200,950,7775,8149,0
657,2,1,140.0,119.0,148.0,122.0,3851,2950,2911,2323,940,627,859,797,445,579,414,218,78,53,5400,4100,2200,950,7775,8149,0
664,2,1,148.0,120.0,148.0,122.0,4098,3129,3135,2435,963,694,604,912,270,614,334,298,79,53,5400,3900,2200,950,7775,8349,0
671,2,1,148.0,122.0,148.0,146.0,4148,3185,3163,2491,985,694,669,877,365,499,304,378,79,53,6100,3600,2350,950,7775,8649,0
679,2,1,146.0,123.0,148.0,146.0,4215,3062,3275,2435,940,627,962,930,550,659,412,271,79,53,5850,3850,2350,1075,8025,8649,0
686,2,1,147.0,139.0,148.0,152.0,4154,3118,3191,2491,963,627,1313,390,785,239,528,151,81,53,5850,3950,2350,1075,8025,8649,0
693,2,1,152.0,142.5,156.0,152.0,4204,2944,3219,2295,985,649,1649,125,1055,94,594,31,81,52,5850,4175,2350,1075,8025,8824,0
700,2,1,163.0,145.5,180.0,152.0,4350,3006,3387,2379,963,627,1170,346,710,239,460,107,82,52,6900,5075,2350,1075,8025,8824,0
707,2,1,162.0,147.5,180.0,160.0,4187,2938,3247,2267,940,671,1126,481,550,444,576,37,82,52,6725,5075,2350,1075,8025,8824,0
714,2,1,160.0,155.0,180.0,160.0,4120,2709,3135,2015,985,694,1321,336,775,219,546,117,83,52,6550,5650,2350,1075,8200,8899,0
721,2,1,171.0,149.0,180.0,160.0,4030,2440,3023,1791,1007,649,1106,288,640,99,466,189,84,52,6850,4950,2350,1075,8200,9649,0
729,2,1,172.0,151.0,180.0,160.0,4154,2670,3191,2043,963,627,1639,414,1115,299,524,115,83,52,7425,5400,2350,1075,8425,9649,0
736,2,1,172.0,157.5,180.0,160.0,4215,2748,3163,2099,1052,649,1842,234,1340,39,502,195,83,52,7425,5675,2350,1275,8425,9824,0
743,2,1,168.0,148.0,180.0,152.0,4243,2860,3191,2211,1052,649,1812,394,1340,119,472,275,83,52,6750,5300,2350,1275,9100,10399,0
750,2,1,173.0,138.5,188.0,152.0,4198,2894,3191,2267,1007,627,1797,590,1355,264,442,326,83,52,7750,4675,2200,1275,9600,10974,0
757,2,1,170.0,140.5,188.0,152.0,4036,3078,3051,2407,985,671,1766,470,1200,64,566,406,81,52,7575,4725,2200,1275,9875,11424,0
764,2,1,167.0,133.0,188.0,168.0,3946,3045,2939,2351,1007,694,2200,670,1510,184,690,486,82,52,7225,4250,2200,1275,10225,12049,0
771,2,1,180.0,136.5,188.0,168.0,4075,3056,2911,2407,1164,649,942,827,400,269,542,558,83,52,7225,4475,2200,1275,10225,12074,0
779,2,1,180.0,142.0,188.0,168.0,4159,2978,2883,2351,1276,627,1430,783,740,224,690,559,84,52,8575,4750,2200,1275,10225,12199,0
784,2,1,180.0,120.5,188.0,168.0,4159,2966,2883,2295,1276,671,1430,798,740,179,690,619,84,52,8575,3425,2200,1275,10225,13724,0
7,0,0,13.0,13.0,15.0,15.0,293,293,293,293,0,0,35,35,35,35,0,0,12,12,0,0,0,0,0,0,0
14,0,0,13.0,14.0,15.0,15.0,587,671,587,671,0,0,5,70,5,70,0,0,13,13,0,0,0,0,0,0,0
21,0,0,14.0,14.0,15.0,15.0,587,699,587,699,0,0,20,45,20,45,0,0,13,13,0,0,0,0,0,0,0
29,0,0,14.0,15.0,15.0,15.0,559,699,559,699,0,0,85,10,85,10,0,0,13,14,0,0,0,0,0,0,0
36,0,0,14.0,15.0,23.0,15.0,587,699,587,699,0,0,160,45,160,45,0,0,14,14,0,0,0,0,0,0,0
43,0,0,14.0,16.0,23.0,23.0,643,727,643,727,0,0,10,125,10,125,0,0,14,15,0,0,0,0,0,0,0
50,0,0,15.0,16.0,23.0,23.0,671,783,671,783,0,0,35,25,35,25,0,0,14,15,0,0,0,0,0,0,0
57,0,0,14.0,17.0,23.0,23.0,615,766,615,699,0,67,10,117,10,105,0,12,14,16,0,0,0,0,0,0,0
64,0,0,15.0,18.0,23.0,23.0,643,855,643,699,0,156,35,172,35,140,0,32,14,17,0,0,0,0,0,0,0
71,0,0,15.0,18.0,23.0,23.0,654,906,587,727,67,179,67,277,55,225,12,52,14,17,0,0,0,0,0,0,0
79,0,0,16.0,19.0,23.0,23.0,715,911,559,755,156,156,152,333,120,265,32,68,15,18,0,0,0,0,0,0,0
86,0,0,18.0,19.0,23.0,23.0,771,939,615,783,156,156,97,448,95,360,2,88,16,18,0,0,150,0,0,0,0
93,0,0,17.0,20.0,23.0,23.0,743,967,587,811,156,156,82,318,60,260,22,58,16,19,0,0,150,150,0,0,0
100,0,0,17.0,20.0,23.0,23.0,794,1051,615,895,179,156,97,438,55,360,42,78,16,19,0,0,150,150,0,0,0
107,0,0,18.0,20.0,23.0,23.0,715,1023,559,867,156,156,83,153,75,55,8,98,16,19,0,0,300,150,0,0,0
114,0,0,19.0,20.0,23.0,23.0,715,1102,559,923,156,179,128,38,100,20,28,18,16,19,0,0,300,150,0,0,0
121,0,0,20.0,21.0,23.0,23.0,844,1018,643,839,201,179,36,93,30,55,6,38,16,19,100,0,300,150,0,0,0
129,0,0,21.0,21.0,23.0,23.0,1018,1163,727,1007,291,156,107,9,65,5,42,4,17,19,100,100,300,150,0,0,0
136,0,0,21.0,22.0,23.0,23.0,1096,1191,783,1035,313,156,187,49,105,25,82,24,17,20,200,100,300,150,0,0,0
143,0,0,23.0,21.0,31.0,23.0,1202,1247,867,1091,335,156,122,179,100,135,22,44,18,21,200,0,300,150,0,100,0
7,1,1,13.0,13.0,14.0,14.0,377,377,377,377,0,0,45,45,45,45,0,0,12,12,0,0,0,0,0,0,0
14,1,1,13.0,13.0,14.0,14.0,671,699,671,699,0,0,20,25,20,25,0,0,13,13,0,0,0,0,0,0,0
21,1,1,14.0,14.0,14.0,14.0,727,727,727,727,0,0,55,55,55,55,0,0,13,13,0,0,0,0,0,0,0
29,1,1,14.0,14.0,14.0,14.0,699,783,699,783,0,0,150,160,150,160,0,0,13,13,0,0,0,0,0,0,0
36,1,1,16.0,17.0,22.0,22.0,783,783,783,783,0,0,150,100,150,100,0,0,14,14,0,0,0,0,0,0,0
43,1,1,16.0,17.0,22.0,22.0,755,839,755,839,0,0,235,195,235,195,0,0,16,16,0,0,0,0,0,0,0
50,1,1,15.0,17.0,22.0,22.0,811,839,811,839,0,0,40,40,40,40,0,0,15,16,0,0,0,0,0,0,0
57,1,1,17.0,17.0,22.0,22.0,811,867,811,867,0,0,30,155,30,155,0,0,15,16,0,0,0,0,0,0,0
64,1,1,18.0,17.0,22.0,22.0,951,895,951,895,0,0,100,260,100,260,0,0,16,17,0,0,0,0,0,0,0
71,1,1,17.0,17.0,22.0,22.0,867,923,867,923,0,0,165,0,165,0,0,0,17,16,0,0,0,0,0,0,0
79,1,1,17.0,17.0,22.0,22.0,1007,895,1007,895,0,0,40,60,40,60,0,0,16,15,0,0,0,0,0,0,0
86,1,1,18.0,17.0,22.0,22.0,923,867,923,867,0,0,100,160,100,160,0,0,16,16,0,0,0,0,0,0,0
93,1,1,19.0,21.0,22.0,22.0,1007,895,1007,895,0,0,160,25,160,25,0,0,18,17,0,0,0,250,0,0,0
100,1,1,20.0,22.0,22.0,22.0,1012,906,923,839,89,67,231,87,215,75,16,12,19,17,0,0,0,250,0,0,0
107,1,1,20.0,22.0,22.0,22.0,1079,967,923,811,156,156,351,207,315,175,36,32,19,18,0,0,0,250,0,0,0
114,1,1,21.0,22.0,22.0,22.0,1079,995,923,839,156,156,431,223,375,175,56,48,20,19,0,50,0,250,0,0,0
121,1,1,23.0,22.0,28.0,22.0,1107,1079,951,923,156,156,461,358,385,290,76,68,21,19,0,50,250,250,0,0,0
129,1,1,27.0,20.0,28.0,22.0,1074,1079,895,923,179,156,281,375,185,287,96,88,21,17,0,200,250,250,0,0,0
136,1,1,28.0,26.0,28.0,30.0,1113,995,979,839,134,156,63,111,55,103,8,8,21,19,0,200,250,250,0,0,0
143,1,1,28.0,28.0,28.0,36.0,1090,1029,979,895,111,134,199,138,175,118,24,20,21,19,100,200,250,250,0,0,0
150,1,1,30.0,29.0,36.0,36.0,1225,1090,1091,979,134,111,250,214,210,178,40,36,22,21,100,200,250,250,0,0,0
157,1,1,32.0,29.5,36.0,36.0,1314,1202,1203,1091,111,111,297,316,245,268,52,48,22,23,100,175,250,250,0,25,0
164,1,1,32.0,32.5,36.0,36.0,1314,1258,1203,1147,111,111,153,112,85,98,68,14,24,23,400,175,250,250,0,25,0
171,1,1,32.0,33.0,36.0,36.0,1309,1365,1175,1231,134,134,124,228,40,198,84,30,24,24,400,300,250,250,0,50,0
179,1,1,32.0,32.0,36.0,36.0,1320,1281,1231,1147,89,134,84,79,42,33,42,46,24,25,400,300,250,250,0,50,0
186,1,1,35.0,33.0,36.0,36.0,1382,1342,1315,1231,67,111,97,96,47,38,50,58,26,26,400,400,250,250,0,50,0
193,1,1,35.0,36.0,36.0,36.0,1522,1365,1455,1231,67,134,285,112,227,38,58,74,27,26,400,400,250,250,0,50,0
200,1,1,40.0,36.0,44.0,36.0,1527,1454,1483,1343,44,111,129,199,67,113,62,86,29,27,400,450,250,250,0,50,0
207,1,1,41.0,41.0,44.0,44.0,1622,1449,1511,1315,111,134,125,125,47,23,78,102,29,29,400,450,250,450,0,50,0
214,1,1,43.0,43.0,44.0,52.0,1589,1673,1455,1539,134,134,171,226,77,108,94,118,33,30,400,450,250,450,0,50,0
221,1,1,45.0,44.0,52.0,52.0,1695,1673,1539,1539,156,134,176,282,112,198,64,84,34,30,450,450,450,450,0,50,0
229,1,1,48.5,48.0,52.0,52.0,1807,1807,1651,1651,156,156,101,292,17,188,84,104,34,30,425,700,575,450,25,50,0
236,1,1,50.5,51.0,52.0,52.0,1835,1718,1679,1539,156,179,126,162,72,63,54,99,35,30,575,850,575,450,50,50,0
243,1,1,52.5,51.0,66.0,52.0,1970,1690,1791,1511,179,179,216,362,167,243,49,119,35,33,575,900,575,450,50,50,0
250,1,1,57.0,49.5,66.0,58.0,1942,1779,1763,1623,179,156,146,423,77,288,69,135,35,35,950,625,575,450,75,250,0
257,1,1,57.5,48.5,66.0,58.0,1919,1779,1763,1623,156,156,287,303,202,198,85,105,35,33,1075,725,575,450,100,250,0
264,1,1,60.5,51.5,66.0,58.0,2031,1807,1875,1651,156,156,372,218,267,93,105,125,39,35,1175,725,575,575,100,250,0
271,1,1,61.5,55.5,66.0,58.0,2059,1891,1903,1735,156,156,222,203,197,83,25,120,42,36,1175,875,575,575,100,250,0
279,1,1,60.5,55.0,74.0,66.0,2171,1863,2015,1707,156,156,327,283,282,143,45,140,43,36,925,700,575,575,275,425,0
286,1,1,61.5,58.0,74.0,66.0,2339,1998,2183,1819,156,179,462,163,397,103,65,60,45,39,875,900,575,575,325,425,0
293,1,1,65.5,62.0,74.0,66.0,2306,2026,2127,1847,179,179,212,183,127,103,85,80,45,43,825,900,575,575,375,425,0
300,1,1,65.5,64.0,74.0,66.0,2446,2154,2267,1931,179,223,422,296,317,188,105,108,47,44,825,1050,575,775,375,425,0
307,1,1,72.5,66.0,82.0,66.0,2507,2328,2351,2015,156,313,248,286,127,138,121,148,52,49,825,1100,575,775,375,425,0
314,1,1,74.5,66.0,90.0,66.0,2586,2384,2407,2071,179,313,462,306,342,218,120,88,52,49,825,1100,775,775,375,425,0
321,1,1,78.5,67.5,90.0,82.0,2866,2468,2463,2155,403,313,617,516,487,388,130,128,52,51,1075,1075,775,775,375,450,0
329,1,1,85.5,78.0,98.0,82.0,2894,2350,2379,2015,515,335,462,226,372,58,90,168,52,51,1275,1000,775,775,425,525,0
336,1,1,86.5,79.0,98.0,82.0,2978,2619,2463,2239,515,380,503,160,407,48,96,112,52,57,1125,700,775,775,675,675,0
343,1,1,86.5,81.0,98.0,82.0,2899,2770,2407,2323,492,447,444,327,392,163,52,164,50,64,1325,700,775,775,675,675,0
350,1,1,88.5,80.0,106.0,82.0,2765,3045,2295,2575,470,470,695,267,587,68,108,199,52,61,1925,800,775,775,675,725,0
357,1,1,90.0,82.5,106.0,90.0,2317,3011,1847,2519,470,492,845,307,677,123,168,184,55,58,1900,925,775,775,700,881,0
364,1,1,94.0,85.0,106.0,106.0,2261,2681,1791,2211,470,470,645,303,517,138,128,165,57,58,1650,650,775,775,1000,1081,0
371,1,1,95.5,85.0,106.0,106.0,2815,2093,2323,1623,492,470,805,363,617,188,188,175,57,58,1425,650,775,1025,1075,1281,0
379,1,1,97.0,92.0,106.0,106.0,3011,2423,2519,1819,492,604,671,164,427,38,244,126,59,58,1250,850,775,1025,1175,1431,0
386,1,1,97.0,97.0,106.0,106.0,3134,3000,2575,2351,559,649,854,215,542,163,312,52,65,59,1650,1250,775,1025,1175,1431,0
393,1,1,98.0,97.0,106.0,106.0,3134,3151,2463,2547,671,604,1119,488,727,368,392,120,65,59,1650,1650,775,1025,1175,1431,0
400,1,1,99.0,103.0,114.0,106.0,3414,3084,2631,2323,783,761,735,164,597,98,138,66,66,59,1650,1950,1025,1025,1175,1431,0
407,1,1,108.0,105.0,114.0,106.0,3526,3106,2743,2323,783,783,415,350,377,188,38,162,67,63,1650,2050,1025,1025,1175,1431,0
414,1,1,114.0,104.0,114.0,114.0,3543,3078,2715,2295,828,783,230,130,167,18,63,112,69,62,1650,2050,1025,1025,1175,1431,0
421,1,1,114.0,104.0,114.0,114.0,3622,3297,2659,2491,963,806,480,435,347,223,133,212,70,66,1650,2150,1025,1025,1175,1431,0
429,1,1,120.0,110.0,122.0,114.0,3728,3526,2743,2631,985,895,332,249,262,8,70,241,70,66,2050,2150,1025,1150,1175,1431,0
436,1,1,128.0,114.0,154.0,122.0,3644,3543,2659,2603,985,940,378,467,292,168,86,299,70,66,2450,2150,1025,1150,1175,1431,0
443,1,1,130.0,118.0,162.0,122.0,3823,3538,2883,2575,940,963,645,280,472,73,173,207,70,66,2450,2450,1025,1150,1175,1431,0
450,1,1,130.0,122.0,162.0,146.0,3678,3532,2715,2547,963,985,995,505,702,228,293,277,70,66,2750,2450,1025,1150,1175,1431,0
457,1,1,130.0,128.0,162.0,146.0,3874,3510,2911,2547,963,963,1455,521,1042,203,413,318,70,66,3250,2650,1025,1150,1175,1431,0
464,1,1,130.0,137.0,176.0,154.0,3756,3571,2771,2631,985,940,1911,297,1382,63,529,234,70,66,3250,2850,1025,1150,1175,1431,0
471,1,1,147.0,137.0,184.0,162.0,3806,3538,2799,2575,1007,963,901,662,852,308,49,354,70,65,3250,3050,1475,1150,1175,1431,0
479,1,1,153.0,145.0,184.0,162.0,3610,3605,2603,2575,1007,1030,718,442,632,93,86,349,75,66,3250,3350,1475,1150,1175,1431,0
486,1,1,163.0,145.0,184.0,168.0,3566,3476,2603,2491,963,985,635,644,562,183,73,461,75,67,3250,3750,1475,1150,1175,1431,0
493,1,1,172.0,155.0,192.0,168.0,3599,3594,2659,2631,940,963,511,576,422,128,89,448,74,67,4450,4150,1475,1150,1175,1431,0
500,1,1,180.0,153.0,208.0,184.0,3734,3588,2771,2603,963,985,561,661,452,193,109,468,74,65,5150,4150,1475,1400,1175,1431,0
507,1,1,185.0,163.0,208.0,200.0,3980,3566,2995,2603,985,963,676,337,547,3,129,334,73,65,5350,4350,1475,1400,1175,1431,0
514,1,1,195.0,165.0,208.0,192.0,3812,3459,2827,2519,985,940,627,468,507,168,120,300,73,65,5750,4650,1475,1400,1175,1531,0
521,1,1,195.0,168.0,208.0,184.0,4002,3633,2995,2603,1007,1030,1093,518,857,198,236,320,76,64,6150,4650,1475,1650,1175,1631,0
529,1,1,200.0,177.0,208.0,192.0,3834,3526,2715,2519,1119,1007,964,249,867,88,97,161,76,64,6400,5150,1475,1650,1175,1631,0
536,1,1,200.0,177.0,208.0,192.0,4081,3515,2827,2575,1254,940,1182,567,1029,298,153,269,75,64,7000,5700,1475,1650,1175,1631,0
543,1,1,198.0,182.0,208.0,192.0,3997,3566,2743,2603,1254,963,1364,492,1059,278,305,214,75,64,6900,5800,1475,1775,1275,1831,0
550,1,1,184.0,158.0,208.0,192.0,4154,3482,2855,2519,1299,963,1374,208,1034,53,340,155,75,64,5900,4150,1475,1775,2475,3881,0
557,1,1,192.0,142.0,208.0,192.0,4070,3683,2771,2743,1299,940,256,459,164,238,92,221,75,64,4700,4000,1475,1775,3675,4881,0
564,1,1,188.0,150.0,208.0,184.0,4232,3538,2911,2575,1321,963,561,469,459,228,102,241,75,64,4400,4000,1475,1775,3975,4981,0
571,1,1,198.0,156.0,208.0,184.0,4092,3717,2771,2687,1321,1030,448,409,344,123,104,286,75,64,6100,4700,1725,1775,4175,4981,0
579,1,1,200.0,161.0,208.0,184.0,4294,3476,2995,2491,1299,985,860,521,629,248,231,273,75,64,6500,5200,1725,1775,4175,4981,0
586,1,1,200.0,169.0,208.0,176.0,4159,3594,2883,2631,1276,963,794,333,663,98,131,235,75,64,6900,5600,1725,1775,4187,5081,0
593,1,1,198.0,164.0,208.0,192.0,4238,3476,2939,2491,1299,985,1285,748,998,393,287,355,75,64,7000,5700,1725,1775,4287,5381,0
600,1,1,198.0,161.0,208.0,200.0,4260,2899,2939,2071,1321,828,1695,475,1273,178,422,297,75,55,7000,5350,1725,1775,4387,6181,0
607,1,1,189.0,163.0,208.0,194.0,4154,2294,2855,1623,1299,671,1772,344,1298,63,474,281,75,53,6100,5550,1725,1775,5287,6831,0
614,1,1,195.0,159.0,208.0,194.0,4154,2350,2855,1679,1299,671,1569,624,1118,263,451,361,75,53,5800,5300,1725,1775,5687,7081,0
621,1,1,187.0,148.0,214.0,194.0,4254,2266,2911,1595,1343,671,979,499,643,158,336,341,75,53,4200,4800,1725,1775,7287,8181,0
629,1,1,160.0,140.0,214.0,194.0,4154,2614,2855,1987,1299,627,1271,606,833,243,438,363,75,53,3000,4600,1725,1775,8887,8781,0
636,1,1,164.0,142.0,214.0,194.0,4109,2636,2855,1987,1254,649,1553,516,1013,223,540,293,75,51,3700,4600,1725,1775,8887,8881,0
643,1,1,188.0,146.0,214.0,194.0,4154,2244,2855,1595,1299,649,528,592,353,273,175,319,75,51,4800,5000,1725,1775,8887,8881,0
650,1,1,199.0,152.0,214.0,194.0,4148,2524,2827,1875,1321,649,419,497,288,298,131,199,75,51,5000,5300,1725,1775,8887,8881,0
657,1,1,199.0,154.0,214.0,194.0,3952,2468,2631,1819,1321,649,480,688,393,438,87,250,75,51,6300,5600,2075,1775,8887,8881,0
664,1,1,199.0,164.0,206.0,194.0,3678,2770,2379,2099,1299,671,832,433,593,178,239,255,75,51,6900,5800,2075,1775,8987,8881,0
671,1,1,200.0,169.0,206.0,194.0,3840,2832,2519,2183,1321,649,1203,374,883,293,320,81,75,51,6900,6100,2075,1775,8987,8881,0
678,1,1,200.0,163.0,206.0,194.0,3840,2888,2519,2239,1321,649,1203,410,883,328,320,82,75,51,6900,5900,2075,1775,8987,9481,0
7,1,2,13.0,13.0,14.0,15.0,377,293,377,293,0,0,45,35,45,35,0,0,12,12,0,0,0,0,0,0,1
14,1,2,13.0,14.0,14.0,15.0,671,615,671,615,0,0,20,60,20,60,0,0,13,13,0,0,0,0,0,0,1
21,1,2,14.0,14.0,14.0,15.0,727,699,727,699,0,0,55,0,55,0,0,0,13,13,0,0,0,0,0,0,1
29,1,2,14.0,15.0,14.0,15.0,783,727,783,727,0,0,160,10,160,10,0,0,13,14,0,0,0,0,0,0,1
36,1,2,16.0,15.0,22.0,15.0,811,783,811,783,0,0,155,60,155,60,0,0,14,14,0,0,0,0,0,0,1
43,1,2,16.0,16.0,22.0,23.0,811,811,811,811,0,0,245,105,245,105,0,0,16,15,0,0,0,0,0,0,1
50,1,2,15.0,17.0,22.0,23.0,867,867,867,867,0,0,45,5,45,5,0,0,15,16,0,0,0,0,0,0,1
57,1,2,18.0,18.0,22.0,23.0,923,895,923,895,0,0,5,55,5,55,0,0,15,17,0,0,0,0,0,0,1
64,1,2,18.0,19.0,22.0,23.0,923,1001,923,979,0,22,110,124,110,120,0,4,16,18,0,0,0,0,0,0,1
71,1,2,17.0,19.0,22.0,23.0,923,1068,923,979,0,89,190,256,190,240,0,16,17,18,0,0,0,0,0,0,1
79,1,2,18.0,20.0,22.0,23.0,895,1085,895,951,0,134,0,372,0,340,0,32,16,19,0,0,0,0,0,0,1
86,1,2,18.0,20.0,22.0,23.0,923,1051,923,895,0,156,120,92,120,40,0,52,16,19,0,0,0,0,0,0,1
93,1,2,19.0,21.0,22.0,23.0,917,1023,895,867,22,156,174,172,170,100,4,72,18,20,0,0,0,0,0,0,1
100,1,2,20.0,21.0,22.0,23.0,984,1135,895,979,89,156,246,162,230,70,16,92,19,21,0,0,0,150,0,0,1
107,1,2,20.0,22.0,22.0,23.0,1113,1107,979,951,134,156,387,157,355,45,32,112,19,21,0,0,0,150,0,0,1
114,1,2,21.0,22.0,22.0,23.0,1107,1158,951,979,156,179,467,152,415,20,52,132,20,21,0,0,0,150,0,0,1
121,1,2,26.0,23.0,28.0,23.0,1135,1102,979,923,156,179,248,237,180,85,68,152,21,22,0,0,250,150,0,0,1
129,1,2,26.0,24.0,28.0,31.0,1163,1208,1007,1007,156,201,288,376,200,200,88,176,21,23,0,0,250,150,0,0,1
136,1,2,28.0,26.0,28.0,31.0,1090,1208,979,895,111,313,115,251,115,110,0,141,21,23,0,0,250,300,0,0,1
143,1,2,30.0,27.0,36.0,31.0,1119,1320,1119,1007,0,313,155,62,155,35,0,27,22,24,50,0,250,300,0,0,1
150,1,2,30.0,28.0,36.0,31.0,1175,1292,1175,979,0,313,300,222,300,155,0,67,23,25,50,0,250,300,0,0,1
157,1,2,31.0,30.0,36.0,46.0,1203,1398,1203,1063,0,335,50,232,50,125,0,107,24,26,350,0,250,300,0,0,1
164,1,2,32.0,33.0,36.0,46.0,1343,1370,1343,1035,0,335,70,117,70,20,0,97,25,27,350,125,250,300,0,0,1
171,1,2,34.0,34.0,36.0,46.0,1399,1538,1399,1203,0,335,90,258,90,125,0,133,26,28,350,125,250,300,0,0,1
179,1,2,36.0,35.0,36.0,46.0,1511,1678,1511,1343,0,335,170,398,170,225,0,173,27,29,350,125,250,300,0,0,1
186,1,2,38.0,40.0,44.0,46.0,1623,1684,1623,1371,0,313,115,144,115,85,0,59,27,31,350,125,250,600,0,0,1
193,1,2,42.0,41.0,44.0,46.0,1645,1824,1623,1511,22,313,109,264,105,165,4,99,29,32,350,300,250,600,0,0,1
200,1,2,43.0,42.0,44.0,46.0,1723,1824,1679,1511,44,313,153,520,145,385,8,135,29,33,350,300,250,600,0,0,1
207,1,2,45.0,44.0,52.0,54.0,1746,1852,1679,1539,67,313,210,235,190,60,20,175,33,35,500,300,250,600,0,0,1
214,1,2,47.0,47.0,52.0,54.0,1835,1880,1679,1567,156,313,335,155,295,90,40,65,34,35,500,600,250,600,0,0,1
221,1,2,50.0,49.0,60.0,54.0,1891,1930,1735,1595,156,335,406,195,350,90,56,105,36,37,650,600,250,600,0,0,1
229,1,2,53.0,49.0,66.0,54.0,2003,2042,1847,1707,156,335,316,101,240,60,76,41,35,38,650,600,250,600,0,0,1
236,1,2,53.0,51.0,66.0,62.0,2031,2104,1875,1791,156,313,466,247,370,170,96,77,38,39,650,600,250,600,0,0,1
243,1,2,60.0,52.0,66.0,62.0,2115,2132,1959,1819,156,313,291,422,175,305,116,117,40,40,800,900,250,600,0,0,1
250,1,2,60.0,53.0,74.0,62.0,2087,2266,1931,1931,156,335,352,377,220,220,132,157,43,41,800,900,375,600,0,0,1
257,1,2,63.0,55.0,74.0,62.0,2143,2138,1987,1735,156,403,352,379,200,170,152,209,46,43,800,900,375,600,0,0,1
264,1,2,65.0,57.0,74.0,62.0,2283,2250,2127,1735,156,515,537,125,365,60,172,65,47,43,950,900,375,850,0,0,1
271,1,2,63.0,59.0,74.0,62.0,2339,2227,2183,1735,156,492,667,346,475,225,192,121,45,45,950,1075,625,850,250,0,1
279,1,2,67.0,61.0,82.0,77.0,2194,2373,2015,1903,179,470,387,317,325,140,62,177,48,46,950,1075,625,850,250,0,1
286,1,2,70.0,63.0,82.0,77.0,2367,2541,2211,2071,156,470,173,383,95,150,78,233,52,48,950,1075,625,850,250,0,1
293,1,2,74.0,67.0,82.0,85.0,2535,2485,2379,2015,156,470,198,363,100,120,98,243,52,50,950,1250,625,1000,250,0,1
300,1,2,77.0,68.0,82.0,85.0,2731,2703,2575,2211,156,492,183,538,65,235,118,303,59,51,950,1250,625,1300,250,0,1
307,1,2,77.0,71.0,82.0,85.0,2955,2810,2799,2295,156,515,188,833,150,470,38,363,57,54,950,1250,625,1300,250,0,1
314,1,2,82.0,80.0,90.0,85.0,3090,2983,2911,2491,179,492,308,334,250,115,58,219,58,55,1050,1775,625,1450,250,0,1
321,1,2,84.0,81.0,90.0,85.0,3095,2983,2939,2491,156,492,449,385,375,210,74,175,58,57,1150,1950,625,1550,250,0,1
329,1,2,88.5,81.0,90.0,85.0,3207,3073,3051,2603,156,470,608,561,514,330,94,231,58,59,1275,1950,950,1550,206,0,1
336,1,2,89.5,89.0,90.0,93.0,3095,3067,2939,2575,156,492,913,226,799,135,114,91,60,59,1525,2300,950,1550,206,0,1
343,1,2,96.5,89.0,98.0,101.0,3190,3151,2967,2659,223,492,406,417,264,370,142,47,60,59,1775,2650,950,1550,206,0,1
350,1,2,97.5,89.0,90.0,117.0,3202,3202,2911,2687,291,515,543,807,369,700,174,107,60,59,1825,2650,950,1550,306,0,1
357,1,2,96.5,91.0,114.0,117.0,3252,3241,2939,2771,313,470,828,579,614,520,214,59,60,59,1925,2475,950,1550,356,175,1
364,1,2,101.5,93.0,120.0,109.0,3196,3134,2883,2687,313,447,903,645,649,580,254,65,59,59,1975,2825,1200,1550,356,275,1
371,1,2,107.0,93.0,136.0,109.0,3336,3325,3023,2855,313,470,843,831,549,710,294,121,59,59,1950,3000,1200,1550,381,275,1
379,1,2,111.0,96.0,144.0,109.0,3325,3218,2967,2771,358,447,1138,477,804,300,334,177,59,59,2250,3000,1200,1550,381,275,1
386,1,2,117.5,104.0,144.0,109.0,3224,3263,2911,2771,313,492,1150,468,784,235,366,233,59,59,2525,3000,1200,1550,406,275,1
393,1,2,123.5,104.0,152.0,109.0,3196,3280,2771,2743,425,537,295,658,169,365,126,293,59,62,2825,3400,1200,1550,406,275,1
400,1,2,127.5,107.0,152.0,109.0,3269,3314,2799,2799,470,515,375,889,189,540,186,349,59,62,3175,3400,1200,1700,406,275,1
407,1,2,134.0,113.0,152.0,117.0,3235,3252,2743,2715,492,537,380,848,134,435,246,413,59,65,3450,3275,1200,1700,431,325,1
414,1,2,135.0,113.0,160.0,125.0,3235,3263,2743,2659,492,604,691,899,389,410,302,489,63,65,3600,3675,1200,2000,431,325,1
421,1,2,138.0,115.0,160.0,125.0,3129,3398,2659,2771,470,627,607,1229,374,660,233,569,71,65,3600,3675,1200,2150,431,325,1
429,1,2,144.0,125.0,160.0,141.0,3431,3448,2939,2799,492,649,682,744,389,345,293,399,70,65,3750,4650,1200,2150,431,325,1
436,1,2,143.5,130.0,152.0,149.0,3465,3392,2995,2743,470,649,613,769,364,290,249,479,70,65,3775,4750,1200,2150,981,425,1
443,1,2,128.5,129.0,144.0,149.0,3851,3414,3359,2743,492,671,888,776,579,375,309,401,70,66,2975,4650,1200,2150,2231,525,1
450,1,2,108.5,117.0,144.0,149.0,3823,3426,3331,2799,492,627,1254,228,889,5,365,223,70,68,2325,3175,1325,2300,3381,2100,1
457,1,2,110.0,115.0,144.0,172.0,3941,3504,3471,2855,470,649,1320,418,899,115,421,303,70,69,1850,3675,1325,2300,3956,2475,1
464,1,2,119.5,119.0,144.0,172.0,3885,3314,3415,2687,470,627,1035,599,654,220,381,379,70,69,1875,3675,1325,2300,4031,2475,1
471,1,2,120.0,120.0,120.0,172.0,3963,3426,3471,2799,492,627,1315,864,924,455,391,409,70,73,2000,3775,1325,2300,4406,2575,1
479,1,2,119.5,133.0,126.0,172.0,3963,3840,3471,3191,492,649,1666,674,1219,185,447,489,70,74,2525,4450,1325,2300,4581,2575,1
486,1,2,113.0,117.0,126.0,172.0,3851,4025,3359,3331,492,694,1672,1154,1169,585,503,569,70,74,1600,3200,1325,2300,5206,3825,1
493,1,2,122.0,124.0,126.0,172.0,3745,4053,3275,3359,470,694,1183,1190,799,545,384,645,70,77,2050,3400,1325,2300,5256,3825,1
500,1,2,126.0,136.0,126.0,172.0,3717,4064,3247,3415,470,649,1418,1057,974,340,444,717,70,77,2500,4000,1325,2300,5256,3825,1
507,1,2,125.5,136.0,126.0,172.0,3767,3846,3275,3219,492,627,1023,1243,544,450,479,793,70,80,2775,4000,1325,2300,5406,3825,1
514,1,2,124.5,139.0,126.0,180.0,3605,3734,3135,3107,470,627,1079,1363,544,590,535,773,69,79,3225,4000,1325,2300,5406,3875,1
521,1,2,123.0,133.0,134.0,172.0,3762,3818,3247,3191,515,627,1019,1223,424,370,595,853,68,79,2300,4050,1325,2300,5756,4875,1
529,1,2,127.0,132.0,158.0,172.0,3610,3896,3163,3247,447,649,717,1628,199,695,518,933,68,79,2300,3950,1325,2300,6056,4975,1
536,1,2,125.5,145.0,182.0,172.0,3526,4008,3079,3359,447,649,818,860,244,55,574,805,67,79,1975,3950,1325,2550,6431,4975,1
543,1,2,125.5,139.0,182.0,172.0,2821,4098,2351,3471,470,627,689,1348,139,475,550,873,65,82,2275,4450,1325,2550,6841,5275,1
550,1,2,120.0,144.0,182.0,172.0,2944,4165,2519,3583,425,582,697,1481,99,540,598,941,65,83,1950,4575,1325,2550,7441,5450,1
557,1,2,117.5,142.0,182.0,172.0,3246,4025,2799,3443,447,582,788,1953,209,940,579,1013,65,83,2725,4475,1325,2550,7791,5550,1
564,1,2,108.5,136.0,182.0,172.0,3420,4002,2995,3443,425,559,1086,1855,459,770,627,1085,65,84,2225,3275,1325,2550,8641,6750,1
571,1,2,117.5,138.0,182.0,172.0,3392,4019,2967,3415,425,604,1012,1641,329,680,683,961,65,84,2525,3800,1325,2550,8716,7025,1
579,1,2,121.5,138.0,182.0,172.0,3218,4114,2771,3443,447,671,574,1287,39,450,535,837,63,84,2625,3800,1325,2700,8916,7025,1
586,1,2,115.5,132.0,188.0,172.0,2770,4081,2323,3499,447,582,850,1772,259,875,591,897,63,86,2425,3500,1325,2850,9366,7325,1
593,1,2,112.0,148.0,188.0,172.0,3308,4002,2883,3443,425,559,503,1251,39,290,464,961,62,86,2350,4100,1325,2850,10266,7525,1
600,1,2,110.0,140.0,188.0,180.0,3347,4193,2967,3611,380,582,502,1398,19,365,483,1033,62,86,2200,3700,1325,2850,10766,8125,1
607,1,2,102.0,120.0,188.0,180.0,3347,3890,2967,3331,380,559,605,995,21,140,584,855,62,68,1675,2875,1325,2850,11752,9850,1
613,1,2,92.5,114.0,188.0,180.0,3207,3291,2827,2687,380,604,786,870,166,55,620,815,62,72,900,2975,1325,2850,12302,10625,1
7,1,0,13.0,13.0,14.0,15.0,377,377,377,377,0,0,45,45,45,45,0,0,12,12,0,0,0,0,0,0,0
14,1,0,13.0,14.0,14.0,15.0,671,671,671,671,0,0,20,70,20,70,0,0,13,13,0,0,0,0,0,0,0
21,1,0,14.0,14.0,14.0,15.0,671,699,671,699,0,0,45,50,45,50,0,0,13,13,0,0,0,0,0,0,0
29,1,0,14.0,15.0,14.0,15.0,699,727,699,727,0,0,145,95,145,95,0,0,13,14,0,0,0,0,0,0,0
36,1,0,16.0,15.0,22.0,15.0,727,727,727,727,0,0,140,130,140,130,0,0,14,14,0,0,0,0,0,0,0
43,1,0,16.0,16.0,22.0,23.0,783,811,783,811,0,0,235,5,235,5,0,0,15,15,0,0,0,0,0,0,0
50,1,0,15.0,16.0,22.0,23.0,783,811,783,811,0,0,30,45,30,45,0,0,15,15,0,0,0,0,0,0,0
57,1,0,17.0,17.0,22.0,23.0,811,811,811,811,0,0,35,95,35,95,0,0,15,16,0,0,0,0,0,0,0
64,1,0,18.0,18.0,22.0,23.0,867,867,867,867,0,0,90,195,90,195,0,0,16,17,0,0,0,0,0,0,0
71,1,0,17.0,18.0,22.0,23.0,867,872,867,783,0,89,170,241,170,225,0,16,17,17,0,0,0,0,0,0,0
79,1,0,17.0,19.0,22.0,23.0,951,967,951,811,0,156,35,357,35,325,0,32,16,18,0,0,0,0,0,0,0
86,1,0,18.0,19.0,22.0,23.0,951,939,951,783,0,156,100,472,100,420,0,52,16,18,0,0,0,0,0,0,0
93,1,0,19.0,19.0,22.0,23.0,979,1023,979,867,0,156,160,347,160,325,0,22,18,19,0,0,0,150,0,0,0
100,1,0,20.0,19.0,22.0,23.0,1018,1023,951,867,67,156,232,62,220,20,12,42,19,19,0,0,0,150,0,0,0
107,1,0,20.0,19.0,22.0,23.0,1113,1023,979,867,134,156,358,87,330,25,28,62,19,19,0,0,0,150,0,0,0
114,1,0,21.0,20.0,22.0,23.0,1135,1018,979,839,156,179,443,162,395,80,48,82,20,19,0,0,0,150,0,0,0
121,1,0,27.0,20.0,28.0,23.0,1079,995,923,839,156,156,163,263,95,165,68,98,21,19,0,0,250,150,0,0,0
129,1,0,27.0,22.0,28.0,31.0,1186,1079,1007,923,179,156,313,58,225,40,88,18,21,20,0,0,250,250,0,0,0
136,1,0,28.0,23.0,28.0,31.0,1085,1219,951,1063,134,156,80,103,80,65,0,38,21,20,0,0,250,250,0,0,0
143,1,0,28.0,24.0,28.0,31.0,1057,1219,1035,1063,22,156,215,193,215,135,0,58,21,21,100,0,250,250,0,0,0
150,1,0,27.0,26.0,36.0,31.0,1035,1247,1035,1091,0,156,35,188,35,110,0,78,21,21,100,100,250,250,0,0,0
157,1,0,30.0,27.0,36.0,31.0,1231,1242,1231,1063,0,179,55,273,55,175,0,98,21,22,400,100,250,250,0,0,0
164,1,0,31.0,29.0,36.0,31.0,1231,1326,1231,1035,0,291,155,343,155,205,0,138,22,22,400,200,250,250,0,0,0
171,1,0,33.0,30.0,36.0,46.0,1203,1460,1203,1147,0,313,35,350,35,180,0,170,25,23,400,200,250,500,0,0,0
179,1,0,36.0,30.0,36.0,46.0,1343,1516,1343,1203,0,313,65,270,65,160,0,110,25,24,400,200,250,500,0,0,0
186,1,0,36.0,35.0,36.0,46.0,1399,1320,1399,1007,0,313,225,190,225,40,0,150,26,24,400,300,250,500,0,0,0
193,1,0,40.0,37.0,44.0,46.0,1483,1432,1483,1119,0,313,125,265,125,75,0,190,28,25,400,300,250,500,0,0,0
200,1,0,43.0,38.0,44.0,46.0,1623,1426,1623,1091,0,335,105,295,105,65,0,230,28,25,400,300,250,500,0,0,0
207,1,0,47.0,42.0,52.0,46.0,1729,1622,1707,1287,22,335,59,301,55,35,4,266,32,26,550,500,250,500,0,0,0
214,1,0,48.0,44.0,52.0,46.0,1813,1790,1679,1455,134,335,224,316,200,110,24,206,33,27,550,550,250,750,0,0,0
221,1,0,49.0,46.0,58.0,54.0,1947,1880,1791,1567,156,313,400,182,360,40,40,142,36,27,550,550,250,750,0,0,0
229,1,0,55.0,47.0,58.0,54.0,1863,1908,1707,1595,156,313,155,252,95,70,60,182,36,27,550,750,250,750,0,0,0
236,1,0,56.0,50.0,58.0,54.0,2031,1684,1875,1371,156,313,370,252,290,30,80,222,37,28,700,750,250,750,0,0,0
243,1,0,60.0,52.0,66.0,54.0,2059,1874,1903,1539,156,335,260,402,160,140,100,262,38,28,950,1000,250,750,0,0,0
250,1,0,62.5,53.0,66.0,54.0,2143,1785,1987,1427,156,358,215,197,95,45,120,152,40,29,975,1000,250,750,25,0,0
257,1,0,62.5,59.0,66.0,62.0,2194,1622,2015,1287,179,335,175,303,85,115,90,188,40,30,1025,1200,250,750,25,0,0
264,1,0,68.5,62.0,82.0,62.0,2166,1992,1987,1679,179,313,185,274,75,50,110,224,39,32,1225,1200,250,1000,25,0,0
271,1,0,68.5,62.0,82.0,62.0,2227,1936,2071,1623,156,313,451,399,325,135,126,264,39,32,1225,1150,250,1000,25,50,0
279,1,0,72.0,61.0,82.0,62.0,2255,2048,2099,1735,156,313,161,489,15,185,146,304,39,33,1300,1150,250,1000,250,150,0
286,1,0,72.0,64.0,82.0,70.0,2255,1572,2099,1259,156,313,296,394,130,50,166,344,39,32,1450,1250,250,1000,350,275,0
293,1,0,68.5,61.0,82.0,70.0,2087,1426,1931,1091,156,335,516,419,330,35,186,384,36,32,1425,950,250,1000,525,575,0
300,1,0,74.5,50.0,82.0,70.0,1611,1925,1455,1567,156,358,316,744,110,320,206,424,34,34,1675,600,250,1000,775,1225,0
307,1,0,74.0,48.0,82.0,78.0,1494,2350,1315,2015,179,335,431,505,205,45,226,460,34,34,1600,700,450,1000,850,1325,0
314,1,0,77.0,50.0,82.0,78.0,1914,2412,1735,2099,179,313,171,596,25,175,146,421,43,36,1750,750,450,1000,850,1325,0
321,1,0,75.0,51.0,82.0,78.0,2003,2328,1847,2015,156,313,417,536,255,125,162,411,41,37,1900,750,450,1000,850,1325,0
329,1,0,78.0,53.0,82.0,78.0,2227,2384,2071,2071,156,313,512,411,330,60,182,351,44,38,1900,750,450,1075,850,1325,0
336,1,0,81.0,55.0,82.0,78.0,2423,2462,2267,2127,156,335,662,486,460,95,202,391,46,40,2050,750,450,1075,850,1325,0
343,1,0,82.0,55.0,82.0,78.0,2479,2681,2323,2323,156,358,412,656,190,225,222,431,47,40,2050,750,575,1075,850,1325,0
350,1,0,82.0,58.0,82.0,78.0,2535,2686,2267,2351,268,335,718,572,460,105,258,467,51,42,2050,800,575,1075,850,1325,0
357,1,0,85.0,59.0,98.0,78.0,2625,2468,2267,2155,358,313,398,538,100,85,298,453,47,43,2050,800,575,1175,850,1325,0
364,1,0,91.0,61.0,98.0,78.0,2636,2524,2323,2211,313,313,414,633,80,240,334,393,47,44,2050,850,575,1300,850,1325,0
371,1,0,92.0,62.0,106.0,86.0,2686,2608,2351,2295,335,313,619,733,245,400,374,333,54,46,2050,850,825,1725,850,1325,0
379,1,0,93.0,67.0,106.0,101.0,2714,2513,2379,2155,335,358,366,719,202,338,164,381,59,46,2050,850,950,1725,850,1362,0
386,1,0,95.0,73.0,106.0,101.0,3006,2731,2603,2127,403,604,268,459,202,198,66,261,60,47,2050,900,1075,1725,850,1362,0
393,1,0,98.0,79.0,106.0,101.0,3101,2714,2631,2043,470,671,173,604,147,263,26,341,61,49,2050,1100,1075,1725,850,1362,0
400,1,0,103.0,83.0,98.0,101.0,3185,2905,2603,2211,582,694,249,455,147,38,102,417,64,50,2050,1150,1075,1825,950,1362,0
407,1,0,103.0,85.0,98.0,101.0,3157,2978,2463,2351,694,627,322,533,132,48,190,485,70,51,2050,1150,1075,1825,950,1362,0
414,1,0,104.5,90.0,106.0,101.0,3325,2670,2519,2043,806,627,214,668,132,103,82,565,72,51,2025,1750,1075,1825,975,1362,0
421,1,0,105.5,96.0,114.0,101.0,3291,2922,2463,2295,828,627,554,668,372,23,182,645,72,53,2025,1950,1075,1825,975,1362,0
429,1,0,117.0,96.0,136.0,109.0,3549,2944,2743,2295,806,649,341,773,67,48,274,725,75,53,2400,2050,1325,1825,1025,1362,0
436,1,0,116.0,102.0,136.0,109.0,3521,3129,2715,2435,806,694,681,693,307,88,374,605,75,55,2400,2200,1325,1825,1025,1362,0
443,1,0,123.0,103.0,136.0,109.0,3157,3213,2351,2519,806,694,707,764,237,183,470,581,82,56,2400,2400,1325,2125,1025,1362,0
450,1,0,129.0,106.0,136.0,109.0,3403,3140,2575,2491,828,649,547,646,77,93,470,553,82,57,2500,2400,1325,2125,1025,1362,0
457,1,0,131.5,106.0,136.0,109.0,3969,3090,3163,2463,806,627,828,622,262,93,566,529,82,59,2775,2100,1450,2125,1100,1662,0
464,1,0,125.5,108.0,136.0,117.0,4159,3006,3331,2379,828,627,934,697,272,138,662,559,82,60,2525,2400,1450,2125,1600,1862,0
471,1,0,130.0,105.0,144.0,117.0,4383,3034,3555,2407,828,627,1169,817,407,178,762,639,82,62,2700,1950,1450,2125,1825,2312,0
479,1,0,134.5,110.0,136.0,117.0,4389,3140,3583,2491,806,649,1241,692,437,173,804,519,82,64,2775,1950,1450,2125,1950,2312,0
486,1,0,134.5,110.0,136.0,117.0,4422,3286,3639,2547,783,739,1617,766,717,263,900,503,81,65,3025,2150,1325,2325,1968,2362,0
493,1,0,134.0,115.0,136.0,117.0,4473,3381,3667,2575,806,806,1852,268,1002,23,850,245,81,66,3200,2350,1325,2325,1993,2362,0
500,1,0,140.0,117.0,152.0,117.0,4383,3392,3555,2631,828,761,1447,532,822,203,625,329,80,66,3500,2400,1325,2575,1993,2362,0
507,1,0,145.5,117.0,152.0,117.0,4361,3470,3555,2687,806,783,763,667,567,263,196,404,80,66,3725,3000,1325,2800,2018,2412,0
514,1,0,150.5,124.0,152.0,125.0,4299,3577,3471,2771,828,806,814,732,672,328,142,404,83,66,3925,3050,1325,2575,2118,2637,0
521,1,0,149.5,128.0,152.0,133.0,4456,3465,3583,2659,873,806,843,537,597,83,246,454,83,65,4175,3100,1325,2575,2168,2687,0
529,1,0,151.5,133.0,152.0,133.0,4042,3543,3191,2715,851,828,1119,408,827,58,292,350,83,65,4625,3450,1325,2650,2168,2687,0
536,1,0,154.5,133.0,192.0,133.0,3952,3532,3079,2659,873,873,1336,483,932,33,404,450,83,65,4925,3400,1325,2875,2318,2837,0
543,1,0,168.5,139.0,192.0,149.0,4148,3465,3163,2659,985,806,386,866,287,328,99,538,82,65,4925,3650,1325,2875,2318,2837,0
550,1,0,171.0,141.0,192.0,149.0,4232,3638,3247,2855,985,783,746,712,527,103,219,609,87,65,5050,3750,1325,2875,2343,2837,0
557,1,0,176.0,149.0,198.0,149.0,4372,3638,3387,2855,985,783,1008,567,677,108,331,459,88,65,6050,4350,1325,2875,2468,2837,0
564,1,0,181.0,149.0,198.0,149.0,4294,3745,3219,2939,1075,806,930,672,567,113,363,559,86,65,6600,4400,1325,2875,2468,2837,0
571,1,0,186.0,149.0,198.0,149.0,4506,3767,3387,2939,1119,828,734,927,497,293,237,634,87,65,6850,4500,1325,2875,2468,2837,0
579,1,0,183.5,157.0,198.0,157.0,4758,3706,3639,2855,1119,851,809,1133,682,428,127,705,90,65,6875,4550,1325,2875,2593,2987,0
586,1,0,187.0,156.0,198.0,157.0,4865,4014,3723,3163,1142,851,749,1174,482,498,267,676,90,65,6300,4400,1325,2875,3093,3437,0
593,1,0,194.5,162.0,198.0,165.0,5027,3778,3751,2995,1276,783,854,817,427,53,427,764,90,65,6875,4700,1325,2875,3143,3437,0
600,1,0,193.5,161.0,198.0,165.0,5111,3694,3835,2911,1276,783,1365,717,782,53,583,664,90,65,7225,4750,1575,2875,3268,3537,0
607,1,0,188.0,164.0,198.0,165.0,5145,3582,3779,2799,1366,783,1366,737,927,98,439,639,90,65,7050,5200,1575,2875,3543,3587,0
614,1,0,192.0,167.0,206.0,173.0,5150,3269,3807,2463,1343,806,1418,1037,827,323,591,714,89,65,7050,5450,1575,2875,3743,3887,0
621,1,0,195.0,161.0,206.0,188.0,4691,3347,3415,2519,1276,828,1386,932,647,193,739,739,81,65,7050,4850,1575,2875,4143,4587,0
629,1,0,199.0,163.0,206.0,188.0,4221,3364,2967,2491,1254,873,1582,933,687,198,895,735,80,65,7600,4900,1575,2875,4143,4687,0
636,1,0,200.0,166.0,206.0,188.0,4327,3398,3051,2547,1276,851,1517,1034,637,278,880,756,89,65,7500,5350,1575,2875,4343,4837,0
643,1,0,200.0,169.0,206.0,188.0,4434,3218,3135,2435,1299,783,1857,842,917,198,940,644,89,65,7500,5800,1575,3325,4343,4837,0
650,1,0,197.0,172.0,206.0,188.0,4708,3050,3387,2267,1321,783,2064,712,1147,43,917,669,89,65,7650,5850,1700,3325,4468,4837,0
657,1,0,195.5,178.0,206.0,188.0,4781,2933,3415,2127,1366,806,2464,717,1387,98,1077,619,89,65,7875,6100,1700,3325,4693,4837,0
664,1,0,193.5,180.0,206.0,188.0,4826,3101,3527,2295,1299,806,2638,767,1617,123,1021,644,89,66,8075,6200,1700,3675,4918,5037,0
671,1,0,172.5,156.0,206.0,188.0,4971,3286,3695,2435,1276,851,3239,758,2062,93,1177,665,89,66,6875,4800,1700,3875,5818,5887,0
679,1,0,185.5,154.0,206.0,196.0,5033,3426,3779,2575,1254,851,1920,864,1087,228,833,636,89,66,6825,4600,2050,3950,6043,6187,0
686,1,0,188.5,154.0,206.0,196.0,4994,3134,3695,2351,1299,783,2235,302,1442,53,793,249,89,66,6825,4550,2050,3950,6043,6487,0
693,1,0,190.5,154.0,206.0,196.0,5055,3330,3779,2547,1276,783,1711,212,1362,113,349,99,88,66,7725,4825,2050,3950,6043,6487,0
700,1,0,198.5,158.0,206.0,196.0,5033,3330,3667,2547,1366,783,1527,432,1022,283,505,149,88,66,7575,5225,2050,3950,6193,6487,0
707,1,0,197.5,162.0,206.0,196.0,5038,3465,3695,2659,1343,806,1723,377,1262,303,461,74,90,66,7575,5425,2050,3950,6193,6487,0
714,1,0,199.5,162.0,206.0,196.0,4803,3655,3527,2827,1276,828,2117,257,1512,108,605,149,89,66,8175,5975,2050,3950,6193,6487,0
721,1,0,199.5,170.0,206.0,196.0,4904,3616,3583,2743,1321,873,2190,73,1667,53,523,20,89,66,8675,6175,2050,3950,6218,6487,0
729,1,0,199.5,172.0,206.0,196.0,4831,3538,3443,2687,1388,851,2672,239,1977,123,695,116,92,66,8675,6275,2050,3950,6218,6487,0
736,1,0,199.5,174.0,206.0,196.0,4646,3610,3191,2827,1455,783,3227,302,2352,223,875,79,92,69,9175,6550,2050,3950,6218,6487,0
743,1,0,199.5,179.0,214.0,196.0,4837,3941,3359,3135,1478,806,3313,341,2512,283,801,58,92,70,9175,6750,2050,4175,6218,6487,0
750,1,0,199.5,179.0,214.0,196.0,4977,3773,3387,2855,1590,918,3911,572,2922,448,989,124,92,70,9175,7025,2050,4175,6218,6487,0
757,1,0,199.5,189.0,214.0,196.0,4999,3896,3387,2799,1612,1097,4511,396,3342,328,1169,68,92,73,9675,7025,2050,4275,6343,6487,0
764,1,0,200.0,192.0,214.0,196.0,4943,4014,3331,2827,1612,1187,4332,640,3267,453,1065,187,92,73,9600,7300,2050,4275,6418,6487,0
771,1,0,195.5,188.0,214.0,196.0,4842,4221,3275,2967,1567,1254,4914,854,3657,673,1257,181,92,76,9275,7325,2050,4375,6593,6837,0
779,1,0,165.5,176.0,212.0,181.0,4775,3728,3163,2631,1612,1097,5509,1079,4052,878,1457,201,92,70,6275,7125,2050,4150,8193,8962,0
786,1,0,195.5,178.0,212.0,181.0,4831,3308,3219,2435,1612,873,4035,603,2582,323,1453,280,91,70,5525,7400,2050,4150,8943,8962,0
793,1,0,197.0,181.0,212.0,181.0,5094,3174,3415,2323,1679,851,3346,431,2272,268,1074,163,91,70,5150,7400,2050,4150,9318,8962,0
800,1,0,199.0,181.0,212.0,181.0,5206,3258,3527,2407,1679,851,3777,810,2557,543,1220,267,91,70,6400,7500,2050,4150,9368,8962,0
807,1,0,181.5,169.0,204.0,181.0,5111,2882,3499,1987,1612,895,4222,748,2822,523,1400,225,91,70,5725,6150,2175,4150,11718,10612,0
814,1,0,192.5,160.0,204.0,181.0,5061,2737,3471,1819,1590,918,3313,642,1942,438,1371,204,91,70,5325,5350,2175,4150,12468,11862,0
821,1,0,190.5,152.0,204.0,181.0,5089,2961,3499,2043,1590,918,3799,206,2232,148,1567,58,91,70,4975,4375,2175,4150,12968,12837,0
829,1,0,198.5,157.0,204.0,181.0,5139,3034,3527,2183,1612,851,3799,292,2132,138,1667,154,91,70,6625,4725,2175,4150,12968,12837,0
836,1,0,192.0,150.0,204.0,181.0,4943,2423,3331,1595,1612,828,4070,591,2207,333,1863,258,81,69,6700,4425,2175,4150,13518,13687,0
843,1,0,199.0,155.0,204.0,181.0,4613,2614,2911,1763,1702,851,4006,268,2147,23,1859,245,81,71,6800,4600,2175,4150,13668,14387,0
850,1,0,199.0,156.0,204.0,181.0,4506,2922,2827,1959,1679,963,4524,478,2477,113,2047,365,87,71,7200,5250,2175,4150,13668,14387,0
857,1,0,199.0,162.0,204.0,196.0,4187,3034,2575,2071,1612,963,3557,289,2047,58,1510,231,87,74,7200,5400,2175,4150,13668,14387,0
864,1,0,199.0,164.0,204.0,196.0,4198,2597,2631,1567,1567,1030,3329,314,1727,88,1602,226,85,74,7200,5600,2175,4150,13668,14387,0
871,1,0,200.0,168.0,204.0,196.0,4221,2524,2631,1539,1590,985,3519,391,1842,103,1677,288,85,76,8750,6000,2175,4150,13793,14387,0
879,1,0,191.0,166.0,204.0,196.0,4439,2686,2827,1679,1612,1007,4079,361,2202,128,1877,233,87,76,8350,5900,2175,4150,14193,14487,0
886,1,0,199.5,154.0,204.0,196.0,4826,2608,3191,1511,1635,1097,4011,527,1942,183,2069,344,87,70,8175,5850,2425,4150,14418,15387,0
893,1,0,177.0,146.0,204.0,196.0,4674,2446,2995,1483,1679,963,4492,663,2227,228,2265,435,82,71,6600,5800,2425,4150,15868,16012,0
7,1,1,13.0,13.0,14.0,14.0,293,293,293,293,0,0,35,35,35,35,0,0,12,12,0,0,0,0,0,0,0
14,1,1,13.0,13.0,14.0,14.0,643,615,643,615,0,0,15,10,15,10,0,0,13,13,0,0,0,0,0,0,0
21,1,1,14.0,14.0,14.0,14.0,727,699,727,699,0,0,40,35,40,35,0,0,13,13,0,0,0,0,0,0,0
29,1,1,14.0,14.0,14.0,14.0,727,727,727,727,0,0,130,135,130,135,0,0,13,13,0,0,0,0,0,0,0
36,1,1,16.0,16.0,22.0,22.0,755,755,755,755,0,0,130,125,130,125,0,0,14,14,0,0,0,0,0,0,0
43,1,1,16.0,16.0,22.0,22.0,811,755,811,755,0,0,215,210,215,210,0,0,14,14,0,0,0,0,0,0,0
50,1,1,16.0,15.0,22.0,22.0,727,755,727,755,0,0,300,5,300,5,0,0,16,15,0,0,0,0,0,0,0
57,1,1,17.0,17.0,22.0,22.0,839,895,839,895,0,0,10,15,10,15,0,0,15,15,0,0,0,0,0,0,0
64,1,1,18.0,18.0,22.0,22.0,867,839,867,839,0,0,65,55,65,55,0,0,15,15,0,0,0,0,0,0,0
71,1,1,17.0,17.0,22.0,22.0,867,895,867,895,0,0,135,140,135,140,0,0,16,16,0,0,0,0,0,0,0
79,1,1,17.0,16.0,22.0,22.0,923,867,923,867,0,0,0,45,0,45,0,0,16,16,0,0,0,0,0,0,0
86,1,1,18.0,18.0,22.0,22.0,867,923,867,923,0,0,50,55,50,55,0,0,16,16,0,0,0,0,0,0,0
93,1,1,19.0,19.0,22.0,22.0,923,895,923,895,0,0,105,115,105,115,0,0,17,17,0,0,0,0,0,0,0
100,1,1,20.0,20.0,22.0,22.0,995,934,951,867,44,67,183,177,175,165,8,12,18,18,0,0,0,0,0,0,0
107,1,1,20.0,20.0,22.0,22.0,1006,1029,895,895,111,134,294,307,270,275,24,32,19,19,0,0,0,0,0,0,0
114,1,1,21.0,21.0,22.0,22.0,1107,1023,951,867,156,156,384,377,340,325,44,52,20,20,0,0,0,0,0,0,0
121,1,1,21.0,21.0,22.0,28.0,1051,1051,895,895,156,156,404,507,340,435,64,72,20,20,0,0,0,0,0,0,0
129,1,1,26.0,26.0,28.0,28.0,1163,1102,1007,923,156,179,199,197,115,105,84,92,21,21,0,0,250,250,0,0,0
136,1,1,28.0,28.0,28.0,28.0,1102,1079,923,923,179,156,24,28,20,20,4,8,21,21,0,0,250,250,0,0,0
143,1,1,28.0,29.0,36.0,36.0,1225,1118,1091,1007,134,111,171,110,155,90,16,20,21,21,50,50,250,250,0,0,0
150,1,1,30.0,30.0,36.0,36.0,1174,1174,1063,1063,111,111,207,211,175,175,32,36,23,23,50,50,250,250,0,0,0
157,1,1,32.0,30.0,36.0,36.0,1309,1197,1175,1063,134,134,273,352,225,300,48,52,24,25,50,50,250,250,0,0,0
164,1,1,31.0,31.0,36.0,36.0,1309,1281,1175,1147,134,134,124,113,60,45,64,68,23,24,400,350,250,250,0,0,0
171,1,1,31.0,31.0,36.0,36.0,1337,1309,1203,1175,134,134,75,74,45,40,30,34,24,23,400,350,250,250,0,0,0
179,1,1,32.0,32.0,36.0,36.0,1314,1342,1203,1231,111,111,87,76,45,30,42,46,25,25,400,350,250,250,0,0,0
186,1,1,33.0,33.0,36.0,36.0,1421,1337,1287,1203,134,134,203,192,145,130,58,62,25,27,400,350,250,250,0,0,0
193,1,1,36.0,36.0,44.0,36.0,1426,1477,1315,1343,111,134,175,223,105,145,70,78,27,27,400,350,250,250,0,0,0
200,1,1,40.0,41.0,44.0,44.0,1477,1510,1343,1399,134,111,160,155,70,65,90,90,27,28,400,400,250,250,0,0,0
207,1,1,42.0,41.0,44.0,44.0,1555,1611,1399,1455,156,156,135,240,25,130,110,110,27,29,450,450,250,250,0,0,0
214,1,1,44.0,44.0,44.0,44.0,1583,1639,1427,1483,156,156,235,200,105,95,130,105,30,32,500,550,450,450,0,0,0
221,1,1,43.0,44.5,52.0,52.0,1611,1662,1455,1483,156,179,345,210,195,85,150,125,30,31,550,525,450,450,0,25,0
229,1,1,50.0,49.5,52.0,52.0,1634,1802,1455,1623,179,179,200,170,30,25,170,145,32,32,700,575,450,450,0,50,0
236,1,1,52.0,51.5,58.0,58.0,1779,1807,1623,1651,156,156,241,296,55,135,186,161,31,36,700,575,450,450,0,50,0
243,1,1,52.0,54.5,58.0,58.0,1779,1779,1623,1623,156,156,356,246,150,65,206,181,37,39,750,575,450,450,0,50,0
250,1,1,52.0,56.5,58.0,58.0,1835,1863,1679,1707,156,156,171,181,45,80,126,101,39,42,750,725,575,575,0,50,0
257,1,1,54.0,57.5,66.0,66.0,1970,1891,1791,1735,179,156,315,236,165,115,150,121,39,45,750,725,575,575,0,50,0
264,1,1,59.0,57.0,66.0,66.0,1970,2199,1679,2043,291,156,310,266,120,125,190,141,41,44,750,700,575,575,0,75,0
271,1,1,64.0,59.0,66.0,74.0,2182,2362,1847,2183,335,179,320,366,90,205,230,161,42,44,750,700,575,575,0,75,0
279,1,1,65.5,62.0,66.0,74.0,2317,2586,1959,2407,358,179,195,181,75,100,120,81,42,47,725,700,575,575,25,75,0
286,1,1,65.5,63.0,66.0,74.0,2322,2468,1987,2267,335,201,271,365,115,285,156,80,42,47,1125,800,775,575,25,75,0
293,1,1,65.0,62.5,66.0,82.0,2384,2586,2071,2295,313,291,447,481,255,415,192,66,42,50,1600,775,775,575,100,100,0
300,1,1,61.5,61.5,74.0,82.0,2412,2552,2099,2239,313,313,687,592,455,448,232,144,42,51,1275,575,775,575,275,324,0
307,1,1,60.5,67.0,82.0,90.0,2384,2384,2071,2071,313,313,822,222,550,188,272,34,42,46,1025,400,775,775,450,749,0
314,1,1,75.5,68.0,90.0,98.0,2384,2132,2071,1707,313,425,112,147,25,103,87,44,42,45,1075,550,775,775,450,749,0
321,1,1,78.5,69.0,90.0,92.0,2457,2227,2099,1735,358,492,137,152,60,48,77,104,47,46,1225,550,775,775,450,1099,0
329,1,1,74.0,68.0,90.0,92.0,2429,2250,2071,1735,358,515,332,428,215,268,117,160,47,49,1300,1100,775,775,675,1149,0
336,1,1,82.5,68.0,90.0,108.0,2468,2395,2155,1903,313,492,169,314,95,148,74,166,50,49,1525,1100,775,1025,775,1149,0
343,1,1,81.5,66.0,90.0,116.0,2608,2412,2295,1875,313,537,394,157,280,148,114,9,48,47,1525,1100,775,1025,775,1149,0
350,1,1,87.0,71.0,98.0,116.0,2664,2502,2351,1875,313,627,409,203,280,118,129,85,51,47,1800,1200,775,1025,800,1149,0
357,1,1,95.0,79.0,98.0,116.0,2664,2558,2351,1931,313,627,239,123,170,58,69,65,52,49,1800,1250,775,1025,800,1149,0
364,1,1,97.0,82.0,98.0,116.0,2860,2552,2547,1903,313,649,389,223,305,78,84,145,56,52,1900,1200,775,1025,800,1199,0
371,1,1,97.0,84.0,98.0,116.0,2905,2630,2435,1959,470,671,429,439,385,218,44,221,56,52,2300,1200,1025,1025,800,1199,0
379,1,1,101.0,85.0,106.0,116.0,2983,2546,2379,1875,604,671,453,280,409,133,44,147,56,57,2300,1600,1025,1025,824,1199,0
386,1,1,105.0,86.5,122.0,116.0,3101,2580,2519,1931,582,649,571,336,534,113,37,223,56,58,2400,1575,1025,1025,824,1224,0
393,1,1,113.0,86.5,130.0,124.0,3129,2446,2547,1819,582,627,448,623,439,328,9,295,56,59,2400,1575,1025,1025,824,1224,0
400,1,1,117.0,86.5,130.0,124.0,3162,2558,2603,1931,559,627,635,943,604,568,31,375,56,59,2600,1575,1025,1025,824,1224,0
407,1,1,121.0,86.5,138.0,132.0,3179,2614,2575,1987,604,627,716,1258,659,803,57,455,56,59,3000,1575,1025,1025,824,1224,0
414,1,1,126.0,96.5,138.0,138.0,3230,2692,2603,2043,627,649,568,589,514,558,54,31,55,59,3200,1575,1025,1475,824,1224,0
421,1,1,130.0,107.5,138.0,138.0,3123,2882,2519,2211,604,671,431,185,359,153,72,32,55,57,3400,1725,1025,1475,824,1224,0
429,1,1,137.0,111.5,146.0,138.0,3157,2938,2575,2267,582,671,404,221,364,163,40,58,55,62,3750,1725,1025,1475,874,1224,0
436,1,1,143.0,113.5,162.0,138.0,3112,3062,2463,2435,649,627,378,453,329,373,49,80,55,62,3950,1725,1025,1475,874,1224,0
443,1,1,149.0,116.5,186.0,146.0,3006,3062,2267,2435,739,627,430,663,364,528,66,135,55,62,4350,3025,1025,1475,874,1224,0
450,1,1,155.0,120.5,194.0,154.0,3196,3123,2435,2295,761,828,418,664,364,488,54,176,55,60,4350,3225,1025,1475,974,1324,0
457,1,1,160.5,131.5,194.0,154.0,3106,2782,2323,1931,783,851,379,379,329,253,50,126,55,61,4475,3275,1025,1475,1099,1474,0
464,1,1,160.5,121.5,194.0,162.0,3106,2518,2323,1735,783,783,442,586,379,393,63,193,55,59,4475,3125,1025,1475,1399,2124,0
471,1,1,162.5,99.5,194.0,162.0,3134,1970,2351,1231,783,739,115,276,64,128,51,148,55,49,4275,2025,1025,1475,1899,3724,0
479,1,1,146.5,75.0,194.0,162.0,3090,1370,2351,811,739,559,488,231,424,73,64,158,55,23,3775,2450,1025,1475,2799,5124,0
486,1,1,146.5,57.0,194.0,162.0,3118,1158,2379,643,739,515,255,265,249,68,6,197,55,23,3575,1650,1025,1475,3399,6224,0
7,2,2,13.0,13.0,15.0,15.0,335,293,335,293,0,0,40,35,40,35,0,0,12,12,0,0,0,0,0,0,0
14,2,2,14.0,14.0,15.0,15.0,671,671,671,671,0,0,70,70,70,70,0,0,13,13,0,0,0,0,0,0,0
21,2,2,14.0,14.0,15.0,15.0,699,699,699,699,0,0,50,50,50,50,0,0,13,13,0,0,0,0,0,0,0
29,2,2,15.0,15.0,15.0,15.0,727,727,727,727,0,0,100,85,100,85,0,0,14,14,0,0,0,0,0,0,0
36,2,2,15.0,15.0,23.0,23.0,839,783,839,783,0,0,150,135,150,135,0,0,14,14,0,0,0,0,0,0,0
43,2,2,16.0,16.0,23.0,23.0,811,783,811,783,0,0,40,25,40,25,0,0,15,15,0,0,0,0,0,0,0
50,2,2,17.0,17.0,23.0,23.0,923,811,923,811,0,0,25,45,25,45,0,0,16,16,0,0,0,0,0,0,0
57,2,2,18.0,18.0,23.0,23.0,895,811,895,811,0,0,55,25,55,25,0,0,17,17,0,0,0,0,0,0,0
64,2,2,19.0,19.0,23.0,23.0,979,895,979,895,0,0,120,80,120,80,0,0,18,18,0,0,0,0,0,0,0
71,2,2,20.0,19.0,23.0,23.0,973,923,951,923,22,0,34,135,30,135,4,0,19,18,0,0,0,0,0,0,0
79,2,2,20.0,20.0,23.0,23.0,1062,867,951,867,111,0,110,30,90,30,20,0,19,19,0,0,0,0,0,0,0
86,2,2,21.0,21.0,23.0,23.0,995,939,839,895,156,44,71,153,35,145,36,8,20,20,0,0,150,150,0,0,0
93,2,2,22.0,22.0,23.0,23.0,1040,962,839,783,201,179,149,72,85,40,64,32,21,21,0,0,150,150,0,0,0
100,2,2,22.0,22.0,23.0,23.0,1068,1062,867,839,201,223,133,105,45,45,88,60,21,21,0,0,150,150,0,0,0
107,2,2,23.0,23.0,23.0,23.0,1163,1096,895,895,268,201,273,194,145,110,128,84,22,22,0,0,150,150,0,0,0
114,2,2,24.0,23.0,31.0,23.0,1096,1051,783,783,313,268,354,275,190,155,164,120,23,23,0,0,300,150,0,0,0
121,2,2,28.0,24.0,31.0,31.0,1174,1130,839,839,335,291,69,411,65,255,4,156,23,23,0,0,450,150,0,0,0
129,2,2,29.0,28.0,31.0,31.0,1230,1152,895,839,335,313,169,106,125,60,44,46,24,23,0,0,450,450,0,0,0
136,2,2,29.0,28.0,31.0,31.0,1264,1208,951,895,313,313,215,251,135,165,80,86,24,24,0,0,450,450,0,0,0
143,2,2,29.0,29.0,31.0,31.0,1264,1253,951,895,313,358,355,241,235,115,120,126,25,24,0,0,450,450,0,0,0
150,2,2,33.0,29.0,39.0,31.0,1230,1225,895,867,335,358,175,86,165,70,10,16,25,24,325,0,450,450,0,0,0
157,2,2,33.0,29.0,39.0,39.0,1314,1208,979,895,335,313,325,223,275,175,50,48,25,25,325,350,450,450,0,0,0
164,2,2,33.0,34.0,39.0,39.0,1264,1236,951,923,313,313,481,74,395,40,86,34,25,25,325,350,450,450,0,0,0
171,2,2,34.0,34.0,39.0,39.0,1286,1264,951,951,335,313,176,229,50,155,126,74,25,25,325,350,450,450,0,0,0
179,2,2,36.0,34.0,39.0,39.0,1286,1292,951,979,335,313,156,389,40,275,116,114,25,26,650,350,450,450,0,0,0
186,2,2,38.0,34.0,39.0,39.0,1264,1342,951,1007,313,335,162,549,110,395,52,154,26,26,650,350,450,450,0,0,0
193,2,2,39.0,34.0,39.0,39.0,1292,1337,979,979,313,358,167,299,75,105,92,194,26,26,650,600,450,750,0,0,0
200,2,2,39.0,38.0,39.0,39.0,1342,1342,1007,1007,335,335,277,105,145,25,132,80,26,26,650,600,450,750,0,0,0
207,2,2,40.0,38.0,47.0,39.0,1270,1376,979,1063,291,313,329,266,165,150,164,116,27,26,975,600,450,750,0,0,0
214,2,2,40.0,39.0,47.0,39.0,1348,1404,1035,1091,313,313,439,276,235,120,204,156,27,27,975,600,450,750,0,0,0
221,2,2,39.0,37.0,47.0,39.0,1398,1348,1063,1035,335,313,504,436,260,240,244,196,28,27,825,425,450,750,150,175,0
229,2,2,41.0,38.0,47.0,47.0,1426,1348,1091,1035,335,313,319,301,135,215,184,86,29,28,675,550,450,750,300,350,0
236,2,2,40.0,38.0,47.0,47.0,1404,1393,1091,1035,313,358,510,366,290,240,220,126,29,28,875,550,550,750,450,350,0
243,2,2,41.0,42.0,62.0,47.0,1454,1477,1119,1119,335,358,580,196,320,130,260,66,29,28,875,900,550,750,450,350,0
250,2,2,47.0,42.0,62.0,47.0,1454,1348,1119,1035,335,313,350,248,150,150,200,98,31,28,875,900,550,750,450,350,0
257,2,2,48.0,42.0,62.0,47.0,956,1376,643,1063,313,313,381,418,145,280,236,138,32,28,1225,900,550,750,450,350,0
264,2,2,52.0,46.0,62.0,62.0,1208,1376,895,1063,313,313,186,238,10,160,176,78,33,28,1225,1250,550,750,450,350,0
271,2,2,51.0,47.0,62.0,62.0,1454,1348,1119,1035,335,313,316,358,100,240,216,118,33,28,1225,1550,550,750,450,450,0
279,2,2,47.0,45.0,62.0,62.0,1426,1348,1091,1035,335,313,491,178,235,120,256,58,33,29,1225,1025,550,750,800,975,0
286,2,2,47.0,43.0,62.0,62.0,1460,1393,1147,1035,313,358,567,298,275,200,292,98,33,29,1050,1075,550,850,975,1275,0
293,2,2,47.0,41.0,62.0,54.0,1152,1398,839,1063,313,335,688,464,360,330,328,134,33,29,1050,900,550,850,975,1550,0
300,2,2,50.0,41.0,62.0,54.0,519,1348,251,1035,268,313,295,630,35,460,260,170,34,30,1225,900,650,850,1200,1550,0
307,2,2,50.0,45.0,62.0,54.0,967,1432,699,1119,268,313,427,355,135,245,292,110,34,30,1225,1125,650,850,1200,1675,0
314,2,2,51.0,43.0,62.0,54.0,1225,1432,979,1119,246,313,534,530,210,380,324,150,36,30,1225,1000,650,850,1200,1800,0
321,2,2,55.0,45.0,62.0,54.0,1359,1074,1091,783,268,291,360,466,100,330,260,136,36,32,1225,1000,650,850,1200,1800,0
329,2,2,56.0,45.0,62.0,54.0,1359,710,1091,419,268,291,467,382,175,260,292,122,37,32,1225,1175,550,850,1200,1975,0
336,2,2,57.0,46.0,62.0,54.0,1415,760,1147,447,268,313,584,373,260,215,324,158,37,31,1575,1175,550,850,1200,2025,0
343,2,2,57.0,48.0,62.0,54.0,1891,855,1623,587,268,268,581,306,325,170,256,136,39,33,1575,1175,550,850,1200,2025,0
350,2,2,54.0,45.0,62.0,54.0,1970,1135,1679,867,291,268,758,272,470,150,288,122,39,32,1225,1000,550,850,1550,2425,0
357,2,2,59.0,44.0,62.0,54.0,2031,855,1763,587,268,268,600,379,380,225,220,154,39,31,1225,1175,550,850,1550,2475,0
364,2,2,58.0,44.0,62.0,54.0,2065,1247,1819,979,246,268,803,355,555,165,248,190,40,31,1400,1000,550,850,1725,2650,0
371,2,2,58.0,47.0,62.0,54.0,1774,1690,1595,1399,179,291,193,186,25,110,168,76,41,33,1400,1000,550,850,1725,2650,0
379,2,2,58.0,47.0,62.0,54.0,1796,1684,1595,1371,201,313,411,282,215,170,196,112,42,33,1400,1175,800,850,1725,2650,0
386,2,2,54.0,45.0,62.0,54.0,1869,1690,1623,1399,246,291,629,324,405,230,224,94,42,34,1050,1000,800,850,2075,3000,0
393,2,2,60.0,47.0,62.0,62.0,1953,1802,1707,1511,246,291,342,351,190,225,152,126,42,34,1050,1000,800,850,2075,3000,0
400,2,2,60.0,51.0,62.0,62.0,1981,1919,1735,1651,246,268,275,298,245,190,30,108,42,36,1400,1175,800,850,2075,3000,0
407,2,2,62.0,51.0,62.0,62.0,2126,1908,1791,1595,335,313,415,483,345,335,70,148,44,36,1400,1175,800,1100,2075,3000,0
414,2,2,62.0,52.0,62.0,62.0,2076,2014,1763,1679,313,335,461,348,355,310,106,38,45,38,1400,1175,800,1100,2075,3000,0
421,2,2,62.0,52.0,62.0,62.0,2255,1958,1875,1623,380,335,578,573,420,495,158,78,46,38,1400,1175,1200,1200,2075,3000,0
429,2,2,62.0,55.0,62.0,62.0,2216,2121,1791,1763,425,358,796,303,590,235,206,68,46,39,1400,1350,1200,1200,2075,3000,0
436,2,2,69.0,58.0,70.0,62.0,2054,1958,1651,1623,403,335,434,304,355,250,79,54,46,39,1400,1525,1200,1200,2075,3000,0
443,2,2,74.0,58.0,93.0,62.0,2311,2143,1819,1763,492,380,276,162,195,60,81,102,48,40,1750,1525,1200,1200,2075,3000,0
450,2,2,74.0,60.0,93.0,62.0,2278,2216,1763,1791,515,425,500,338,355,180,145,158,48,41,1925,1525,1200,1200,2075,3000,0
457,2,2,77.0,62.0,101.0,62.0,2496,2244,1959,1819,537,425,650,425,445,265,205,160,51,41,2025,1525,1200,1200,2075,3000,0
464,2,2,80.0,62.0,109.0,62.0,2675,2216,2183,1791,492,425,571,696,410,480,161,216,51,43,2375,1700,1300,1350,2175,3000,0
471,2,2,84.0,61.0,109.0,62.0,2675,2367,2183,1875,492,492,611,797,465,575,146,222,53,43,2375,1400,1300,1350,2175,3300,0
479,2,2,84.0,62.0,117.0,62.0,2647,2423,2155,1931,492,492,342,558,140,380,202,178,53,43,2375,1575,1300,1500,2175,3300,0
486,2,2,84.0,62.0,117.0,62.0,2602,2350,2155,1903,447,447,639,816,385,590,254,226,56,44,2475,1575,1300,1500,2175,3300,0
493,2,2,90.0,68.0,117.0,70.0,2664,2339,2239,1847,425,492,281,346,125,160,156,186,56,44,3000,1575,1300,1500,2175,3300,0
500,2,2,90.0,68.0,117.0,70.0,2888,2233,2463,1763,425,470,518,447,310,205,208,242,56,44,3000,1925,1300,1500,2175,3300,0
507,2,2,90.0,70.0,117.0,70.0,2793,2233,2323,1763,470,470,443,317,175,115,268,202,56,46,3000,1925,1300,1500,2175,3300,0
514,2,2,96.0,70.0,117.0,70.0,2899,2210,2407,1651,492,559,264,387,90,105,174,282,56,46,3000,1925,1300,1500,2175,3300,0
521,2,2,96.0,75.0,125.0,85.0,2927,2328,2435,1679,492,649,434,402,200,90,234,312,56,48,3525,2100,1300,1500,2175,3300,0
529,2,2,98.0,81.0,125.0,93.0,2843,2384,2351,1735,492,649,465,337,275,45,190,292,56,51,3525,2275,1900,1650,2175,3300,0
536,2,2,99.0,82.0,125.0,93.0,2821,2630,2351,1959,470,671,651,468,405,100,246,368,58,51,3525,2450,2050,1650,2175,3300,0
543,2,2,108.0,84.0,133.0,93.0,2793,2709,2323,2015,470,694,236,603,130,205,106,398,58,54,3525,2450,2050,1650,2175,3300,0
550,2,2,104.0,80.0,133.0,85.0,2927,2670,2323,2043,604,627,591,931,405,465,186,466,59,54,3175,2275,2050,1900,2525,3750,0
557,2,2,106.0,69.0,141.0,85.0,2922,2429,2295,1847,627,582,828,1208,570,670,258,538,60,49,3875,1750,2050,1900,2525,4525,0
564,2,2,118.0,69.0,141.0,85.0,3000,2306,2351,1791,649,515,153,1387,115,785,38,602,60,49,3875,1750,2050,1900,2525,4525,0
571,2,2,119.0,69.0,141.0,100.0,2994,2378,2323,1819,671,559,443,1290,325,720,118,570,62,45,3875,1750,2050,1900,2525,4725,0
579,2,2,121.0,72.0,156.0,108.0,2916,2440,2267,1903,649,537,439,1314,245,730,194,584,62,45,4925,1925,2050,1900,2525,4725,0
586,2,2,123.0,77.0,156.0,108.0,2972,2597,2323,2015,649,582,695,1262,425,710,270,552,65,46,4925,1925,2050,2050,2525,4725,0
593,2,2,134.0,77.0,156.0,93.0,3190,2630,2519,2071,671,559,170,1061,70,595,100,466,66,45,4925,2275,2050,2050,2525,5175,0
599,2,2,134.0,70.0,156.0,93.0,3190,2485,2519,1903,671,582,170,1307,70,785,100,522,66,44,4925,1775,2050,2050,2525,6100,0
7,1,0,13.0,13.0,14.0,15.0,251,251,251,251,0,0,30,30,30,30,0,0,12,12,0,0,0,0,0,0,1
14,1,0,13.0,14.0,14.0,15.0,671,615,671,615,0,0,20,60,20,60,0,0,12,13,0,0,0,0,0,0,1
21,1,0,14.0,14.0,14.0,15.0,699,615,699,615,0,0,40,20,40,20,0,0,13,13,0,0,0,0,0,0,1
29,1,0,14.0,15.0,14.0,15.0,671,587,671,587,0,0,125,45,125,45,0,0,13,14,0,0,0,0,0,0,1
36,1,0,16.0,15.0,22.0,15.0,699,643,699,643,0,0,120,130,120,130,0,0,14,14,0,0,0,0,0,0,1
43,1,0,16.0,15.0,22.0,23.0,811,671,811,671,0,0,215,55,215,55,0,0,14,15,0,0,0,0,0,0,1
50,1,0,16.0,15.0,22.0,23.0,755,699,755,699,0,0,300,135,300,135,0,0,16,15,0,0,0,0,0,0,1
57,1,0,17.0,16.0,22.0,23.0,839,727,839,727,0,0,5,25,5,25,0,0,15,15,0,0,0,0,0,0,1
64,1,0,18.0,16.0,22.0,23.0,839,755,839,755,0,0,55,70,55,70,0,0,15,15,0,0,0,0,0,0,1
71,1,0,18.0,17.0,22.0,23.0,867,783,867,783,0,0,160,75,160,75,0,0,17,16,0,0,0,0,0,0,1
79,1,0,17.0,17.0,22.0,23.0,867,727,867,727,0,0,60,115,60,115,0,0,17,16,0,0,0,0,0,0,1
86,1,0,19.0,18.0,22.0,23.0,783,727,783,727,0,0,60,210,60,210,0,0,17,17,0,0,0,0,0,0,1
93,1,0,19.0,19.0,22.0,23.0,783,783,783,783,0,0,145,100,145,100,0,0,18,18,0,0,0,150,0,0,1
100,1,0,20.0,19.0,22.0,23.0,839,844,839,755,0,89,200,211,200,195,0,16,19,18,0,0,0,150,0,0,1
107,1,0,20.0,19.0,22.0,23.0,839,939,839,783,0,156,305,316,305,280,0,36,20,18,0,50,0,150,0,0,1
114,1,0,20.0,20.0,22.0,23.0,923,883,923,727,0,156,410,321,410,315,0,6,20,18,0,50,0,150,0,0,1
121,1,0,20.0,21.0,22.0,23.0,783,878,783,699,0,179,500,84,500,58,0,26,20,18,0,50,250,150,0,0,1
129,1,0,28.0,21.0,28.0,23.0,867,1018,867,839,0,179,115,64,115,18,0,46,20,18,0,50,250,150,0,0,1
136,1,0,27.0,21.0,28.0,23.0,811,1163,811,1007,0,156,180,180,180,118,0,62,19,19,0,0,250,150,0,50,1
143,1,0,28.0,22.0,28.0,23.0,839,1191,839,1035,0,156,125,280,125,198,0,82,20,20,150,0,250,150,0,50,1
150,1,0,28.0,22.0,28.0,31.0,811,1219,811,1063,0,156,230,155,230,153,0,2,21,20,150,100,250,150,0,50,1
157,1,0,28.0,23.0,36.0,31.0,979,1247,979,1091,0,156,350,205,350,183,0,22,21,21,150,100,250,150,0,50,1
164,1,0,32.0,23.0,36.0,31.0,1062,1219,951,1063,111,156,295,340,275,298,20,42,21,21,450,100,250,150,0,50,1
171,1,0,34.0,24.0,36.0,31.0,1079,1214,923,1035,156,179,320,495,280,433,40,62,25,22,450,100,250,150,0,50,1
179,1,0,34.0,23.0,36.0,31.0,1247,1158,1091,979,156,179,130,190,70,108,60,82,24,21,450,100,250,150,0,100,1
186,1,0,34.0,24.0,36.0,31.0,1354,1135,1175,979,179,156,290,326,210,228,80,98,26,22,450,100,250,150,0,100,1
193,1,0,35.5,25.0,36.0,31.0,1499,1135,1343,979,156,156,271,371,175,253,96,118,27,23,425,100,250,400,25,100,1
200,1,0,35.0,25.0,36.0,31.0,1382,1303,1315,1147,67,156,230,346,230,258,0,88,27,23,400,100,250,400,50,100,1
207,1,0,36.0,26.0,36.0,31.0,1427,1303,1427,1147,0,156,210,246,210,238,0,8,29,24,400,100,250,400,50,100,1
214,1,0,41.0,26.0,44.0,46.0,1679,1438,1679,1259,0,179,160,211,160,183,0,28,30,24,400,100,250,400,50,100,1
221,1,0,43.0,27.0,44.0,46.0,1707,1410,1707,1231,0,179,260,316,260,268,0,48,30,25,400,100,250,400,50,100,1
229,1,0,44.0,28.0,52.0,46.0,1735,1320,1735,1119,0,201,415,485,415,413,0,72,33,26,400,100,250,400,50,100,1
236,1,0,50.0,33.0,52.0,46.0,1807,1438,1763,1147,44,291,288,375,280,263,8,112,36,26,400,100,250,500,50,100,1
243,1,0,50.0,34.0,52.0,46.0,1947,1656,1791,1343,156,313,283,520,255,393,28,127,38,27,400,100,250,750,50,100,1
250,1,0,52.0,36.0,58.0,61.0,2003,1796,1847,1483,156,313,513,475,465,308,48,167,40,28,550,100,250,750,50,100,1
257,1,0,54.0,41.0,58.0,61.0,2003,1790,1847,1455,156,335,458,285,390,78,68,207,40,29,550,300,250,750,50,100,1
264,1,0,59.0,42.0,66.0,61.0,1914,2009,1735,1651,179,358,415,535,327,288,88,247,42,31,550,350,250,825,50,100,1
271,1,0,59.0,45.0,74.0,61.0,2283,2042,2127,1707,156,335,541,411,437,328,104,83,41,32,700,350,250,825,100,100,1
279,1,0,61.0,50.0,82.0,61.0,2087,2160,1931,1847,156,313,521,307,397,213,124,94,46,32,700,450,250,825,100,200,1
286,1,0,66.0,51.0,90.0,69.0,2171,2440,2015,2127,156,313,251,262,107,228,144,34,47,33,850,450,250,825,100,200,1
293,1,0,68.0,52.0,98.0,69.0,2283,2636,2127,2323,156,313,77,447,17,373,60,74,47,35,850,450,250,825,100,200,1
300,1,0,70.0,54.0,90.0,69.0,2591,2468,2435,2155,156,313,212,672,132,558,80,114,50,36,850,650,250,900,200,200,1
307,1,0,73.0,55.0,90.0,77.0,2619,2294,2463,1959,156,335,162,257,112,153,50,104,51,38,850,650,250,900,200,200,1
314,1,0,77.0,56.0,90.0,77.0,2703,2518,2547,2183,156,335,302,238,232,148,70,90,51,38,1050,1000,250,900,200,200,1
321,1,0,82.0,58.0,90.0,77.0,2787,2608,2631,2295,156,313,177,334,87,208,90,126,53,39,1250,1000,250,900,200,200,1
329,1,0,84.0,61.0,90.0,77.0,2670,2580,2379,2267,291,313,137,439,7,273,130,166,53,41,1400,1000,250,900,200,200,1
336,1,0,85.0,62.0,90.0,85.0,2832,2636,2519,2323,313,313,318,44,152,38,166,6,56,42,1400,1000,250,1150,200,200,1
343,1,0,90.0,65.0,90.0,85.0,3056,2804,2743,2491,313,313,744,254,538,208,206,46,63,45,1400,1050,250,1150,200,200,1
350,1,0,88.0,66.0,90.0,85.0,3252,2698,2939,2295,313,403,689,301,443,203,246,98,63,45,1400,1050,700,1550,200,200,1
357,1,0,88.0,72.0,90.0,85.0,3291,2726,2799,2211,492,515,762,177,448,73,314,104,65,48,1550,1050,700,1550,200,200,1
364,1,0,97.0,74.0,112.0,85.0,3364,2759,2715,2267,649,492,562,353,168,193,394,160,65,50,1550,1100,700,1550,200,200,1
371,1,0,102.0,79.0,136.0,93.0,3582,2849,2911,2379,671,470,448,205,128,93,320,112,65,51,1550,1100,700,1550,200,200,1
379,1,0,107.0,82.0,152.0,101.0,3829,2709,3135,2239,694,470,283,325,33,153,250,172,72,53,1550,1250,950,1850,200,200,1
386,1,0,112.0,85.0,152.0,101.0,3812,2905,3163,2435,649,470,270,330,48,148,222,182,74,54,1550,1250,950,1850,200,200,1
393,1,0,114.0,90.0,152.0,101.0,3790,3157,3163,2687,627,470,556,396,258,258,298,138,73,57,1750,1350,950,1950,250,200,1
400,1,0,109.0,97.0,152.0,101.0,3538,3448,2911,2911,627,537,631,504,253,298,378,206,69,59,1650,1500,950,1950,900,200,1
407,1,0,112.5,102.0,152.0,109.0,3476,3605,2827,3023,649,582,836,413,378,193,458,220,70,60,1875,1700,950,1950,925,200,1
414,1,0,112.0,104.0,152.0,109.0,3638,3521,2967,2939,671,582,981,436,443,248,538,188,77,62,2000,1700,950,1950,950,200,1
421,1,0,117.0,108.0,152.0,109.0,3946,3588,3275,2939,671,649,1117,326,503,258,614,68,80,63,1950,2150,950,2050,1000,200,1
429,1,0,121.5,115.0,152.0,125.0,4114,3504,3443,2855,671,649,993,557,303,438,690,119,80,66,1875,2350,950,2050,1075,200,1
436,1,0,124.5,115.0,152.0,125.0,4204,3314,3555,2687,649,627,954,138,363,43,591,95,79,66,2225,2500,950,2050,1075,200,1
443,1,0,134.5,121.0,152.0,125.0,4210,3342,3583,2715,627,627,805,274,213,103,592,171,79,67,2275,2500,950,2050,1075,200,1
450,1,0,134.5,127.0,152.0,133.0,4344,3134,3695,2463,649,671,1263,349,597,148,666,201,79,67,3000,2600,950,2050,1212,200,1
457,1,0,138.5,127.0,144.0,141.0,4372,3140,3723,2491,649,649,1143,720,572,443,571,277,79,67,3150,3000,950,2300,1562,200,1
464,1,0,138.5,129.0,136.0,149.0,4456,3246,3807,2575,649,671,1904,230,1257,48,647,182,80,69,3400,3250,950,2300,1437,250,1
471,1,0,124.5,121.0,136.0,149.0,4422,3381,3751,2575,671,806,2074,635,1372,353,702,282,80,68,3250,3100,950,2300,2087,600,1
479,1,0,129.5,126.0,136.0,149.0,4484,3487,3835,2659,649,828,2191,790,1417,458,774,332,80,68,3100,3100,950,2300,2237,600,1
486,1,0,136.5,132.0,152.0,149.0,4344,3689,3695,2883,649,806,1676,77,972,3,704,74,80,69,3150,3250,950,2750,2237,600,1
493,1,0,138.0,132.0,160.0,149.0,4322,4025,3695,3219,627,806,1857,363,1077,243,780,120,78,69,3525,3250,950,2750,2362,600,1
500,1,0,139.5,138.0,168.0,149.0,4176,4047,3527,3219,649,828,2207,499,1347,383,860,116,78,69,3650,3300,950,2750,2412,750,1
507,1,0,149.5,149.0,174.0,157.0,4316,3997,3667,3191,649,806,1167,240,752,153,415,87,78,69,3950,3650,950,2900,2412,750,1
514,1,0,151.5,151.0,174.0,157.0,4394,3806,3723,3023,671,783,1470,511,979,328,491,183,78,72,3900,3600,950,2900,2512,800,1
521,1,0,158.5,153.0,174.0,157.0,4226,4025,3555,3219,671,806,1496,407,979,328,517,79,78,72,4350,3800,950,3000,2512,800,1
529,1,0,158.5,165.0,174.0,165.0,4176,4002,3527,3219,649,783,2132,244,1539,148,593,96,78,72,4800,4800,950,3000,2387,800,1
536,1,0,163.0,165.0,174.0,180.0,4070,3067,3443,2351,627,716,2103,548,1434,368,669,180,77,72,4875,4600,1075,3000,2712,1000,1
543,1,0,163.0,163.0,174.0,188.0,3986,2255,3359,1539,627,716,2173,639,1449,371,724,268,77,70,4475,4700,1075,3000,3112,1250,1
550,1,0,170.0,172.0,174.0,188.0,4008,2563,3359,1847,649,716,1803,442,1099,165,704,277,77,71,4525,5325,1075,3000,3112,1250,1
557,1,0,174.0,172.0,174.0,188.0,3946,3179,3275,2463,671,716,1863,592,1179,281,684,311,77,73,5275,5225,1075,3000,3112,1450,1
564,1,0,172.0,171.0,174.0,188.0,3974,3521,3303,2715,671,806,2029,847,1269,436,760,411,76,74,5275,5425,1075,3000,3462,1550,1
571,1,0,173.5,163.0,174.0,188.0,4198,3605,3527,2799,671,806,2175,872,1339,511,836,361,76,75,5650,5250,1075,3000,3737,2100,1
579,1,0,170.5,175.0,174.0,188.0,4008,3750,3359,2967,649,783,1331,669,919,366,412,303,75,75,5700,5450,1075,3000,3837,2100,1
586,1,0,171.0,182.0,174.0,196.0,3958,3991,3331,3163,627,828,1017,419,729,191,288,228,75,75,5875,5450,1075,3000,4212,2100,1
593,1,0,167.0,182.0,190.0,196.0,4036,3902,3387,3051,649,851,1746,565,1226,391,520,174,75,75,6500,5450,1075,3000,4558,2100,1
600,1,0,150.5,170.0,198.0,204.0,4008,3745,3359,2939,649,806,1641,542,1041,351,600,191,75,75,4425,4900,1075,3000,5583,3400,1
607,1,0,157.0,176.0,198.0,204.0,4058,3918,3387,3135,671,783,1672,673,996,436,676,237,75,75,4550,5300,1075,3000,5758,3400,1
614,1,0,159.0,182.0,174.0,204.0,4114,3941,3443,3135,671,806,1012,164,756,106,256,58,75,75,5150,5650,1325,3000,6058,3400,1
621,1,0,170.0,189.0,166.0,204.0,4036,4081,3387,3275,649,806,679,319,476,261,203,58,75,75,5150,6200,1325,3000,6158,3400,1
629,1,0,164.5,190.0,166.0,204.0,4070,4058,3443,3275,627,783,1030,816,751,666,279,150,75,75,6075,6600,1325,3000,6583,3400,1
636,1,0,159.5,164.0,172.0,204.0,4014,4075,3387,3247,627,828,805,1291,446,1041,359,250,75,75,5175,5275,1325,3000,7383,4575,1
643,1,0,162.5,175.0,172.0,204.0,4036,4103,3387,3275,649,828,780,487,341,366,439,121,75,75,5175,5400,1325,3000,7383,4725,1
650,1,0,168.5,177.0,172.0,204.0,3974,3997,3303,3191,671,806,815,949,296,886,519,63,74,75,5625,5650,1325,3000,7483,4725,1
657,1,0,172.0,184.0,172.0,204.0,3918,4053,3247,3247,671,806,721,915,276,731,445,184,74,75,5850,5750,1325,3000,7608,4725,1
664,1,0,172.0,190.0,172.0,204.0,3694,3941,3023,3135,671,806,907,990,386,706,521,284,74,75,5900,6225,1325,3000,7658,4825,1
671,1,0,172.0,190.0,172.0,204.0,3868,3862,3219,3079,649,783,823,552,426,426,397,126,74,75,6850,6425,1325,3000,7708,4825,1
679,1,0,172.0,199.0,164.0,204.0,3762,3879,3135,3051,627,828,1189,412,716,261,473,151,74,75,6950,6900,1325,3000,7808,4825,1
686,1,0,167.0,193.0,188.0,204.0,3762,3986,3135,3135,627,851,1624,1013,1071,741,553,272,75,75,6850,7050,1675,3000,8083,5125,1
693,1,0,172.5,193.0,196.0,204.0,3812,3997,3163,3191,649,806,909,590,276,376,633,214,76,75,5425,6475,1675,3000,8933,5550,1
700,1,0,164.5,182.0,188.0,204.0,3778,3974,3107,3191,671,783,1220,676,511,566,709,110,76,75,4225,5875,1675,3000,9833,6650,1
707,1,0,169.5,173.0,182.0,204.0,3442,3941,2771,3135,671,806,1090,647,301,491,789,156,76,75,4875,5150,1675,3000,10283,7375,1
714,1,0,159.5,175.0,176.0,204.0,2916,3913,2267,3107,649,806,982,617,346,461,636,156,76,74,4425,5400,1675,3000,11208,7825,1
721,1,0,151.5,159.0,176.0,204.0,2922,3330,2295,2659,627,671,1013,938,301,706,712,232,76,56,3625,5675,1675,3000,11933,8900,1
729,1,0,155.5,164.0,176.0,180.0,3118,2860,2491,2211,627,649,918,968,126,706,792,262,76,55,4575,5925,1675,3000,11983,8950,1
736,1,0,152.0,172.0,176.0,172.0,3560,2910,2911,2239,649,671,978,723,431,581,547,142,75,55,4750,6675,1675,3000,12158,9050,1
743,1,0,150.0,161.0,176.0,179.0,3588,2412,2939,1763,649,649,808,890,181,676,627,214,75,57,3800,6225,1675,3000,12708,9950,1
750,1,0,149.0,154.0,168.0,171.0,3526,2278,2855,1651,671,627,1074,1166,371,876,703,290,75,54,3700,6075,1675,3000,13108,10400,1
757,1,0,146.5,161.0,168.0,171.0,3638,2356,2967,1707,671,649,760,1096,281,776,479,320,75,56,3825,6325,1675,3000,13433,10400,1
7,1,0,13.0,13.0,14.0,15.0,251,293,251,293,0,0,30,35,30,35,0,0,12,12,0,0,0,0,0,0,1
14,1,0,13.0,14.0,14.0,15.0,671,671,671,671,0,0,20,70,20,70,0,0,13,13,0,0,0,0,0,0,1
21,1,0,14.0,14.0,14.0,15.0,699,643,699,643,0,0,50,45,50,45,0,0,13,13,0,0,0,0,0,0,1
29,1,0,14.0,15.0,14.0,15.0,727,643,727,643,0,0,145,35,145,35,0,0,13,14,0,0,0,0,0,0,1
36,1,0,16.0,15.0,22.0,15.0,755,727,755,727,0,0,140,130,140,130,0,0,14,14,0,0,0,0,0,0,1
43,1,0,16.0,16.0,22.0,23.0,783,755,783,755,0,0,235,75,235,75,0,0,14,15,0,0,0,0,0,0,1
50,1,0,15.0,16.0,22.0,23.0,755,755,755,755,0,0,20,45,20,45,0,0,15,15,0,0,0,0,0,0,1
57,1,0,17.0,17.0,22.0,23.0,783,727,783,727,0,0,30,135,30,135,0,0,15,16,0,0,0,0,0,0,1
64,1,0,18.0,17.0,22.0,23.0,923,811,923,811,0,0,85,30,85,30,0,0,16,16,0,0,0,0,0,0,1
71,1,0,17.0,18.0,22.0,23.0,895,799,895,755,0,44,165,78,165,70,0,8,17,17,0,0,0,0,0,0,1
79,1,0,17.0,19.0,22.0,23.0,895,911,895,755,0,156,25,183,25,155,0,28,16,18,0,0,0,0,0,0,1
86,1,0,18.0,19.0,22.0,23.0,951,939,951,783,0,156,90,294,90,250,0,44,16,18,0,0,0,0,0,0,1
93,1,0,19.0,20.0,22.0,23.0,951,995,951,839,0,156,155,54,155,40,0,14,18,19,0,0,0,150,0,0,1
100,1,0,20.0,20.0,22.0,23.0,1018,995,951,839,67,156,227,169,215,135,12,34,18,19,0,0,0,150,0,0,1
107,1,0,20.0,21.0,22.0,23.0,1001,995,867,839,134,156,343,184,315,180,28,4,19,19,0,0,0,300,0,0,1
114,1,0,21.0,22.0,22.0,23.0,1079,1023,923,867,156,156,433,259,385,235,48,24,20,19,0,0,0,300,0,0,1
121,1,0,27.0,22.0,28.0,31.0,956,1074,867,895,89,179,146,379,90,335,56,44,20,19,0,100,250,300,0,0,1
129,1,0,27.0,24.0,28.0,31.0,995,1214,951,1035,44,179,275,374,215,360,60,14,21,20,0,100,250,300,0,0,1
136,1,0,28.0,24.0,28.0,31.0,1107,1219,1063,1063,44,156,273,135,205,105,68,30,21,20,0,100,250,300,0,0,1
143,1,0,28.0,26.0,28.0,31.0,1186,1331,1119,1175,67,156,416,205,340,155,76,50,21,21,100,200,250,300,0,0,1
150,1,0,28.0,26.0,36.0,31.0,1130,1303,1063,1147,67,156,199,235,115,165,84,70,20,21,150,200,250,300,0,0,1
157,1,0,29.0,27.0,36.0,31.0,1158,1359,1091,1203,67,156,292,400,200,310,92,90,21,22,450,350,250,300,0,0,1
164,1,0,30.0,28.0,36.0,31.0,1186,1382,1119,1203,67,179,290,260,190,250,100,10,22,23,400,350,250,300,50,0,1
171,1,0,32.0,28.0,36.0,31.0,1270,1432,1203,1231,67,201,38,369,30,335,8,34,22,23,400,350,250,300,50,0,1
179,1,0,33.0,29.0,36.0,31.0,1247,1354,1203,1063,44,291,142,390,130,345,12,45,23,24,400,350,250,300,50,0,1
186,1,0,35.0,29.0,36.0,31.0,1298,1180,1231,867,67,313,167,425,147,390,20,35,23,24,450,350,250,300,50,0,1
193,1,0,40.0,30.0,44.0,31.0,1410,1152,1343,839,67,313,85,170,57,95,28,75,23,25,500,350,250,300,50,0,1
200,1,0,40.0,31.0,44.0,31.0,1326,1482,1259,1147,67,335,188,120,152,105,36,15,26,26,600,350,250,375,100,0,1
207,1,0,43.0,31.0,44.0,46.0,1494,1538,1427,1203,67,335,66,145,22,90,44,55,31,26,600,350,250,375,100,0,1
214,1,0,44.0,32.0,44.0,46.0,1494,1622,1427,1287,67,335,199,181,147,140,52,41,31,27,600,350,250,625,100,0,1
221,1,0,48.0,34.0,50.0,46.0,1611,1678,1567,1343,44,335,98,266,42,185,56,81,31,27,600,350,250,725,150,0,1
229,1,0,51.0,32.0,58.0,46.0,1494,1656,1427,1343,67,313,116,462,52,345,64,117,32,27,600,200,250,725,150,200,1
236,1,0,54.0,36.0,58.0,46.0,1634,1684,1567,1371,67,313,179,102,107,45,72,57,32,28,600,200,250,725,150,200,1
243,1,0,56.0,38.0,58.0,46.0,1746,1908,1679,1595,67,313,132,182,52,85,80,97,35,29,900,250,250,725,150,200,1
250,1,0,58.0,40.0,58.0,46.0,1886,1930,1819,1595,67,335,165,357,77,220,88,137,38,30,900,350,250,825,150,200,1
257,1,0,61.0,46.0,66.0,46.0,2026,1986,1959,1651,67,335,103,188,7,15,96,173,38,32,1050,400,250,825,150,200,1
264,1,0,65.0,48.0,66.0,61.0,2031,1874,1987,1539,44,335,142,278,42,65,100,213,40,32,1050,400,250,825,150,200,1
271,1,0,69.0,51.0,74.0,69.0,2227,1964,2183,1651,44,313,220,279,112,130,108,149,41,34,1050,500,250,1075,150,200,1
279,1,0,71.0,58.0,82.0,69.0,2306,2048,2239,1735,67,313,298,194,182,5,116,189,45,34,1200,750,250,1075,150,200,1
286,1,0,76.0,60.0,82.0,69.0,2334,2188,2267,1875,67,313,126,269,52,40,74,229,49,35,1200,750,250,1075,150,200,1
293,1,0,76.0,62.0,90.0,69.0,2518,2294,2407,1959,111,335,167,219,77,50,90,169,52,36,1350,850,250,1075,150,200,1
300,1,0,78.0,64.0,90.0,69.0,2569,2462,2435,2127,134,335,223,369,117,160,106,209,52,38,1350,1250,250,1075,150,200,1
307,1,0,80.0,71.0,90.0,77.0,2703,2686,2547,2351,156,335,78,85,52,40,26,45,51,39,1350,1300,250,1075,150,200,1
314,1,0,85.5,74.0,98.0,77.0,2927,2434,2771,2099,156,335,128,170,82,85,46,85,55,39,1325,1400,375,1075,175,200,1
321,1,0,87.5,77.0,98.0,77.0,2955,2356,2799,2043,156,313,268,236,202,115,66,121,59,41,1475,1450,375,1075,175,200,1
329,1,0,86.5,77.0,98.0,77.0,2978,2524,2575,2211,403,313,268,61,142,50,126,11,58,42,1475,1650,500,1075,175,200,1
336,1,0,89.5,77.0,98.0,77.0,3118,2636,2603,2323,515,313,153,101,142,50,11,51,58,43,1675,1700,700,1075,175,200,1
343,1,0,94.5,85.0,98.0,85.0,3297,2770,2827,2435,470,335,35,386,22,295,13,91,61,43,1825,1950,700,1325,275,200,1
350,1,0,97.5,85.0,98.0,85.0,3235,2742,2743,2407,492,335,204,226,152,95,52,131,61,46,2175,1950,700,1325,300,200,1
357,1,0,99.5,82.0,106.0,85.0,3319,2658,2603,2323,716,335,165,292,17,125,148,167,61,46,2125,1700,950,1325,450,500,1
364,1,0,101.5,86.0,106.0,93.0,3297,2462,2491,2127,806,335,161,172,67,65,94,107,61,46,2325,1900,1200,1325,450,500,1
371,1,0,105.5,89.0,106.0,93.0,3487,2406,2659,1959,828,447,191,352,22,185,169,167,61,49,2325,1900,1200,1575,450,500,1
379,1,0,106.5,89.0,106.0,101.0,3459,2765,2631,2295,828,470,537,702,272,475,265,227,63,49,2625,1900,1200,1825,550,500,1
386,1,0,106.5,95.0,106.0,101.0,3521,2866,2715,2351,806,515,253,247,192,185,61,62,63,52,2675,2100,1200,1825,550,500,1
393,1,0,109.5,101.0,122.0,101.0,3465,3084,2659,2547,806,537,414,226,257,150,157,76,64,55,3125,2100,1200,1825,550,500,1
400,1,0,111.5,101.0,130.0,101.0,3571,3090,2743,2463,828,627,329,593,97,445,232,148,63,55,3125,2100,1200,1825,550,500,1
407,1,0,117.5,106.0,138.0,109.0,3437,3168,2631,2519,806,649,330,258,27,130,303,128,66,57,3125,2250,1200,1900,325,500,1
414,1,0,118.5,105.0,138.0,117.0,3493,3224,2687,2575,806,649,441,429,117,225,324,204,66,57,3075,2400,1200,1900,425,550,1
421,1,0,118.0,106.0,138.0,117.0,3655,3336,2827,2687,828,649,697,669,277,385,420,284,65,60,3000,2300,1200,1900,700,650,1
429,1,0,121.0,102.0,138.0,117.0,3627,3314,2799,2687,828,627,962,500,442,140,520,360,65,60,3450,2200,1200,1900,700,850,1
436,1,0,124.0,109.0,138.0,125.0,3689,3190,2883,2519,806,671,949,580,487,190,462,390,66,63,3750,2200,1200,1900,700,850,1
443,1,0,124.0,119.0,138.0,125.0,3605,3526,2799,2855,806,671,1099,305,537,160,562,145,66,66,3750,2200,1200,1900,700,850,1
450,1,0,122.0,122.0,138.0,125.0,3549,3868,2743,3219,806,649,1465,482,807,265,658,217,66,66,3900,2200,1200,1900,850,850,1
457,1,0,118.0,123.0,146.0,125.0,3487,3728,2659,3079,828,649,1750,512,992,290,758,222,67,69,3600,2150,1200,1900,1075,1100,1
464,1,0,127.0,124.0,146.0,125.0,3549,3834,2743,3163,806,671,1306,462,502,160,804,302,68,69,3600,2150,1325,1900,1075,1100,1
471,1,0,130.0,130.0,146.0,133.0,3375,3857,2547,3163,828,694,1107,621,407,335,700,286,68,72,3650,2975,1575,1900,1075,1100,1
479,1,0,132.0,137.0,146.0,148.0,3409,3868,2603,3107,806,761,1318,636,572,400,746,236,77,72,3750,3175,1575,2350,1100,1100,1
486,1,0,133.0,140.0,146.0,148.0,3498,4075,2603,3247,895,828,1685,456,827,270,858,186,77,73,3750,3275,1575,2350,1100,1100,1
493,1,0,135.0,141.0,160.0,156.0,3588,3918,2603,3135,985,783,1800,768,872,490,928,278,78,73,3850,3375,1575,2350,1125,1100,1
500,1,0,145.0,144.0,160.0,156.0,3980,3661,2995,2855,985,806,1791,223,747,195,1044,28,78,74,4250,3575,1575,2350,1125,1100,1
507,1,0,148.0,150.0,168.0,156.0,4014,3263,3051,2435,963,828,1018,584,437,460,581,124,78,76,4400,4150,1575,2425,1175,1100,1
514,1,0,150.0,153.0,168.0,180.0,4260,3179,3275,2351,985,828,1388,499,687,325,701,174,78,77,4250,3850,1575,2875,1175,1400,1
521,1,0,152.0,157.0,168.0,180.0,4232,3470,3247,2687,985,783,1104,451,537,335,567,116,79,79,4750,3850,1575,3075,1175,1400,1
529,1,0,147.0,165.0,168.0,180.0,4109,3655,3191,2827,918,828,1138,236,567,95,571,141,71,80,5050,4050,1575,3075,1575,1400,1
536,1,0,147.0,170.0,168.0,180.0,3532,3963,2771,3135,761,828,1545,301,882,110,663,191,73,83,5050,4450,1575,3150,1575,1600,1
543,1,0,163.0,171.0,182.0,180.0,3386,3913,2715,3107,671,806,501,293,162,210,339,83,73,83,5050,4450,1700,3225,1825,1700,1
550,1,0,164.0,176.0,182.0,180.0,3582,4081,2911,3275,671,806,791,638,422,455,369,183,73,85,5050,4800,1700,3225,1825,1800,1
557,1,0,168.0,177.0,182.0,188.0,3588,4411,2939,3583,649,828,912,144,467,65,445,79,77,86,5050,4700,1700,3325,1925,2100,1
564,1,0,172.0,178.0,182.0,188.0,3549,4551,2855,3723,694,828,791,449,412,320,379,129,77,86,6350,4600,1950,3550,1925,2200,1
571,1,0,182.0,181.0,182.0,188.0,4042,4282,3191,3499,851,783,413,531,122,335,291,196,83,86,6350,5200,1950,3550,1925,2200,1
579,1,0,173.5,176.0,174.0,188.0,4327,4635,3387,3807,940,828,634,396,227,200,407,196,84,86,5525,4875,1950,3550,2825,2750,1
586,1,0,167.5,174.0,174.0,188.0,3963,4439,3023,3611,940,828,881,346,362,250,519,96,85,86,5775,4350,1950,3550,3075,3275,1
593,1,0,172.0,176.0,174.0,196.0,3577,4669,2659,3863,918,806,868,358,237,320,631,38,85,86,5950,4325,1950,3550,3200,3475,1
600,1,0,176.0,178.0,182.0,196.0,3610,4495,2715,3667,895,828,787,794,152,685,635,109,82,86,5950,4800,1950,3550,3350,3575,1
607,1,0,178.0,188.0,190.0,196.0,4221,4590,3303,3695,918,895,630,581,112,460,518,121,81,86,6400,5000,1950,3550,3350,3675,1
614,1,0,180.0,192.0,198.0,196.0,4585,4333,3667,3303,918,1030,783,385,157,215,626,170,84,86,6500,5425,1950,3550,3350,3675,1
621,1,0,180.0,189.0,198.0,196.0,4512,4165,3639,3023,873,1142,948,520,272,385,676,135,88,86,6700,5800,1950,3550,3650,3850,1
629,1,0,160.0,161.0,190.0,211.0,4646,4221,3751,3079,895,1142,1256,990,472,715,784,275,88,86,4550,4425,2075,3550,4675,5750,1
636,1,0,158.5,157.0,182.0,211.0,4630,4137,3667,2995,963,1142,1647,762,797,455,850,307,87,86,4225,3625,2425,3750,5250,6775,1
643,1,0,160.5,163.0,182.0,211.0,4775,4249,3835,3107,940,1142,1773,347,807,250,966,97,87,86,4475,3675,2425,3750,5300,6775,1
650,1,0,165.5,171.0,174.0,211.0,4663,4159,3723,2995,940,1164,1874,169,892,65,982,104,87,86,4425,3975,2425,3750,5500,6775,1
657,1,0,165.0,177.0,174.0,211.0,4842,4243,3835,3079,1007,1164,959,309,607,190,352,119,87,86,4100,4525,2425,3750,5925,6925,1
664,1,0,166.0,176.0,174.0,211.0,4624,4064,3639,2967,985,1097,1170,797,952,550,218,247,86,86,4650,4475,2425,3750,6025,6975,1
671,1,0,164.0,182.0,174.0,211.0,4742,3717,3779,2575,963,1142,1502,352,1172,315,330,37,86,86,4300,5225,2425,3750,6375,7075,1
679,1,0,172.0,187.0,182.0,211.0,4736,3549,3751,2407,985,1142,917,502,867,450,50,52,90,86,4750,5675,2425,3750,6600,7125,1
686,1,0,175.0,193.0,182.0,211.0,4596,3605,3611,2463,985,1142,818,244,752,60,66,184,90,86,5350,5675,2425,3750,6600,7125,1
693,1,0,180.0,193.0,182.0,226.0,4406,3795,3443,2631,963,1164,959,545,777,225,182,320,88,86,5950,5975,2425,3750,6600,7125,1
700,1,0,181.5,196.0,182.0,226.0,4518,4551,3555,3387,963,1164,1205,941,907,510,298,431,88,86,6625,6600,2425,3750,6625,7125,1
707,1,0,176.5,198.0,174.0,226.0,4646,4540,3639,3443,1007,1097,1250,944,832,460,418,484,88,86,5825,6800,2425,3750,7725,7325,1
714,1,0,168.0,185.0,176.0,226.0,4322,4512,3359,3415,963,1097,2003,1289,1477,765,526,524,88,86,5600,6000,2425,3750,8175,8125,1
721,1,0,179.0,186.0,184.0,226.0,3806,4585,2799,3443,1007,1142,1526,679,872,465,654,214,87,86,5800,5775,2425,3750,8250,8525,1
729,1,0,170.0,167.0,192.0,226.0,4131,4607,3079,3443,1052,1164,1896,665,1122,565,774,100,87,86,4950,4375,2425,3750,8875,10450,1
736,1,0,170.0,168.0,192.0,226.0,3622,4557,2659,3415,963,1142,2022,651,1232,465,790,186,84,86,5250,4000,2300,3750,9093,10875,1
743,1,0,167.5,172.0,192.0,226.0,3638,4607,2631,3443,1007,1164,2310,893,1392,650,918,243,84,86,5325,4325,2300,3750,9343,11050,1
750,1,0,176.5,177.0,192.0,226.0,3638,4551,2631,3387,1007,1164,1900,343,912,210,988,133,84,86,5325,4950,2300,3750,9343,11050,1
757,1,0,185.0,175.0,192.0,226.0,4131,4372,3079,3275,1052,1097,608,636,542,475,66,161,83,86,5800,5475,2300,3750,9343,11350,1
764,1,0,187.0,183.0,192.0,241.0,3610,4305,2603,3163,1007,1142,810,686,632,530,178,156,86,86,5850,5725,2300,3750,9343,11350,1
771,1,0,188.0,191.0,200.0,241.0,3297,4557,2267,3415,1030,1142,548,386,517,240,31,146,85,86,6150,5825,2300,3750,9343,11350,1
779,1,0,196.0,194.0,208.0,241.0,3375,4473,2323,3331,1052,1142,363,402,262,297,101,105,85,86,7600,6575,2300,3750,9343,11350,1
786,1,0,197.0,194.0,208.0,241.0,2950,4226,1987,3107,963,1119,609,845,392,623,217,222,84,86,8000,7250,2300,3750,9368,11550,1
793,1,0,198.0,200.0,214.0,241.0,3269,4159,2239,2995,1030,1164,867,556,522,448,345,108,83,86,8450,7500,2300,3750,9368,11550,1
800,1,0,200.0,200.0,206.0,241.0,3678,4310,2603,3191,1075,1119,400,1058,327,818,73,240,85,86,8250,7650,2300,3750,9568,11550,1
807,1,0,190.5,194.0,206.0,241.0,3857,4378,2715,3079,1142,1299,316,1100,182,938,134,162,85,86,7275,7850,2775,3750,10543,11875,1
814,1,0,184.0,187.0,206.0,241.0,4086,4540,2967,3107,1119,1433,479,1452,175,1168,304,284,85,86,6850,7200,2775,3750,11367,12525,1
821,1,0,184.0,184.0,206.0,256.0,4086,4921,2967,3443,1119,1478,175,2052,35,1588,140,464,85,86,6550,7050,2925,3750,11767,12675,1
829,1,0,180.0,190.0,212.0,256.0,4277,4870,3135,3415,1142,1455,180,1664,100,1403,80,261,85,86,6650,7050,2925,3750,12367,12675,1
836,1,0,187.0,192.0,212.0,256.0,4316,4803,3219,3303,1097,1500,357,655,145,593,212,62,85,86,6850,6700,2925,3750,12367,13225,1
843,1,0,179.5,183.0,212.0,256.0,4630,4798,3443,3275,1187,1523,562,1221,310,983,252,238,85,86,6075,6050,2925,3750,12917,13875,1
850,1,0,167.0,157.0,212.0,256.0,4882,4758,3695,3303,1187,1455,442,1194,50,1038,392,156,85,86,4500,4275,2925,3750,14217,15650,1
857,1,0,161.0,160.0,212.0,256.0,4758,4702,3639,3247,1119,1455,846,1326,355,1123,491,203,86,86,4350,4975,2925,3750,14717,16125,1
864,1,0,164.0,168.0,212.0,256.0,4893,4702,3751,3247,1142,1455,321,1436,65,1353,256,83,86,85,4450,5300,2925,3750,15317,16125,1
871,1,0,160.5,156.0,212.0,248.0,4641,4646,3499,3191,1142,1455,577,1993,185,1738,392,255,86,85,4275,4675,2925,3750,15942,16900,1
879,1,0,162.0,151.0,212.0,248.0,4730,4646,3611,3191,1119,1455,108,1308,30,1198,78,110,86,85,3800,3725,2775,3750,17092,17575,1
886,1,0,160.5,161.0,212.0,248.0,4725,4607,3583,3107,1142,1500,369,1085,155,953,214,132,85,85,4025,4750,2775,3750,17117,17575,1
893,1,0,168.5,171.0,212.0,248.0,4910,4490,3723,2967,1187,1523,254,365,50,128,204,237,85,85,4675,5700,2775,3750,17117,17575,1
900,1,0,174.5,175.0,212.0,248.0,4809,4372,3667,2995,1142,1377,376,474,115,283,261,191,85,85,5425,5700,2775,3750,17117,17575,1
907,1,0,179.0,179.0,212.0,248.0,4753,4137,3611,2827,1142,1310,327,754,105,403,222,351,85,85,5700,5900,2775,4050,17142,17575,1
914,1,0,183.0,181.0,212.0,248.0,4854,4098,3667,2799,1187,1299,690,1024,320,613,370,411,88,85,6100,7125,2775,4050,17017,17575,1
921,1,0,195.0,187.0,212.0,248.0,4848,4047,3639,2771,1209,1276,544,1166,80,653,464,513,88,85,6650,7400,2775,4050,17017,17575,1
929,1,0,196.5,197.0,212.0,248.0,4714,4159,3527,2883,1187,1276,788,612,255,293,533,319,87,85,7025,8000,2775,4250,17042,17575,1
936,1,0,196.5,197.0,212.0,248.0,4876,4221,3667,2855,1209,1366,227,1102,125,623,102,479,89,85,7425,8200,2775,4475,17192,17575,1
943,1,0,195.5,195.0,212.0,248.0,4557,4126,3303,2827,1254,1299,330,1595,80,968,250,627,80,85,7575,8450,2775,4475,17592,17675,1
950,1,0,196.5,200.0,212.0,248.0,4327,4053,3163,2799,1164,1254,738,1227,360,823,378,404,79,85,8875,8800,2900,4475,17642,17775,1
957,1,0,195.5,200.0,212.0,248.0,3991,4406,2827,3107,1164,1299,1006,912,530,773,476,139,84,85,8875,8800,2900,4475,17792,17775,1
964,1,0,185.0,179.0,204.0,278.0,3924,4187,2715,2911,1209,1276,810,1404,190,1113,620,291,85,85,6900,7350,2900,4475,18917,19279,1
971,1,0,172.0,173.0,188.0,278.0,3930,4467,2743,3191,1187,1276,749,1624,60,1223,689,401,87,85,4900,6675,2775,4475,20842,19679,1
7,1,0,13.0,13.0,14.0,15.0,377,335,377,335,0,0,45,40,45,40,0,0,12,12,0,0,0,0,0,0,0
14,1,0,13.0,14.0,14.0,15.0,671,671,671,671,0,0,20,70,20,70,0,0,13,13,0,0,0,0,0,0,0
21,1,0,14.0,14.0,14.0,15.0,699,643,699,643,0,0,55,40,55,40,0,0,13,13,0,0,0,0,0,0,0
29,1,0,14.0,15.0,14.0,15.0,755,671,755,671,0,0,155,90,155,90,0,0,13,14,0,0,0,0,0,0,0
36,1,0,16.0,15.0,22.0,15.0,811,699,811,699,0,0,150,125,150,125,0,0,14,14,0,0,0,0,0,0,0
43,1,0,16.0,16.0,22.0,23.0,811,783,811,783,0,0,230,220,230,220,0,0,15,15,0,0,0,0,0,0,0
50,1,0,15.0,16.0,22.0,23.0,811,839,811,839,0,0,35,280,35,280,0,0,15,15,0,0,0,0,0,0,0
57,1,0,17.0,17.0,22.0,23.0,895,867,895,867,0,0,40,380,40,380,0,0,15,16,0,0,0,0,0,0,0
64,1,0,18.0,18.0,22.0,23.0,895,895,895,895,0,0,85,30,85,30,0,0,16,17,0,0,0,0,0,0,0
71,1,0,17.0,18.0,22.0,23.0,923,923,923,923,0,0,170,145,170,145,0,0,17,17,0,0,0,0,0,0,0
79,1,0,17.0,19.0,22.0,23.0,867,923,867,923,0,0,25,45,25,45,0,0,16,18,0,0,0,0,0,0,0
86,1,0,18.0,19.0,22.0,23.0,923,951,923,951,0,0,90,25,90,25,0,0,16,18,0,0,0,0,0,0,0
93,1,0,19.0,20.0,22.0,23.0,895,923,895,923,0,0,150,130,150,130,0,0,18,19,0,0,0,0,0,0,0
100,1,0,20.0,21.0,22.0,23.0,962,895,895,895,67,0,217,35,205,35,12,0,19,20,0,0,0,0,0,0,0
107,1,0,20.0,21.0,22.0,23.0,1057,895,923,895,134,0,353,90,325,90,28,0,19,20,0,0,0,0,0,0,0
114,1,0,21.0,22.0,22.0,23.0,1079,956,923,867,156,89,433,136,385,120,48,16,20,21,0,0,0,0,0,0,0
121,1,0,26.0,23.0,28.0,23.0,1079,1029,923,895,156,134,208,202,140,170,68,32,21,21,0,0,250,150,0,0,0
129,1,0,27.0,23.0,28.0,23.0,1079,950,923,839,156,111,298,164,210,120,88,44,21,22,0,0,250,150,0,0,0
136,1,0,28.0,23.0,28.0,38.0,1034,1001,923,867,111,134,280,145,180,85,100,60,22,22,0,0,250,150,0,0,0
143,1,0,28.0,23.0,28.0,38.0,1057,1130,1035,951,22,179,400,109,300,100,100,9,22,22,50,50,250,300,0,0,0
150,1,0,28.0,24.0,36.0,38.0,1119,1197,1119,951,0,246,195,202,95,165,100,37,22,22,50,50,250,300,0,0,0
157,1,0,31.0,24.0,36.0,38.0,1315,1174,1315,951,0,223,210,355,110,290,100,65,22,22,350,50,250,300,0,0,0
164,1,0,33.0,27.0,36.0,38.0,1259,1393,1259,1147,0,246,5,387,5,290,0,97,24,23,350,50,250,375,0,0,0
171,1,0,33.0,27.0,36.0,38.0,1371,1527,1371,1259,0,268,80,394,80,365,0,29,26,24,350,50,250,375,0,0,0
179,1,0,36.0,31.0,36.0,38.0,1539,1925,1539,1679,0,246,100,386,100,325,0,61,26,25,350,50,250,475,0,0,0
186,1,0,36.0,33.0,36.0,38.0,1511,1802,1511,1511,0,291,275,552,275,455,0,97,27,26,350,100,250,475,0,0,0
193,1,0,41.5,34.0,44.0,38.0,1623,1942,1623,1651,0,291,20,29,20,0,0,29,29,27,325,200,250,475,25,0,0
200,1,0,42.5,35.0,44.0,38.0,1623,1841,1623,1595,0,246,0,137,0,80,0,57,30,28,475,250,250,475,25,0,0
207,1,0,46.5,38.0,52.0,38.0,1757,1869,1735,1623,22,246,114,159,110,70,4,89,33,29,475,250,250,475,25,0,0
214,1,0,47.5,38.0,52.0,38.0,1841,1919,1707,1651,134,268,289,241,265,120,24,121,34,30,475,250,250,475,25,0,0
221,1,0,52.5,43.0,58.0,46.0,1975,1897,1819,1651,156,246,124,199,80,50,44,149,36,31,475,350,250,475,25,0,0
229,1,0,55.5,43.0,58.0,46.0,1947,1706,1791,1483,156,223,209,403,145,230,64,173,37,31,625,350,250,475,25,0,0
236,1,0,57.5,45.0,58.0,46.0,2031,1919,1875,1651,156,268,204,165,120,110,84,55,41,33,625,350,250,725,25,0,0
243,1,0,61.5,48.0,66.0,54.0,2138,2048,1959,1735,179,313,209,115,105,20,104,95,43,33,775,500,250,725,25,0,0
250,1,0,63.5,50.0,66.0,54.0,2362,2020,2183,1707,179,313,289,276,165,145,124,131,43,35,775,500,250,725,25,0,0
257,1,0,69.5,52.0,74.0,54.0,2423,2048,2267,1735,156,313,230,171,90,100,140,71,45,36,925,550,250,725,25,0,0
264,1,0,69.5,55.0,82.0,77.0,2563,1992,2407,1567,156,425,135,187,25,60,110,127,46,37,925,650,250,725,25,0,0
271,1,0,71.5,56.0,82.0,77.0,2619,2339,2463,1847,156,492,275,352,145,165,130,187,49,38,1075,650,250,1075,25,0,0
279,1,0,78.5,63.0,82.0,77.0,2703,2485,2547,2015,156,470,185,64,35,50,150,14,51,39,1225,800,250,1075,25,0,0
286,1,0,81.0,65.0,98.0,77.0,2838,2619,2659,2127,179,492,270,149,100,75,170,74,51,41,1200,800,250,1075,50,0,0
293,1,0,83.0,66.0,98.0,85.0,2978,2535,2799,2043,179,492,220,254,130,120,90,134,51,42,1450,850,250,1075,50,0,0
300,1,0,85.0,66.0,106.0,85.0,2888,2681,2687,2211,201,470,199,575,85,385,114,190,50,44,1700,900,250,1150,50,0,0
307,1,0,90.0,71.0,106.0,85.0,2804,3056,2491,2519,313,537,244,403,90,270,154,133,49,44,1850,900,450,1150,50,0,0
314,1,0,92.0,72.0,98.0,85.0,2804,2866,2491,2239,313,627,470,254,280,45,190,209,49,45,2150,1300,450,1275,150,0,0
321,1,0,95.0,73.0,106.0,85.0,2804,2804,2491,2155,313,649,420,476,240,245,180,231,56,46,2150,1300,575,1400,150,0,0
329,1,0,98.0,78.0,106.0,85.0,2860,2692,2547,2043,313,649,335,177,115,70,220,107,56,48,2300,1300,575,1400,150,0,0
336,1,0,103.0,82.0,106.0,93.0,2860,2692,2435,2043,425,649,346,102,70,40,276,62,57,49,2500,1575,575,1400,150,0,0
343,1,0,101.5,84.0,106.0,93.0,2955,3006,2463,2379,492,627,553,298,217,160,336,138,55,51,2625,1575,575,1400,175,0,0
350,1,0,103.5,86.0,106.0,93.0,2955,3084,2463,2435,492,649,814,573,422,355,392,218,59,52,2725,1625,825,1400,175,100,0
357,1,0,105.5,89.0,106.0,101.0,3129,2888,2659,2239,470,649,810,614,512,320,298,294,62,54,2725,1625,825,1400,175,100,0
364,1,0,105.5,95.0,106.0,101.0,3263,2714,2659,2043,604,671,435,284,182,110,253,174,63,55,2725,1725,825,1700,175,100,0
371,1,0,105.5,99.0,106.0,101.0,3470,2698,2799,2071,671,627,245,201,162,55,83,146,64,57,2725,2050,1075,1850,175,100,0
379,1,0,110.0,103.0,138.0,109.0,3426,2832,2799,2183,627,649,247,226,92,125,155,101,64,57,2800,2050,1075,1850,350,100,0
386,1,0,111.0,106.0,154.0,125.0,3588,2994,2939,2323,649,671,627,331,392,150,235,181,64,59,2800,2250,1075,1850,350,100,0
393,1,0,112.5,109.0,154.0,125.0,3448,3062,2799,2435,649,627,593,443,382,190,211,253,67,60,2925,2650,1075,1850,375,100,0
400,1,0,116.5,115.0,154.0,125.0,3476,3146,2827,2519,649,627,813,433,522,200,291,233,70,63,2925,2800,1075,1850,375,100,0
407,1,0,116.5,122.0,154.0,125.0,3566,3302,2939,2631,627,671,1099,373,732,160,367,213,70,63,2875,2800,1075,2050,525,100,0
414,1,0,125.0,124.0,160.0,141.0,3750,3308,3079,2659,671,649,1089,404,642,215,447,189,70,63,3050,3175,1075,2050,550,100,0
421,1,0,128.0,127.0,160.0,141.0,3722,3420,3051,2771,671,649,1394,405,867,240,527,165,70,64,3200,3325,1325,2050,550,100,0
429,1,0,132.0,130.0,160.0,141.0,3638,3392,2967,2743,671,649,1315,656,837,415,478,241,70,66,3350,3675,1325,2050,550,100,0
436,1,0,139.0,132.0,160.0,141.0,3694,3342,2911,2715,783,627,1035,362,657,45,378,317,70,66,3650,3875,1325,2050,550,100,0
443,1,0,138.5,137.0,160.0,141.0,3571,3286,2743,2659,828,627,1141,462,817,65,324,397,70,66,4025,4075,1325,2050,600,100,0
450,1,0,140.0,141.0,160.0,141.0,3493,3308,2687,2659,806,649,1217,577,822,225,395,352,70,66,3950,4275,1325,2050,775,100,0
457,1,0,129.5,141.0,160.0,141.0,3722,3269,2939,2575,783,694,1673,862,1182,430,491,432,70,66,3925,4275,1325,2050,1450,150,0
464,1,0,130.0,135.0,168.0,149.0,3907,3246,3079,2575,828,671,1593,858,1002,350,591,508,70,66,3000,3575,1325,2550,2425,1100,0
471,1,0,132.5,140.0,168.0,149.0,3806,3347,3023,2631,783,716,1640,667,1082,325,558,342,70,66,3175,3625,1325,2550,2450,1100,0
479,1,0,133.5,142.0,168.0,149.0,3913,3392,3107,2631,806,761,1910,1023,1252,585,658,438,77,66,3025,3950,1325,2550,2600,1100,0
486,1,0,133.5,149.0,168.0,149.0,3879,3358,3051,2575,828,783,2221,269,1467,210,754,59,77,67,3275,4250,1325,2550,2800,1150,0
493,1,0,129.0,138.0,168.0,149.0,3997,3409,3191,2603,806,806,1642,534,1167,375,475,159,77,67,2650,3500,1325,2550,3200,1950,0
500,1,0,129.5,134.0,168.0,149.0,4142,3459,3359,2631,783,828,1858,355,1387,100,471,255,77,68,2925,3400,1325,2550,3275,2300,0
507,1,0,136.5,140.0,168.0,164.0,4131,3454,3303,2603,828,851,1038,365,717,160,321,205,77,68,2975,3800,1325,2650,3275,2300,0
514,1,0,145.5,140.0,168.0,164.0,3991,3297,3163,2491,828,806,778,287,607,165,171,122,77,71,3525,4225,1325,2650,3275,2300,0
521,1,0,150.0,145.0,184.0,164.0,3941,3297,3135,2491,806,806,595,318,357,175,238,143,76,71,3700,4225,1325,2650,3350,2300,0
529,1,0,150.0,150.0,192.0,164.0,3907,3375,3079,2547,828,828,1025,468,712,225,313,243,76,71,4150,4425,1325,2650,3350,2300,0
536,1,0,157.0,151.0,192.0,172.0,3851,2994,3023,2211,828,783,1141,340,732,155,409,185,77,74,4950,4625,1325,2650,3350,2300,0
543,1,0,159.5,154.0,192.0,172.0,3773,3162,2967,2379,806,783,1262,580,857,295,405,285,77,74,5225,4900,1325,2650,3375,2300,0
550,1,0,158.5,159.0,192.0,180.0,3918,3627,3135,2799,783,828,1418,445,1067,235,351,210,76,75,5575,4900,1325,3100,3375,2400,0
557,1,0,167.0,162.0,192.0,180.0,3991,3823,3163,2995,828,828,1458,471,1007,240,451,231,76,76,5700,4950,1325,3100,3400,2450,0
564,1,0,164.0,162.0,192.0,188.0,4103,3986,3275,3135,828,851,1703,547,1152,270,551,277,85,76,5500,4800,1325,3100,3700,2600,0
571,1,0,166.0,155.0,192.0,196.0,4025,3885,3219,3079,806,806,2025,324,1382,230,643,94,86,77,5450,4250,1325,3100,3750,3350,0
579,1,0,171.0,160.0,200.0,196.0,4103,3890,3275,3107,828,783,1750,535,1257,395,493,140,88,79,5450,4750,1325,3325,3750,3350,0
586,1,0,176.0,166.0,206.0,196.0,4299,3974,3471,3191,828,783,1391,555,952,365,439,190,89,79,5600,4750,1575,3325,3750,3350,0
593,1,0,183.0,168.0,212.0,196.0,4506,4092,3723,3219,783,873,1448,412,917,285,531,127,89,79,6300,4900,1575,3325,3850,3400,0
600,1,0,190.0,170.0,212.0,196.0,4719,4109,3891,3079,828,1030,1508,548,927,355,581,193,89,80,6300,5275,1575,3325,3850,3400,0
607,1,0,168.5,172.0,220.0,204.0,4355,3980,3527,2995,828,985,1998,995,1317,690,681,305,77,80,5975,5325,1575,3325,5125,3600,0
614,1,0,159.5,164.0,220.0,204.0,4002,3958,3219,2995,783,963,2425,312,1652,170,773,142,77,80,5725,4725,1575,3550,5550,4600,0
621,1,0,173.0,170.0,220.0,204.0,4109,4064,3303,3079,806,985,2500,621,1627,355,873,266,78,80,5700,4850,1575,3550,5300,4600,0
629,1,0,180.0,174.0,220.0,204.0,4187,4428,3359,3219,828,1209,2016,422,1272,350,744,72,86,84,5700,5100,1575,3750,5350,4600,0
636,1,0,180.0,176.0,212.0,204.0,4187,4714,3359,3415,828,1299,1716,918,972,740,744,178,86,84,5900,5625,1575,3750,5450,4600,0
643,1,0,184.0,179.0,212.0,204.0,4282,4910,3499,3611,783,1299,1878,380,1092,325,786,55,87,84,6650,5650,1575,3750,5500,4700,0
650,1,0,187.0,181.0,212.0,204.0,4523,4910,3695,3611,828,1299,1788,971,1102,760,686,211,84,85,6550,6125,1700,3750,5750,4750,0
657,1,0,197.5,179.0,212.0,204.0,4103,4658,3275,3359,828,1299,1378,892,742,806,636,86,82,85,6825,5850,2050,3750,5750,5150,0
664,1,0,196.5,179.0,212.0,204.0,4277,4148,3471,2827,806,1321,940,912,687,704,253,208,84,85,6825,6050,2050,3975,5750,5150,0
671,1,0,199.5,179.0,212.0,204.0,4361,4316,3555,2995,806,1321,1225,804,922,619,303,185,84,85,7925,6050,2050,4225,5750,5150,0
679,1,0,199.5,181.0,212.0,204.0,4439,4691,3611,3415,828,1276,1376,406,977,344,399,62,82,85,8875,6325,2050,4225,5800,5150,0
686,1,0,199.5,172.0,212.0,204.0,4579,4579,3751,3303,828,1276,1941,952,1442,734,499,218,82,85,9125,6325,2050,4225,5825,5700,0
693,1,0,191.5,176.0,212.0,204.0,4534,4182,3751,2883,783,1299,1478,912,1387,784,91,128,84,85,8725,6325,2050,4425,6225,5700,0
700,1,0,186.0,174.0,220.0,204.0,4551,4322,3723,3023,828,1299,1618,1433,1427,1149,191,284,84,85,7800,6225,2300,4525,7150,5800,0
707,1,0,180.0,173.0,220.0,204.0,4534,4450,3751,3107,783,1343,2000,1950,1717,1514,283,436,84,85,7350,6450,2300,4525,7600,5800,0
714,1,0,171.0,169.0,220.0,219.0,4305,4490,3499,3191,806,1299,2230,1182,2047,1094,183,88,88,85,7100,5575,2300,4525,8200,6550,0
721,1,0,178.0,171.0,220.0,219.0,4467,4495,3639,3219,828,1276,2125,1034,2042,919,83,115,86,85,7100,6125,2300,4525,8200,6550,0
729,1,0,200.0,176.0,226.0,219.0,4355,4383,3527,3107,828,1276,1531,1106,1352,962,179,144,86,85,7100,6125,2300,4525,8200,6550,0
736,1,0,200.0,176.0,232.0,234.0,4142,4434,3359,3135,783,1299,1723,1637,1452,1337,271,300,95,85,7100,6325,2300,4525,8200,6550,0
743,1,0,198.5,180.0,232.0,234.0,4299,4338,3471,2995,828,1343,2243,1697,1872,1337,371,360,94,85,7375,6875,2300,4525,8225,6550,0
750,1,0,196.5,183.0,232.0,249.0,4607,4294,3667,2995,940,1299,2028,1915,1937,1532,91,383,94,85,8525,7575,2300,4525,8325,6550,0
757,1,0,199.5,186.0,232.0,249.0,4988,4260,3891,2939,1097,1321,2175,1481,2102,1192,73,289,94,85,8525,7850,2300,4600,8325,6550,0
764,1,0,199.5,186.0,232.0,249.0,5150,4098,4031,2799,1119,1299,2657,1157,2452,1012,205,145,92,85,8525,8050,2300,4600,8325,6550,0
771,1,0,197.5,186.0,232.0,249.0,5027,4019,3863,2743,1164,1276,3263,1639,2922,1342,341,297,95,85,8375,8050,2300,4600,8475,6550,0
779,1,0,197.5,190.0,232.0,249.0,5089,3784,3947,2463,1142,1321,3554,1594,3227,1287,327,307,97,85,8375,8050,2300,4600,8475,6550,0
786,1,0,195.5,193.0,232.0,249.0,4562,3370,3443,2071,1119,1299,3840,962,3377,604,463,358,95,85,8375,8600,2300,4575,8475,6550,0
793,1,0,194.0,193.0,232.0,249.0,4322,3370,3023,2071,1299,1299,3955,658,3532,497,423,161,94,85,8350,8600,2300,4825,8500,6550,0
800,1,0,194.5,190.0,232.0,264.0,4490,3868,3191,2547,1299,1321,4136,1144,3557,827,579,317,94,85,8025,8650,2650,4825,8825,6714,0
807,1,0,167.0,156.0,224.0,264.0,4327,4260,3051,2939,1276,1321,4623,905,3892,682,731,223,94,85,5550,6125,2900,4625,11300,9207,0
814,1,0,199.0,157.0,230.0,264.0,4602,4305,3303,3051,1299,1254,3108,795,2217,732,891,63,94,80,5150,6125,3025,4625,12050,9682,0
821,1,0,195.0,159.0,230.0,264.0,4876,3722,3555,2715,1321,1007,3699,1016,2652,837,1047,179,94,79,4950,6125,3025,4625,12250,9682,0
829,1,0,200.0,163.0,230.0,279.0,4854,3806,3555,2687,1299,1119,3326,1044,2402,817,924,227,93,82,6000,6325,3025,4625,12250,9682,0
836,1,0,200.0,172.0,230.0,279.0,5150,4019,3807,2743,1343,1276,3967,545,2887,312,1080,233,94,83,7050,6325,3025,4625,12250,9682,0
843,1,0,200.0,172.0,230.0,279.0,5156,3829,3835,2575,1321,1254,4458,502,3222,367,1236,135,93,86,7850,6600,3025,4625,12250,9682,0
850,1,0,200.0,177.0,230.0,279.0,5195,4170,3919,2827,1276,1343,4121,372,3037,202,1084,170,93,87,7500,6775,3150,4850,12600,9682,0
857,1,0,200.0,177.0,230.0,309.0,5223,4260,3947,2939,1276,1321,3851,473,3057,147,794,326,94,87,7500,7825,3150,5075,12600,9682,0
864,1,0,200.0,177.0,230.0,309.0,5240,4445,3919,3079,1321,1366,4497,1002,3547,512,950,490,94,87,7500,7925,3275,5075,12600,9682,0
871,1,0,199.0,177.0,230.0,309.0,5318,4826,3975,3415,1343,1411,4752,1398,3842,832,910,566,93,87,8750,8025,3275,5175,12600,9682,0
879,1,0,179.5,168.0,230.0,309.0,5223,5100,3947,3667,1276,1433,5360,1976,4302,1242,1058,734,93,87,7575,7525,3275,5175,13700,10007,0
886,1,0,180.0,143.0,230.0,294.0,5156,4411,3835,3023,1321,1388,4126,1694,2912,1046,1214,648,93,75,4250,5900,3275,4950,16800,13233,0
893,1,0,189.5,132.0,230.0,294.0,5268,3459,3947,2183,1321,1276,3876,776,2502,580,1374,196,93,69,3325,4625,3275,4950,17725,14708,0
900,1,0,198.5,140.0,230.0,294.0,5223,3532,3947,2211,1276,1321,3944,691,2472,335,1472,356,93,69,3375,4625,3275,4950,17725,14708,0
907,1,0,198.5,140.0,230.0,294.0,5302,3767,4003,2491,1299,1276,3724,266,2517,166,1207,100,93,69,6075,4825,3275,4950,17725,14708,0
914,1,0,199.5,147.0,230.0,294.0,5436,3622,4115,2323,1321,1299,3920,401,2757,149,1163,252,93,77,6625,4825,3275,5375,17725,14708,0
921,1,0,199.5,151.0,230.0,294.0,5184,3778,3863,2435,1321,1343,3836,714,2717,302,1119,412,93,79,7475,6475,3275,5375,17725,14708,0
929,1,0,199.5,162.0,222.0,294.0,5386,4613,4087,3247,1299,1366,4463,482,3192,160,1271,322,94,84,7275,6475,3275,5375,17925,14708,0
936,1,0,198.5,162.0,222.0,294.0,5268,4590,3947,3023,1321,1567,4724,713,3472,370,1252,343,93,84,7675,6475,3275,5375,17925,14708,0
943,1,0,198.5,166.0,222.0,294.0,5313,5106,4059,3471,1254,1635,5377,1139,3977,650,1400,489,93,84,7675,6475,3725,5375,17925,14708,0
950,1,0,169.5,153.0,222.0,294.0,5363,5598,4087,4031,1276,1567,5747,1813,4337,1140,1410,673,93,80,6575,6700,3725,5150,19375,15233,0
957,1,0,170.5,131.0,222.0,294.0,5324,4187,4003,2855,1321,1332,4867,2023,3297,1250,1570,773,93,73,3775,5000,3725,5150,22175,17283,0
964,1,0,198.0,143.0,206.0,294.0,5346,3470,4003,2295,1343,1175,3263,1389,1887,655,1376,734,93,72,2800,5800,3725,5150,23150,17283,0
971,1,0,198.0,154.0,206.0,294.0,5111,3890,3835,2771,1276,1119,3356,960,2332,290,1024,670,93,72,2800,5800,3725,5150,23150,17283,0
979,1,0,200.0,158.0,206.0,294.0,5100,4254,3779,3135,1321,1119,3822,892,2642,343,1180,549,93,74,4300,6400,3725,5150,23150,17283,0
986,1,0,199.0,171.0,206.0,294.0,4960,4422,3639,3303,1321,1119,3622,476,2682,62,940,414,92,81,6300,6650,3725,5375,23150,17283,0
993,1,0,200.0,173.0,206.0,294.0,4915,4518,3639,3331,1276,1187,4150,797,3062,302,1088,495,92,81,7150,6650,3725,5575,23150,17283,0
1000,1,0,200.0,178.0,206.0,294.0,4971,4394,3751,3331,1220,1063,4500,1143,3387,539,1113,604,93,82,7950,6775,3725,5575,23150,17283,0
1007,1,0,195.5,182.0,212.0,294.0,5055,4887,3835,3835,1220,1052,5108,1276,3847,628,1261,648,93,82,7725,7650,3725,5675,23375,17283,0
1014,1,0,167.0,173.0,212.0,294.0,5184,5341,3751,4199,1433,1142,5724,1886,4287,1099,1437,787,93,81,6050,7875,3875,5350,25075,18258,0
1021,1,0,174.5,163.0,212.0,294.0,5313,5262,3835,4143,1478,1119,5326,1314,3717,799,1609,515,93,71,4575,7025,4125,5350,26550,19782,0
1029,1,0,199.5,170.0,212.0,294.0,5341,3902,3863,2827,1478,1075,4299,962,2822,419,1477,543,93,71,4475,7250,4125,5250,26650,19882,0
1036,1,0,195.0,170.0,212.0,294.0,5262,3689,3807,2659,1455,1030,4725,832,3172,419,1553,413,93,78,4250,7500,4125,5250,26875,19882,0
1043,1,0,193.0,170.0,212.0,294.0,5330,3381,3919,2351,1411,1030,5037,1021,3337,584,1700,437,93,78,5400,7700,3975,5250,27650,19882,0
1050,1,0,193.0,178.0,212.0,294.0,5408,3252,3975,2267,1433,985,4497,871,3217,564,1280,307,93,78,5750,8375,3975,5675,27650,19982,0
1057,1,0,200.0,188.0,212.0,294.0,5442,3291,3919,2239,1523,1052,4587,487,3227,352,1360,135,93,78,5800,8600,3975,5675,27650,19982,0
1064,1,0,200.0,188.0,212.0,294.0,5447,3644,3947,2435,1500,1209,5229,549,3697,262,1532,287,93,78,7650,8600,4125,5675,27650,19982,0
1071,1,0,200.0,188.0,212.0,294.0,5335,3577,3835,2323,1500,1254,5867,203,4167,22,1700,181,93,78,8200,8600,4125,5575,27650,20082,0
1079,1,0,193.0,191.0,212.0,294.0,5453,3554,3975,2323,1478,1231,6503,626,4627,297,1876,329,93,78,7850,9300,4125,5475,28000,20182,0
1086,1,0,193.0,171.0,212.0,294.0,5358,3011,3947,1847,1411,1164,6086,972,4042,507,2044,465,93,76,6200,8250,4125,5400,29425,22207,0
1093,1,0,184.5,128.0,212.0,279.0,5414,2328,4003,1399,1411,929,6001,1237,3777,662,2224,575,93,61,4175,5975,4125,5100,31375,25994,0
1100,1,0,187.0,124.0,212.0,279.0,5453,2222,3975,1371,1478,851,5941,498,3537,127,2404,371,93,58,3250,5825,3975,5100,32268,27585,0
1107,1,0,187.0,127.0,212.0,279.0,5520,2115,3975,1287,1545,828,6591,334,4007,67,2584,267,93,57,5000,5825,3975,5100,32268,27635,0
1114,1,0,200.0,133.0,212.0,279.0,5369,1846,3891,1063,1478,783,4654,498,2852,163,1802,335,93,57,5750,6375,3975,5100,32268,27635,0
1121,1,0,200.0,137.0,212.0,279.0,5453,2294,3975,1511,1478,783,4832,475,2937,128,1895,347,93,57,5750,6825,3975,5100,32268,27710,0
1129,1,0,199.5,141.0,212.0,279.0,5391,2541,3947,1735,1444,806,5451,537,3382,119,2069,418,93,57,8275,6825,3975,5100,32343,27710,0
1136,1,0,198.5,149.0,212.0,279.0,5296,3146,4031,2295,1265,851,5769,461,3702,16,2067,445,92,57,8275,7225,4125,5100,32343,27710,0
1143,1,0,169.5,135.0,212.0,279.0,5307,3661,4031,2855,1276,806,6404,868,4177,331,2227,537,92,57,6675,6475,4125,5100,33943,28610,0
1150,1,0,187.0,121.0,212.0,279.0,5386,3190,4087,2463,1299,727,5394,742,3407,204,1987,538,92,50,5550,5950,3975,5100,35218,30239,0
1157,1,0,200.0,116.0,212.0,279.0,5318,2686,3975,2015,1343,671,5025,662,2882,244,2143,418,92,45,4950,5800,3975,5100,35518,31289,0
1164,1,0,199.5,122.0,212.0,279.0,5145,2250,3947,1623,1198,627,5315,369,3142,129,2173,240,92,45,4675,5800,3975,5100,35793,31289,0
1171,1,0,199.5,126.0,212.0,279.0,5201,2110,4059,1483,1142,627,4916,449,3132,129,1784,320,92,45,6625,6150,3975,5100,35793,31289,0
1179,1,0,189.0,120.0,212.0,279.0,5324,2546,4227,1875,1097,671,5553,799,3637,399,1916,400,92,43,6800,6075,3975,5100,36718,31591,0
1186,1,0,184.5,90.0,212.0,279.0,5352,1958,4255,1287,1097,671,5513,1044,3457,564,2056,480,92,35,5975,4750,3975,5100,38543,33760,0
1193,1,0,199.0,93.0,212.0,279.0,5358,1438,4339,811,1019,627,5190,361,3012,59,2178,302,92,28,5750,5100,3975,5100,38768,34235,0
1200,1,0,197.5,89.0,212.0,279.0,5229,1510,4199,839,1030,671,5820,541,3522,159,2298,382,92,28,6375,4825,3975,5100,38843,34785,0
1207,1,0,193.0,80.0,218.0,264.0,5234,1466,4227,839,1007,627,5567,613,3157,159,2410,454,92,26,5600,4200,3975,5100,40568,36287,0
1214,1,0,174.0,68.0,210.0,264.0,5190,1236,4227,811,963,425,5970,517,3452,44,2518,473,92,20,3900,3700,3975,5100,42118,37387,0
7,2,1,13.0,13.0,15.0,14.0,335,251,335,251,0,0,40,30,40,30,0,0,12,12,0,0,0,0,0,0,1
14,2,1,14.0,13.0,15.0,14.0,671,643,671,643,0,0,70,15,70,15,0,0,13,13,0,0,0,0,0,0,1
21,2,1,14.0,14.0,15.0,14.0,699,727,699,727,0,0,50,50,50,50,0,0,13,13,0,0,0,0,0,0,1
29,2,1,15.0,14.0,15.0,14.0,699,755,699,755,0,0,40,140,40,140,0,0,14,13,0,0,0,0,0,0,1
36,2,1,15.0,16.0,15.0,22.0,783,755,783,755,0,0,135,135,135,135,0,0,14,14,0,0,0,0,0,0,1
43,2,1,16.0,16.0,23.0,22.0,811,811,811,811,0,0,25,225,25,225,0,0,15,16,0,0,0,0,0,0,1
50,2,1,17.0,15.0,23.0,22.0,811,839,811,839,0,0,50,15,50,15,0,0,16,15,0,0,0,0,0,0,1
57,2,1,18.0,17.0,23.0,22.0,867,895,867,895,0,0,50,25,50,25,0,0,17,15,0,0,0,0,0,0,1
64,2,1,19.0,18.0,23.0,22.0,923,895,923,895,0,0,115,75,115,75,0,0,18,16,0,0,0,0,0,0,1
71,2,1,19.0,17.0,23.0,22.0,973,839,951,839,22,0,234,145,230,145,4,0,18,16,0,0,0,0,0,0,1
79,2,1,20.0,17.0,23.0,22.0,1034,923,923,923,111,0,350,15,330,15,20,0,19,16,0,0,0,0,0,0,1
86,2,1,20.0,18.0,23.0,22.0,1051,923,895,923,156,0,76,80,40,80,36,0,19,16,0,0,0,0,0,0,1
93,2,1,20.0,19.0,23.0,22.0,1051,895,895,895,156,0,191,125,135,125,56,0,20,17,0,0,150,0,0,0,1
100,2,1,21.0,20.0,23.0,22.0,1079,962,923,895,156,67,126,207,50,195,76,12,20,18,0,0,150,0,0,0,1
107,2,1,21.0,20.0,23.0,22.0,1085,1029,951,895,134,134,137,333,45,305,92,28,20,19,0,0,150,0,0,0,1
114,2,1,22.0,21.0,23.0,22.0,1079,1051,923,895,156,156,112,404,0,360,112,44,21,20,0,0,150,0,0,0,1
121,2,1,23.0,25.0,23.0,28.0,1135,1023,979,867,156,156,247,234,115,170,132,64,22,20,0,0,150,250,0,0,1
129,2,1,23.0,26.0,23.0,28.0,1174,1107,951,951,223,156,335,234,175,150,160,84,22,21,0,0,150,250,0,0,1
136,2,1,26.0,28.0,31.0,28.0,1258,1085,923,951,335,134,65,60,40,60,25,0,23,21,0,0,300,250,0,0,1
143,2,1,27.0,28.0,31.0,28.0,1264,1085,951,1063,313,22,56,190,45,190,11,0,24,21,0,50,300,250,0,0,1
150,2,1,28.0,30.0,31.0,36.0,1286,1119,951,1119,335,0,161,235,110,235,51,0,25,23,0,50,300,250,0,0,1
157,2,1,29.0,29.0,46.0,36.0,1292,1287,979,1287,313,0,162,70,75,70,87,0,25,22,0,350,300,250,0,0,1
164,2,1,33.0,32.0,46.0,36.0,1376,1287,1063,1287,313,0,152,40,50,40,102,0,27,24,125,350,300,250,0,0,1
171,2,1,35.0,33.0,46.0,36.0,1404,1399,1091,1399,313,0,277,45,135,45,142,0,29,25,125,350,300,250,0,0,1
179,2,1,38.0,36.0,46.0,36.0,1622,1455,1287,1455,335,0,67,55,35,55,32,0,29,25,125,350,600,250,0,0,1
186,2,1,40.0,36.0,46.0,36.0,1566,1399,1231,1399,335,0,92,235,20,235,72,0,31,26,125,350,600,250,0,0,1
193,2,1,40.0,40.0,46.0,44.0,1678,1595,1343,1595,335,0,158,70,50,70,108,0,31,29,250,350,600,250,0,0,1
200,2,1,42.0,42.0,46.0,44.0,1818,1595,1483,1595,335,0,323,150,175,150,148,0,33,29,250,500,600,250,0,0,1
207,2,1,46.0,44.0,54.0,52.0,1796,1707,1483,1707,313,0,279,210,245,210,34,0,34,32,550,500,600,250,0,0,1
214,2,1,47.0,46.0,54.0,52.0,1824,1679,1511,1679,313,0,114,190,40,190,74,0,35,32,550,500,600,250,0,0,1
221,2,1,49.0,47.0,54.0,52.0,1874,1763,1539,1763,335,0,129,245,15,245,114,0,37,33,550,500,600,250,0,0,1
229,2,1,49.0,47.0,54.0,58.0,2014,1645,1679,1623,335,22,284,239,130,235,154,4,37,31,550,650,600,250,0,200,1
236,2,1,54.0,52.0,54.0,58.0,2076,1762,1763,1651,313,111,85,220,45,200,40,20,39,35,850,650,600,375,0,200,1
243,2,1,55.0,56.0,62.0,66.0,2042,1729,1707,1595,335,134,165,171,85,135,80,36,40,37,850,800,600,375,0,200,1
250,2,1,56.0,59.0,62.0,66.0,2188,1975,1875,1819,313,156,176,221,60,165,116,56,41,42,850,800,600,375,0,200,1
257,2,1,58.0,62.0,62.0,66.0,2110,2003,1819,1847,291,156,377,156,225,80,152,76,43,41,850,800,600,375,0,350,1
264,2,1,55.0,65.0,70.0,66.0,2238,2143,1903,1987,335,156,497,166,305,70,192,96,43,41,850,800,600,375,300,350,1
271,2,1,59.0,66.0,70.0,66.0,2283,2395,1791,2239,492,156,166,316,110,200,56,116,45,47,850,800,600,375,300,350,1
279,2,1,60.0,66.0,70.0,66.0,2334,2474,1707,2295,627,179,138,311,10,175,128,136,46,51,1000,950,600,375,300,350,1
286,2,1,61.0,65.0,85.0,74.0,2395,2670,1791,2491,604,179,431,531,235,375,196,156,47,50,1000,1100,600,375,300,350,1
293,2,1,64.0,72.0,85.0,82.0,2502,2703,1875,2547,627,156,277,82,5,10,272,72,49,50,1000,1100,600,375,300,350,1
300,2,1,68.0,76.0,85.0,82.0,2642,2815,2015,2659,627,156,293,157,45,65,248,92,51,49,1150,1100,750,375,300,350,1
307,2,1,70.0,81.0,85.0,98.0,2726,2843,2099,2687,627,156,74,237,0,125,74,112,53,57,1150,1100,1150,375,300,350,1
314,2,1,72.0,80.0,85.0,98.0,2838,2927,2211,2771,627,156,274,417,120,285,154,132,55,61,1150,1100,1150,375,300,350,1
321,2,1,76.0,87.0,85.0,98.0,3000,3062,2351,2883,649,179,249,172,65,20,184,152,57,59,1150,1100,1150,500,300,350,1
329,2,1,80.0,90.0,85.0,98.0,3185,3146,2491,2967,694,179,369,192,155,120,214,72,59,59,1500,1300,1450,500,300,350,1
336,2,1,83.0,92.0,93.0,114.0,3112,3123,2463,2967,649,156,406,353,170,265,236,88,61,66,1675,1300,1450,500,300,350,1
343,2,1,86.0,94.0,93.0,114.0,3252,3123,2603,2967,649,156,577,533,315,425,262,108,62,69,1850,1300,1750,500,300,350,1
350,2,1,93.0,94.0,93.0,114.0,3174,3398,2547,2995,627,403,288,502,100,380,188,122,64,68,1850,1300,1750,750,300,450,1
357,2,1,93.0,92.5,93.0,120.0,3263,3482,2659,2855,604,627,489,768,225,570,264,198,64,67,2375,1525,1750,750,300,475,1
364,2,1,93.0,104.0,93.0,128.0,3370,3622,2743,2995,627,627,909,413,565,235,344,178,65,67,2375,1700,1900,750,300,500,1
371,2,1,93.0,108.0,93.0,128.0,3448,3722,2799,3051,649,671,925,663,505,405,420,258,65,67,2375,1750,1900,750,300,500,1
379,2,1,101.0,109.0,109.0,128.0,3554,3778,2883,3107,671,671,650,1059,350,725,300,334,65,67,3075,2350,1900,750,300,500,1
386,2,1,106.0,112.5,109.0,128.0,3566,3840,2939,3191,627,649,568,1180,300,770,268,410,65,67,3425,2275,2000,750,300,575,1
393,2,1,107.0,117.5,109.0,128.0,3510,3784,2883,3135,627,649,788,1091,440,605,348,486,65,67,3425,2475,2000,750,300,575,1
400,2,1,109.0,123.5,117.0,136.0,3532,3868,2883,3219,649,649,1034,1191,660,675,374,516,67,66,3425,2775,2000,950,300,575,1
407,2,1,98.0,112.5,117.0,136.0,3594,3706,2967,3079,627,627,1400,1437,950,845,450,592,67,66,2675,2275,2000,950,1225,1325,1
414,2,1,109.0,117.5,117.0,136.0,3476,3784,2827,3135,649,649,455,1397,325,825,130,572,67,69,3550,2425,2000,950,1225,1375,1
421,2,1,110.0,122.0,117.0,142.0,3526,3857,2855,3163,671,694,610,1497,400,845,210,652,68,69,3550,2400,2150,950,1225,1400,1
429,2,1,111.0,125.5,117.0,142.0,3588,3890,2939,3219,649,671,876,1553,640,825,236,728,69,69,3725,2675,2150,950,1275,1625,1
436,2,1,117.0,141.5,117.0,142.0,3526,3986,2855,3359,671,627,712,1135,550,660,162,475,68,69,3725,2925,2150,950,1325,1625,1
443,2,1,116.0,137.0,140.0,150.0,3588,3924,2939,3275,649,649,853,1595,715,1040,138,555,67,69,4250,3250,2150,950,1375,1850,1
450,2,1,112.0,142.5,140.0,150.0,3588,3874,2939,3247,649,627,1264,1361,1050,880,214,481,68,69,3925,3175,2250,950,1700,1975,1
457,2,1,122.0,147.5,148.0,150.0,3672,3874,3023,3247,649,627,944,1441,800,880,144,561,68,69,3925,3825,2250,950,1700,2025,1
464,2,1,129.0,149.5,148.0,150.0,3538,3890,2911,3219,627,671,615,1811,395,1170,220,641,72,69,4750,4225,2400,950,1700,2025,1
471,2,1,134.0,149.0,148.0,156.0,3554,3997,2883,3303,671,694,690,1931,390,1235,300,696,72,69,4750,4500,2400,950,1700,2050,1
479,2,1,138.0,158.0,148.0,164.0,3582,3896,2911,3247,671,649,736,1903,510,1135,226,768,73,69,4850,4450,2400,950,1700,2100,1
486,2,1,141.0,161.0,148.0,188.0,3784,3840,3135,3191,649,649,702,1819,400,975,302,844,76,68,4950,4400,2400,950,2000,2250,1
493,2,1,143.0,166.0,148.0,188.0,4014,3588,3387,2939,627,649,559,1794,385,995,174,799,78,75,4950,4500,2400,950,2100,2250,1
500,2,1,147.0,188.0,148.0,188.0,3935,3538,3331,2911,604,627,635,1025,385,425,250,600,78,75,5150,4850,2400,950,2100,2250,1
507,2,1,146.0,186.5,164.0,196.0,3980,3952,3331,3303,649,649,856,1405,530,725,326,680,79,75,5450,5075,2400,1075,2150,2325,1
514,2,1,157.0,195.5,164.0,196.0,3784,4086,3135,3415,649,671,647,1455,245,695,402,760,79,75,5950,5075,2850,1075,2150,2325,1
521,2,1,164.0,195.5,164.0,212.0,3790,4366,3051,3695,739,671,703,1971,205,1135,498,836,79,75,6250,6175,2850,1075,2150,2325,1
529,2,1,163.0,194.0,180.0,212.0,3902,4238,2939,3611,963,627,999,2478,385,1570,614,908,80,75,6250,6550,2850,1075,2150,2400,1
536,2,1,171.0,199.5,172.0,212.0,3694,4232,2687,3583,1007,649,1054,2638,320,1650,734,988,80,75,6250,6475,3200,1275,2250,2475,1
543,2,1,165.0,194.0,172.0,212.0,3924,4288,2939,3639,985,649,1506,3163,660,2095,846,1068,80,75,6350,6200,3200,1275,2550,2750,1
550,2,1,167.0,190.5,172.0,212.0,3902,4182,2939,3555,963,627,1168,3169,810,2275,358,894,80,75,6700,6025,3300,1275,3000,2925,1
557,2,1,168.0,186.0,172.0,212.0,4137,4428,3107,3779,1030,649,1230,3209,1040,2235,190,974,80,73,6100,5750,3450,1275,3200,3650,1
564,2,1,168.0,173.5,180.0,212.0,4366,3801,3247,3107,1119,694,1360,3264,1030,2210,330,1054,80,68,6050,5175,3450,1275,3750,4675,1
571,2,1,162.0,186.5,180.0,212.0,4226,3672,3107,3023,1119,649,1305,2451,835,1475,470,976,81,68,6600,5375,3450,1275,4050,4975,1
579,2,1,150.0,180.5,180.0,212.0,4333,3616,3079,2967,1254,649,1342,2887,920,1835,422,1052,81,75,6000,5075,3450,1275,4750,5275,1
586,2,1,168.0,182.0,180.0,212.0,4434,3728,3135,3079,1299,649,790,2822,220,1690,570,1132,81,75,6400,5250,3450,1275,4750,5475,1
593,2,1,162.0,183.5,180.0,212.0,4490,3566,3191,2939,1299,627,1332,2848,610,1640,722,1208,81,72,6500,5725,3450,1275,5050,5875,1
600,2,1,173.0,190.5,180.0,212.0,4417,3846,3163,3219,1254,627,819,2968,695,1680,124,1288,83,72,6900,5925,3600,1275,5050,5875,1
607,2,1,173.0,188.0,180.0,212.0,4495,4142,3219,3471,1276,671,945,3453,815,2085,130,1368,77,72,6900,6150,3600,1275,5350,5975,1
614,2,1,145.0,195.5,180.0,212.0,3801,4170,2547,3499,1254,671,1273,2144,995,1425,278,719,68,72,6250,6125,3450,1275,6900,6275,1
621,2,1,130.0,186.5,180.0,212.0,3034,4120,1847,3471,1187,649,1514,2635,1100,1840,414,795,63,72,5450,5575,3450,1275,8400,6750,1
629,2,1,134.0,197.5,180.0,204.0,2580,4120,1595,3471,985,649,1265,2371,1035,1500,230,871,62,72,5900,6475,3600,1725,8550,7050,1
636,2,1,147.0,197.5,180.0,204.0,3006,4232,2043,3583,963,649,787,2066,445,1515,342,551,64,72,6800,7175,3600,1725,8550,7050,1
643,2,1,150.0,197.5,195.0,204.0,3297,3986,2155,3359,1142,627,929,1442,435,1365,494,77,66,72,6400,7925,3600,1725,8550,7050,1
650,2,1,160.0,197.0,203.0,204.0,3342,4092,2043,3443,1299,649,262,1727,220,1670,42,57,70,72,6750,8700,3600,1725,8650,7350,1
657,2,1,162.0,197.0,203.0,204.0,3515,3941,2239,3247,1276,694,274,2197,80,2060,194,137,72,72,6750,9800,3600,1725,8650,7450,1
664,2,1,150.0,183.5,211.0,204.0,3588,3868,2379,3219,1209,649,673,2639,335,2430,338,209,74,72,6975,8775,3600,1725,9525,8475,1
671,2,1,115.0,170.5,203.0,204.0,3241,3706,2099,3079,1142,627,1040,2285,570,2000,470,285,72,72,4075,5425,3350,1725,13025,11375,1
679,2,1,82.0,167.5,203.0,204.0,2597,3700,1679,3051,918,649,733,2285,155,2020,578,265,43,72,3275,4225,3350,1725,15875,12275,1
7,1,2,13.0,13.0,14.0,15.0,377,335,377,335,0,0,45,40,45,40,0,0,12,12,0,0,0,0,0,0,1
14,1,2,13.0,14.0,14.0,15.0,671,643,671,643,0,0,20,65,20,65,0,0,13,13,0,0,0,0,0,0,1
21,1,2,14.0,14.0,14.0,15.0,727,671,727,671,0,0,55,40,55,40,0,0,13,13,0,0,0,0,0,0,1
29,1,2,14.0,15.0,14.0,15.0,699,643,699,643,0,0,145,75,145,75,0,0,13,14,0,0,0,0,0,0,1
36,1,2,16.0,15.0,22.0,15.0,727,699,727,699,0,0,140,120,140,120,0,0,14,14,0,0,0,0,0,0,1
43,1,2,17.0,16.0,22.0,23.0,783,727,783,727,0,0,185,5,185,5,0,0,15,15,0,0,0,0,0,0,1
50,1,2,17.0,17.0,22.0,23.0,755,755,755,755,0,0,280,20,280,20,0,0,17,16,0,0,0,0,0,0,1
57,1,2,17.0,18.0,22.0,23.0,867,783,867,783,0,0,40,15,40,15,0,0,16,17,0,0,0,0,0,0,1
64,1,2,18.0,19.0,22.0,23.0,923,895,923,895,0,0,100,130,100,130,0,0,16,18,0,0,0,0,0,0,1
71,1,2,17.0,19.0,22.0,23.0,923,951,923,951,0,0,180,250,180,250,0,0,17,18,0,0,0,0,0,0,1
79,1,2,18.0,20.0,22.0,23.0,951,967,951,923,0,44,0,313,0,305,0,8,16,19,0,0,0,0,0,0,1
86,1,2,18.0,20.0,22.0,23.0,951,939,951,895,0,44,105,422,105,410,0,12,16,19,0,0,0,0,0,0,1
93,1,2,19.0,20.0,22.0,23.0,923,1068,923,979,0,89,155,404,155,380,0,24,18,20,0,0,0,150,0,0,1
100,1,2,20.0,21.0,22.0,23.0,928,1085,839,951,89,134,231,85,215,45,16,40,18,20,0,0,0,150,0,0,1
107,1,2,20.0,21.0,22.0,23.0,1029,1062,895,951,134,111,362,102,330,50,32,52,19,20,0,0,0,150,0,0,1
114,1,2,20.0,22.0,22.0,23.0,1107,1051,951,895,156,156,392,107,340,35,52,72,20,21,0,0,0,150,0,0,1
121,1,2,22.0,22.0,22.0,23.0,1102,1051,923,895,179,156,362,192,290,100,72,92,20,21,0,0,250,150,0,0,1
129,1,2,26.0,25.0,36.0,31.0,1023,1079,867,923,156,156,238,92,150,55,88,37,20,22,0,0,250,300,0,0,1
136,1,2,28.0,26.0,36.0,31.0,1090,1074,979,895,111,179,75,127,75,70,0,57,20,23,0,0,250,300,0,0,1
143,1,2,28.0,26.0,36.0,31.0,1007,1169,1007,923,0,246,190,274,190,185,0,89,20,23,100,0,250,300,0,0,1
150,1,2,30.0,29.0,36.0,31.0,951,1286,951,951,0,335,200,304,200,200,0,104,22,24,100,125,250,300,0,0,1
157,1,2,29.0,29.0,36.0,31.0,1119,1214,1119,923,0,291,35,246,35,110,0,136,22,24,250,125,250,300,0,0,1
164,1,2,31.0,30.0,36.0,31.0,1147,1275,1147,1007,0,268,80,227,80,105,0,122,23,25,400,125,250,300,0,0,1
171,1,2,32.0,32.0,36.0,46.0,1343,1365,1343,1119,0,246,90,390,90,240,0,150,24,26,400,250,250,300,0,0,1
179,1,2,35.0,34.0,36.0,46.0,1315,1477,1315,1231,0,246,40,463,40,285,0,178,24,26,400,250,250,300,0,0,1
186,1,2,36.0,36.0,36.0,46.0,1427,1482,1427,1259,0,223,165,331,165,125,0,206,24,28,500,250,250,300,0,0,1
193,1,2,38.0,36.0,44.0,46.0,1343,1359,1343,1091,0,268,75,228,75,90,0,138,25,28,450,250,250,300,50,0,1
200,1,2,39.0,38.0,44.0,46.0,1259,1533,1259,1287,0,246,110,316,110,150,0,166,25,30,450,425,250,450,100,0,1
207,1,2,38.5,36.0,44.0,46.0,923,1617,923,1371,0,246,175,359,175,165,0,194,27,30,475,300,250,450,175,125,1
214,1,2,38.5,36.0,52.0,46.0,531,1757,531,1511,0,246,135,326,135,200,0,126,26,32,625,175,250,450,275,250,1
221,1,2,42.5,38.0,52.0,46.0,1007,1762,1007,1539,0,223,35,425,35,275,0,150,28,34,625,175,250,450,275,250,1
229,1,2,44.5,38.0,58.0,46.0,1371,1762,1371,1539,0,223,30,447,30,365,0,82,29,34,625,175,250,850,275,250,1
236,1,2,46.5,46.0,58.0,46.0,1651,1925,1651,1679,0,246,130,205,130,170,0,35,33,36,625,175,250,850,275,250,1
243,1,2,49.0,46.0,58.0,54.0,1768,1981,1679,1735,89,246,186,452,170,385,16,67,34,36,600,550,250,850,300,250,1
250,1,2,51.5,46.0,66.0,54.0,1863,1981,1707,1735,156,246,71,240,35,145,36,95,35,38,575,550,250,850,325,250,1
257,1,2,53.5,52.0,66.0,54.0,1919,1886,1763,1595,156,291,106,101,50,45,56,56,39,38,725,550,250,850,325,250,1
264,1,2,56.5,54.0,66.0,54.0,2082,2020,1903,1707,179,313,196,266,120,170,76,96,39,38,725,925,250,1100,325,250,1
271,1,2,60.5,54.0,66.0,54.0,2143,2126,1987,1791,156,335,212,267,120,135,92,132,39,38,925,925,250,1100,325,250,1
279,1,2,60.5,54.0,74.0,54.0,2255,2126,2099,1791,156,335,367,417,255,245,112,172,39,38,1075,925,250,1100,325,250,1
286,1,2,60.5,54.0,74.0,54.0,2255,2104,2099,1791,156,313,542,583,410,375,132,208,39,38,1075,925,450,1100,325,250,1
293,1,2,72.5,62.0,82.0,62.0,2255,2182,2099,1847,156,335,202,383,200,210,2,173,39,38,1175,925,450,1100,325,250,1
300,1,2,73.5,62.0,82.0,70.0,2311,2154,2155,1819,156,335,347,543,325,330,22,213,38,38,1175,1550,450,1550,325,250,1
307,1,2,79.5,65.0,90.0,70.0,2194,2104,2015,1791,179,313,57,534,40,360,17,174,36,40,1325,1550,450,1550,325,250,1
314,1,2,80.5,64.0,90.0,70.0,2082,2020,1903,1707,179,313,147,884,110,670,37,214,36,40,2025,1550,450,1550,325,250,1
321,1,2,81.5,70.0,90.0,70.0,2003,2216,1847,1791,156,425,338,610,285,415,53,195,42,41,2125,1925,450,1550,325,250,1
329,1,2,85.5,78.0,90.0,78.0,2143,2149,1987,1679,156,470,263,355,215,175,48,180,44,41,2125,2400,700,1550,325,250,1
336,1,2,91.0,76.0,98.0,86.0,2227,2255,1959,1763,268,492,233,526,195,290,38,236,44,41,2100,2275,700,1550,350,375,1
343,1,2,84.0,74.0,106.0,86.0,2266,2233,1931,1763,335,470,153,792,125,500,28,292,37,43,1650,2150,700,1550,1150,500,1
350,1,2,82.0,72.0,106.0,94.0,1354,2261,1063,1791,291,470,285,687,225,410,60,277,35,43,1950,1975,700,1550,1250,1050,1
357,1,2,84.0,74.0,106.0,102.0,514,2401,335,1931,179,470,76,312,0,200,76,112,32,43,2200,1725,700,1550,1400,1300,1
364,1,2,79.0,72.0,106.0,102.0,407,2451,363,1959,44,492,116,593,40,425,76,168,31,43,2500,1975,700,1550,1650,1425,1
371,1,2,75.0,66.0,106.0,102.0,447,2479,447,1987,0,492,96,624,20,400,76,224,30,43,2350,1475,700,1550,1950,1925,1
379,1,2,77.0,73.0,106.0,102.0,1203,2429,1203,1959,0,470,106,340,30,185,76,155,30,45,2300,1250,575,1550,2125,2150,1
386,1,2,77.0,76.0,106.0,102.0,979,2345,979,1875,0,470,121,435,45,245,76,190,33,45,2200,2000,575,1550,2225,2150,1
393,1,2,78.0,72.0,106.0,102.0,1426,2479,1315,1987,111,492,266,735,170,485,96,250,35,45,2200,1750,575,1550,2225,2400,1
400,1,2,86.0,82.0,106.0,102.0,1914,2373,1735,1903,179,470,101,256,85,100,16,156,38,46,2200,1750,575,1550,2225,2400,1
407,1,2,88.0,84.0,106.0,102.0,2087,2367,1931,1875,156,492,142,427,110,215,32,212,38,46,2200,2425,575,1550,2225,2400,1
414,1,2,89.5,77.0,106.0,102.0,1975,2390,1707,1875,268,515,77,712,5,440,72,272,40,47,2175,2050,575,1550,2450,2825,1
421,1,2,82.5,67.0,106.0,102.0,1662,2356,1371,1819,291,537,219,991,115,655,104,336,35,47,2225,1425,575,1550,2850,3450,1
429,1,2,81.5,68.0,114.0,102.0,822,2474,755,1847,67,627,154,498,50,465,104,33,39,47,2125,1050,575,1850,3050,3825,1
436,1,2,83.5,64.0,114.0,102.0,1147,2580,1147,1931,0,649,144,798,40,685,104,113,41,47,2125,1550,575,1850,3050,4075,1
443,1,2,83.5,57.0,114.0,102.0,1427,2530,1427,1903,0,627,144,1059,40,870,104,189,42,48,2125,925,575,1850,3050,4700,1
450,1,2,84.5,62.0,114.0,102.0,1371,2558,1371,1931,0,627,254,814,150,795,104,19,43,48,2125,1175,575,1850,3050,4700,1
457,1,2,81.0,63.0,114.0,102.0,1483,2580,1483,1931,0,649,319,1075,215,980,104,95,43,49,2100,1425,575,1850,3350,4700,1
7,1,2,13.0,13.0,14.0,15.0,419,377,419,377,0,0,50,45,50,45,0,0,12,12,0,0,0,0,0,0,1
14,1,2,13.0,14.0,14.0,15.0,671,671,671,671,0,0,20,70,20,70,0,0,13,13,0,0,0,0,0,0,1
21,1,2,14.0,14.0,14.0,15.0,727,671,727,671,0,0,55,45,55,45,0,0,13,13,0,0,0,0,0,0,1
29,1,2,14.0,15.0,14.0,15.0,727,671,727,671,0,0,150,30,150,30,0,0,13,14,0,0,0,0,0,0,1
36,1,2,16.0,15.0,22.0,15.0,755,755,755,755,0,0,145,130,145,130,0,0,14,14,0,0,0,0,0,0,1
43,1,2,16.0,16.0,22.0,23.0,783,783,783,783,0,0,230,15,230,15,0,0,16,15,0,0,0,0,0,0,1
50,1,2,15.0,17.0,22.0,23.0,839,783,839,783,0,0,25,40,25,40,0,0,15,16,0,0,0,0,0,0,1
57,1,2,17.0,18.0,22.0,23.0,867,783,867,783,0,0,35,45,35,45,0,0,15,17,0,0,0,0,0,0,1
64,1,2,18.0,19.0,22.0,23.0,895,951,895,951,0,0,80,115,80,115,0,0,16,18,0,0,0,0,0,0,1
71,1,2,17.0,19.0,22.0,23.0,895,917,895,895,0,22,165,219,165,215,0,4,17,18,0,0,0,0,0,0,1
79,1,2,17.0,20.0,22.0,23.0,923,984,923,895,0,89,25,341,25,325,0,16,16,19,0,0,0,0,0,0,1
86,1,2,18.0,20.0,22.0,23.0,923,1034,923,923,0,111,80,67,80,35,0,32,16,19,0,0,0,0,0,0,1
93,1,2,19.0,21.0,22.0,23.0,867,1029,867,895,0,134,135,133,135,85,0,48,17,20,0,0,0,150,0,0,1
100,1,2,19.0,21.0,22.0,23.0,934,1074,867,895,67,179,247,103,235,35,12,68,19,21,0,0,0,150,0,0,1
107,1,2,20.0,22.0,22.0,23.0,995,1051,839,895,156,156,322,104,290,20,32,84,19,21,0,0,0,150,0,0,1
114,1,2,20.0,22.0,22.0,23.0,1079,1135,923,979,156,156,337,134,285,30,52,104,20,21,0,0,0,150,0,0,1
121,1,2,26.0,23.0,28.0,23.0,1079,1107,923,951,156,156,72,209,0,85,72,124,20,22,0,0,250,150,0,0,1
129,1,2,26.0,23.0,36.0,23.0,1074,1079,895,923,179,156,197,294,105,150,92,144,20,22,0,0,250,150,0,0,1
136,1,2,28.0,26.0,36.0,31.0,1062,1191,951,923,111,268,20,309,20,150,0,159,20,23,0,0,250,300,0,0,1
143,1,2,28.0,27.0,36.0,31.0,1035,1202,1035,867,0,335,145,99,145,50,0,49,20,24,100,0,250,300,0,0,1
150,1,2,26.0,28.0,36.0,31.0,839,1174,839,839,0,335,385,94,385,55,0,39,20,25,150,0,250,300,0,0,1
157,1,2,27.0,29.0,36.0,46.0,615,1286,615,951,0,335,55,150,55,75,0,75,19,25,350,0,250,300,0,0,1
164,1,2,29.0,31.0,36.0,46.0,503,1292,503,979,0,313,15,86,15,25,0,61,19,27,350,0,250,300,0,0,1
171,1,2,32.0,34.0,36.0,46.0,475,1348,475,1035,0,313,195,101,195,0,0,101,20,28,450,125,250,300,0,0,1
179,1,2,34.0,35.0,36.0,46.0,503,1516,503,1203,0,313,175,241,175,100,0,141,20,29,500,125,250,300,0,0,1
186,1,2,34.0,40.0,36.0,46.0,559,1516,559,1203,0,313,235,121,235,90,0,31,20,31,650,125,250,600,0,0,1
193,1,2,35.0,36.0,36.0,46.0,587,1426,587,1091,0,335,205,196,205,125,0,71,20,29,700,125,250,600,50,100,1
200,1,2,36.0,35.0,36.0,46.0,587,950,587,615,0,335,80,162,80,80,0,82,17,28,700,175,250,600,50,275,1
207,1,2,32.5,31.0,36.0,54.0,643,710,643,419,0,291,55,239,55,125,0,114,13,24,725,175,250,600,200,475,1
214,1,2,30.0,26.0,36.0,54.0,587,626,587,335,0,291,115,310,115,160,0,150,11,19,700,475,250,600,325,725,1
221,1,2,27.0,23.0,36.0,54.0,643,631,643,363,0,268,100,82,100,50,0,32,11,13,650,475,250,700,575,1025,1
229,1,2,28.0,23.0,36.0,54.0,531,502,531,279,0,223,55,91,55,35,0,56,10,12,750,600,250,700,625,1075,1
236,1,2,29.0,21.0,36.0,54.0,615,172,615,83,0,89,80,154,80,90,0,64,10,11,850,600,250,700,625,1125,1
243,1,2,27.5,21.0,36.0,54.0,559,94,559,27,0,67,100,167,100,95,0,72,10,11,775,900,250,700,750,1125,1
250,1,2,27.5,23.0,36.0,54.0,587,99,587,55,0,44,65,81,65,5,0,76,10,11,725,900,250,700,850,1125,1
257,1,2,26.5,24.0,36.0,54.0,587,491,587,447,0,44,90,84,90,25,0,59,10,11,725,900,250,700,950,1125,1
264,1,2,25.5,23.0,36.0,54.0,587,626,587,559,0,67,110,117,110,50,0,67,10,11,675,1025,250,700,1050,1125,1
271,1,2,25.5,23.0,36.0,54.0,587,570,587,503,0,67,80,175,80,100,0,75,10,11,625,1025,250,700,1150,1125,1
279,1,2,27.0,25.0,36.0,54.0,559,491,559,447,0,44,40,84,40,5,0,79,10,11,700,1025,250,700,1175,1125,1
286,1,2,29.0,27.0,36.0,62.0,587,570,587,503,0,67,30,102,30,15,0,87,12,13,750,1025,250,700,1175,1125,1
293,1,2,27.5,27.0,36.0,62.0,671,676,671,587,0,89,50,189,50,90,0,99,14,14,625,1025,250,700,1300,1125,1
300,1,2,27.0,26.0,36.0,62.0,811,670,811,559,0,111,45,221,45,110,0,111,15,14,500,1025,250,550,1425,1275,1
307,1,2,29.0,27.0,36.0,62.0,783,704,783,615,0,89,50,158,50,35,0,123,17,14,500,1025,250,550,1425,1275,1
314,1,2,32.0,28.0,36.0,70.0,979,721,979,587,0,134,30,199,30,60,0,139,19,14,500,1025,250,550,1425,1275,1
321,1,2,30.5,30.0,36.0,70.0,1007,833,1007,699,0,134,65,210,65,55,0,155,20,16,475,1025,250,550,1450,1275,1
329,1,2,31.0,31.0,36.0,70.0,1119,866,1119,755,0,111,30,207,30,40,0,167,21,17,450,1025,250,550,1475,1275,1
336,1,2,34.0,32.0,36.0,70.0,1119,1029,1119,895,0,134,15,278,15,95,0,183,21,18,450,1025,250,650,1475,1275,1
343,1,2,35.0,33.0,36.0,70.0,1231,1029,1231,895,0,134,15,209,15,10,0,199,24,19,450,1025,375,650,1475,1275,1
350,1,2,36.0,34.0,36.0,70.0,1287,1012,1287,923,0,89,20,227,20,20,0,207,26,20,450,1025,500,650,1475,1275,1
357,1,2,36.0,36.0,36.0,70.0,1119,1197,1119,1063,0,134,50,268,50,45,0,223,25,22,450,1025,500,650,1575,1275,1
364,1,2,38.0,38.0,44.0,70.0,1063,1225,1063,1091,0,134,95,319,95,80,0,239,26,24,450,1025,500,650,1575,1275,1
371,1,2,38.5,42.0,52.0,70.0,1371,1370,1371,1259,0,111,205,131,205,30,0,101,29,25,425,1025,500,650,1600,1275,1
379,1,2,38.5,44.0,52.0,70.0,1399,1482,1399,1371,0,111,30,202,30,85,0,117,30,27,425,1025,500,650,1600,1275,1
386,1,2,41.5,45.0,52.0,70.0,1539,1510,1539,1399,0,111,90,229,90,100,0,129,30,28,425,1025,500,650,1600,1275,1
393,1,2,45.5,46.0,52.0,70.0,1623,1566,1623,1455,0,111,30,415,30,270,0,145,32,29,425,1025,500,800,1600,1275,1
400,1,2,47.5,50.0,52.0,70.0,1763,1706,1763,1595,0,111,150,432,150,300,0,132,36,31,425,1450,500,800,1600,1275,1
407,1,2,50.5,51.0,52.0,70.0,1813,1729,1791,1595,22,134,59,433,55,285,4,148,37,32,425,1450,500,800,1600,1275,1
414,1,2,48.5,52.0,52.0,70.0,2014,1785,1903,1651,111,134,255,594,235,430,20,164,35,33,425,1450,500,800,1750,1275,1
421,1,2,51.0,54.0,52.0,70.0,1835,1818,1679,1707,156,111,130,711,90,535,40,176,37,35,400,1450,500,800,1775,1275,1
429,1,2,52.0,57.0,60.0,70.0,1919,1902,1763,1791,156,111,170,623,110,460,60,163,39,36,550,1575,500,800,1775,1275,1
436,1,2,52.0,59.0,68.0,70.0,1914,1886,1735,1707,179,179,395,292,315,105,80,187,39,38,550,1575,500,800,1775,1275,1
443,1,2,56.0,59.0,76.0,70.0,2026,1964,1847,1651,179,313,240,182,140,55,100,127,41,38,700,1575,500,800,1775,1275,1
450,1,2,56.0,63.0,82.0,78.0,1785,1992,1651,1679,134,313,132,252,120,110,12,142,40,40,700,1575,625,800,1875,1275,1
457,1,2,59.0,65.0,82.0,86.0,1874,2070,1763,1735,111,335,84,297,60,115,24,182,40,42,700,1700,625,950,1875,1275,1
464,1,2,62.0,65.0,82.0,86.0,2138,2205,1959,1847,179,358,194,257,150,35,44,222,44,42,700,1700,625,950,1875,1275,1
471,1,2,66.0,67.0,82.0,86.0,2222,2210,2043,1875,179,335,269,413,205,155,64,258,44,44,700,1700,625,950,1875,1275,1
479,1,2,71.5,68.0,82.0,86.0,2110,2216,1931,1903,179,313,259,589,175,295,84,294,44,45,925,1700,750,1200,1950,1275,1
486,1,2,72.5,72.0,82.0,86.0,2283,2300,2127,1987,156,313,435,364,335,280,100,84,43,47,1225,1700,750,1200,2000,1275,1
493,1,2,74.5,73.0,82.0,86.0,2395,2289,2239,1931,156,358,315,322,195,240,120,82,49,48,1225,1850,750,1450,2000,1275,1
500,1,2,76.5,74.0,82.0,86.0,2479,2384,2323,1847,156,537,240,434,150,280,90,154,48,49,1225,1850,750,1450,2000,1275,1
507,1,2,76.5,77.0,82.0,101.0,2647,2496,2491,1847,156,649,265,324,255,90,10,234,52,51,1225,1850,750,1450,2000,1275,1
514,1,2,81.5,83.0,82.0,101.0,2787,2658,2631,1987,156,671,290,245,260,35,30,210,54,53,1325,1850,750,1450,2050,1275,1
521,1,2,81.5,85.0,82.0,101.0,2642,2804,2463,2155,179,649,560,431,510,145,50,286,59,55,1325,2200,750,1450,2050,1275,1
529,1,2,82.0,86.0,82.0,101.0,2698,2950,2519,2323,179,627,640,582,570,220,70,362,59,56,1250,2200,750,1450,2125,1275,1
536,1,2,81.5,89.0,82.0,101.0,3011,3000,2855,2351,156,649,731,657,645,215,86,442,59,59,1175,2200,750,1450,2200,1275,1
543,1,2,80.5,93.0,82.0,109.0,2860,3056,2659,2407,201,649,969,572,855,150,114,422,61,60,1175,2200,950,1750,2200,1275,1
550,1,2,88.5,93.0,90.0,109.0,2860,3168,2547,2519,313,649,824,848,670,350,154,498,62,62,1175,2550,950,1900,2200,1275,1
557,1,2,90.5,93.0,114.0,109.0,3190,3241,2743,2547,447,694,809,743,745,165,64,578,62,62,1175,2550,950,2050,2200,1275,1
564,1,2,91.5,93.0,122.0,109.0,2972,3414,2547,2743,425,671,1039,1154,927,500,112,654,61,62,1575,2550,1200,2050,2250,1275,1
571,1,2,93.5,103.0,128.0,125.0,2871,3258,2491,2631,380,627,1088,836,1032,110,56,726,61,62,1925,3050,1200,2050,2300,1275,1
579,1,2,99.5,105.0,128.0,133.0,3246,3336,2687,2687,559,649,1025,1151,897,345,128,806,60,62,1975,3150,1200,2050,2400,1275,1
586,1,2,100.0,106.0,128.0,133.0,3056,2776,2407,2127,649,649,1041,1311,937,425,104,886,66,62,1850,3025,1200,2350,2575,1400,1
593,1,2,103.0,114.0,128.0,141.0,3202,2670,2575,2043,627,627,1082,1142,902,180,180,962,70,62,1600,3425,1200,2350,2825,1400,1
600,1,2,105.0,117.0,128.0,141.0,3258,2854,2631,2183,627,671,1152,967,992,75,160,892,72,65,1600,3425,1200,2350,2825,1400,1
607,1,2,110.5,117.0,128.0,141.0,3336,2602,2687,1931,649,671,707,1163,567,195,140,968,69,65,1725,3425,1450,2450,2900,1400,1
614,1,2,106.5,120.0,128.0,141.0,3521,2692,2827,2043,694,649,1118,1279,860,235,258,1044,64,68,1925,3425,1450,2450,3174,1400,1
621,1,2,108.5,123.0,128.0,149.0,3498,3286,2827,2659,671,627,864,1035,730,265,134,770,61,71,2425,3425,1700,2450,3324,1400,1
629,1,2,114.5,124.0,128.0,164.0,3224,3392,2575,2743,649,649,786,995,730,145,56,850,62,71,2825,3425,1700,2450,3324,1400,1
636,1,2,114.5,127.0,128.0,164.0,3084,3420,2435,2771,649,649,846,1110,710,180,136,930,66,74,2825,3425,1700,2450,3324,1400,1
643,1,2,122.5,131.0,128.0,164.0,3280,3448,2519,2799,761,649,606,1361,545,355,61,1006,66,78,2825,3425,2000,2450,3324,1400,1
650,1,2,125.5,134.0,144.0,164.0,3521,3857,2715,3163,806,694,551,1440,490,350,61,1090,65,82,3125,3425,2000,2450,3324,1400,1
657,1,2,131.5,134.0,152.0,172.0,3633,4002,2827,3107,806,895,686,1632,525,430,161,1202,66,82,3475,3425,2000,2450,3324,1400,1
664,1,2,137.5,142.0,152.0,172.0,3683,4165,2855,3247,828,918,527,931,420,425,107,506,71,85,3775,3425,2000,2800,3324,1400,1
671,1,2,145.5,142.0,152.0,180.0,3678,3717,2827,2799,851,918,408,912,355,290,53,622,75,85,3825,4225,2125,2800,3324,1400,1
679,1,2,151.5,148.0,152.0,180.0,3823,3991,2995,2827,828,1164,284,564,260,240,24,324,78,85,3975,4225,2125,2800,3374,1400,1
686,1,2,151.5,148.0,152.0,180.0,3778,4254,2995,3023,783,1231,241,1093,125,625,116,468,78,85,3975,4425,2125,2950,3374,1400,1
693,1,2,151.0,148.0,152.0,180.0,3806,4478,3023,3247,783,1231,501,735,285,115,216,620,78,85,4000,4875,2125,2950,3424,1400,1
700,1,2,149.5,148.0,152.0,180.0,4014,4366,3163,3135,851,1231,799,1119,475,355,324,764,77,85,4925,4875,2125,3400,3449,1400,1
707,1,2,165.5,156.0,184.0,180.0,4254,4574,3247,3387,1007,1187,149,760,55,460,94,300,77,85,4925,4875,2125,3800,3449,1400,1
714,1,2,169.5,156.0,192.0,180.0,4254,4618,3247,3387,1007,1231,160,1173,50,725,110,448,77,85,4725,5775,2125,3800,3649,1400,1
721,1,2,173.5,144.0,200.0,180.0,4254,4697,3247,3443,1007,1254,372,1674,150,1078,222,596,77,85,4625,5175,2125,4400,3749,1887,1
729,1,2,181.5,150.0,200.0,180.0,4344,4590,3359,3359,985,1231,483,1398,145,1258,338,140,77,85,5775,5075,2125,4850,3749,1987,1
736,1,2,184.0,150.0,200.0,180.0,4327,4534,3387,3303,940,1231,345,1781,145,1493,200,288,77,85,6200,5075,2125,4850,3774,1987,1
743,1,2,187.5,150.0,200.0,180.0,4243,4478,3303,3247,940,1231,495,2008,275,1568,220,440,77,85,6725,5975,2125,5250,3849,1987,1
750,1,2,194.0,146.0,200.0,180.0,4266,4467,3303,3191,963,1276,555,2131,215,1843,340,288,77,85,7400,5550,2125,5250,3999,2412,1
757,1,2,199.0,154.0,200.0,180.0,4288,4383,3303,3107,985,1276,251,1934,45,1498,206,436,77,85,7400,5875,2125,5250,4049,2787,1
764,1,2,200.0,156.0,200.0,180.0,4411,4305,3359,3051,1052,1254,321,1846,195,1608,126,238,77,85,7950,6525,2125,5250,4049,2787,1
771,1,2,198.5,168.0,206.0,180.0,4288,4187,3303,2911,985,1276,769,958,535,918,234,40,79,85,8475,6425,2125,5550,4274,2887,1
779,1,2,197.0,166.0,206.0,180.0,4103,4215,3163,2939,940,1276,896,1473,550,1273,346,200,79,85,8550,7475,2125,5700,4724,3212,1
786,1,2,191.0,152.0,206.0,172.0,4159,3846,3219,2659,940,1187,821,1913,355,1573,466,340,79,78,7200,6825,2125,5250,6074,4837,1
793,1,2,194.5,166.0,214.0,172.0,4014,3286,3051,2211,963,1075,906,1172,320,1008,586,164,79,78,6975,7475,2125,5250,6349,4837,1
800,1,2,187.5,171.0,214.0,172.0,4114,3454,3107,2379,1007,1075,784,996,384,858,400,138,79,78,7050,8275,2125,5100,6686,5312,1
807,1,2,182.5,169.0,214.0,172.0,4092,3157,3107,2127,985,1030,741,1377,229,1123,512,254,79,80,6800,7700,2125,5100,7711,5487,1
814,1,2,182.5,171.0,214.0,172.0,4176,3134,3191,2127,985,1007,823,1406,199,1128,624,278,79,81,6850,8000,2125,5100,8311,5637,1
821,1,2,169.5,165.0,214.0,164.0,4098,3101,3135,2071,963,1030,709,710,169,558,540,152,79,81,5300,6775,2125,4800,10311,7562,1
829,1,2,148.0,157.0,214.0,149.0,3991,3056,3051,2071,940,985,845,1085,189,813,656,272,79,81,3725,6950,2125,4600,12336,8862,1
836,1,2,129.5,151.0,214.0,165.0,4042,3073,3079,2043,963,1030,1175,849,449,453,726,396,79,81,2300,6325,2125,4600,13811,9262,1
843,1,2,141.5,159.0,214.0,165.0,4042,2994,3079,1987,963,1007,591,510,24,198,567,312,79,81,2150,6325,2125,4600,13961,9262,1
850,1,2,143.5,160.0,214.0,165.0,4008,3050,3023,2043,985,1007,567,780,34,348,533,432,78,80,2950,7125,2125,4600,14161,9312,1
857,1,2,141.5,160.0,208.0,181.0,3946,3022,2939,2015,1007,1007,872,1141,269,593,603,548,77,80,3150,7125,2125,4600,14811,9312,1
864,1,2,147.5,160.0,208.0,181.0,3924,3112,2939,2127,985,985,814,812,224,298,590,514,77,80,4250,7125,2125,4600,14861,9312,1
871,1,2,146.5,168.0,208.0,181.0,3734,2804,2771,1819,963,985,956,327,254,293,702,34,77,80,4300,7125,2125,4600,14911,9312,1
879,1,2,154.5,168.0,208.0,181.0,3683,2804,2743,1819,940,985,797,472,129,318,668,154,76,80,4650,7125,2125,4600,14911,9312,1
886,1,2,159.5,168.0,208.0,181.0,3622,3000,2659,2015,963,985,977,617,189,343,788,274,76,80,4950,8025,2125,4600,14911,9312,1
893,1,2,167.5,170.0,208.0,189.0,3762,3398,2799,2323,963,1075,992,760,134,508,858,252,77,80,5050,8225,2125,4600,14911,9312,1
900,1,2,174.5,170.0,208.0,197.0,3672,2765,2687,1735,985,1030,833,1061,59,693,774,368,77,80,5600,8225,2125,4600,14986,9312,1
907,1,2,176.0,164.0,208.0,197.0,3829,3207,2799,2155,1030,1052,939,379,149,333,790,46,77,80,5625,7625,2125,4600,15111,9912,1
914,1,2,165.5,164.0,208.0,212.0,3868,3381,2883,2351,985,1030,846,758,194,588,652,170,77,80,5100,8225,2125,4800,15786,9912,1
921,1,2,166.5,160.0,208.0,212.0,3627,3045,2687,2015,940,1030,543,1142,29,848,514,294,78,80,4600,7775,2125,4800,16286,10312,1
929,1,2,172.5,160.0,208.0,212.0,3739,3554,2799,2547,940,1007,608,1220,24,798,584,422,78,80,5750,7775,2125,4800,16286,10312,1
936,1,2,176.5,164.0,208.0,227.0,3790,3504,2827,2407,963,1097,813,968,134,718,679,250,78,80,6050,7775,2125,5000,16286,10312,1
943,1,2,170.5,176.0,208.0,227.0,3745,3291,2715,2239,1030,1052,923,208,124,138,799,70,77,80,5600,8025,2125,5150,17386,10662,1
950,1,2,177.0,181.0,214.0,235.0,3974,3375,2967,2323,1007,1052,950,362,139,168,811,194,77,82,6375,9175,2125,5150,17411,10662,1
957,1,2,164.5,165.0,214.0,235.0,3952,3493,2967,2463,985,1030,1052,792,129,478,923,314,77,82,5050,7750,2125,5400,18711,12037,1
964,1,2,149.0,155.0,214.0,235.0,3958,4002,2995,2883,963,1119,913,1211,74,753,839,458,81,85,3625,6775,2125,5500,20336,13062,1
971,1,2,138.0,167.0,206.0,235.0,4131,4434,3191,3135,940,1299,1109,832,154,218,955,614,81,85,2825,6950,2125,5500,21686,13412,1
978,1,2,131.0,163.0,206.0,235.0,4120,4540,3135,3219,985,1321,961,1348,94,578,867,770,81,85,2125,6800,2125,5500,22536,13762,1
7,2,2,13.0,13.0,15.0,15.0,335,293,335,293,0,0,40,35,40,35,0,0,12,12,0,0,0,0,0,0,0
14,2,2,14.0,14.0,15.0,15.0,671,671,671,671,0,0,70,70,70,70,0,0,13,13,0,0,0,0,0,0,0
21,2,2,14.0,14.0,15.0,15.0,671,699,671,699,0,0,50,45,50,45,0,0,13,13,0,0,0,0,0,0,0
29,2,2,15.0,15.0,15.0,15.0,727,727,727,727,0,0,100,85,100,85,0,0,14,14,0,0,0,0,0,0,0
36,2,2,16.0,15.0,23.0,23.0,727,839,727,839,0,0,135,140,135,140,0,0,15,14,0,0,0,0,0,0,0
43,2,2,16.0,16.0,23.0,23.0,755,811,755,811,0,0,35,30,35,30,0,0,15,15,0,0,0,0,0,0,0
50,2,2,17.0,17.0,23.0,23.0,811,839,811,839,0,0,10,50,10,50,0,0,16,16,0,0,0,0,0,0,0
57,2,2,18.0,18.0,23.0,23.0,839,923,839,923,0,0,45,115,45,115,0,0,17,17,0,0,0,0,0,0,0
64,2,2,19.0,19.0,23.0,23.0,923,951,923,951,0,0,105,170,105,170,0,0,18,18,0,0,0,0,0,0,0
71,2,2,19.0,19.0,23.0,23.0,923,973,923,951,0,22,20,289,20,285,0,4,18,18,0,0,0,0,0,0,0
79,2,2,20.0,20.0,23.0,23.0,967,990,923,923,44,67,133,362,125,350,8,12,19,19,0,0,0,0,0,0,0
86,2,2,21.0,20.0,23.0,23.0,1079,1012,923,923,156,89,68,69,40,45,28,24,20,19,0,0,150,0,0,0,0
93,2,2,22.0,20.0,23.0,23.0,1124,1006,923,895,201,111,147,55,95,15,52,40,21,20,0,0,150,150,0,0,0
100,2,2,22.0,20.0,23.0,23.0,1180,1023,979,867,201,156,186,90,110,30,76,60,21,20,0,0,150,150,0,0,0
107,2,2,23.0,21.0,23.0,23.0,1219,995,951,839,268,156,273,170,165,90,108,80,22,20,0,0,150,150,0,0,0
114,2,2,24.0,22.0,31.0,23.0,1258,1018,923,839,335,179,373,140,225,40,148,100,23,21,0,0,300,150,0,0,0
121,2,2,24.0,22.0,31.0,23.0,1286,1074,951,895,335,179,519,275,335,155,184,120,23,21,0,0,450,150,0,0,0
129,2,2,29.0,22.0,31.0,31.0,1236,1068,923,867,313,201,160,404,90,260,70,144,24,22,0,0,450,300,0,0,0
136,2,2,29.0,24.0,31.0,31.0,1236,1141,923,895,313,246,210,116,100,40,110,76,24,22,0,0,450,300,0,0,0
143,2,2,29.0,25.0,31.0,31.0,1208,1169,895,923,313,246,360,113,210,5,150,108,25,22,0,0,450,300,0,0,0
150,2,2,29.0,25.0,31.0,31.0,1242,1135,951,867,291,268,211,254,175,110,36,144,25,22,0,175,450,300,0,0,0
157,2,2,31.0,27.0,39.0,46.0,1236,1169,923,923,313,246,186,217,160,95,26,122,25,23,350,175,450,300,0,0,0
164,2,2,33.0,27.0,39.0,54.0,1208,984,895,671,313,313,152,177,140,15,12,162,25,23,350,175,450,300,0,0,0
171,2,2,33.0,27.0,39.0,54.0,1236,917,923,604,313,313,307,296,255,98,52,198,25,23,350,175,450,300,0,0,0
179,2,2,33.0,28.0,39.0,54.0,1258,1332,923,1019,335,313,457,310,365,72,92,238,25,23,350,175,450,300,0,0,0
186,2,2,33.0,28.0,39.0,54.0,1230,1432,895,1097,335,335,602,465,470,187,132,278,25,23,525,350,450,450,0,0,0
193,2,2,36.0,29.0,39.0,54.0,1292,1371,979,1080,313,291,458,466,440,156,18,310,25,24,700,350,750,450,0,0,0
200,2,2,37.0,32.0,39.0,54.0,1258,1506,923,1215,335,291,158,379,100,79,58,300,25,24,700,350,750,450,0,0,0
207,2,2,37.0,34.0,39.0,54.0,1258,1578,923,1265,335,313,153,449,55,113,98,336,25,26,700,350,750,550,0,0,0
214,2,2,38.0,35.0,39.0,54.0,1236,1701,923,1500,313,201,304,494,170,138,134,356,26,27,700,350,750,700,0,0,0
221,2,2,42.0,37.0,47.0,54.0,1292,1606,979,1450,313,156,104,332,80,56,24,276,27,29,1000,350,750,800,0,0,0
229,2,2,42.0,37.0,47.0,54.0,1398,1763,1063,1584,335,179,169,461,105,165,64,296,27,29,1000,525,750,800,0,0,0
236,2,2,43.0,42.0,47.0,54.0,1348,1919,1035,1651,313,268,170,279,70,47,100,232,28,31,1000,525,750,800,0,0,0
243,2,2,43.0,42.0,47.0,54.0,1404,2014,1091,1679,313,335,40,359,0,187,40,172,28,31,1000,850,750,800,0,175,0
250,2,2,44.0,42.0,47.0,62.0,1398,2042,1063,1707,335,335,195,513,115,301,80,212,29,32,1300,850,750,900,0,175,0
257,2,2,45.0,42.0,55.0,62.0,1370,2003,1035,1668,335,335,301,450,185,348,116,102,30,32,1300,850,850,1150,0,175,0
264,2,2,45.0,48.0,55.0,62.0,1292,1987,979,1629,313,358,302,113,150,63,152,50,30,32,1300,1200,850,1150,0,175,0
271,2,2,46.0,47.0,70.0,62.0,1236,2060,923,1657,313,403,402,200,210,152,192,48,31,29,1300,1200,850,1150,0,375,0
279,2,2,47.0,45.0,70.0,62.0,1398,1488,1063,1108,335,380,522,355,290,263,232,92,31,28,1300,1375,1100,1250,0,475,0
286,2,2,48.0,50.0,70.0,62.0,1594,1522,1259,1231,335,291,322,105,200,81,122,24,32,29,1300,1375,1100,1250,0,475,0
293,2,2,54.0,52.0,70.0,62.0,1650,1825,1315,1534,335,291,113,161,55,101,58,60,34,30,1475,1725,1100,1250,0,475,0
300,2,2,55.0,55.0,70.0,62.0,1762,1981,1427,1623,335,358,223,85,125,31,98,54,35,31,1650,1725,1100,1250,0,475,0
307,2,2,56.0,54.0,70.0,62.0,1768,1902,1455,1567,313,335,384,287,250,197,134,90,36,31,1650,1900,1100,1250,0,525,0
314,2,2,57.0,59.0,70.0,62.0,1930,1679,1595,1366,335,313,69,141,45,119,24,22,37,32,1650,1900,1250,1250,0,525,0
321,2,2,58.0,60.0,70.0,62.0,1902,2009,1567,1629,335,380,164,224,100,154,64,70,38,33,1650,2250,1250,1250,0,525,0
329,2,2,63.0,61.0,70.0,62.0,1936,1987,1623,1517,313,470,45,355,45,221,0,134,39,33,1825,2250,1250,1250,0,525,0
336,2,2,64.0,62.0,70.0,62.0,1964,1903,1651,1276,313,627,185,484,145,274,40,210,40,34,2000,2250,1250,1250,0,525,0
343,2,2,68.0,63.0,78.0,70.0,2037,2121,1679,1517,358,604,89,718,55,436,34,282,42,36,2175,2250,1350,1250,0,525,0
350,2,2,69.0,64.0,78.0,70.0,2042,2143,1595,1539,447,604,275,507,185,157,90,350,43,37,2175,2250,1350,1400,0,525,0
357,2,2,70.0,64.0,78.0,78.0,2093,2245,1623,1663,470,582,381,624,235,210,146,414,44,37,2175,2250,1350,1400,0,525,0
364,2,2,70.0,69.0,86.0,78.0,2171,2228,1679,1646,492,582,636,503,430,117,206,386,45,38,2175,2250,1650,1400,0,525,0
371,2,2,72.0,73.0,86.0,78.0,2177,2474,1707,1847,470,627,657,453,520,91,137,362,46,39,2175,2600,1650,1400,0,525,0
379,2,2,76.0,73.0,94.0,78.0,2339,2367,1847,1763,492,604,117,715,95,281,22,434,46,39,2175,2950,1650,1400,0,525,0
386,2,2,75.0,73.0,94.0,78.0,2233,2536,1763,1954,470,582,788,936,710,434,78,502,45,39,2850,2950,1650,1550,50,525,0
393,2,2,77.0,76.0,86.0,78.0,2317,2525,1847,1898,470,627,869,726,735,248,134,478,45,38,2850,2950,1650,1550,150,575,0
400,2,2,77.0,70.0,86.0,86.0,2261,2166,1791,1629,470,537,1144,748,950,314,194,434,45,32,2850,3300,1650,1550,150,875,0
407,2,2,77.0,70.0,78.0,86.0,2390,1275,1875,895,515,380,1419,751,1165,377,254,374,47,32,2850,3300,1650,1550,250,875,0
414,2,2,83.0,76.0,86.0,86.0,2334,1303,1819,923,515,380,474,384,310,112,164,272,47,32,3375,3475,1650,1550,0,875,0
421,2,2,85.0,77.0,86.0,101.0,2339,1275,1847,895,492,380,496,358,280,92,216,266,47,31,3375,3825,1650,1550,0,925,0
429,2,2,85.0,75.0,86.0,101.0,2373,1281,1903,923,470,358,682,507,410,197,272,310,49,29,3200,4000,1650,1550,175,1025,0
436,2,2,91.0,75.0,94.0,93.0,2345,1230,1875,895,470,335,343,556,165,202,178,354,49,28,3200,4000,1650,1550,175,1175,0
443,2,2,88.0,71.0,94.0,93.0,2367,1202,1875,867,492,335,573,696,335,302,238,394,51,28,3375,3650,1650,1450,575,1525,0
450,2,2,87.0,74.0,94.0,93.0,2306,1253,1791,895,515,358,698,216,500,7,198,209,50,24,3375,3650,1800,1700,525,1775,0
457,2,2,89.0,68.0,102.0,93.0,2339,1034,1847,699,492,335,884,322,630,77,254,245,51,18,3375,4175,1800,1700,525,2075,0
463,2,2,89.0,68.0,102.0,93.0,2339,928,1847,615,492,313,884,414,630,137,254,277,51,19,3375,4175,1800,1700,525,2075,0
7,1,2,13.0,13.0,14.0,15.0,377,335,377,335,0,0,45,40,45,40,0,0,12,12,0,0,0,0,0,0,0
14,1,2,13.0,14.0,14.0,15.0,671,643,671,643,0,0,20,65,20,65,0,0,13,13,0,0,0,0,0,0,0
21,1,2,14.0,14.0,14.0,15.0,727,615,727,615,0,0,55,35,55,35,0,0,13,13,0,0,0,0,0,0,0
29,1,2,14.0,15.0,14.0,15.0,727,727,727,727,0,0,155,20,155,20,0,0,13,14,0,0,0,0,0,0,0
36,1,2,16.0,15.0,22.0,23.0,783,811,783,811,0,0,145,65,145,65,0,0,14,14,0,0,0,0,0,0,0
43,1,2,16.0,16.0,22.0,23.0,839,811,839,811,0,0,245,5,245,5,0,0,16,15,0,0,0,0,0,0,0
50,1,2,15.0,17.0,22.0,23.0,839,839,839,839,0,0,45,60,45,60,0,0,15,16,0,0,0,0,0,0,0
57,1,2,17.0,18.0,22.0,23.0,867,895,867,895,0,0,45,120,45,120,0,0,15,17,0,0,0,0,0,0,0
64,1,2,18.0,19.0,22.0,23.0,839,1023,839,979,0,44,95,188,95,180,0,8,16,18,0,0,0,0,0,0,0
71,1,2,17.0,19.0,22.0,23.0,951,1040,951,951,0,89,185,260,185,240,0,20,17,18,0,0,0,0,0,0,0
79,1,2,17.0,20.0,22.0,23.0,923,1062,923,951,0,111,40,387,40,355,0,32,16,19,0,0,0,0,0,0,0
86,1,2,18.0,20.0,22.0,23.0,951,1034,951,923,0,111,105,104,105,60,0,44,16,19,0,0,0,0,0,0,0
93,1,2,19.0,20.0,22.0,23.0,923,1118,923,1007,0,111,165,90,165,30,0,60,18,20,0,0,0,150,0,0,0
100,1,2,20.0,21.0,22.0,23.0,1046,1079,979,923,67,156,242,95,230,15,12,80,19,20,0,0,0,150,0,0,0
107,1,2,20.0,22.0,22.0,23.0,1113,1135,979,979,134,156,377,180,345,80,32,100,19,21,0,0,0,150,0,0,0
114,1,2,21.0,22.0,22.0,23.0,1107,1051,951,895,156,156,453,200,405,80,48,120,20,21,0,0,0,150,0,0,0
121,1,2,26.0,23.0,28.0,23.0,1163,1135,1007,979,156,156,138,290,70,150,68,140,21,22,0,0,250,150,0,0,0
129,1,2,26.0,26.0,28.0,31.0,1163,1113,1007,867,156,246,273,247,185,100,88,147,21,23,0,0,250,300,0,0,0
136,1,2,28.0,26.0,28.0,31.0,1146,1242,1035,951,111,291,110,48,110,15,0,33,21,23,0,0,250,300,0,0,0
143,1,2,30.0,27.0,36.0,31.0,1119,1230,1119,895,0,335,150,44,150,25,0,19,23,24,50,0,250,300,0,0,0
150,1,2,30.0,30.0,36.0,31.0,1315,1286,1315,951,0,335,300,69,300,35,0,34,23,25,50,125,250,300,0,0,0
157,1,2,31.0,32.0,36.0,46.0,1343,1292,1343,979,0,313,405,130,405,60,0,70,25,26,350,125,250,300,0,0,0
164,1,2,33.0,33.0,36.0,46.0,1399,1348,1399,1035,0,313,65,195,65,85,0,110,25,27,350,125,250,300,0,0,0
171,1,2,34.0,35.0,36.0,46.0,1455,1404,1455,1091,0,313,90,320,90,170,0,150,25,29,350,125,250,300,0,0,0
179,1,2,36.0,38.0,36.0,46.0,1539,1510,1539,1175,0,335,170,160,170,120,0,40,26,29,350,250,250,600,0,0,0
186,1,2,35.5,40.0,44.0,46.0,1427,1650,1427,1315,0,335,225,306,225,230,0,76,27,31,325,250,250,600,25,0,0
193,1,2,40.5,40.0,44.0,46.0,1539,1706,1539,1371,0,335,25,366,25,250,0,116,29,31,325,250,250,600,25,0,0
200,1,2,43.5,42.0,44.0,46.0,1539,1796,1539,1483,0,313,15,517,15,365,0,152,30,33,475,250,250,600,25,0,0
207,1,2,46.5,43.0,52.0,54.0,1707,1852,1707,1539,0,313,70,287,70,95,0,192,33,34,475,550,250,600,25,0,0
214,1,2,48.5,47.0,60.0,54.0,1735,1852,1735,1539,0,313,175,147,175,65,0,82,33,35,475,550,250,600,25,0,0
221,1,2,50.5,48.0,60.0,54.0,1819,1986,1819,1651,0,335,300,232,300,110,0,122,36,36,475,550,250,600,25,0,0
229,1,2,52.5,49.0,60.0,54.0,2042,2076,1931,1763,111,313,455,93,435,35,20,58,37,37,625,550,250,600,25,0,0
236,1,2,58.5,50.0,66.0,62.0,2082,2048,1903,1735,179,313,265,229,225,135,40,94,37,38,925,550,250,600,25,0,0
243,1,2,58.5,51.0,66.0,62.0,2054,2104,1875,1791,179,313,460,229,400,95,60,134,40,39,925,850,250,600,25,0,0
250,1,2,59.5,53.0,66.0,62.0,2110,2188,1931,1875,179,313,315,235,235,65,80,170,40,41,925,850,250,600,25,0,0
257,1,2,65.5,54.0,66.0,62.0,2087,2149,1931,1791,156,358,251,233,155,15,96,218,43,42,925,850,250,600,25,0,0
264,1,2,66.5,56.0,74.0,62.0,2227,2121,2071,1651,156,470,246,438,130,160,116,278,46,44,925,850,375,850,25,0,0
271,1,2,68.5,56.0,74.0,62.0,2395,2227,2239,1735,156,492,331,259,195,75,136,184,49,44,1075,850,500,850,25,0,0
279,1,2,70.5,59.0,74.0,85.0,2535,2261,2379,1791,156,470,216,335,160,95,56,240,50,46,1075,850,625,850,25,0,0
286,1,2,73.5,60.0,82.0,85.0,2619,2311,2463,1819,156,492,433,566,357,270,76,296,52,47,1075,850,750,850,75,0,0
293,1,2,76.5,64.0,90.0,93.0,2782,2423,2603,1931,179,492,323,691,227,385,96,306,56,49,1075,1025,750,1000,75,0,0
300,1,2,80.5,66.0,90.0,93.0,2810,2625,2631,2155,179,470,168,767,152,405,16,362,57,51,1075,1025,750,1150,75,0,0
307,1,2,80.5,71.0,90.0,93.0,2871,2647,2715,2155,156,492,284,682,252,360,32,322,54,52,1225,1025,750,1300,75,0,0
314,1,2,83.5,78.0,90.0,93.0,3011,2821,2855,2351,156,470,304,428,302,150,2,278,62,55,1225,1375,750,1300,75,0,0
321,1,2,89.5,78.0,90.0,93.0,3011,2955,2855,2463,156,492,214,663,192,325,22,338,61,55,1225,1725,750,1300,75,0,0
329,1,2,90.0,81.0,90.0,93.0,3067,3067,2911,2575,156,492,434,928,392,530,42,398,64,58,1200,1725,750,1300,100,0,0
336,1,2,89.0,87.0,90.0,93.0,3039,3123,2771,2631,268,492,405,744,327,390,78,354,63,60,1450,1725,750,1450,100,0,0
343,1,2,93.0,88.0,106.0,93.0,3179,3286,2687,2771,492,515,418,674,272,260,146,414,62,61,1450,2075,750,1550,100,0,0
350,1,2,98.0,93.0,114.0,93.0,3342,3269,2715,2799,627,470,574,596,352,230,222,366,62,64,1650,2075,750,1550,100,0,0
357,1,2,99.0,95.0,122.0,101.0,3034,3185,2407,2715,627,470,629,656,427,230,202,426,61,64,1650,2425,1000,1550,100,0,0
364,1,2,100.0,96.0,122.0,101.0,2748,3314,2099,2799,649,515,930,329,652,135,278,194,62,65,1900,2425,1200,1550,100,0,0
371,1,2,109.0,98.0,128.0,101.0,3039,3375,2323,2771,716,604,858,660,492,390,366,270,64,67,2100,2425,1200,1550,100,0,0
379,1,2,108.0,96.0,128.0,109.0,2989,3521,2183,2827,806,694,1150,1030,692,680,458,350,63,69,2100,2125,1200,1550,200,300,0
386,1,2,108.0,98.0,128.0,117.0,2894,3498,2155,2603,739,895,1183,1251,737,785,446,466,71,70,2100,2125,1450,1550,250,300,0
393,1,2,110.0,99.0,128.0,117.0,3090,3711,2351,2771,739,940,1365,748,827,170,538,578,70,71,2100,2125,1450,1550,250,300,0
400,1,2,119.0,102.0,128.0,117.0,3521,3650,2715,2687,806,963,756,448,422,50,334,398,75,74,2100,2125,1450,1900,250,300,0
407,1,2,121.0,109.0,134.0,117.0,3829,3756,3023,2771,806,985,1121,228,687,160,434,68,75,75,2100,2125,1450,1900,250,300,0
414,1,2,123.0,113.0,134.0,125.0,3997,3706,3191,2743,806,963,1302,230,872,200,430,30,77,77,2100,2725,1575,1900,250,300,0
421,1,2,133.0,114.0,134.0,125.0,4064,3902,3303,2939,761,963,629,287,357,145,272,142,77,79,2550,2925,1825,2150,250,300,0
429,1,2,132.0,116.0,134.0,140.0,4215,3935,3387,2995,828,940,489,334,267,80,222,254,77,80,2550,2925,1825,2150,250,300,0
436,1,2,135.0,118.0,150.0,140.0,4081,3913,3275,2995,806,918,710,502,392,140,318,362,77,81,2550,2925,1825,2150,250,300,0
443,1,2,145.0,123.0,174.0,140.0,4114,4120,3331,3247,783,873,202,416,192,350,10,66,78,84,3300,2925,1825,2750,250,300,0
450,1,2,145.0,126.0,182.0,156.0,4137,4350,3331,3163,806,1187,667,587,557,440,110,147,80,86,3300,3325,1825,3150,250,300,0
457,1,2,145.0,128.0,190.0,156.0,4277,4557,3471,3303,806,1254,873,476,667,335,206,141,81,88,3300,3325,1825,3300,250,300,0
464,1,2,160.0,138.0,190.0,156.0,4288,4730,3303,3499,985,1231,481,559,297,270,184,289,81,88,4050,3525,1825,3600,250,300,0
471,1,2,160.0,138.0,190.0,156.0,4383,4803,3219,3527,1164,1276,1017,526,697,185,320,341,81,88,4050,4125,1825,3600,250,300,0
479,1,2,167.0,143.0,190.0,156.0,4495,4786,3331,3555,1164,1231,1012,475,602,365,410,110,80,88,4450,4125,1825,3750,300,300,0
486,1,2,167.0,143.0,190.0,156.0,4394,4820,3275,3611,1119,1209,1220,1055,832,805,388,250,80,88,4900,4125,1825,3750,300,300,0
493,1,2,167.0,155.0,190.0,188.0,4411,4702,3247,3471,1164,1231,1775,817,1247,715,528,102,80,88,5450,4525,1825,3750,300,300,0
500,1,2,178.0,155.0,190.0,188.0,4389,4842,3247,3611,1142,1231,1656,644,992,540,664,104,80,88,5550,5075,2175,3750,300,300,0
507,1,2,178.0,155.0,190.0,188.0,4450,4506,3331,3275,1119,1231,1488,727,1042,475,446,252,80,88,5550,5525,2175,4300,300,300,0
514,1,2,177.5,155.0,190.0,204.0,4394,4641,3275,3387,1119,1254,2024,1304,1442,900,582,404,81,88,6025,5525,2175,4300,325,300,0
521,1,2,177.5,163.0,198.0,204.0,4551,4602,3387,3303,1164,1299,2330,927,1612,375,718,552,81,88,5875,5925,2175,4300,475,800,0
529,1,2,177.0,170.0,198.0,204.0,4439,4417,3275,3163,1164,1254,2840,671,1982,375,858,296,81,88,5850,5825,2175,4300,500,900,0
536,1,2,172.5,170.0,206.0,204.0,4372,4350,3275,3163,1097,1187,3368,1005,2382,565,986,440,84,88,5625,5825,2175,4550,725,900,0
543,1,2,185.0,156.0,206.0,204.0,4445,4557,3303,3303,1142,1254,2578,1146,1652,850,926,296,83,88,5450,5375,2175,5000,900,1800,0
550,1,2,195.0,170.0,212.0,204.0,4198,4613,3079,3359,1119,1254,1555,738,1497,290,58,448,83,88,5450,6075,2175,5000,900,1800,0
557,1,2,194.0,172.0,212.0,212.0,4114,4641,2995,3387,1119,1254,1956,1297,1762,705,194,592,82,88,5450,6900,2175,5000,900,1800,0
564,1,2,196.0,172.0,212.0,220.0,3997,4630,2855,3331,1142,1299,2277,1814,1947,1070,330,744,82,88,6300,6900,2300,5000,900,1800,0
571,1,2,196.0,174.0,212.0,220.0,4047,4613,2883,3359,1164,1254,2242,2163,2022,1425,220,738,82,88,7800,6900,2300,5000,900,1800,0
579,1,2,200.0,194.0,212.0,220.0,4260,4512,3163,3303,1097,1209,2220,1207,2172,1075,48,132,81,88,7800,7400,2300,5000,900,1800,0
586,1,2,197.0,194.0,212.0,220.0,4473,4506,3331,3275,1142,1231,2441,639,2257,505,184,134,80,88,7800,8100,2300,5000,900,1800,0
593,1,2,198.0,194.0,212.0,220.0,4333,4417,3191,3163,1142,1254,3031,886,2707,600,324,286,81,88,7800,9000,2450,5000,900,1800,0
600,1,2,190.5,178.0,212.0,220.0,4310,4534,3191,3303,1119,1231,3358,949,2902,565,456,384,80,88,8075,8100,2300,5000,1225,2700,0
607,1,2,185.0,172.0,212.0,220.0,4389,4310,3247,3079,1142,1231,3892,1452,3292,920,600,532,79,88,7800,7975,2300,5000,1500,3000,0
614,1,2,196.5,172.0,212.0,228.0,4378,4546,3079,3247,1299,1299,2658,1634,2202,1050,456,584,79,88,6125,7525,2300,5000,3175,3450,0
621,1,2,184.0,190.0,212.0,228.0,4484,4551,3163,3275,1321,1276,2999,1182,2387,450,612,732,79,88,5300,7350,2600,5300,4000,3625,0
629,1,2,185.0,190.0,212.0,228.0,4333,4540,3079,3331,1254,1209,1942,1332,1907,560,35,772,78,88,6150,8250,2600,5450,4000,3625,0
636,1,2,196.0,190.0,212.0,228.0,4372,4529,3051,3275,1321,1254,1607,1189,1412,365,195,824,82,88,7050,8350,2750,5600,4000,3625,0
643,1,2,194.0,188.0,204.0,228.0,4350,4534,3051,3303,1299,1231,2139,1341,1792,565,347,776,81,88,8150,8250,2900,5600,4550,3725,0
650,1,2,195.5,172.0,204.0,228.0,4467,4590,3191,3359,1276,1231,1706,1864,1407,940,299,924,80,88,8375,7450,3025,5750,4875,4525,0
657,1,2,185.5,163.0,204.0,228.0,4305,4394,3051,3163,1254,1231,2232,2283,1777,1215,455,1068,80,83,7025,7200,3025,5750,5925,5725,0
664,1,2,181.5,161.0,204.0,243.0,4366,3431,3023,2379,1343,1052,2747,1755,2132,975,615,780,80,71,6575,7550,3025,6150,6150,6325,0
671,1,2,181.5,180.0,204.0,243.0,4456,3493,3135,2575,1321,918,2283,414,2012,230,271,184,80,73,7175,8350,3025,6150,6150,6325,0
679,1,2,199.5,182.0,204.0,243.0,4378,3532,3079,2659,1299,873,1631,557,1462,265,169,292,80,75,7175,8850,3025,6150,6150,6325,0
686,1,2,197.0,177.0,204.0,243.0,4361,3426,2995,2463,1366,963,1409,985,1322,565,87,420,80,80,7050,8925,3025,6150,7400,7075,0
693,1,2,182.5,186.0,204.0,243.0,4344,3773,2911,2743,1433,1030,1753,728,1552,180,201,548,80,81,6625,8375,3025,6150,8225,7625,0
700,1,2,183.5,192.0,204.0,243.0,4316,3907,2883,2855,1433,1052,1958,892,1777,220,181,672,80,81,7225,9075,3025,6150,8375,7625,0
707,1,2,175.0,180.0,204.0,228.0,4198,3650,2743,2575,1455,1075,2459,1007,2102,215,357,792,80,72,5950,8975,3025,6300,8600,9300,0
714,1,2,195.0,173.0,210.0,228.0,4254,3146,2799,2183,1455,963,1881,1385,1352,485,529,900,79,71,7050,8675,3025,6300,8750,9650,0
721,1,2,200.0,176.0,204.0,228.0,4355,3213,2967,2295,1388,918,1985,1204,1292,200,693,1004,79,71,7050,9050,3025,6300,9100,9650,0
729,1,2,199.5,180.0,204.0,228.0,4372,3414,2939,2519,1433,895,1908,1256,1397,240,511,1016,77,71,8125,9050,3025,6300,9125,9650,0
736,1,2,198.5,181.0,210.0,228.0,4344,3162,2911,2267,1433,895,1439,1573,1252,445,187,1128,81,74,8125,9050,3025,6300,9175,9650,0
743,1,2,198.5,167.0,210.0,228.0,4277,3207,2911,2267,1366,940,1470,1909,1127,665,343,1244,81,73,7975,8350,3025,6300,9325,10400,0
750,1,2,196.0,170.0,210.0,228.0,4222,3185,2811,2267,1411,918,1988,1646,1469,390,519,1256,80,74,8900,8350,3275,6300,9500,10400,0
757,1,2,192.0,181.0,210.0,228.0,4171,3224,2738,2239,1433,985,2478,1223,1791,55,687,1168,83,77,8700,8600,3275,6300,9700,10525,0
764,1,2,176.5,168.0,210.0,228.0,4271,3314,2816,2351,1455,963,2731,1571,1922,295,809,1276,83,78,6925,7600,3275,6000,11325,12675,0
771,1,2,166.5,142.0,210.0,228.0,4338,3241,2950,2323,1388,918,1801,1780,1032,400,769,1380,83,67,3725,6175,3275,5600,14450,15050,0
779,1,2,180.5,142.0,202.0,212.0,4574,3162,3141,2267,1433,895,1367,1777,726,285,641,1492,83,67,3525,6175,3275,5450,14650,15650,0
786,1,2,180.0,141.0,202.0,196.0,4608,3112,3197,2239,1411,873,1848,2099,1039,495,809,1604,83,68,3550,6375,3275,5300,14725,16225,0
793,1,2,188.0,147.0,202.0,196.0,4540,3101,3152,2183,1388,918,1184,2130,1011,510,173,1620,83,71,5550,6375,3275,5300,14725,16225,0
800,1,2,185.0,146.0,202.0,196.0,4249,3364,2861,2379,1388,985,1983,2482,1042,750,941,1732,83,74,5750,6275,3275,5300,15471,16325,0
807,1,2,195.5,143.0,202.0,196.0,4322,3510,2889,2547,1433,963,1814,2481,697,745,1117,1736,83,74,5425,6075,3275,5300,15796,16525,0
814,1,2,199.5,165.0,202.0,196.0,4585,3678,3197,2603,1388,1075,243,718,112,500,131,218,83,76,6025,6075,3275,5300,15796,16525,0
821,1,2,199.5,172.0,208.0,196.0,4708,3868,3253,2659,1455,1209,824,895,521,675,303,220,83,76,6025,6650,3275,5300,15796,16525,0
829,1,2,199.5,172.0,208.0,196.0,4669,3834,3236,2603,1433,1231,1167,1361,796,985,371,376,83,76,8825,8000,3275,5300,15896,16525,0
836,1,2,199.5,172.0,208.0,196.0,4674,3918,3286,2687,1388,1231,1718,1838,1187,1310,531,528,83,76,8825,8900,3275,5300,15896,16525,0
843,1,2,200.0,172.0,208.0,196.0,4719,3913,3331,2659,1388,1254,2143,2301,1536,1625,607,676,83,76,9000,8900,3275,5300,15921,16525,0
850,1,2,200.0,172.0,200.0,196.0,4820,3980,3387,2659,1433,1321,2694,1964,1923,1490,771,474,83,76,9000,9275,3275,5300,16021,16525,0
857,1,2,197.5,194.0,200.0,196.0,4770,3907,3359,2631,1411,1276,2625,1217,1907,595,718,622,81,76,8975,10075,3275,5300,16046,16525,0
864,1,2,196.5,194.0,200.0,196.0,4652,3728,3286,2519,1366,1209,1982,1637,1900,875,82,762,81,76,8275,10675,3275,5300,16896,16525,0
871,1,2,200.0,194.0,200.0,204.0,4629,3666,3174,2435,1455,1231,2267,2089,2013,1175,254,914,81,76,8200,10675,3275,5300,16971,16525,0
879,1,2,167.0,186.0,200.0,204.0,4747,3778,3314,2547,1433,1231,2852,2546,2426,1480,426,1066,81,76,5150,9775,3275,5300,20021,17425,0
886,1,2,173.5,169.0,192.0,204.0,4579,3638,3191,2407,1388,1231,1570,2974,984,1760,586,1214,81,76,3875,7875,3275,5300,22671,18775,0
7,1,0,13.0,13.0,14.0,15.0,335,335,335,335,0,0,40,40,40,40,0,0,12,12,0,0,0,0,0,0,0
14,1,0,13.0,14.0,14.0,15.0,671,643,671,643,0,0,20,65,20,65,0,0,13,13,0,0,0,0,0,0,0
21,1,0,14.0,14.0,14.0,15.0,699,727,699,727,0,0,50,50,50,50,0,0,13,13,0,0,0,0,0,0,0
29,1,0,14.0,15.0,14.0,15.0,755,727,755,727,0,0,150,40,150,40,0,0,13,14,0,0,0,0,0,0,0
36,1,0,16.0,15.0,22.0,15.0,783,727,783,727,0,0,150,125,150,125,0,0,14,14,0,0,0,0,0,0,0
43,1,0,16.0,16.0,22.0,23.0,811,783,811,783,0,0,235,70,235,70,0,0,16,15,0,0,0,0,0,0,0
50,1,0,15.0,16.0,22.0,23.0,811,839,811,839,0,0,40,45,40,45,0,0,15,15,0,0,0,0,0,0,0
57,1,0,17.0,17.0,22.0,23.0,867,783,867,783,0,0,45,80,45,80,0,0,15,16,0,0,0,0,0,0,0
64,1,0,18.0,18.0,22.0,23.0,895,783,895,783,0,0,95,175,95,175,0,0,16,17,0,0,0,0,0,0,0
71,1,0,17.0,18.0,22.0,23.0,895,827,895,783,0,44,180,233,180,225,0,8,17,17,0,0,0,0,0,0,0
79,1,0,17.0,19.0,22.0,23.0,951,883,951,727,0,156,40,343,40,315,0,28,16,18,0,0,0,0,0,0,0
86,1,0,18.0,19.0,22.0,23.0,923,995,923,839,0,156,100,468,100,420,0,48,16,18,0,0,0,0,0,0,0
93,1,0,19.0,20.0,22.0,23.0,945,939,923,783,22,156,159,378,155,310,4,68,18,19,0,0,0,150,0,0,0
100,1,0,20.0,20.0,22.0,23.0,984,1102,895,923,89,179,231,113,215,25,16,88,19,19,0,0,0,150,0,0,0
107,1,0,20.0,20.0,22.0,23.0,1085,1046,951,867,134,179,362,233,330,125,32,108,19,19,0,50,0,150,0,0,0
114,1,0,21.0,21.0,22.0,23.0,1107,1051,951,895,156,156,442,49,390,25,52,24,20,19,0,50,0,150,0,0,0
121,1,0,26.0,21.0,28.0,23.0,1074,1023,895,867,179,156,212,94,140,50,72,44,21,19,0,50,250,150,0,0,0
129,1,0,27.0,22.0,28.0,23.0,1107,1247,951,1091,156,156,303,99,215,85,88,14,21,20,0,50,250,150,0,0,0
136,1,0,28.0,22.0,28.0,23.0,1062,1219,951,1063,111,156,275,89,175,55,100,34,22,20,0,50,250,150,0,0,0
143,1,0,27.0,23.0,28.0,23.0,1035,1191,1035,1035,0,156,105,224,5,170,100,54,22,21,50,50,250,150,0,0,0
150,1,0,29.0,23.0,36.0,23.0,1231,1253,1231,1007,0,246,160,316,60,230,100,86,22,22,50,50,250,150,0,0,0
157,1,0,31.0,26.0,36.0,31.0,1259,1314,1259,979,0,335,195,117,95,95,100,22,22,22,350,50,250,400,0,0,0
164,1,0,33.0,29.0,36.0,31.0,1287,1376,1287,1063,0,313,20,128,20,70,0,58,25,23,350,50,250,500,0,0,0
171,1,0,33.5,29.0,36.0,46.0,1287,1432,1287,1119,0,313,25,153,25,55,0,98,26,23,325,50,250,500,25,0,0
179,1,0,35.5,32.0,36.0,46.0,1455,1370,1455,1035,0,335,95,168,95,55,0,113,26,24,325,200,250,500,25,0,0
186,1,0,35.5,34.0,36.0,46.0,1483,1314,1483,979,0,335,170,188,170,35,0,153,28,24,325,250,250,500,25,0,0
193,1,0,41.5,37.0,44.0,46.0,1567,1544,1567,1231,0,313,30,184,30,95,0,89,29,25,325,250,250,750,25,0,0
200,1,0,43.5,38.0,44.0,46.0,1595,1650,1595,1315,0,335,105,224,105,95,0,129,33,26,475,450,250,750,25,0,0
207,1,0,46.5,40.0,52.0,46.0,1774,1740,1707,1427,67,313,122,335,110,170,12,165,34,26,475,450,250,750,25,0,0
214,1,0,47.5,46.0,58.0,46.0,1886,2020,1707,1707,179,313,312,265,280,60,32,205,35,28,475,450,250,750,25,0,0
221,1,0,51.5,46.0,58.0,54.0,1998,2020,1819,1707,179,313,182,380,130,135,52,245,35,28,475,650,250,750,25,0,0
229,1,0,53.5,48.0,58.0,54.0,1947,2154,1791,1819,156,335,308,325,240,90,68,235,35,30,725,700,250,750,25,0,0
236,1,0,57.5,48.0,66.0,54.0,2003,2210,1847,1875,156,335,198,575,110,300,88,275,35,30,725,900,250,750,25,0,0
243,1,0,62.5,50.0,66.0,62.0,2003,1986,1847,1651,156,335,138,461,30,250,108,211,38,32,1025,900,250,900,25,0,0
250,1,0,64.5,52.0,66.0,62.0,2059,1902,1903,1567,156,335,188,401,60,350,128,51,41,33,1025,900,250,900,25,0,0
257,1,0,66.5,53.0,74.0,62.0,2143,2048,1987,1735,156,313,238,202,90,115,148,87,41,33,1175,900,250,900,25,0,0
264,1,0,70.5,54.0,74.0,62.0,1818,2216,1707,1903,111,313,186,367,30,240,156,127,41,33,1225,950,250,900,75,0,0
271,1,0,72.5,59.0,90.0,70.0,1740,1964,1651,1651,89,313,223,337,55,170,168,167,43,34,1375,950,250,900,75,0,0
279,1,0,74.5,60.0,90.0,70.0,2339,2042,2183,1707,156,335,118,342,30,135,88,207,47,34,1525,950,250,900,75,0,0
286,1,0,75.5,63.0,98.0,70.0,2395,2042,2239,1707,156,335,218,537,110,290,108,247,48,36,1575,1000,250,900,75,0,0
293,1,0,77.5,64.0,98.0,70.0,2647,2462,2491,2127,156,335,133,433,55,200,78,233,50,37,1575,1500,250,900,75,0,0
300,1,0,80.5,65.0,106.0,78.0,2563,2356,2407,2043,156,313,138,394,40,125,98,269,49,38,1575,1550,250,900,75,0,0
307,1,0,84.5,69.0,106.0,78.0,2754,2356,2575,2043,179,313,213,294,95,110,118,184,51,39,1575,1550,250,900,75,0,0
314,1,0,86.5,70.0,106.0,78.0,2720,2468,2519,2155,201,313,307,344,165,120,142,224,56,40,1575,1550,250,900,75,0,0
321,1,0,89.5,73.0,106.0,78.0,2782,2322,2491,1987,291,335,503,449,325,185,178,264,58,41,1575,1600,500,1150,75,0,0
329,1,0,84.0,74.0,106.0,93.0,2916,2434,2603,2099,313,335,868,634,650,330,218,304,59,42,1400,1600,500,1150,350,0,0
336,1,0,93.5,72.0,106.0,93.0,3000,2630,2687,2295,313,335,723,180,465,40,258,140,59,43,1375,1350,875,1150,375,300,0
343,1,0,92.5,73.0,106.0,93.0,3112,2395,2799,2015,313,380,308,328,260,140,48,188,58,44,1675,1625,1075,1300,375,300,0
350,1,0,94.5,75.0,106.0,93.0,3134,2490,2799,2043,335,447,533,319,445,200,88,119,66,45,1725,1525,1075,1450,325,400,0
357,1,0,97.5,78.0,106.0,93.0,3269,2479,2911,1987,358,492,423,64,295,35,128,29,68,46,1725,1525,1075,1450,325,450,0
364,1,0,96.5,81.0,106.0,93.0,3274,2759,2939,2267,335,492,109,279,95,190,14,89,71,47,1725,1525,1075,1450,325,450,0
371,1,0,101.5,85.0,114.0,93.0,3314,2703,2911,2211,403,492,271,295,205,150,66,145,71,49,1725,1675,1075,1450,325,450,0
379,1,0,105.5,89.0,122.0,93.0,3510,2647,2883,2155,627,492,481,405,335,200,146,205,71,50,1725,2050,1075,1450,325,450,0
386,1,0,105.0,89.0,122.0,93.0,3616,2754,2967,2239,649,515,431,695,405,430,26,265,71,50,1950,2050,1075,1600,350,450,0
393,1,0,112.0,95.0,122.0,101.0,3414,2675,2743,2071,671,604,371,356,265,115,106,241,71,52,1950,2200,1075,1750,350,450,0
400,1,0,112.0,100.0,130.0,109.0,3196,2698,2547,2071,649,627,743,292,565,100,178,192,71,53,2550,2300,1075,1750,375,450,0
407,1,0,117.0,105.0,138.0,109.0,3218,2664,2547,2015,671,649,688,162,480,90,208,72,71,55,2550,2300,1075,1750,375,450,0
414,1,0,117.0,109.0,138.0,117.0,3476,2916,2827,2267,649,649,724,55,590,22,134,33,71,55,3000,2450,1075,1750,375,450,0
421,1,0,118.0,111.0,138.0,125.0,3510,3336,2883,2687,627,649,1085,209,875,120,210,89,71,56,3250,2550,1075,1750,375,450,0
429,1,0,123.0,113.0,152.0,125.0,3560,3336,2911,2687,649,649,1215,295,925,130,290,165,71,58,3550,2825,1075,1950,375,450,0
436,1,0,128.5,116.0,166.0,125.0,3890,3386,3219,2715,671,671,985,405,765,285,220,120,72,58,3525,3325,1075,1950,400,450,0
443,1,0,138.5,127.0,166.0,133.0,3868,3538,3219,2911,649,627,886,162,590,70,296,92,75,60,3525,3425,1075,1950,400,450,0
450,1,0,138.0,127.0,174.0,149.0,3918,3560,3247,2911,671,649,1002,417,805,245,197,172,75,60,4100,3425,1075,1950,425,450,0
457,1,0,145.0,133.0,174.0,149.0,4086,3588,3415,2939,671,649,1142,587,865,335,277,252,76,63,4400,3675,1075,1950,425,450,0
464,1,0,151.0,132.0,174.0,149.0,4154,3588,3527,2939,627,649,1284,813,935,485,349,328,76,58,4800,4000,1075,1950,425,700,0
471,1,0,156.0,135.0,174.0,157.0,4098,2832,3471,2183,627,649,1279,863,925,455,354,408,76,57,4850,4350,1075,2200,725,800,0
479,1,0,152.0,136.0,174.0,157.0,4148,2574,3499,1903,649,671,1759,1024,1325,540,434,484,76,58,4900,4350,1075,2200,975,900,0
486,1,0,132.5,108.0,174.0,157.0,4142,2994,3471,2323,671,671,2269,694,1755,480,514,214,76,60,3575,2900,1075,2200,2125,2550,0
493,1,0,144.5,121.0,174.0,157.0,4170,3006,3499,2379,671,627,1595,141,1255,55,340,86,75,60,3925,3150,1075,2200,2125,2550,0
500,1,0,150.5,122.0,174.0,157.0,4086,2804,3415,2155,671,649,1046,271,1005,105,41,166,78,59,3925,3150,1075,2200,2125,2600,0
507,1,0,129.5,113.0,174.0,141.0,4008,2894,3359,2267,649,627,1322,397,1205,155,117,242,80,62,2875,2850,1075,2200,3700,3350,0
514,1,0,132.5,117.0,174.0,141.0,3986,3196,3359,2547,627,649,1338,262,1145,65,193,197,80,63,2875,2850,1075,2200,3700,3350,0
521,1,0,132.5,126.0,174.0,141.0,3706,3168,3079,2519,627,649,1478,294,1305,23,173,271,78,65,3175,3350,1075,2200,3700,3350,0
529,1,0,145.5,131.0,174.0,141.0,3946,3442,3275,2771,671,671,1203,520,950,280,253,240,81,68,3375,3350,1325,2200,3700,3350,0
536,1,0,145.5,132.0,174.0,149.0,4092,3784,3443,3135,649,649,1364,625,1185,316,179,309,81,68,3675,3500,1325,2200,3725,3350,0
543,1,0,148.5,137.0,166.0,149.0,4450,4400,3779,3751,671,649,1205,573,1150,292,55,281,80,70,4125,3975,1325,2200,3925,3350,0
550,1,0,155.5,140.0,174.0,149.0,4450,4176,3779,3527,671,649,1125,343,1115,207,10,136,80,71,4125,3975,1325,2200,3925,3350,0
557,1,0,162.5,138.0,174.0,149.0,4518,4232,3891,3583,627,649,1072,744,990,532,82,212,79,71,4275,4375,1325,2200,4175,3450,0
564,1,0,162.5,142.0,174.0,149.0,4434,3840,3807,3191,627,649,1212,529,1050,237,162,292,81,71,4875,4375,1450,2200,4175,3450,0
571,1,0,163.5,147.0,174.0,165.0,4540,3241,3891,2547,649,694,1262,374,1020,152,242,222,84,71,4875,4375,1450,2200,4175,3450,0
579,1,0,168.0,151.0,174.0,173.0,4366,3330,3583,2547,783,783,1222,280,980,162,242,118,82,71,5100,4375,1450,2200,4200,3450,0
586,1,0,178.0,154.0,206.0,173.0,4478,3280,3583,2519,895,761,1256,668,910,462,346,206,84,71,5100,4850,1450,2200,4200,3450,0
593,1,0,178.0,160.0,212.0,173.0,4400,3504,3415,2743,985,761,1762,460,1300,287,462,173,84,71,5450,5125,1575,2450,4200,3450,0
600,1,0,178.0,160.0,212.0,181.0,4596,3582,3611,2687,985,895,2328,536,1750,397,578,139,84,71,5950,5125,1575,2450,4200,3450,0
607,1,0,182.0,162.0,212.0,196.0,4350,3868,3387,2883,963,985,2634,873,1940,622,694,251,84,72,5950,5475,2175,2450,4200,3450,0
614,1,0,180.5,167.0,212.0,204.0,4327,4120,3387,3135,940,985,3060,1083,2250,787,810,296,84,73,5875,6075,2175,3200,4275,3450,0
621,1,0,198.5,170.0,212.0,204.0,4568,4176,3583,3191,985,985,1570,1310,1440,927,130,383,83,74,5875,6075,2175,3200,4275,3450,0
629,1,0,194.0,170.0,212.0,204.0,4534,4232,3527,3247,1007,985,2105,1550,1855,1097,250,453,83,77,5850,6075,2175,3200,4500,3450,0
636,1,0,199.0,164.0,212.0,204.0,4630,4215,3667,3275,963,940,1133,1777,775,1262,358,515,81,77,5350,5575,2175,3425,5425,3975,0
643,1,0,200.0,169.0,212.0,204.0,4506,4176,3499,3191,1007,985,1103,1648,825,1144,278,504,80,77,5350,5575,2175,3425,5425,3975,0
650,1,0,199.5,177.0,212.0,204.0,4602,3678,3639,2715,963,963,1640,1164,1250,901,390,263,80,79,5925,5850,2175,3425,5450,3975,0
657,1,0,199.5,179.0,212.0,204.0,4439,3868,3499,2883,940,985,1371,632,1265,532,106,100,80,80,7675,6225,2425,3425,5475,3975,0
664,1,0,199.5,182.0,212.0,204.0,4456,4092,3471,3107,985,985,1886,773,1660,557,226,216,80,82,7775,6350,2550,3425,5475,3975,0
671,1,0,199.5,173.0,212.0,204.0,4366,4008,3359,3023,1007,985,2421,1224,2075,892,346,332,80,83,7775,5750,2550,3650,5475,4575,0
679,1,0,199.0,178.0,212.0,204.0,4462,3767,3499,2827,963,940,2393,341,2210,272,183,69,80,85,7750,6025,2550,3850,5500,4975,0
686,1,0,198.0,171.0,212.0,204.0,4512,4114,3527,3107,985,1007,2779,579,2555,507,224,72,80,86,7700,5475,2550,3850,5550,5525,0
693,1,0,199.5,175.0,218.0,204.0,4316,4204,3331,3107,985,1097,3175,821,2835,617,340,204,80,86,8225,5475,2550,3850,5600,5575,0
700,1,0,199.5,178.0,218.0,204.0,3874,4338,2911,3219,963,1119,2846,843,2790,657,56,186,80,86,8375,5525,2425,3850,5625,5575,0
707,1,0,199.5,179.0,218.0,204.0,3711,4204,2771,3107,940,1097,2962,451,2915,387,47,64,82,86,8375,6350,2425,3850,5625,5575,0
714,1,0,199.5,182.0,218.0,204.0,3812,4305,2827,3051,985,1254,3432,827,3265,607,167,220,82,86,9175,7150,2425,3850,5650,5575,0
721,1,0,198.5,188.0,218.0,204.0,4114,4372,3107,3051,1007,1321,3842,558,3555,532,287,26,80,86,9425,7350,2425,3850,5650,5575,0
729,1,0,198.5,188.0,218.0,219.0,4204,4294,3219,2995,985,1299,3769,1060,3370,882,399,178,80,86,9425,7350,2425,3850,5650,5575,0
736,1,0,196.5,188.0,218.0,219.0,4226,4260,3219,2939,1007,1321,4050,1170,3635,832,415,338,79,86,9425,7500,2425,3850,5650,5575,0
743,1,0,175.0,186.0,218.0,219.0,4338,4210,3331,2911,1007,1299,4565,1657,4030,1167,535,490,79,86,8150,7400,2550,3850,6925,5675,0
750,1,0,165.0,178.0,210.0,219.0,4322,3644,3247,2435,1075,1209,3592,1003,2925,677,667,326,79,76,4200,7025,2550,3850,10300,7800,0
757,1,0,191.0,174.0,210.0,219.0,4506,3017,3387,1987,1119,1030,2567,753,1760,557,807,196,79,76,3500,6725,2550,3625,10850,8325,0
764,1,0,199.0,174.0,210.0,219.0,4523,3095,3359,2043,1164,1052,2212,461,1865,391,347,70,79,76,3500,6725,2550,3625,10850,8325,0
771,1,0,199.0,174.0,210.0,219.0,4282,2826,3163,1819,1119,1007,2124,782,1795,596,329,186,79,78,6250,7225,2550,3875,10850,8325,0
779,1,0,199.0,177.0,210.0,219.0,4310,2681,3191,1651,1119,1030,1790,473,1650,392,140,81,77,78,6350,7225,2550,3875,10850,8325,0
786,1,0,198.0,177.0,210.0,219.0,4294,2602,3107,1483,1187,1119,1805,544,1775,435,30,109,76,81,6550,7775,2550,3875,10850,8325,0
793,1,0,199.0,181.0,210.0,219.0,4305,3862,3163,2743,1142,1119,2267,763,2105,524,162,239,78,81,8400,7775,2550,3875,10900,8325,0
800,1,0,198.0,181.0,210.0,219.0,4114,4719,2995,3555,1119,1164,2433,514,2285,387,148,127,78,81,8900,7775,2550,3875,10900,8325,0
807,1,0,198.0,171.0,216.0,219.0,4288,4630,3079,3331,1209,1299,2866,1044,2570,771,296,273,78,81,8600,7150,2675,4100,10900,8950,0
814,1,0,198.0,181.0,216.0,227.0,4182,4596,2883,3275,1299,1321,3316,975,2860,901,456,74,80,81,8600,7350,2675,4200,10900,8950,0
821,1,0,200.0,181.0,216.0,242.0,3650,4585,2351,3331,1299,1254,3192,599,2780,380,412,219,79,81,8600,7350,2675,4200,10900,8950,0
829,1,0,200.0,185.0,216.0,242.0,3958,4495,2547,3219,1411,1276,3271,613,2895,386,376,227,82,81,8600,7350,2675,4200,10900,8950,0
836,1,0,199.0,191.0,216.0,242.0,4098,4658,2687,3359,1411,1299,3739,560,3195,475,544,85,81,81,8600,7350,2675,4200,10900,8950,0
843,1,0,200.0,191.0,216.0,242.0,4344,4652,2799,3331,1545,1321,4161,808,3425,567,736,241,80,81,8600,8450,2675,4300,10900,8950,0
850,1,0,200.0,190.0,222.0,242.0,4366,4344,2687,3023,1679,1321,4681,1289,3745,892,936,397,80,81,8600,8600,2675,4300,10900,9000,0
857,1,0,200.0,200.0,222.0,242.0,4394,3476,2715,2155,1679,1321,5210,703,4070,440,1140,263,82,81,8600,8600,2675,4300,10900,9000,0
864,1,0,200.0,200.0,222.0,242.0,4014,3392,2379,2071,1635,1321,4888,929,3960,608,928,321,82,81,8600,8600,2675,4850,10900,9000,0
871,1,0,200.0,200.0,222.0,242.0,4557,4131,2743,2855,1814,1276,5451,1432,4295,963,1156,469,82,81,8600,8600,2675,4850,10900,9000,0
879,1,0,200.0,200.0,222.0,242.0,4966,4294,2995,2995,1971,1299,6046,1937,4650,1308,1396,629,82,81,8600,9400,2675,4850,10900,9000,0
886,1,0,199.0,196.0,222.0,242.0,5050,4456,3079,3135,1971,1321,6653,2473,5025,1688,1628,785,82,81,8450,9150,2675,4850,10900,9250,0
893,1,0,200.0,199.0,222.0,257.0,4949,4428,3023,3107,1926,1321,7195,2244,5335,1578,1860,666,82,81,8450,9375,2675,4850,10900,9575,0
900,1,0,199.0,199.0,222.0,272.0,5022,4148,3051,2883,1971,1265,7122,2726,5380,1918,1742,808,81,81,8450,9375,2675,4850,10900,9575,0
907,1,0,199.0,199.0,222.0,272.0,4954,3896,2939,2743,2015,1153,7727,3192,5745,2248,1982,944,81,81,8450,9375,3125,4850,10900,9575,0
914,1,0,191.5,197.0,222.0,272.0,4893,3840,2967,2743,1926,1097,7946,3664,5915,2588,2031,1076,78,81,8675,9275,3125,4850,11125,9675,0
921,1,0,194.5,188.0,216.0,272.0,4613,3778,2687,2659,1926,1119,7728,3609,5465,2643,2263,966,76,81,8075,9275,3125,4850,11875,10125,0
929,1,0,192.0,173.0,216.0,272.0,4344,3437,2463,2295,1881,1142,6997,3364,4510,2508,2487,856,76,81,6200,8050,3125,4850,14125,11625,0
936,1,0,183.0,169.0,216.0,272.0,4271,3347,2435,2183,1836,1164,6727,1585,4290,1518,2437,67,76,81,4450,7075,3125,4850,15875,12500,0
943,1,0,182.5,176.0,216.0,272.0,4098,3235,2351,2071,1747,1164,6865,1611,4395,1408,2470,203,76,81,5175,7075,3125,4850,15900,12500,0
950,1,0,199.5,176.0,216.0,272.0,4103,2899,2491,1735,1612,1164,5952,1938,3665,1603,2287,335,76,81,6425,7175,3125,4850,15900,12500,0
957,1,0,195.5,180.0,216.0,272.0,4260,2709,2603,1567,1657,1142,6217,1389,3880,1143,2337,246,76,81,7225,7800,3125,4850,16350,12500,0
964,1,0,194.5,196.0,216.0,272.0,4154,2804,2519,1707,1635,1097,6369,1066,4015,943,2354,123,76,81,7975,9175,3125,4850,16450,12500,0
971,1,0,178.0,195.0,216.0,272.0,4154,2933,2519,1791,1635,1142,6871,1002,4325,941,2546,61,76,80,7600,8850,3125,4850,17425,12825,0
979,1,0,190.0,166.0,216.0,272.0,4350,2737,2715,1651,1635,1086,4947,1328,2205,1139,2742,189,76,73,5150,7400,3125,4625,20225,15018,0
986,1,0,198.5,157.0,216.0,272.0,4355,2619,2743,1623,1612,996,3715,570,985,519,2730,51,76,68,3475,6175,3125,4625,21750,16243,0
993,1,0,199.0,164.0,216.0,272.0,4383,2636,2771,1651,1612,985,4210,890,1280,719,2930,171,76,68,4600,7275,3125,4625,21775,16243,0
1000,1,0,199.0,169.0,216.0,272.0,4439,2384,2827,1399,1612,985,3679,402,1090,269,2589,133,77,68,7350,7675,3125,4625,21775,16243,0
1007,1,0,200.0,171.0,216.0,272.0,4109,2166,2687,1203,1422,963,3415,662,860,449,2555,213,77,73,7350,8300,3125,4625,21775,16243,0
1014,1,0,200.0,175.0,216.0,272.0,3991,2418,2715,1455,1276,963,3892,513,1185,388,2707,125,77,73,8700,8700,3125,4625,21775,16243,0
1021,1,0,186.5,170.0,216.0,272.0,4540,2496,3219,1511,1321,985,4447,1034,1580,676,2867,358,77,72,8275,8425,3125,4625,22600,16767,0
1029,1,0,184.0,158.0,216.0,272.0,4618,2356,3275,1371,1343,985,3933,1315,910,841,3023,474,77,70,6900,7825,3375,4625,23975,17627,0
1036,1,0,177.5,133.0,216.0,257.0,4546,2205,3247,1287,1299,918,3570,1574,395,996,3175,578,77,69,4975,6925,3375,4625,25900,19390,0
1043,1,0,170.5,123.0,200.0,242.0,4439,1382,3163,643,1276,739,3837,739,510,356,3327,383,77,49,4175,7100,3375,4625,26700,21399,0
1050,1,0,178.5,123.0,200.0,242.0,4439,1096,3275,447,1164,649,2834,870,75,411,2759,459,77,49,4175,7100,3375,4625,26700,21399,0
1057,1,0,182.5,130.0,200.0,242.0,4221,1326,3191,699,1030,627,2974,496,170,61,2804,435,77,49,5325,7100,3375,4625,26700,21399,0
1064,1,0,184.0,136.0,200.0,242.0,4159,1684,3219,1035,940,649,3317,586,405,71,2912,515,77,49,6250,7425,3375,4625,26775,21399,0
1071,1,0,188.0,138.0,200.0,242.0,4154,1594,3303,923,851,671,3640,706,620,111,3020,595,77,49,6650,7425,3375,4625,26775,21399,0
1079,1,0,200.0,142.0,200.0,242.0,4137,3392,3219,2743,918,649,3182,952,225,331,2957,621,77,49,7300,8400,3375,4625,26775,21399,0
1086,1,0,200.0,139.0,200.0,242.0,4355,3280,3415,2631,940,649,3259,1388,190,691,3069,697,78,49,7050,8450,3375,4625,27225,21674,0
1093,1,0,200.0,153.0,206.0,242.0,4249,3504,3331,2855,918,649,3428,594,430,371,2998,223,80,49,7850,8550,3375,4625,27225,21674,0
1100,1,0,190.5,157.0,206.0,242.0,4467,3672,3527,3023,940,649,3980,534,870,281,3110,253,80,49,7375,8525,3375,4625,27700,21949,0
1107,1,0,164.0,128.0,198.0,242.0,4439,3370,3611,2743,828,627,4502,940,1300,611,3202,329,80,49,6150,6150,3375,4625,29750,24224,0
1114,1,0,160.0,108.0,198.0,242.0,4534,2742,3639,2071,895,671,4144,1230,830,821,3314,409,80,39,4250,5500,3375,4625,31275,25524,0
1121,1,0,166.5,121.0,198.0,250.0,4708,1460,3835,811,873,649,3782,463,410,78,3372,385,80,39,3475,6125,3375,4625,32050,25836,0
1129,1,0,169.0,121.0,198.0,250.0,4697,1544,3779,895,918,649,3769,649,485,188,3284,461,80,39,4350,6125,3375,4625,32075,25836,0
1136,1,0,177.0,124.0,198.0,250.0,4781,1846,3863,1175,918,671,3333,563,195,147,3138,416,80,39,5200,6925,3375,4625,32075,25836,0
1143,1,0,181.0,128.0,206.0,250.0,4512,1768,3639,1119,873,649,3308,619,170,127,3138,492,82,39,5700,7625,3375,4625,32075,25836,0
1150,1,0,180.0,134.0,214.0,250.0,4322,2250,3471,1623,851,627,3736,530,540,37,3196,493,81,39,6500,7625,3375,4625,32125,25836,0
1157,1,0,188.0,134.0,208.0,250.0,4002,1936,3107,1287,895,649,3569,645,265,97,3304,548,76,37,6950,7625,3375,4625,32850,25936,0
1164,1,0,168.0,130.0,208.0,250.0,3857,1090,3051,419,806,671,4005,670,605,42,3400,628,74,35,6150,7900,3375,4625,33925,26236,0
1171,1,0,166.0,108.0,208.0,250.0,3706,1258,3079,643,627,615,3317,835,45,137,3272,698,74,35,5200,6725,3375,4625,35525,27561,0
1179,1,0,151.5,98.0,208.0,242.0,3638,1438,3079,979,559,459,3395,728,55,107,3340,621,74,35,3575,5850,3375,4525,37150,28511,0
1186,1,0,155.5,101.0,208.0,242.0,3560,1398,3023,951,537,447,3278,634,203,82,3075,552,74,35,3575,5950,3375,4525,37187,28511,0
1193,1,0,153.0,99.0,208.0,242.0,3762,1169,3135,699,627,470,3228,770,106,162,3122,608,74,35,3500,5850,3375,4525,37849,28611,0
1200,1,0,144.5,90.0,208.0,242.0,3818,1006,3303,559,515,447,3365,907,191,247,3174,660,74,35,3125,5375,3375,4525,39174,29086,0
1207,1,0,143.5,93.0,208.0,242.0,3398,816,3107,391,291,425,3432,814,226,102,3206,712,74,34,3075,5650,3375,4525,39224,29211,0
1214,1,0,148.5,93.0,202.0,242.0,3011,654,2743,195,268,459,3044,888,31,122,3013,766,73,34,3875,5925,3375,4525,39574,29286,0
1221,1,0,151.5,95.0,202.0,242.0,2832,441,2631,139,201,302,3174,806,141,37,3033,769,73,34,4325,5925,3375,4525,39624,29286,0
1229,1,0,160.5,92.0,202.0,242.0,3034,458,2855,167,179,291,3102,862,41,57,3061,805,73,34,4775,5850,3375,4525,39624,29561,0
1236,1,0,158.0,92.0,202.0,242.0,3319,379,3051,111,268,268,3204,904,111,67,3093,837,73,34,4950,5850,3375,4525,39749,29561,0
1243,1,0,155.5,92.0,202.0,242.0,3235,206,2967,27,268,179,3281,924,156,67,3125,857,72,34,5075,5975,3375,4525,39824,29561,0
1250,1,0,157.0,92.0,202.0,242.0,2927,458,2659,279,268,179,3133,998,151,117,2982,881,71,34,5500,5975,3375,4525,39849,29561,0
1257,1,0,160.0,89.0,202.0,242.0,2927,682,2659,503,268,179,3510,963,496,62,3014,901,72,29,5400,5975,3375,4525,39674,29761,0
1264,1,0,166.5,84.0,202.0,242.0,2944,179,2743,0,201,179,3320,987,286,62,3034,925,71,24,5725,5975,3375,4525,39899,30011,0
1271,1,0,142.5,76.0,202.0,242.0,2983,201,2715,0,268,201,3407,1011,466,62,2941,949,70,24,4475,5525,3375,4525,41399,30361,0
1279,1,0,150.0,59.0,202.0,242.0,3157,564,2911,363,246,201,3055,1100,86,127,2969,973,70,24,4300,3975,3375,4525,42124,32109,0
1286,1,0,148.0,59.0,192.0,242.0,3011,715,2743,559,268,156,3207,1181,306,192,2901,989,68,24,4150,3975,3375,4525,42624,32109,0
1293,1,0,156.0,63.0,192.0,242.0,3207,648,2939,447,268,201,2789,1000,131,37,2658,963,68,24,4350,3975,3375,4525,42624,32109,0
1300,1,0,156.5,55.0,192.0,242.0,3112,234,2911,55,201,179,2749,1020,71,37,2678,983,67,24,5025,3200,3375,4525,42624,32952,0
1307,1,0,157.5,55.0,186.0,242.0,3162,201,2995,0,167,201,2885,1044,181,37,2704,1007,67,24,5075,3200,3375,4525,42824,32952,0
1314,1,0,154.5,55.0,192.0,242.0,2894,256,2715,55,179,201,3010,1078,286,47,2724,1031,68,24,5375,3450,3375,4525,42824,32952,0
1321,1,0,163.5,57.0,192.0,242.0,2843,704,2687,503,156,201,2771,1087,31,32,2740,1055,68,24,5425,3450,3375,4525,42924,32952,0
1329,1,0,160.5,59.0,192.0,242.0,2681,1158,2547,979,134,179,3087,1147,331,72,2756,1075,69,24,5375,3450,3375,4525,43224,32952,0
